
n1000x8192-coef-inner-2048, 19, 30006, 13822, 437, 44284, 1.36533e+07
n1000x8192-coef-inner-2048, 16, 28480, 13741, 402, 42639, 1.36533e+07
n1000x8192-coef-inner-2048, 16, 27421, 12747, 392, 40576, 1.36533e+07
n1000x8192-coef-inner-2048, 16, 27565, 12783, 397, 40761, 1.36533e+07
n1000x8192-coef-inner-2048, 16, 27603, 12761, 396, 40776, 1.36533e+07
n1000x8192-coef-inner-2048, 16, 27374, 12667, 398, 40455, 1.36533e+07
n1000x8192-coef-inner-2048, 17, 27568, 12741, 407, 40733, 1.36533e+07
n1000x8192-coef-inner-2048, 16, 27502, 12729, 396, 40643, 1.36533e+07
n1000x8192-coef-inner-2048, 16, 27272, 12647, 397, 40332, 1.36533e+07
n1000x8192-coef-inner-2048, 16, 27592, 13204, 401, 41213, 1.36533e+07
n1000x8192-coef-inner-2048, 17, 27626, 12798, 401, 40842, 1.36533e+07
n1000x8192-coef-inner-2048, 20, 27578, 12736, 392, 40726, 1.36533e+07
n1000x8192-coef-inner-2048, 16, 27391, 13089, 392, 40888, 1.36533e+07
n1000x8192-coef-inner-2048, 16, 27611, 13165, 395, 41187, 1.36533e+07
n1000x8192-coef-inner-2048, 16, 27515, 12742, 396, 40669, 1.36533e+07
n1000x8192-coef-inner-2048, 16, 27549, 12750, 399, 40714, 1.36533e+07
n1000x8192-coef-inner-2048, 16, 27638, 12679, 395, 40728, 1.36533e+07
n1000x8192-coef-inner-2048, 22, 27532, 13382, 398, 41334, 1.36533e+07
n1000x8192-coef-inner-2048, 17, 27744, 13379, 399, 41539, 1.36533e+07
n1000x8192-coef-inner-2048, 16, 27801, 13186, 393, 41396, 1.36533e+07
n1000x8192-coef-inner-2048, 16, 27639, 13278, 398, 41331, 1.36533e+07
n1000x8192-coef-inner-2048, 16, 27683, 12743, 405, 40847, 1.36533e+07
n1000x8192-coef-inner-2048, 16, 27593, 12717, 397, 40723, 1.36533e+07
n1000x8192-coef-inner-2048, 16, 27709, 12681, 394, 40800, 1.36533e+07
n1000x8192-coef-inner-2048, 16, 27284, 12713, 392, 40405, 1.36533e+07
n1000x8192-coef-inner-2048, 16, 27536, 13170, 399, 41121, 1.36533e+07
n1000x8192-coef-inner-2048, 16, 27583, 12635, 394, 40628, 1.36533e+07
n1000x8192-coef-inner-2048, 22, 27577, 12773, 403, 40775, 1.36533e+07
n1000x8192-coef-inner-2048, 16, 27527, 12707, 396, 40646, 1.36533e+07
n1000x8192-coef-inner-2048, 16, 27899, 12824, 400, 41139, 1.36533e+07
n1000x8192-coef-inner-2048, 16, 27605, 12789, 396, 40806, 1.36533e+07
n1000x8192-coef-inner-2048, 16, 27422, 12662, 397, 40497, 1.36533e+07
n1000x8192-coef-inner-2048, 16, 27483, 13164, 394, 41057, 1.36533e+07
n1000x8192-coef-inner-2048, 16, 27515, 12736, 394, 40661, 1.36533e+07
n1000x8192-coef-inner-2048, 16, 27412, 12712, 400, 40540, 1.36533e+07
n1000x8192-coef-inner-2048, 16, 27624, 12723, 395, 40758, 1.36533e+07
n1000x8192-coef-inner-2048, 16, 27476, 12694, 396, 40582, 1.36533e+07
n1000x8192-coef-inner-2048, 16, 27476, 12751, 407, 40650, 1.36533e+07
n1000x8192-coef-inner-2048, 16, 27304, 12713, 394, 40427, 1.36533e+07
n1000x8192-coef-inner-2048, 16, 27508, 13291, 399, 41214, 1.36533e+07
n1000x8192-coef-inner-2048, 16, 27579, 12797, 395, 40787, 1.36533e+07
n1000x8192-coef-inner-2048, 16, 27321, 12612, 392, 40341, 1.36533e+07
n1000x8192-coef-inner-2048, 18, 27552, 13193, 396, 41159, 1.36533e+07
n1000x8192-coef-inner-2048, 17, 27494, 12986, 396, 40893, 1.36533e+07
n1000x8192-coef-inner-2048, 16, 27531, 13267, 397, 41211, 1.36533e+07
n1000x8192-coef-inner-2048, 16, 27542, 12812, 399, 40769, 1.36533e+07
n1000x8192-coef-inner-2048, 16, 27426, 12705, 405, 40552, 1.36533e+07
n1000x8192-coef-inner-2048, 19, 27501, 12765, 401, 40686, 1.36533e+07
n1000x8192-coef-inner-2048, 16, 27599, 13151, 396, 41162, 1.36533e+07
n1000x8192-coef-inner-2048, 16, 27600, 12847, 401, 40864, 1.36533e+07
n1000x8192-coef-inner-2048, 16, 27520, 12678, 400, 40614, 1.36533e+07
n1000x8192-coef-inner-2048, 16, 27437, 12747, 395, 40595, 1.36533e+07
n1000x8192-coef-inner-2048, 16, 27574, 12687, 401, 40678, 1.36533e+07
n1000x8192-coef-inner-2048, 16, 27500, 12722, 400, 40638, 1.36533e+07
n1000x8192-coef-inner-2048, 16, 27554, 12795, 400, 40765, 1.36533e+07
n1000x8192-coef-inner-2048, 16, 27522, 13307, 401, 41246, 1.36533e+07
n1000x8192-coef-inner-2048, 16, 27498, 13014, 396, 40924, 1.36533e+07
n1000x8192-coef-inner-2048, 16, 27508, 13176, 398, 41098, 1.36533e+07
n1000x8192-coef-inner-2048, 16, 27558, 13217, 395, 41186, 1.36533e+07
n1000x8192-coef-inner-2048, 28, 27510, 13212, 395, 41145, 1.36533e+07
n1000x8192-coef-inner-2048, 20, 27361, 13138, 397, 40916, 1.36533e+07
n1000x8192-coef-inner-2048, 16, 27392, 12720, 399, 40527, 1.36533e+07
n1000x8192-coef-inner-2048, 16, 27640, 13186, 398, 41240, 1.36533e+07
n1000x8192-coef-inner-2048, 20, 27388, 12666, 400, 40474, 1.36533e+07
n1000x8192-coef-inner-2048, 16, 27597, 12680, 393, 40686, 1.36533e+07
n1000x8192-coef-inner-2048, 22, 27672, 12795, 406, 40895, 1.36533e+07
n1000x8192-coef-inner-2048, 16, 27527, 12829, 400, 40772, 1.36533e+07
n1000x8192-coef-inner-2048, 16, 27512, 12619, 392, 40539, 1.36533e+07
n1000x8192-coef-inner-2048, 16, 27682, 12802, 399, 40899, 1.36533e+07
n1000x8192-coef-inner-2048, 16, 27437, 12677, 395, 40525, 1.36533e+07
n1000x8192-coef-inner-2048, 16, 27537, 12636, 394, 40583, 1.36533e+07
n1000x8192-coef-inner-2048, 17, 27667, 12756, 396, 40836, 1.36533e+07
n1000x8192-coef-inner-2048, 16, 27481, 12768, 404, 40669, 1.36533e+07
n1000x8192-coef-inner-2048, 16, 27518, 12680, 393, 40607, 1.36533e+07
n1000x8192-coef-inner-2048, 16, 27618, 12686, 399, 40719, 1.36533e+07
n1000x8192-coef-inner-2048, 28, 27357, 12644, 394, 40423, 1.36533e+07
n1000x8192-coef-inner-2048, 16, 27468, 12772, 401, 40657, 1.36533e+07
n1000x8192-coef-inner-2048, 16, 27582, 12714, 405, 40717, 1.36533e+07
n1000x8192-coef-inner-2048, 20, 27584, 13282, 401, 41287, 1.36533e+07
n1000x8192-coef-inner-2048, 16, 27462, 12722, 396, 40596, 1.36533e+07
n1000x8192-coef-inner-2048, 28, 27444, 13168, 401, 41041, 1.36533e+07
n1000x8192-coef-inner-2048, 16, 27492, 12601, 397, 40506, 1.36533e+07
n1000x8192-coef-inner-2048, 16, 27443, 12664, 402, 40525, 1.36533e+07
n1000x8192-coef-inner-2048, 18, 27529, 12679, 395, 40621, 1.36533e+07
n1000x8192-coef-inner-2048, 16, 27583, 12699, 394, 40692, 1.36533e+07
n1000x8192-coef-inner-2048, 17, 27420, 12910, 399, 40746, 1.36533e+07
n1000x8192-coef-inner-2048, 16, 27465, 12645, 396, 40522, 1.36533e+07
n1000x8192-coef-inner-2048, 16, 27549, 12870, 396, 40831, 1.36533e+07
n1000x8192-coef-inner-2048, 16, 27473, 13213, 397, 41099, 1.36533e+07
n1000x8192-coef-inner-2048, 17, 27451, 12665, 415, 40548, 1.36533e+07
n1000x8192-coef-inner-2048, 16, 27373, 12682, 402, 40473, 1.36533e+07
n1000x8192-coef-inner-2048, 16, 27527, 12663, 398, 40604, 1.36533e+07
n1000x8192-coef-inner-2048, 16, 27323, 12639, 399, 40377, 1.36533e+07
n1000x8192-coef-inner-2048, 16, 27613, 12670, 398, 40697, 1.36533e+07
n1000x8192-coef-inner-2048, 18, 27485, 12731, 402, 40636, 1.36533e+07
n1000x8192-coef-inner-2048, 16, 27470, 12715, 403, 40604, 1.36533e+07
n1000x8192-coef-inner-2048, 16, 27328, 12624, 392, 40360, 1.36533e+07
n1000x8192-coef-inner-2048, 16, 27451, 12700, 397, 40564, 1.36533e+07
n1000x8192-coef-inner-2048, 16, 27527, 12884, 397, 40824, 1.36533e+07
n1000x8192-coef-inner-2048, 16, 27577, 12568, 392, 40553, 1.36533e+07
n8192-coef-inner-2048, 17, 27, 13, 0, 57, 13655
n8192-coef-inner-2048, 20, 27, 13, 0, 60, 13655
n8192-coef-inner-2048, 20, 27, 13, 0, 60, 13655
n8192-coef-inner-2048, 16, 27, 13, 0, 56, 13655
n8192-coef-inner-2048, 16, 27, 13, 0, 56, 13655
n8192-coef-inner-2048, 23, 27, 14, 0, 64, 13655
n8192-coef-inner-2048, 16, 28, 13, 0, 57, 13655
n8192-coef-inner-2048, 16, 27, 13, 0, 56, 13655
n8192-coef-inner-2048, 16, 27, 13, 0, 56, 13655
n8192-coef-inner-2048, 16, 27, 13, 0, 56, 13655
n8192-coef-inner-2048, 16, 28, 13, 0, 57, 13655
n8192-coef-inner-2048, 16, 27, 14, 0, 57, 13655
n8192-coef-inner-2048, 16, 27, 13, 0, 56, 13655
n8192-coef-inner-2048, 16, 27, 13, 0, 56, 13655
n8192-coef-inner-2048, 16, 27, 13, 0, 56, 13655
n8192-coef-inner-2048, 16, 27, 13, 0, 56, 13655
n8192-coef-inner-2048, 16, 27, 13, 0, 56, 13655
n8192-coef-inner-2048, 16, 27, 13, 0, 56, 13655
n8192-coef-inner-2048, 16, 27, 13, 0, 56, 13655
n8192-coef-inner-2048, 16, 27, 13, 0, 56, 13655
n8192-coef-inner-2048, 16, 27, 13, 0, 56, 13655
n8192-coef-inner-2048, 22, 27, 13, 0, 62, 13655
n8192-coef-inner-2048, 16, 27, 13, 0, 56, 13655
n8192-coef-inner-2048, 20, 27, 14, 0, 61, 13655
n8192-coef-inner-2048, 16, 27, 13, 0, 56, 13655
n8192-coef-inner-2048, 16, 27, 13, 0, 56, 13655
n8192-coef-inner-2048, 16, 27, 13, 0, 56, 13655
n8192-coef-inner-2048, 16, 27, 13, 0, 56, 13655
n8192-coef-inner-2048, 16, 27, 13, 0, 56, 13655
n8192-coef-inner-2048, 16, 27, 13, 0, 56, 13655
n8192-coef-inner-2048, 16, 27, 13, 0, 56, 13655
n8192-coef-inner-2048, 16, 27, 13, 0, 56, 13655
n8192-coef-inner-2048, 16, 27, 13, 0, 56, 13655
n8192-coef-inner-2048, 16, 27, 13, 0, 56, 13655
n8192-coef-inner-2048, 16, 27, 13, 0, 56, 13655
n8192-coef-inner-2048, 16, 27, 13, 0, 56, 13655
n8192-coef-inner-2048, 17, 27, 13, 0, 57, 13655
n8192-coef-inner-2048, 16, 28, 13, 0, 57, 13655
n8192-coef-inner-2048, 16, 27, 13, 0, 56, 13655
n8192-coef-inner-2048, 16, 28, 13, 0, 57, 13655
n8192-coef-inner-2048, 16, 27, 13, 0, 56, 13655
n8192-coef-inner-2048, 16, 27, 13, 0, 56, 13655
n8192-coef-inner-2048, 16, 27, 13, 0, 56, 13655
n8192-coef-inner-2048, 16, 27, 13, 0, 56, 13655
n8192-coef-inner-2048, 16, 27, 13, 0, 56, 13655
n8192-coef-inner-2048, 16, 27, 13, 0, 56, 13655
n8192-coef-inner-2048, 16, 27, 13, 0, 56, 13655
n8192-coef-inner-2048, 16, 27, 13, 0, 56, 13655
n8192-coef-inner-2048, 16, 27, 13, 0, 56, 13655
n8192-coef-inner-2048, 16, 27, 13, 0, 56, 13655
n8192-coef-inner-2048, 16, 27, 13, 0, 56, 13655
n8192-coef-inner-2048, 16, 27, 13, 0, 56, 13655
n8192-coef-inner-2048, 24, 27, 16, 0, 67, 13655
n8192-coef-inner-2048, 16, 27, 14, 0, 57, 13655
n8192-coef-inner-2048, 16, 27, 13, 0, 56, 13655
n8192-coef-inner-2048, 16, 28, 13, 0, 57, 13655
n8192-coef-inner-2048, 18, 27, 13, 0, 58, 13655
n8192-coef-inner-2048, 16, 27, 13, 0, 56, 13655
n8192-coef-inner-2048, 16, 27, 13, 0, 56, 13655
n8192-coef-inner-2048, 16, 27, 13, 0, 56, 13655
n8192-coef-inner-2048, 16, 28, 13, 0, 57, 13655
n8192-coef-inner-2048, 16, 27, 13, 0, 56, 13655
n8192-coef-inner-2048, 16, 27, 13, 0, 56, 13655
n8192-coef-inner-2048, 16, 27, 13, 0, 56, 13655
n8192-coef-inner-2048, 16, 27, 13, 0, 56, 13655
n8192-coef-inner-2048, 16, 27, 13, 0, 56, 13655
n8192-coef-inner-2048, 16, 27, 13, 0, 56, 13655
n8192-coef-inner-2048, 16, 27, 13, 0, 56, 13655
n8192-coef-inner-2048, 16, 28, 13, 0, 57, 13655
n8192-coef-inner-2048, 16, 27, 13, 0, 56, 13655
n8192-coef-inner-2048, 18, 27, 13, 0, 58, 13655
n8192-coef-inner-2048, 19, 27, 13, 0, 59, 13655
n8192-coef-inner-2048, 16, 27, 13, 0, 56, 13655
n8192-coef-inner-2048, 16, 27, 13, 0, 56, 13655
n8192-coef-inner-2048, 18, 27, 13, 0, 58, 13655
n8192-coef-inner-2048, 16, 27, 13, 0, 56, 13655
n8192-coef-inner-2048, 16, 27, 13, 0, 56, 13655
n8192-coef-inner-2048, 17, 27, 14, 0, 58, 13655
n8192-coef-inner-2048, 16, 27, 13, 0, 56, 13655
n8192-coef-inner-2048, 16, 27, 14, 0, 57, 13655
n8192-coef-inner-2048, 16, 27, 13, 0, 56, 13655
n8192-coef-inner-2048, 16, 27, 13, 0, 56, 13655
n8192-coef-inner-2048, 16, 27, 14, 0, 57, 13655
n8192-coef-inner-2048, 20, 28, 14, 0, 62, 13655
n8192-coef-inner-2048, 16, 28, 13, 0, 57, 13655
n8192-coef-inner-2048, 18, 28, 14, 0, 60, 13655
n8192-coef-inner-2048, 16, 27, 13, 0, 56, 13655
n8192-coef-inner-2048, 16, 28, 13, 0, 57, 13655
n8192-coef-inner-2048, 16, 27, 13, 0, 56, 13655
n8192-coef-inner-2048, 16, 27, 14, 0, 57, 13655
n8192-coef-inner-2048, 16, 27, 13, 0, 56, 13655
n8192-coef-inner-2048, 16, 27, 13, 0, 56, 13655
n8192-coef-inner-2048, 16, 27, 13, 0, 56, 13655
n8192-coef-inner-2048, 16, 27, 14, 0, 57, 13655
n8192-coef-inner-2048, 16, 27, 13, 0, 56, 13655
n8192-coef-inner-2048, 16, 27, 13, 0, 56, 13655
n8192-coef-inner-2048, 18, 27, 14, 0, 59, 13655
n8192-coef-inner-2048, 16, 27, 13, 0, 56, 13655
n8192-coef-inner-2048, 16, 27, 13, 0, 56, 13655
n8192-coef-inner-2048, 16, 28, 13, 0, 57, 13655
n10x8192-coef-inner-2048, 16, 265, 125, 3, 409, 136535
n10x8192-coef-inner-2048, 16, 265, 125, 3, 409, 136535
n10x8192-coef-inner-2048, 16, 268, 125, 3, 412, 136535
n10x8192-coef-inner-2048, 16, 267, 126, 3, 412, 136535
n10x8192-coef-inner-2048, 16, 267, 127, 3, 413, 136535
n10x8192-coef-inner-2048, 16, 265, 125, 3, 409, 136535
n10x8192-coef-inner-2048, 16, 268, 125, 3, 412, 136535
n10x8192-coef-inner-2048, 16, 266, 125, 3, 410, 136535
n10x8192-coef-inner-2048, 16, 265, 124, 3, 408, 136535
n10x8192-coef-inner-2048, 28, 267, 130, 3, 428, 136535
n10x8192-coef-inner-2048, 16, 266, 124, 3, 409, 136535
n10x8192-coef-inner-2048, 16, 268, 126, 3, 413, 136535
n10x8192-coef-inner-2048, 16, 267, 125, 3, 411, 136535
n10x8192-coef-inner-2048, 16, 265, 124, 3, 408, 136535
n10x8192-coef-inner-2048, 19, 266, 129, 3, 417, 136535
n10x8192-coef-inner-2048, 16, 265, 125, 3, 409, 136535
n10x8192-coef-inner-2048, 16, 267, 125, 3, 411, 136535
n10x8192-coef-inner-2048, 16, 266, 137, 3, 422, 136535
n10x8192-coef-inner-2048, 16, 266, 125, 3, 410, 136535
n10x8192-coef-inner-2048, 24, 267, 131, 3, 425, 136535
n10x8192-coef-inner-2048, 16, 265, 125, 3, 409, 136535
n10x8192-coef-inner-2048, 16, 268, 126, 3, 413, 136535
n10x8192-coef-inner-2048, 16, 267, 125, 3, 411, 136535
n10x8192-coef-inner-2048, 18, 268, 126, 3, 415, 136535
n10x8192-coef-inner-2048, 16, 265, 126, 3, 410, 136535
n10x8192-coef-inner-2048, 18, 265, 126, 3, 412, 136535
n10x8192-coef-inner-2048, 16, 267, 126, 3, 412, 136535
n10x8192-coef-inner-2048, 23, 267, 130, 3, 423, 136535
n10x8192-coef-inner-2048, 16, 268, 125, 3, 412, 136535
n10x8192-coef-inner-2048, 16, 266, 125, 3, 410, 136535
n10x8192-coef-inner-2048, 16, 269, 128, 3, 416, 136535
n10x8192-coef-inner-2048, 16, 267, 126, 3, 412, 136535
n10x8192-coef-inner-2048, 16, 265, 125, 3, 409, 136535
n10x8192-coef-inner-2048, 16, 266, 125, 3, 410, 136535
n10x8192-coef-inner-2048, 16, 267, 131, 3, 417, 136535
n10x8192-coef-inner-2048, 16, 266, 126, 3, 411, 136535
n10x8192-coef-inner-2048, 16, 268, 125, 3, 412, 136535
n10x8192-coef-inner-2048, 16, 267, 126, 3, 412, 136535
n10x8192-coef-inner-2048, 16, 267, 125, 3, 411, 136535
n10x8192-coef-inner-2048, 16, 267, 128, 3, 414, 136535
n10x8192-coef-inner-2048, 16, 268, 126, 3, 413, 136535
n10x8192-coef-inner-2048, 16, 266, 125, 3, 410, 136535
n10x8192-coef-inner-2048, 16, 267, 126, 3, 412, 136535
n10x8192-coef-inner-2048, 16, 267, 124, 3, 410, 136535
n10x8192-coef-inner-2048, 16, 267, 125, 3, 411, 136535
n10x8192-coef-inner-2048, 16, 266, 125, 3, 410, 136535
n10x8192-coef-inner-2048, 16, 269, 126, 3, 414, 136535
n10x8192-coef-inner-2048, 16, 271, 125, 3, 415, 136535
n10x8192-coef-inner-2048, 16, 266, 125, 3, 410, 136535
n10x8192-coef-inner-2048, 16, 267, 125, 3, 411, 136535
n10x8192-coef-inner-2048, 16, 265, 125, 3, 409, 136535
n10x8192-coef-inner-2048, 16, 267, 126, 3, 412, 136535
n10x8192-coef-inner-2048, 16, 265, 125, 3, 409, 136535
n10x8192-coef-inner-2048, 16, 266, 126, 3, 411, 136535
n10x8192-coef-inner-2048, 16, 268, 126, 3, 413, 136535
n10x8192-coef-inner-2048, 16, 267, 124, 3, 410, 136535
n10x8192-coef-inner-2048, 16, 266, 135, 3, 420, 136535
n10x8192-coef-inner-2048, 17, 266, 125, 3, 411, 136535
n10x8192-coef-inner-2048, 16, 267, 126, 3, 412, 136535
n10x8192-coef-inner-2048, 16, 267, 125, 3, 411, 136535
n10x8192-coef-inner-2048, 16, 267, 126, 3, 412, 136535
n10x8192-coef-inner-2048, 20, 265, 131, 3, 419, 136535
n10x8192-coef-inner-2048, 16, 266, 124, 3, 409, 136535
n10x8192-coef-inner-2048, 16, 268, 125, 3, 412, 136535
n10x8192-coef-inner-2048, 16, 266, 125, 3, 410, 136535
n10x8192-coef-inner-2048, 16, 267, 127, 3, 413, 136535
n10x8192-coef-inner-2048, 18, 266, 126, 3, 413, 136535
n10x8192-coef-inner-2048, 16, 265, 127, 3, 411, 136535
n10x8192-coef-inner-2048, 16, 267, 124, 3, 410, 136535
n10x8192-coef-inner-2048, 16, 266, 125, 3, 410, 136535
n10x8192-coef-inner-2048, 16, 268, 125, 3, 412, 136535
n10x8192-coef-inner-2048, 16, 265, 125, 3, 409, 136535
n10x8192-coef-inner-2048, 16, 267, 124, 3, 410, 136535
n10x8192-coef-inner-2048, 20, 268, 124, 3, 415, 136535
n10x8192-coef-inner-2048, 16, 266, 125, 3, 410, 136535
n10x8192-coef-inner-2048, 16, 268, 126, 3, 413, 136535
n10x8192-coef-inner-2048, 20, 267, 126, 3, 416, 136535
n10x8192-coef-inner-2048, 18, 267, 125, 3, 413, 136535
n10x8192-coef-inner-2048, 18, 265, 125, 3, 411, 136535
n10x8192-coef-inner-2048, 17, 267, 125, 3, 412, 136535
n10x8192-coef-inner-2048, 16, 267, 125, 3, 411, 136535
n10x8192-coef-inner-2048, 16, 266, 125, 3, 410, 136535
n10x8192-coef-inner-2048, 16, 268, 124, 3, 411, 136535
n10x8192-coef-inner-2048, 16, 267, 126, 3, 412, 136535
n10x8192-coef-inner-2048, 16, 267, 125, 3, 411, 136535
n10x8192-coef-inner-2048, 16, 265, 125, 3, 409, 136535
n10x8192-coef-inner-2048, 16, 268, 127, 3, 414, 136535
n10x8192-coef-inner-2048, 16, 267, 125, 3, 411, 136535
n10x8192-coef-inner-2048, 16, 266, 127, 3, 412, 136535
n10x8192-coef-inner-2048, 20, 267, 125, 3, 415, 136535
n10x8192-coef-inner-2048, 16, 268, 126, 3, 413, 136535
n10x8192-coef-inner-2048, 16, 268, 127, 3, 414, 136535
n10x8192-coef-inner-2048, 20, 268, 124, 3, 415, 136535
n10x8192-coef-inner-2048, 23, 267, 132, 3, 425, 136535
n10x8192-coef-inner-2048, 16, 267, 125, 3, 411, 136535
n10x8192-coef-inner-2048, 16, 267, 125, 3, 411, 136535
n10x8192-coef-inner-2048, 16, 268, 125, 3, 412, 136535
n10x8192-coef-inner-2048, 20, 265, 124, 3, 412, 136535
n10x8192-coef-inner-2048, 17, 267, 125, 3, 412, 136535
n10x8192-coef-inner-2048, 22, 266, 125, 3, 416, 136535
n25x8192-coef-inner-2048, 16, 666, 312, 9, 1003, 341335
n25x8192-coef-inner-2048, 16, 668, 310, 9, 1003, 341335
n25x8192-coef-inner-2048, 16, 667, 316, 9, 1008, 341335
n25x8192-coef-inner-2048, 16, 671, 313, 9, 1009, 341335
n25x8192-coef-inner-2048, 22, 665, 324, 9, 1020, 341335
n25x8192-coef-inner-2048, 18, 666, 312, 9, 1005, 341335
n25x8192-coef-inner-2048, 16, 667, 317, 9, 1009, 341335
n25x8192-coef-inner-2048, 19, 671, 311, 9, 1010, 341335
n25x8192-coef-inner-2048, 18, 670, 315, 9, 1012, 341335
n25x8192-coef-inner-2048, 16, 666, 312, 9, 1003, 341335
n25x8192-coef-inner-2048, 16, 671, 316, 9, 1012, 341335
n25x8192-coef-inner-2048, 16, 666, 311, 9, 1002, 341335
n25x8192-coef-inner-2048, 17, 663, 312, 9, 1001, 341335
n25x8192-coef-inner-2048, 16, 665, 318, 9, 1008, 341335
n25x8192-coef-inner-2048, 16, 668, 315, 9, 1008, 341335
n25x8192-coef-inner-2048, 17, 666, 326, 9, 1018, 341335
n25x8192-coef-inner-2048, 16, 666, 313, 9, 1004, 341335
n25x8192-coef-inner-2048, 16, 671, 314, 9, 1010, 341335
n25x8192-coef-inner-2048, 16, 678, 314, 9, 1017, 341335
n25x8192-coef-inner-2048, 28, 665, 312, 9, 1014, 341335
n25x8192-coef-inner-2048, 16, 667, 313, 9, 1005, 341335
n25x8192-coef-inner-2048, 16, 670, 317, 9, 1012, 341335
n25x8192-coef-inner-2048, 16, 666, 310, 9, 1001, 341335
n25x8192-coef-inner-2048, 16, 668, 312, 9, 1005, 341335
n25x8192-coef-inner-2048, 16, 669, 314, 9, 1008, 341335
n25x8192-coef-inner-2048, 16, 669, 314, 9, 1008, 341335
n25x8192-coef-inner-2048, 16, 671, 315, 9, 1011, 341335
n25x8192-coef-inner-2048, 16, 668, 323, 9, 1016, 341335
n25x8192-coef-inner-2048, 16, 666, 313, 9, 1004, 341335
n25x8192-coef-inner-2048, 16, 667, 315, 9, 1007, 341335
n25x8192-coef-inner-2048, 16, 678, 316, 9, 1019, 341335
n25x8192-coef-inner-2048, 16, 667, 312, 9, 1004, 341335
n25x8192-coef-inner-2048, 16, 669, 312, 9, 1006, 341335
n25x8192-coef-inner-2048, 16, 670, 314, 9, 1009, 341335
n25x8192-coef-inner-2048, 16, 668, 309, 9, 1002, 341335
n25x8192-coef-inner-2048, 16, 669, 317, 9, 1011, 341335
n25x8192-coef-inner-2048, 16, 669, 331, 9, 1025, 341335
n25x8192-coef-inner-2048, 16, 670, 313, 9, 1008, 341335
n25x8192-coef-inner-2048, 16, 670, 311, 9, 1006, 341335
n25x8192-coef-inner-2048, 16, 668, 313, 8, 1005, 341335
n25x8192-coef-inner-2048, 17, 668, 326, 9, 1020, 341335
n25x8192-coef-inner-2048, 16, 668, 312, 9, 1005, 341335
n25x8192-coef-inner-2048, 16, 667, 312, 9, 1004, 341335
n25x8192-coef-inner-2048, 25, 668, 325, 9, 1027, 341335
n25x8192-coef-inner-2048, 16, 667, 315, 9, 1007, 341335
n25x8192-coef-inner-2048, 16, 667, 315, 9, 1007, 341335
n25x8192-coef-inner-2048, 17, 668, 316, 9, 1010, 341335
n25x8192-coef-inner-2048, 16, 666, 315, 9, 1006, 341335
n25x8192-coef-inner-2048, 16, 666, 311, 9, 1002, 341335
n25x8192-coef-inner-2048, 16, 669, 311, 9, 1005, 341335
n25x8192-coef-inner-2048, 16, 667, 310, 9, 1002, 341335
n25x8192-coef-inner-2048, 16, 665, 312, 9, 1002, 341335
n25x8192-coef-inner-2048, 16, 668, 314, 9, 1007, 341335
n25x8192-coef-inner-2048, 16, 668, 314, 9, 1007, 341335
n25x8192-coef-inner-2048, 16, 669, 313, 9, 1007, 341335
n25x8192-coef-inner-2048, 16, 668, 316, 9, 1009, 341335
n25x8192-coef-inner-2048, 16, 666, 311, 9, 1002, 341335
n25x8192-coef-inner-2048, 22, 666, 326, 9, 1023, 341335
n25x8192-coef-inner-2048, 16, 668, 314, 9, 1007, 341335
n25x8192-coef-inner-2048, 16, 667, 313, 9, 1005, 341335
n25x8192-coef-inner-2048, 16, 673, 315, 9, 1013, 341335
n25x8192-coef-inner-2048, 16, 671, 313, 9, 1009, 341335
n25x8192-coef-inner-2048, 21, 670, 313, 9, 1013, 341335
n25x8192-coef-inner-2048, 16, 668, 312, 8, 1004, 341335
n25x8192-coef-inner-2048, 28, 672, 313, 9, 1022, 341335
n25x8192-coef-inner-2048, 16, 669, 311, 9, 1005, 341335
n25x8192-coef-inner-2048, 16, 669, 313, 9, 1007, 341335
n25x8192-coef-inner-2048, 16, 666, 312, 9, 1003, 341335
n25x8192-coef-inner-2048, 16, 665, 313, 9, 1003, 341335
n25x8192-coef-inner-2048, 17, 668, 326, 9, 1020, 341335
n25x8192-coef-inner-2048, 17, 666, 324, 9, 1016, 341335
n25x8192-coef-inner-2048, 16, 666, 317, 9, 1008, 341335
n25x8192-coef-inner-2048, 20, 665, 314, 9, 1008, 341335
n25x8192-coef-inner-2048, 16, 667, 313, 9, 1005, 341335
n25x8192-coef-inner-2048, 16, 668, 312, 9, 1005, 341335
n25x8192-coef-inner-2048, 17, 670, 313, 9, 1009, 341335
n25x8192-coef-inner-2048, 16, 667, 313, 9, 1005, 341335
n25x8192-coef-inner-2048, 16, 667, 313, 9, 1005, 341335
n25x8192-coef-inner-2048, 16, 669, 311, 9, 1005, 341335
n25x8192-coef-inner-2048, 16, 671, 313, 9, 1009, 341335
n25x8192-coef-inner-2048, 20, 666, 323, 9, 1018, 341335
n25x8192-coef-inner-2048, 16, 668, 314, 9, 1007, 341335
n25x8192-coef-inner-2048, 16, 678, 316, 9, 1019, 341335
n25x8192-coef-inner-2048, 20, 671, 326, 9, 1026, 341335
n25x8192-coef-inner-2048, 16, 670, 314, 9, 1009, 341335
n25x8192-coef-inner-2048, 17, 673, 313, 9, 1012, 341335
n25x8192-coef-inner-2048, 16, 668, 316, 9, 1009, 341335
n25x8192-coef-inner-2048, 16, 668, 317, 9, 1010, 341335
n25x8192-coef-inner-2048, 16, 669, 314, 9, 1008, 341335
n25x8192-coef-inner-2048, 16, 672, 317, 9, 1014, 341335
n25x8192-coef-inner-2048, 16, 670, 312, 9, 1007, 341335
n25x8192-coef-inner-2048, 16, 666, 312, 9, 1003, 341335
n25x8192-coef-inner-2048, 23, 670, 324, 9, 1026, 341335
n25x8192-coef-inner-2048, 16, 670, 312, 9, 1007, 341335
n25x8192-coef-inner-2048, 16, 674, 329, 9, 1028, 341335
n25x8192-coef-inner-2048, 19, 671, 327, 9, 1026, 341335
n25x8192-coef-inner-2048, 16, 670, 316, 9, 1011, 341335
n25x8192-coef-inner-2048, 18, 673, 329, 9, 1029, 341335
n25x8192-coef-inner-2048, 16, 675, 312, 9, 1012, 341335
n25x8192-coef-inner-2048, 16, 665, 310, 9, 1000, 341335
n50x8192-coef-inner-2048, 16, 1334, 628, 19, 1997, 682666
n50x8192-coef-inner-2048, 16, 1333, 628, 19, 1996, 682666
n50x8192-coef-inner-2048, 16, 1339, 621, 19, 1995, 682666
n50x8192-coef-inner-2048, 16, 1330, 628, 18, 1992, 682666
n50x8192-coef-inner-2048, 16, 1337, 625, 19, 1997, 682666
n50x8192-coef-inner-2048, 16, 1331, 626, 19, 1992, 682666
n50x8192-coef-inner-2048, 17, 1337, 652, 19, 2025, 682666
n50x8192-coef-inner-2048, 16, 1337, 623, 18, 1994, 682666
n50x8192-coef-inner-2048, 16, 1332, 623, 18, 1989, 682666
n50x8192-coef-inner-2048, 16, 1342, 629, 18, 2005, 682666
n50x8192-coef-inner-2048, 17, 1336, 627, 19, 1999, 682666
n50x8192-coef-inner-2048, 18, 1335, 622, 20, 1995, 682666
n50x8192-coef-inner-2048, 16, 1334, 627, 19, 1996, 682666
n50x8192-coef-inner-2048, 20, 1335, 649, 18, 2022, 682666
n50x8192-coef-inner-2048, 23, 1332, 650, 19, 2024, 682666
n50x8192-coef-inner-2048, 16, 1336, 631, 19, 2002, 682666
n50x8192-coef-inner-2048, 17, 1343, 633, 19, 2012, 682666
n50x8192-coef-inner-2048, 16, 1339, 632, 19, 2006, 682666
n50x8192-coef-inner-2048, 16, 1336, 627, 19, 1998, 682666
n50x8192-coef-inner-2048, 19, 1333, 630, 19, 2001, 682666
n50x8192-coef-inner-2048, 16, 1363, 640, 19, 2038, 682666
n50x8192-coef-inner-2048, 16, 1338, 626, 19, 1999, 682666
n50x8192-coef-inner-2048, 16, 1338, 626, 18, 1998, 682666
n50x8192-coef-inner-2048, 16, 1340, 636, 19, 2011, 682666
n50x8192-coef-inner-2048, 16, 1344, 634, 19, 2013, 682666
n50x8192-coef-inner-2048, 16, 1337, 633, 18, 2004, 682666
n50x8192-coef-inner-2048, 16, 1335, 627, 18, 1996, 682666
n50x8192-coef-inner-2048, 16, 1334, 632, 19, 2001, 682666
n50x8192-coef-inner-2048, 16, 1339, 630, 19, 2004, 682666
n50x8192-coef-inner-2048, 16, 1336, 634, 19, 2005, 682666
n50x8192-coef-inner-2048, 16, 1344, 639, 19, 2018, 682666
n50x8192-coef-inner-2048, 16, 1357, 635, 19, 2027, 682666
n50x8192-coef-inner-2048, 16, 1347, 636, 19, 2018, 682666
n50x8192-coef-inner-2048, 16, 1341, 632, 19, 2008, 682666
n50x8192-coef-inner-2048, 16, 1347, 631, 19, 2013, 682666
n50x8192-coef-inner-2048, 20, 1351, 657, 19, 2047, 682666
n50x8192-coef-inner-2048, 17, 1340, 630, 19, 2006, 682666
n50x8192-coef-inner-2048, 16, 1340, 626, 19, 2001, 682666
n50x8192-coef-inner-2048, 16, 1342, 631, 19, 2008, 682666
n50x8192-coef-inner-2048, 16, 1343, 628, 19, 2006, 682666
n50x8192-coef-inner-2048, 16, 1339, 626, 18, 1999, 682666
n50x8192-coef-inner-2048, 16, 1334, 631, 19, 2000, 682666
n50x8192-coef-inner-2048, 16, 1348, 629, 18, 2011, 682666
n50x8192-coef-inner-2048, 16, 1336, 623, 18, 1993, 682666
n50x8192-coef-inner-2048, 16, 1337, 625, 19, 1997, 682666
n50x8192-coef-inner-2048, 16, 1338, 625, 19, 1998, 682666
n50x8192-coef-inner-2048, 16, 1340, 630, 18, 2004, 682666
n50x8192-coef-inner-2048, 23, 1335, 652, 18, 2028, 682666
n50x8192-coef-inner-2048, 16, 1336, 623, 18, 1993, 682666
n50x8192-coef-inner-2048, 16, 1348, 629, 18, 2011, 682666
n50x8192-coef-inner-2048, 16, 1342, 625, 19, 2002, 682666
n50x8192-coef-inner-2048, 16, 1336, 628, 18, 1998, 682666
n50x8192-coef-inner-2048, 16, 1345, 625, 18, 2004, 682666
n50x8192-coef-inner-2048, 20, 1350, 633, 18, 2021, 682666
n50x8192-coef-inner-2048, 16, 1342, 626, 18, 2002, 682666
n50x8192-coef-inner-2048, 21, 1354, 629, 18, 2022, 682666
n50x8192-coef-inner-2048, 18, 1347, 629, 19, 2013, 682666
n50x8192-coef-inner-2048, 16, 1343, 629, 19, 2007, 682666
n50x8192-coef-inner-2048, 17, 1338, 655, 19, 2029, 682666
n50x8192-coef-inner-2048, 16, 1335, 632, 19, 2002, 682666
n50x8192-coef-inner-2048, 18, 1342, 660, 19, 2039, 682666
n50x8192-coef-inner-2048, 16, 1338, 628, 19, 2001, 682666
n50x8192-coef-inner-2048, 16, 1339, 628, 19, 2002, 682666
n50x8192-coef-inner-2048, 16, 1330, 631, 18, 1995, 682666
n50x8192-coef-inner-2048, 16, 1332, 625, 18, 1991, 682666
n50x8192-coef-inner-2048, 16, 1332, 620, 19, 1987, 682666
n50x8192-coef-inner-2048, 16, 1331, 623, 18, 1988, 682666
n50x8192-coef-inner-2048, 16, 1336, 627, 19, 1998, 682666
n50x8192-coef-inner-2048, 17, 1334, 626, 18, 1995, 682666
n50x8192-coef-inner-2048, 16, 1330, 625, 18, 1989, 682666
n50x8192-coef-inner-2048, 16, 1336, 623, 19, 1994, 682666
n50x8192-coef-inner-2048, 16, 1331, 624, 19, 1990, 682666
n50x8192-coef-inner-2048, 16, 1334, 628, 18, 1996, 682666
n50x8192-coef-inner-2048, 19, 1337, 662, 19, 2037, 682666
n50x8192-coef-inner-2048, 16, 1337, 634, 19, 2006, 682666
n50x8192-coef-inner-2048, 21, 1349, 658, 19, 2047, 682666
n50x8192-coef-inner-2048, 16, 1341, 627, 19, 2003, 682666
n50x8192-coef-inner-2048, 16, 1344, 629, 19, 2008, 682666
n50x8192-coef-inner-2048, 16, 1335, 642, 19, 2012, 682666
n50x8192-coef-inner-2048, 16, 1345, 631, 18, 2010, 682666
n50x8192-coef-inner-2048, 17, 1334, 630, 19, 2000, 682666
n50x8192-coef-inner-2048, 16, 1340, 631, 19, 2006, 682666
n50x8192-coef-inner-2048, 16, 1346, 633, 19, 2014, 682666
n50x8192-coef-inner-2048, 16, 1348, 629, 19, 2012, 682666
n50x8192-coef-inner-2048, 16, 1342, 636, 18, 2012, 682666
n50x8192-coef-inner-2048, 16, 1338, 631, 18, 2003, 682666
n50x8192-coef-inner-2048, 16, 1339, 634, 19, 2008, 682666
n50x8192-coef-inner-2048, 16, 1333, 626, 18, 1993, 682666
n50x8192-coef-inner-2048, 16, 1340, 626, 18, 2000, 682666
n50x8192-coef-inner-2048, 18, 1344, 636, 19, 2017, 682666
n50x8192-coef-inner-2048, 16, 1337, 630, 18, 2001, 682666
n50x8192-coef-inner-2048, 24, 1334, 654, 18, 2030, 682666
n50x8192-coef-inner-2048, 16, 1333, 623, 18, 1990, 682666
n50x8192-coef-inner-2048, 16, 1339, 633, 18, 2006, 682666
n50x8192-coef-inner-2048, 16, 1340, 629, 18, 2003, 682666
n50x8192-coef-inner-2048, 16, 1335, 627, 18, 1996, 682666
n50x8192-coef-inner-2048, 16, 1336, 630, 19, 2001, 682666
n50x8192-coef-inner-2048, 23, 1340, 653, 18, 2034, 682666
n50x8192-coef-inner-2048, 17, 1338, 626, 19, 2000, 682666
n50x8192-coef-inner-2048, 16, 1339, 625, 18, 1998, 682666
n100x8192-coef-inner-2048, 16, 2685, 1255, 40, 3996, 1.36534e+06
n100x8192-coef-inner-2048, 16, 2677, 1267, 39, 3999, 1.36534e+06
n100x8192-coef-inner-2048, 20, 2693, 1259, 38, 4010, 1.36534e+06
n100x8192-coef-inner-2048, 27, 2684, 1318, 38, 4067, 1.36534e+06
n100x8192-coef-inner-2048, 16, 2683, 1258, 38, 3995, 1.36534e+06
n100x8192-coef-inner-2048, 16, 2680, 1261, 39, 3996, 1.36534e+06
n100x8192-coef-inner-2048, 16, 2691, 1264, 39, 4010, 1.36534e+06
n100x8192-coef-inner-2048, 17, 2685, 1261, 39, 4002, 1.36534e+06
n100x8192-coef-inner-2048, 16, 2687, 1312, 39, 4054, 1.36534e+06
n100x8192-coef-inner-2048, 16, 2679, 1246, 38, 3979, 1.36534e+06
n100x8192-coef-inner-2048, 16, 2676, 1253, 38, 3983, 1.36534e+06
n100x8192-coef-inner-2048, 16, 2682, 1258, 39, 3995, 1.36534e+06
n100x8192-coef-inner-2048, 16, 2671, 1250, 38, 3975, 1.36534e+06
n100x8192-coef-inner-2048, 16, 2672, 1247, 38, 3973, 1.36534e+06
n100x8192-coef-inner-2048, 16, 2676, 1250, 38, 3980, 1.36534e+06
n100x8192-coef-inner-2048, 16, 2677, 1254, 39, 3986, 1.36534e+06
n100x8192-coef-inner-2048, 16, 2680, 1253, 38, 3987, 1.36534e+06
n100x8192-coef-inner-2048, 21, 2684, 1254, 39, 3998, 1.36534e+06
n100x8192-coef-inner-2048, 16, 2669, 1267, 39, 3991, 1.36534e+06
n100x8192-coef-inner-2048, 16, 2678, 1258, 38, 3990, 1.36534e+06
n100x8192-coef-inner-2048, 16, 2680, 1252, 39, 3987, 1.36534e+06
n100x8192-coef-inner-2048, 28, 2677, 1304, 38, 4047, 1.36534e+06
n100x8192-coef-inner-2048, 17, 2674, 1255, 38, 3984, 1.36534e+06
n100x8192-coef-inner-2048, 19, 2676, 1237, 38, 3970, 1.36534e+06
n100x8192-coef-inner-2048, 16, 2672, 1244, 38, 3970, 1.36534e+06
n100x8192-coef-inner-2048, 16, 2671, 1242, 39, 3968, 1.36534e+06
n100x8192-coef-inner-2048, 16, 2663, 1254, 38, 3971, 1.36534e+06
n100x8192-coef-inner-2048, 19, 2677, 1251, 38, 3985, 1.36534e+06
n100x8192-coef-inner-2048, 16, 2677, 1254, 38, 3985, 1.36534e+06
n100x8192-coef-inner-2048, 16, 2668, 1247, 38, 3969, 1.36534e+06
n100x8192-coef-inner-2048, 16, 2680, 1261, 37, 3994, 1.36534e+06
n100x8192-coef-inner-2048, 16, 2672, 1254, 38, 3980, 1.36534e+06
n100x8192-coef-inner-2048, 16, 2676, 1253, 38, 3983, 1.36534e+06
n100x8192-coef-inner-2048, 16, 2683, 1254, 38, 3991, 1.36534e+06
n100x8192-coef-inner-2048, 27, 2668, 1302, 38, 4035, 1.36534e+06
n100x8192-coef-inner-2048, 16, 2677, 1259, 38, 3990, 1.36534e+06
n100x8192-coef-inner-2048, 20, 2682, 1315, 39, 4056, 1.36534e+06
n100x8192-coef-inner-2048, 17, 2697, 1262, 38, 4014, 1.36534e+06
n100x8192-coef-inner-2048, 16, 2676, 1256, 38, 3986, 1.36534e+06
n100x8192-coef-inner-2048, 21, 2690, 1258, 41, 4010, 1.36534e+06
n100x8192-coef-inner-2048, 19, 2670, 1314, 39, 4042, 1.36534e+06
n100x8192-coef-inner-2048, 16, 2694, 1259, 39, 4008, 1.36534e+06
n100x8192-coef-inner-2048, 16, 2679, 1269, 38, 4002, 1.36534e+06
n100x8192-coef-inner-2048, 16, 2699, 1262, 38, 4015, 1.36534e+06
n100x8192-coef-inner-2048, 16, 2691, 1265, 39, 4011, 1.36534e+06
n100x8192-coef-inner-2048, 16, 2681, 1258, 38, 3993, 1.36534e+06
n100x8192-coef-inner-2048, 16, 2684, 1253, 38, 3991, 1.36534e+06
n100x8192-coef-inner-2048, 16, 2675, 1265, 38, 3994, 1.36534e+06
n100x8192-coef-inner-2048, 18, 2697, 1259, 38, 4012, 1.36534e+06
n100x8192-coef-inner-2048, 16, 2683, 1260, 38, 3997, 1.36534e+06
n100x8192-coef-inner-2048, 16, 2685, 1251, 38, 3990, 1.36534e+06
n100x8192-coef-inner-2048, 16, 2685, 1253, 38, 3992, 1.36534e+06
n100x8192-coef-inner-2048, 16, 2672, 1259, 39, 3986, 1.36534e+06
n100x8192-coef-inner-2048, 16, 2678, 1255, 38, 3987, 1.36534e+06
n100x8192-coef-inner-2048, 16, 2674, 1254, 38, 3982, 1.36534e+06
n100x8192-coef-inner-2048, 16, 2681, 1255, 39, 3991, 1.36534e+06
n100x8192-coef-inner-2048, 16, 2667, 1255, 38, 3976, 1.36534e+06
n100x8192-coef-inner-2048, 16, 2676, 1249, 38, 3979, 1.36534e+06
n100x8192-coef-inner-2048, 17, 2669, 1247, 38, 3971, 1.36534e+06
n100x8192-coef-inner-2048, 16, 2669, 1251, 38, 3974, 1.36534e+06
n100x8192-coef-inner-2048, 18, 2677, 1254, 39, 3988, 1.36534e+06
n100x8192-coef-inner-2048, 16, 2672, 1259, 38, 3985, 1.36534e+06
n100x8192-coef-inner-2048, 16, 2675, 1252, 38, 3981, 1.36534e+06
n100x8192-coef-inner-2048, 16, 2688, 1248, 38, 3990, 1.36534e+06
n100x8192-coef-inner-2048, 16, 2673, 1258, 38, 3985, 1.36534e+06
n100x8192-coef-inner-2048, 16, 2706, 1248, 38, 4008, 1.36534e+06
n100x8192-coef-inner-2048, 16, 2679, 1254, 38, 3987, 1.36534e+06
n100x8192-coef-inner-2048, 16, 2671, 1251, 39, 3977, 1.36534e+06
n100x8192-coef-inner-2048, 17, 2669, 1252, 38, 3976, 1.36534e+06
n100x8192-coef-inner-2048, 16, 2678, 1253, 38, 3985, 1.36534e+06
n100x8192-coef-inner-2048, 16, 2674, 1248, 38, 3976, 1.36534e+06
n100x8192-coef-inner-2048, 16, 2667, 1257, 38, 3978, 1.36534e+06
n100x8192-coef-inner-2048, 16, 2679, 1256, 38, 3989, 1.36534e+06
n100x8192-coef-inner-2048, 16, 2673, 1246, 38, 3973, 1.36534e+06
n100x8192-coef-inner-2048, 16, 2670, 1243, 38, 3967, 1.36534e+06
n100x8192-coef-inner-2048, 16, 2686, 1254, 38, 3994, 1.36534e+06
n100x8192-coef-inner-2048, 16, 2685, 1254, 39, 3994, 1.36534e+06
n100x8192-coef-inner-2048, 16, 2669, 1272, 38, 3995, 1.36534e+06
n100x8192-coef-inner-2048, 16, 2696, 1247, 38, 3997, 1.36534e+06
n100x8192-coef-inner-2048, 16, 2676, 1260, 38, 3990, 1.36534e+06
n100x8192-coef-inner-2048, 16, 2683, 1252, 38, 3989, 1.36534e+06
n100x8192-coef-inner-2048, 16, 2685, 1252, 38, 3991, 1.36534e+06
n100x8192-coef-inner-2048, 16, 2673, 1250, 38, 3977, 1.36534e+06
n100x8192-coef-inner-2048, 16, 2677, 1246, 38, 3977, 1.36534e+06
n100x8192-coef-inner-2048, 16, 2679, 1250, 38, 3983, 1.36534e+06
n100x8192-coef-inner-2048, 16, 2671, 1250, 38, 3975, 1.36534e+06
n100x8192-coef-inner-2048, 17, 2666, 1305, 39, 4027, 1.36534e+06
n100x8192-coef-inner-2048, 16, 2678, 1251, 38, 3983, 1.36534e+06
n100x8192-coef-inner-2048, 16, 2671, 1255, 38, 3980, 1.36534e+06
n100x8192-coef-inner-2048, 16, 2680, 1251, 38, 3985, 1.36534e+06
n100x8192-coef-inner-2048, 18, 2671, 1261, 39, 3989, 1.36534e+06
n100x8192-coef-inner-2048, 17, 2674, 1261, 38, 3990, 1.36534e+06
n100x8192-coef-inner-2048, 16, 2694, 1252, 38, 4000, 1.36534e+06
n100x8192-coef-inner-2048, 20, 2671, 1246, 38, 3975, 1.36534e+06
n100x8192-coef-inner-2048, 26, 2674, 1315, 38, 4053, 1.36534e+06
n100x8192-coef-inner-2048, 21, 2678, 1305, 38, 4042, 1.36534e+06
n100x8192-coef-inner-2048, 16, 2675, 1301, 38, 4030, 1.36534e+06
n100x8192-coef-inner-2048, 16, 2682, 1246, 39, 3983, 1.36534e+06
n100x8192-coef-inner-2048, 23, 2673, 1295, 38, 4029, 1.36534e+06
n100x8192-coef-inner-2048, 16, 2663, 1248, 38, 3965, 1.36534e+06
n250x8192-coef-inner-2048, 16, 668, 315, 9, 1008, 341335
n250x8192-coef-inner-2048, 16, 668, 311, 9, 1004, 341335
n250x8192-coef-inner-2048, 16, 665, 312, 9, 1002, 341335
n250x8192-coef-inner-2048, 16, 663, 310, 9, 998, 341335
n250x8192-coef-inner-2048, 16, 667, 309, 9, 1001, 341335
n250x8192-coef-inner-2048, 16, 664, 311, 9, 1000, 341335
n250x8192-coef-inner-2048, 16, 662, 311, 9, 998, 341335
n250x8192-coef-inner-2048, 28, 667, 315, 9, 1019, 341335
n250x8192-coef-inner-2048, 16, 666, 314, 9, 1005, 341335
n250x8192-coef-inner-2048, 16, 664, 313, 9, 1002, 341335
n250x8192-coef-inner-2048, 24, 662, 312, 9, 1007, 341335
n250x8192-coef-inner-2048, 16, 663, 314, 9, 1002, 341335
n250x8192-coef-inner-2048, 16, 666, 312, 8, 1002, 341335
n250x8192-coef-inner-2048, 16, 664, 313, 9, 1002, 341335
n250x8192-coef-inner-2048, 16, 664, 312, 9, 1001, 341335
n250x8192-coef-inner-2048, 16, 667, 313, 9, 1005, 341335
n250x8192-coef-inner-2048, 16, 669, 310, 9, 1004, 341335
n250x8192-coef-inner-2048, 16, 661, 310, 9, 996, 341335
n250x8192-coef-inner-2048, 16, 666, 313, 9, 1004, 341335
n250x8192-coef-inner-2048, 16, 666, 312, 9, 1003, 341335
n250x8192-coef-inner-2048, 16, 666, 312, 9, 1003, 341335
n250x8192-coef-inner-2048, 16, 666, 314, 9, 1005, 341335
n250x8192-coef-inner-2048, 16, 666, 315, 9, 1006, 341335
n250x8192-coef-inner-2048, 16, 664, 312, 9, 1001, 341335
n250x8192-coef-inner-2048, 16, 668, 312, 8, 1004, 341335
n250x8192-coef-inner-2048, 16, 667, 311, 9, 1003, 341335
n250x8192-coef-inner-2048, 16, 667, 312, 9, 1004, 341335
n250x8192-coef-inner-2048, 23, 663, 323, 9, 1018, 341335
n250x8192-coef-inner-2048, 19, 665, 325, 9, 1018, 341335
n250x8192-coef-inner-2048, 16, 666, 311, 8, 1001, 341335
n250x8192-coef-inner-2048, 16, 669, 311, 9, 1005, 341335
n250x8192-coef-inner-2048, 16, 666, 311, 9, 1002, 341335
n250x8192-coef-inner-2048, 16, 663, 309, 9, 997, 341335
n250x8192-coef-inner-2048, 16, 667, 310, 9, 1002, 341335
n250x8192-coef-inner-2048, 20, 665, 310, 9, 1004, 341335
n250x8192-coef-inner-2048, 17, 665, 313, 9, 1004, 341335
n250x8192-coef-inner-2048, 16, 667, 311, 9, 1003, 341335
n250x8192-coef-inner-2048, 16, 667, 310, 9, 1002, 341335
n250x8192-coef-inner-2048, 16, 665, 309, 9, 999, 341335
n250x8192-coef-inner-2048, 16, 665, 314, 9, 1004, 341335
n250x8192-coef-inner-2048, 16, 666, 323, 9, 1014, 341335
n250x8192-coef-inner-2048, 23, 669, 312, 9, 1013, 341335
n250x8192-coef-inner-2048, 18, 666, 311, 9, 1004, 341335
n250x8192-coef-inner-2048, 16, 672, 312, 9, 1009, 341335
n250x8192-coef-inner-2048, 23, 664, 324, 9, 1020, 341335
n250x8192-coef-inner-2048, 16, 668, 311, 9, 1004, 341335
n250x8192-coef-inner-2048, 16, 662, 315, 9, 1002, 341335
n250x8192-coef-inner-2048, 16, 668, 317, 9, 1010, 341335
n250x8192-coef-inner-2048, 16, 670, 314, 9, 1009, 341335
n250x8192-coef-inner-2048, 16, 673, 315, 9, 1013, 341335
n250x8192-coef-inner-2048, 17, 670, 315, 9, 1011, 341335
n250x8192-coef-inner-2048, 22, 671, 329, 9, 1031, 341335
n250x8192-coef-inner-2048, 16, 671, 312, 9, 1008, 341335
n250x8192-coef-inner-2048, 16, 668, 312, 9, 1005, 341335
n250x8192-coef-inner-2048, 16, 674, 313, 9, 1012, 341335
n250x8192-coef-inner-2048, 16, 665, 311, 9, 1001, 341335
n250x8192-coef-inner-2048, 16, 666, 312, 9, 1003, 341335
n250x8192-coef-inner-2048, 16, 671, 313, 9, 1009, 341335
n250x8192-coef-inner-2048, 16, 670, 321, 9, 1016, 341335
n250x8192-coef-inner-2048, 16, 668, 316, 9, 1009, 341335
n250x8192-coef-inner-2048, 16, 667, 314, 9, 1006, 341335
n250x8192-coef-inner-2048, 16, 668, 314, 9, 1007, 341335
n250x8192-coef-inner-2048, 16, 668, 312, 9, 1005, 341335
n250x8192-coef-inner-2048, 20, 667, 313, 9, 1009, 341335
n250x8192-coef-inner-2048, 16, 675, 315, 9, 1015, 341335
n250x8192-coef-inner-2048, 16, 668, 312, 9, 1005, 341335
n250x8192-coef-inner-2048, 16, 668, 312, 9, 1005, 341335
n250x8192-coef-inner-2048, 16, 668, 315, 9, 1008, 341335
n250x8192-coef-inner-2048, 19, 668, 314, 9, 1010, 341335
n250x8192-coef-inner-2048, 18, 669, 314, 9, 1010, 341335
n250x8192-coef-inner-2048, 16, 666, 314, 9, 1005, 341335
n250x8192-coef-inner-2048, 16, 667, 311, 9, 1003, 341335
n250x8192-coef-inner-2048, 21, 671, 314, 9, 1015, 341335
n250x8192-coef-inner-2048, 18, 670, 313, 9, 1010, 341335
n250x8192-coef-inner-2048, 16, 669, 314, 9, 1008, 341335
n250x8192-coef-inner-2048, 16, 665, 311, 9, 1001, 341335
n250x8192-coef-inner-2048, 20, 670, 316, 9, 1015, 341335
n250x8192-coef-inner-2048, 25, 669, 328, 9, 1031, 341335
n250x8192-coef-inner-2048, 16, 667, 313, 8, 1004, 341335
n250x8192-coef-inner-2048, 16, 669, 313, 9, 1007, 341335
n250x8192-coef-inner-2048, 16, 669, 316, 9, 1010, 341335
n250x8192-coef-inner-2048, 16, 667, 315, 9, 1007, 341335
n250x8192-coef-inner-2048, 16, 670, 314, 9, 1009, 341335
n250x8192-coef-inner-2048, 16, 668, 314, 9, 1007, 341335
n250x8192-coef-inner-2048, 16, 672, 314, 9, 1011, 341335
n250x8192-coef-inner-2048, 16, 667, 313, 9, 1005, 341335
n250x8192-coef-inner-2048, 16, 668, 314, 9, 1007, 341335
n250x8192-coef-inner-2048, 16, 677, 317, 9, 1019, 341335
n250x8192-coef-inner-2048, 17, 672, 327, 9, 1025, 341335
n250x8192-coef-inner-2048, 16, 670, 312, 9, 1007, 341335
n250x8192-coef-inner-2048, 16, 666, 311, 9, 1002, 341335
n250x8192-coef-inner-2048, 27, 668, 326, 9, 1030, 341335
n250x8192-coef-inner-2048, 17, 669, 312, 9, 1007, 341335
n250x8192-coef-inner-2048, 19, 671, 327, 9, 1026, 341335
n250x8192-coef-inner-2048, 16, 670, 315, 9, 1010, 341335
n250x8192-coef-inner-2048, 16, 671, 315, 9, 1011, 341335
n250x8192-coef-inner-2048, 20, 669, 311, 9, 1009, 341335
n250x8192-coef-inner-2048, 16, 672, 312, 9, 1009, 341335
n250x8192-coef-inner-2048, 16, 668, 316, 9, 1009, 341335
n250x8192-coef-inner-2048, 18, 673, 318, 9, 1018, 341335
n500x8192-coef-inner-2048, 16, 13521, 6322, 204, 20063, 6.82667e+06
n500x8192-coef-inner-2048, 16, 13433, 6328, 196, 19973, 6.82667e+06
n500x8192-coef-inner-2048, 16, 13559, 6328, 197, 20100, 6.82667e+06
n500x8192-coef-inner-2048, 16, 13500, 6302, 196, 20014, 6.82667e+06
n500x8192-coef-inner-2048, 16, 13567, 6319, 194, 20096, 6.82667e+06
n500x8192-coef-inner-2048, 16, 13524, 6377, 196, 20113, 6.82667e+06
n500x8192-coef-inner-2048, 16, 13484, 6305, 201, 20006, 6.82667e+06
n500x8192-coef-inner-2048, 19, 13466, 6563, 197, 20245, 6.82667e+06
n500x8192-coef-inner-2048, 16, 13482, 6295, 196, 19989, 6.82667e+06
n500x8192-coef-inner-2048, 16, 13476, 6376, 198, 20066, 6.82667e+06
n500x8192-coef-inner-2048, 16, 13510, 6329, 198, 20053, 6.82667e+06
n500x8192-coef-inner-2048, 16, 13565, 6293, 198, 20072, 6.82667e+06
n500x8192-coef-inner-2048, 16, 13557, 6323, 198, 20094, 6.82667e+06
n500x8192-coef-inner-2048, 16, 13556, 6306, 197, 20075, 6.82667e+06
n500x8192-coef-inner-2048, 17, 13536, 6331, 197, 20081, 6.82667e+06
n500x8192-coef-inner-2048, 16, 13531, 6293, 196, 20036, 6.82667e+06
n500x8192-coef-inner-2048, 16, 13487, 6351, 199, 20053, 6.82667e+06
n500x8192-coef-inner-2048, 16, 13551, 6558, 199, 20324, 6.82667e+06
n500x8192-coef-inner-2048, 16, 13485, 6302, 196, 19999, 6.82667e+06
n500x8192-coef-inner-2048, 16, 13531, 6367, 199, 20113, 6.82667e+06
n500x8192-coef-inner-2048, 16, 13520, 6310, 196, 20042, 6.82667e+06
n500x8192-coef-inner-2048, 16, 13509, 6318, 194, 20037, 6.82667e+06
n500x8192-coef-inner-2048, 16, 13532, 6472, 197, 20217, 6.82667e+06
n500x8192-coef-inner-2048, 16, 13547, 6374, 199, 20136, 6.82667e+06
n500x8192-coef-inner-2048, 16, 13473, 6297, 197, 19983, 6.82667e+06
n500x8192-coef-inner-2048, 17, 13532, 6285, 195, 20029, 6.82667e+06
n500x8192-coef-inner-2048, 18, 13481, 6331, 196, 20026, 6.82667e+06
n500x8192-coef-inner-2048, 16, 13497, 6587, 199, 20299, 6.82667e+06
n500x8192-coef-inner-2048, 16, 13550, 6592, 198, 20356, 6.82667e+06
n500x8192-coef-inner-2048, 26, 13524, 6327, 199, 20076, 6.82667e+06
n500x8192-coef-inner-2048, 16, 13498, 6322, 196, 20032, 6.82667e+06
n500x8192-coef-inner-2048, 16, 13673, 6378, 202, 20269, 6.82667e+06
n500x8192-coef-inner-2048, 16, 13547, 6380, 196, 20139, 6.82667e+06
n500x8192-coef-inner-2048, 16, 13522, 6327, 194, 20059, 6.82667e+06
n500x8192-coef-inner-2048, 16, 13550, 6350, 197, 20113, 6.82667e+06
n500x8192-coef-inner-2048, 16, 13535, 6583, 202, 20336, 6.82667e+06
n500x8192-coef-inner-2048, 16, 13604, 6311, 199, 20130, 6.82667e+06
n500x8192-coef-inner-2048, 16, 13540, 6345, 199, 20100, 6.82667e+06
n500x8192-coef-inner-2048, 16, 13474, 6302, 193, 19985, 6.82667e+06
n500x8192-coef-inner-2048, 16, 13469, 6333, 198, 20016, 6.82667e+06
n500x8192-coef-inner-2048, 16, 13499, 6330, 197, 20042, 6.82667e+06
n500x8192-coef-inner-2048, 17, 13495, 6309, 198, 20019, 6.82667e+06
n500x8192-coef-inner-2048, 16, 13525, 6349, 200, 20090, 6.82667e+06
n500x8192-coef-inner-2048, 20, 13576, 6438, 199, 20233, 6.82667e+06
n500x8192-coef-inner-2048, 16, 13551, 6307, 194, 20068, 6.82667e+06
n500x8192-coef-inner-2048, 16, 13481, 6332, 197, 20026, 6.82667e+06
n500x8192-coef-inner-2048, 16, 13566, 6366, 199, 20147, 6.82667e+06
n500x8192-coef-inner-2048, 17, 13543, 6343, 197, 20100, 6.82667e+06
n500x8192-coef-inner-2048, 16, 13559, 6355, 197, 20127, 6.82667e+06
n500x8192-coef-inner-2048, 16, 13521, 6383, 198, 20118, 6.82667e+06
n500x8192-coef-inner-2048, 17, 13549, 6406, 193, 20165, 6.82667e+06
n500x8192-coef-inner-2048, 17, 13532, 6655, 196, 20400, 6.82667e+06
n500x8192-coef-inner-2048, 16, 13603, 6367, 204, 20190, 6.82667e+06
n500x8192-coef-inner-2048, 16, 13560, 6365, 198, 20139, 6.82667e+06
n500x8192-coef-inner-2048, 16, 13523, 6316, 197, 20052, 6.82667e+06
n500x8192-coef-inner-2048, 16, 13521, 6351, 196, 20084, 6.82667e+06
n500x8192-coef-inner-2048, 16, 13506, 6273, 196, 19991, 6.82667e+06
n500x8192-coef-inner-2048, 16, 13531, 6376, 197, 20120, 6.82667e+06
n500x8192-coef-inner-2048, 16, 13607, 6340, 202, 20165, 6.82667e+06
n500x8192-coef-inner-2048, 16, 13558, 6405, 197, 20176, 6.82667e+06
n500x8192-coef-inner-2048, 17, 13651, 6460, 198, 20326, 6.82667e+06
n500x8192-coef-inner-2048, 16, 13604, 6378, 198, 20196, 6.82667e+06
n500x8192-coef-inner-2048, 16, 13551, 6337, 195, 20099, 6.82667e+06
n500x8192-coef-inner-2048, 16, 13556, 6349, 196, 20117, 6.82667e+06
n500x8192-coef-inner-2048, 17, 13541, 6657, 200, 20415, 6.82667e+06
n500x8192-coef-inner-2048, 16, 13600, 6391, 200, 20207, 6.82667e+06
n500x8192-coef-inner-2048, 16, 13539, 6502, 196, 20253, 6.82667e+06
n500x8192-coef-inner-2048, 19, 13566, 6348, 196, 20129, 6.82667e+06
n500x8192-coef-inner-2048, 16, 13478, 6367, 195, 20056, 6.82667e+06
n500x8192-coef-inner-2048, 16, 13471, 6291, 196, 19974, 6.82667e+06
n500x8192-coef-inner-2048, 16, 13495, 6361, 198, 20070, 6.82667e+06
n500x8192-coef-inner-2048, 16, 13508, 6374, 203, 20101, 6.82667e+06
n500x8192-coef-inner-2048, 16, 13566, 6413, 196, 20191, 6.82667e+06
n500x8192-coef-inner-2048, 16, 13579, 6316, 200, 20111, 6.82667e+06
n500x8192-coef-inner-2048, 16, 13446, 6288, 194, 19944, 6.82667e+06
n500x8192-coef-inner-2048, 22, 13530, 6312, 198, 20062, 6.82667e+06
n500x8192-coef-inner-2048, 18, 13539, 6373, 202, 20132, 6.82667e+06
n500x8192-coef-inner-2048, 16, 13529, 6378, 197, 20120, 6.82667e+06
n500x8192-coef-inner-2048, 16, 13539, 6610, 196, 20361, 6.82667e+06
n500x8192-coef-inner-2048, 16, 13493, 6327, 194, 20030, 6.82667e+06
n500x8192-coef-inner-2048, 16, 13509, 6367, 197, 20089, 6.82667e+06
n500x8192-coef-inner-2048, 18, 13533, 6881, 197, 20629, 6.82667e+06
n500x8192-coef-inner-2048, 16, 13525, 6324, 198, 20063, 6.82667e+06
n500x8192-coef-inner-2048, 16, 13451, 6318, 195, 19980, 6.82667e+06
n500x8192-coef-inner-2048, 16, 13490, 6281, 199, 19986, 6.82667e+06
n500x8192-coef-inner-2048, 16, 13475, 6313, 196, 20000, 6.82667e+06
n500x8192-coef-inner-2048, 16, 13509, 6316, 196, 20037, 6.82667e+06
n500x8192-coef-inner-2048, 16, 13538, 6376, 202, 20132, 6.82667e+06
n500x8192-coef-inner-2048, 16, 13538, 6333, 197, 20084, 6.82667e+06
n500x8192-coef-inner-2048, 16, 13436, 6309, 198, 19959, 6.82667e+06
n500x8192-coef-inner-2048, 16, 13571, 6415, 196, 20198, 6.82667e+06
n500x8192-coef-inner-2048, 16, 13522, 6338, 195, 20071, 6.82667e+06
n500x8192-coef-inner-2048, 16, 13513, 6337, 195, 20061, 6.82667e+06
n500x8192-coef-inner-2048, 16, 13560, 6359, 195, 20130, 6.82667e+06
n500x8192-coef-inner-2048, 16, 13499, 6359, 198, 20072, 6.82667e+06
n500x8192-coef-inner-2048, 16, 13506, 6359, 195, 20076, 6.82667e+06
n500x8192-coef-inner-2048, 16, 13568, 6340, 193, 20117, 6.82667e+06
n500x8192-coef-inner-2048, 16, 13441, 6312, 195, 19964, 6.82667e+06
n500x8192-coef-inner-2048, 16, 13451, 6332, 195, 19994, 6.82667e+06
n500x8192-coef-inner-2048, 16, 13463, 6613, 196, 20288, 6.82667e+06
