
n8192-coef-inner-2048, 63, 18, 15, 0, 96, 4
n8192-coef-inner-2048, 22, 18, 15, 0, 55, 4
n8192-coef-inner-2048, 16, 17, 14, 0, 47, 4
n8192-coef-inner-2048, 17, 17, 14, 0, 48, 4
n8192-coef-inner-2048, 17, 17, 14, 0, 48, 4
n8192-coef-inner-2048, 16, 17, 14, 0, 47, 4
n8192-coef-inner-2048, 16, 17, 14, 0, 47, 4
n8192-coef-inner-2048, 16, 17, 14, 0, 47, 4
n8192-coef-inner-2048, 21, 17, 23, 0, 61, 4
n8192-coef-inner-2048, 16, 17, 14, 0, 47, 4
n8192-coef-inner-2048, 20, 17, 14, 0, 51, 4
n8192-coef-inner-2048, 16, 17, 14, 0, 47, 4
n8192-coef-inner-2048, 16, 17, 14, 0, 47, 4
n8192-coef-inner-2048, 16, 17, 14, 0, 47, 4
n8192-coef-inner-2048, 20, 17, 14, 0, 51, 4
n8192-coef-inner-2048, 16, 16, 14, 0, 46, 4
n8192-coef-inner-2048, 16, 17, 13, 0, 46, 4
n8192-coef-inner-2048, 16, 17, 14, 0, 47, 4
n8192-coef-inner-2048, 16, 17, 14, 0, 47, 4
n8192-coef-inner-2048, 18, 21, 14, 0, 53, 4
n8192-coef-inner-2048, 16, 16, 14, 0, 46, 4
n8192-coef-inner-2048, 16, 17, 14, 0, 47, 4
n8192-coef-inner-2048, 16, 17, 15, 0, 48, 4
n8192-coef-inner-2048, 17, 17, 15, 0, 49, 4
n8192-coef-inner-2048, 17, 17, 14, 0, 48, 4
n8192-coef-inner-2048, 16, 17, 14, 0, 47, 4
n8192-coef-inner-2048, 16, 17, 15, 0, 48, 4
n8192-coef-inner-2048, 17, 18, 14, 0, 49, 4
n8192-coef-inner-2048, 17, 17, 14, 0, 48, 4
n8192-coef-inner-2048, 16, 17, 13, 0, 46, 4
n8192-coef-inner-2048, 22, 17, 13, 0, 52, 4
n8192-coef-inner-2048, 16, 17, 14, 0, 47, 4
n8192-coef-inner-2048, 16, 17, 13, 0, 46, 4
n8192-coef-inner-2048, 16, 17, 14, 0, 47, 4
n8192-coef-inner-2048, 17, 17, 13, 0, 47, 4
n8192-coef-inner-2048, 17, 17, 14, 0, 48, 4
n8192-coef-inner-2048, 16, 17, 14, 0, 47, 4
n8192-coef-inner-2048, 17, 18, 14, 0, 49, 4
n8192-coef-inner-2048, 16, 18, 14, 0, 48, 4
n8192-coef-inner-2048, 21, 17, 14, 0, 52, 4
n8192-coef-inner-2048, 16, 18, 17, 0, 51, 4
n8192-coef-inner-2048, 16, 22, 13, 0, 51, 4
n8192-coef-inner-2048, 17, 17, 15, 0, 49, 4
n8192-coef-inner-2048, 18, 17, 14, 0, 49, 4
n8192-coef-inner-2048, 17, 16, 14, 0, 47, 4
n8192-coef-inner-2048, 18, 17, 14, 0, 49, 4
n8192-coef-inner-2048, 16, 17, 13, 0, 46, 4
n8192-coef-inner-2048, 16, 16, 14, 0, 46, 4
n8192-coef-inner-2048, 21, 17, 13, 0, 51, 4
n8192-coef-inner-2048, 16, 17, 15, 0, 48, 4
n8192-coef-inner-2048, 16, 18, 14, 0, 48, 4
n8192-coef-inner-2048, 17, 21, 14, 0, 52, 4
n8192-coef-inner-2048, 16, 18, 16, 0, 50, 4
n8192-coef-inner-2048, 16, 17, 14, 0, 47, 4
n8192-coef-inner-2048, 16, 17, 14, 0, 47, 4
n8192-coef-inner-2048, 17, 17, 14, 0, 48, 4
n8192-coef-inner-2048, 17, 21, 14, 0, 52, 4
n8192-coef-inner-2048, 17, 17, 14, 0, 48, 4
n8192-coef-inner-2048, 16, 17, 14, 0, 47, 4
n8192-coef-inner-2048, 16, 16, 14, 0, 46, 4
n8192-coef-inner-2048, 16, 18, 14, 0, 48, 4
n8192-coef-inner-2048, 16, 17, 16, 0, 49, 4
n8192-coef-inner-2048, 16, 21, 15, 0, 52, 4
n8192-coef-inner-2048, 16, 17, 13, 0, 46, 4
n8192-coef-inner-2048, 16, 17, 14, 0, 47, 4
n8192-coef-inner-2048, 16, 17, 13, 0, 46, 4
n8192-coef-inner-2048, 16, 17, 14, 0, 47, 4
n8192-coef-inner-2048, 16, 17, 14, 0, 47, 4
n8192-coef-inner-2048, 16, 17, 14, 0, 47, 4
n8192-coef-inner-2048, 16, 17, 13, 0, 46, 4
n8192-coef-inner-2048, 18, 17, 14, 0, 49, 4
n8192-coef-inner-2048, 16, 17, 14, 0, 47, 4
n8192-coef-inner-2048, 16, 19, 14, 0, 49, 4
n8192-coef-inner-2048, 31, 18, 14, 0, 63, 4
n8192-coef-inner-2048, 16, 17, 14, 0, 47, 4
n8192-coef-inner-2048, 16, 17, 13, 0, 46, 4
n8192-coef-inner-2048, 16, 17, 14, 0, 47, 4
n8192-coef-inner-2048, 16, 17, 14, 0, 47, 4
n8192-coef-inner-2048, 16, 17, 14, 0, 47, 4
n8192-coef-inner-2048, 16, 17, 14, 0, 47, 4
n8192-coef-inner-2048, 18, 17, 14, 0, 49, 4
n8192-coef-inner-2048, 21, 17, 14, 0, 52, 4
n8192-coef-inner-2048, 16, 16, 14, 0, 46, 4
n8192-coef-inner-2048, 16, 17, 19, 0, 52, 4
n8192-coef-inner-2048, 16, 17, 13, 0, 46, 4
n8192-coef-inner-2048, 16, 17, 14, 0, 47, 4
n8192-coef-inner-2048, 16, 17, 15, 0, 48, 4
n8192-coef-inner-2048, 16, 17, 14, 0, 47, 4
n8192-coef-inner-2048, 20, 17, 14, 0, 51, 4
n8192-coef-inner-2048, 16, 17, 14, 0, 47, 4
n8192-coef-inner-2048, 16, 17, 14, 0, 47, 4
n8192-coef-inner-2048, 16, 17, 14, 0, 47, 4
n8192-coef-inner-2048, 17, 17, 15, 0, 49, 4
n8192-coef-inner-2048, 16, 17, 16, 0, 49, 4
n8192-coef-inner-2048, 20, 17, 13, 0, 50, 4
n8192-coef-inner-2048, 16, 16, 14, 0, 46, 4
n8192-coef-inner-2048, 17, 17, 13, 0, 47, 4
n8192-coef-inner-2048, 16, 17, 14, 0, 47, 4
n8192-coef-inner-2048, 16, 17, 14, 0, 47, 4
n8192-coef-inner-2048, 16, 17, 14, 0, 47, 4
n10x8192-coef-inner-2048, 19, 210, 136, 3, 368, 28
n10x8192-coef-inner-2048, 16, 153, 129, 3, 301, 28
n10x8192-coef-inner-2048, 16, 163, 152, 3, 334, 28
n10x8192-coef-inner-2048, 22, 160, 131, 3, 316, 28
n10x8192-coef-inner-2048, 22, 161, 128, 3, 314, 28
n10x8192-coef-inner-2048, 16, 151, 131, 3, 301, 28
n10x8192-coef-inner-2048, 17, 151, 129, 3, 300, 28
n10x8192-coef-inner-2048, 16, 154, 135, 3, 308, 28
n10x8192-coef-inner-2048, 16, 152, 133, 3, 304, 28
n10x8192-coef-inner-2048, 16, 152, 137, 3, 308, 28
n10x8192-coef-inner-2048, 16, 152, 129, 3, 300, 28
n10x8192-coef-inner-2048, 17, 154, 135, 3, 309, 28
n10x8192-coef-inner-2048, 16, 152, 128, 3, 299, 28
n10x8192-coef-inner-2048, 16, 154, 134, 3, 307, 28
n10x8192-coef-inner-2048, 18, 153, 130, 3, 304, 28
n10x8192-coef-inner-2048, 16, 160, 128, 3, 307, 28
n10x8192-coef-inner-2048, 16, 152, 129, 3, 300, 28
n10x8192-coef-inner-2048, 17, 161, 131, 3, 312, 28
n10x8192-coef-inner-2048, 16, 152, 128, 3, 299, 28
n10x8192-coef-inner-2048, 16, 158, 128, 3, 305, 28
n10x8192-coef-inner-2048, 17, 155, 129, 3, 304, 28
n10x8192-coef-inner-2048, 16, 160, 128, 3, 307, 28
n10x8192-coef-inner-2048, 16, 153, 133, 8, 310, 28
n10x8192-coef-inner-2048, 17, 153, 127, 3, 300, 28
n10x8192-coef-inner-2048, 16, 155, 138, 3, 312, 28
n10x8192-coef-inner-2048, 16, 164, 129, 3, 312, 28
n10x8192-coef-inner-2048, 16, 152, 141, 3, 312, 28
n10x8192-coef-inner-2048, 16, 151, 129, 3, 299, 28
n10x8192-coef-inner-2048, 22, 160, 135, 3, 320, 28
n10x8192-coef-inner-2048, 24, 154, 135, 3, 316, 28
n10x8192-coef-inner-2048, 16, 160, 129, 3, 308, 28
n10x8192-coef-inner-2048, 16, 151, 128, 3, 298, 28
n10x8192-coef-inner-2048, 16, 158, 129, 3, 306, 28
n10x8192-coef-inner-2048, 16, 151, 127, 3, 297, 28
n10x8192-coef-inner-2048, 23, 161, 129, 3, 316, 28
n10x8192-coef-inner-2048, 16, 152, 130, 3, 301, 28
n10x8192-coef-inner-2048, 18, 164, 128, 3, 313, 28
n10x8192-coef-inner-2048, 16, 152, 136, 3, 307, 28
n10x8192-coef-inner-2048, 21, 155, 128, 3, 307, 28
n10x8192-coef-inner-2048, 16, 156, 136, 3, 311, 28
n10x8192-coef-inner-2048, 16, 153, 129, 3, 301, 28
n10x8192-coef-inner-2048, 16, 154, 135, 3, 308, 28
n10x8192-coef-inner-2048, 16, 155, 128, 3, 302, 28
n10x8192-coef-inner-2048, 16, 159, 128, 3, 306, 28
n10x8192-coef-inner-2048, 18, 152, 137, 3, 310, 28
n10x8192-coef-inner-2048, 16, 158, 128, 3, 305, 28
n10x8192-coef-inner-2048, 16, 154, 130, 3, 303, 28
n10x8192-coef-inner-2048, 17, 158, 128, 3, 306, 28
n10x8192-coef-inner-2048, 16, 151, 128, 3, 298, 28
n10x8192-coef-inner-2048, 16, 163, 128, 3, 310, 28
n10x8192-coef-inner-2048, 16, 152, 128, 3, 299, 28
n10x8192-coef-inner-2048, 17, 165, 128, 3, 313, 28
n10x8192-coef-inner-2048, 22, 151, 146, 3, 322, 28
n10x8192-coef-inner-2048, 16, 154, 128, 3, 301, 28
n10x8192-coef-inner-2048, 21, 158, 146, 3, 328, 28
n10x8192-coef-inner-2048, 16, 156, 130, 3, 305, 28
n10x8192-coef-inner-2048, 16, 153, 134, 3, 306, 28
n10x8192-coef-inner-2048, 16, 152, 129, 3, 300, 28
n10x8192-coef-inner-2048, 16, 158, 128, 3, 305, 28
n10x8192-coef-inner-2048, 17, 154, 130, 3, 304, 28
n10x8192-coef-inner-2048, 16, 161, 131, 3, 311, 28
n10x8192-coef-inner-2048, 16, 155, 129, 3, 303, 28
n10x8192-coef-inner-2048, 16, 159, 128, 3, 306, 28
n10x8192-coef-inner-2048, 16, 155, 130, 3, 304, 28
n10x8192-coef-inner-2048, 16, 159, 129, 3, 307, 28
n10x8192-coef-inner-2048, 16, 153, 132, 3, 304, 28
n10x8192-coef-inner-2048, 20, 153, 128, 3, 304, 28
n10x8192-coef-inner-2048, 17, 152, 136, 3, 308, 28
n10x8192-coef-inner-2048, 19, 153, 133, 3, 308, 28
n10x8192-coef-inner-2048, 16, 152, 135, 3, 306, 28
n10x8192-coef-inner-2048, 16, 152, 128, 3, 299, 28
n10x8192-coef-inner-2048, 16, 154, 135, 3, 308, 28
n10x8192-coef-inner-2048, 16, 152, 127, 3, 298, 28
n10x8192-coef-inner-2048, 17, 155, 136, 3, 311, 28
n10x8192-coef-inner-2048, 16, 157, 130, 3, 306, 28
n10x8192-coef-inner-2048, 16, 159, 126, 3, 304, 28
n10x8192-coef-inner-2048, 17, 156, 129, 3, 305, 28
n10x8192-coef-inner-2048, 16, 159, 128, 3, 306, 28
n10x8192-coef-inner-2048, 16, 153, 129, 3, 301, 28
n10x8192-coef-inner-2048, 16, 161, 129, 3, 309, 28
n10x8192-coef-inner-2048, 16, 154, 132, 3, 305, 28
n10x8192-coef-inner-2048, 20, 154, 129, 3, 306, 28
n10x8192-coef-inner-2048, 16, 152, 129, 8, 305, 28
n10x8192-coef-inner-2048, 16, 153, 126, 3, 298, 28
n10x8192-coef-inner-2048, 17, 150, 136, 3, 306, 28
n10x8192-coef-inner-2048, 16, 152, 129, 3, 300, 28
n10x8192-coef-inner-2048, 16, 153, 137, 3, 309, 28
n10x8192-coef-inner-2048, 16, 153, 129, 3, 301, 28
n10x8192-coef-inner-2048, 17, 153, 137, 3, 310, 28
n10x8192-coef-inner-2048, 16, 152, 127, 3, 298, 28
n10x8192-coef-inner-2048, 16, 159, 128, 3, 306, 28
n10x8192-coef-inner-2048, 16, 152, 130, 3, 301, 28
n10x8192-coef-inner-2048, 16, 159, 129, 3, 307, 28
n10x8192-coef-inner-2048, 16, 157, 129, 3, 305, 28
n10x8192-coef-inner-2048, 16, 158, 129, 3, 306, 28
n10x8192-coef-inner-2048, 16, 156, 128, 3, 303, 28
n10x8192-coef-inner-2048, 16, 159, 128, 3, 306, 28
n10x8192-coef-inner-2048, 16, 156, 133, 3, 308, 28
n10x8192-coef-inner-2048, 16, 160, 129, 3, 308, 28
n10x8192-coef-inner-2048, 16, 151, 135, 3, 305, 28
n25x8192-coef-inner-2048, 18, 427, 335, 9, 789, 68
n25x8192-coef-inner-2048, 16, 388, 321, 9, 734, 68
n25x8192-coef-inner-2048, 16, 389, 330, 8, 743, 68
n25x8192-coef-inner-2048, 16, 379, 329, 9, 733, 68
n25x8192-coef-inner-2048, 16, 388, 320, 9, 733, 68
n25x8192-coef-inner-2048, 16, 383, 314, 8, 721, 68
n25x8192-coef-inner-2048, 16, 385, 335, 9, 745, 68
n25x8192-coef-inner-2048, 17, 381, 327, 9, 734, 68
n25x8192-coef-inner-2048, 17, 393, 322, 8, 740, 68
n25x8192-coef-inner-2048, 22, 392, 329, 8, 751, 68
n25x8192-coef-inner-2048, 21, 381, 328, 9, 739, 68
n25x8192-coef-inner-2048, 20, 382, 327, 8, 737, 68
n25x8192-coef-inner-2048, 23, 392, 324, 9, 748, 68
n25x8192-coef-inner-2048, 20, 389, 340, 8, 757, 68
n25x8192-coef-inner-2048, 16, 381, 331, 9, 737, 68
n25x8192-coef-inner-2048, 23, 389, 336, 9, 757, 68
n25x8192-coef-inner-2048, 19, 392, 321, 9, 741, 68
n25x8192-coef-inner-2048, 17, 380, 332, 9, 738, 68
n25x8192-coef-inner-2048, 16, 385, 327, 9, 737, 68
n25x8192-coef-inner-2048, 16, 387, 325, 9, 737, 68
n25x8192-coef-inner-2048, 16, 382, 319, 9, 726, 68
n25x8192-coef-inner-2048, 16, 381, 327, 9, 733, 68
n25x8192-coef-inner-2048, 17, 384, 325, 9, 735, 68
n25x8192-coef-inner-2048, 16, 382, 323, 8, 729, 68
n25x8192-coef-inner-2048, 16, 386, 331, 8, 741, 68
n25x8192-coef-inner-2048, 16, 381, 320, 8, 725, 68
n25x8192-coef-inner-2048, 17, 377, 326, 9, 729, 68
n25x8192-coef-inner-2048, 16, 380, 324, 9, 729, 68
n25x8192-coef-inner-2048, 16, 380, 323, 9, 728, 68
n25x8192-coef-inner-2048, 16, 378, 323, 8, 725, 68
n25x8192-coef-inner-2048, 16, 385, 326, 9, 736, 68
n25x8192-coef-inner-2048, 16, 381, 326, 9, 732, 68
n25x8192-coef-inner-2048, 16, 383, 321, 9, 729, 68
n25x8192-coef-inner-2048, 17, 394, 325, 9, 745, 68
n25x8192-coef-inner-2048, 19, 382, 322, 9, 732, 68
n25x8192-coef-inner-2048, 20, 378, 327, 9, 734, 68
n25x8192-coef-inner-2048, 16, 379, 320, 8, 723, 68
n25x8192-coef-inner-2048, 17, 379, 322, 9, 727, 68
n25x8192-coef-inner-2048, 16, 403, 329, 8, 756, 68
n25x8192-coef-inner-2048, 16, 380, 326, 9, 731, 68
n25x8192-coef-inner-2048, 17, 380, 320, 9, 726, 68
n25x8192-coef-inner-2048, 18, 383, 333, 9, 743, 68
n25x8192-coef-inner-2048, 20, 383, 322, 8, 733, 68
n25x8192-coef-inner-2048, 19, 384, 335, 9, 747, 68
n25x8192-coef-inner-2048, 16, 380, 319, 9, 724, 68
n25x8192-coef-inner-2048, 20, 377, 333, 9, 739, 68
n25x8192-coef-inner-2048, 16, 395, 325, 9, 745, 68
n25x8192-coef-inner-2048, 16, 392, 319, 9, 736, 68
n25x8192-coef-inner-2048, 17, 387, 323, 9, 736, 68
n25x8192-coef-inner-2048, 16, 383, 319, 8, 726, 68
n25x8192-coef-inner-2048, 16, 384, 322, 8, 730, 68
n25x8192-coef-inner-2048, 17, 389, 329, 9, 744, 68
n25x8192-coef-inner-2048, 16, 375, 318, 8, 717, 68
n25x8192-coef-inner-2048, 16, 377, 318, 8, 719, 68
n25x8192-coef-inner-2048, 16, 385, 322, 9, 732, 68
n25x8192-coef-inner-2048, 16, 378, 323, 8, 725, 68
n25x8192-coef-inner-2048, 16, 381, 318, 8, 723, 68
n25x8192-coef-inner-2048, 16, 387, 327, 8, 738, 68
n25x8192-coef-inner-2048, 16, 382, 324, 8, 730, 68
n25x8192-coef-inner-2048, 16, 376, 328, 8, 728, 68
n25x8192-coef-inner-2048, 18, 390, 327, 9, 744, 68
n25x8192-coef-inner-2048, 16, 378, 321, 8, 723, 68
n25x8192-coef-inner-2048, 16, 388, 318, 8, 730, 68
n25x8192-coef-inner-2048, 16, 386, 323, 8, 733, 68
n25x8192-coef-inner-2048, 16, 379, 323, 9, 727, 68
n25x8192-coef-inner-2048, 16, 389, 321, 9, 735, 68
n25x8192-coef-inner-2048, 20, 387, 337, 8, 752, 68
n25x8192-coef-inner-2048, 16, 385, 330, 9, 740, 68
n25x8192-coef-inner-2048, 16, 383, 320, 8, 727, 68
n25x8192-coef-inner-2048, 16, 377, 319, 9, 721, 68
n25x8192-coef-inner-2048, 16, 384, 317, 9, 726, 68
n25x8192-coef-inner-2048, 16, 382, 322, 9, 729, 68
n25x8192-coef-inner-2048, 16, 384, 323, 8, 731, 68
n25x8192-coef-inner-2048, 18, 391, 322, 8, 739, 68
n25x8192-coef-inner-2048, 17, 379, 331, 8, 735, 68
n25x8192-coef-inner-2048, 22, 380, 340, 9, 751, 68
n25x8192-coef-inner-2048, 24, 379, 322, 8, 733, 68
n25x8192-coef-inner-2048, 20, 385, 334, 9, 748, 68
n25x8192-coef-inner-2048, 16, 388, 319, 9, 732, 68
n25x8192-coef-inner-2048, 16, 381, 320, 9, 726, 68
n25x8192-coef-inner-2048, 16, 377, 317, 9, 719, 68
n25x8192-coef-inner-2048, 18, 392, 332, 9, 751, 68
n25x8192-coef-inner-2048, 16, 382, 321, 9, 728, 68
n25x8192-coef-inner-2048, 17, 378, 320, 15, 730, 68
n25x8192-coef-inner-2048, 17, 427, 363, 13, 820, 68
n25x8192-coef-inner-2048, 26, 432, 329, 9, 796, 68
n25x8192-coef-inner-2048, 16, 382, 321, 9, 728, 68
n25x8192-coef-inner-2048, 16, 383, 320, 9, 728, 68
n25x8192-coef-inner-2048, 16, 412, 337, 9, 774, 68
n25x8192-coef-inner-2048, 16, 380, 318, 9, 723, 68
n25x8192-coef-inner-2048, 16, 381, 319, 9, 725, 68
n25x8192-coef-inner-2048, 20, 382, 316, 9, 727, 68
n25x8192-coef-inner-2048, 19, 384, 333, 9, 745, 68
n25x8192-coef-inner-2048, 19, 376, 331, 9, 735, 68
n25x8192-coef-inner-2048, 16, 377, 318, 9, 720, 68
n25x8192-coef-inner-2048, 17, 379, 318, 9, 723, 68
n25x8192-coef-inner-2048, 22, 382, 330, 9, 743, 68
n25x8192-coef-inner-2048, 16, 383, 326, 9, 734, 68
n25x8192-coef-inner-2048, 16, 377, 318, 8, 719, 68
n25x8192-coef-inner-2048, 16, 382, 320, 8, 726, 68
n50x8192-coef-inner-2048, 16, 830, 673, 19, 1538, 134
n50x8192-coef-inner-2048, 16, 763, 642, 23, 1444, 134
n50x8192-coef-inner-2048, 16, 778, 650, 18, 1462, 134
n50x8192-coef-inner-2048, 18, 758, 650, 18, 1444, 134
n50x8192-coef-inner-2048, 16, 758, 651, 18, 1443, 134
n50x8192-coef-inner-2048, 16, 766, 646, 19, 1447, 134
n50x8192-coef-inner-2048, 16, 768, 647, 18, 1449, 134
n50x8192-coef-inner-2048, 16, 762, 645, 19, 1442, 134
n50x8192-coef-inner-2048, 21, 766, 659, 19, 1465, 134
n50x8192-coef-inner-2048, 16, 760, 647, 18, 1441, 134
n50x8192-coef-inner-2048, 16, 764, 649, 18, 1447, 134
n50x8192-coef-inner-2048, 16, 768, 646, 19, 1449, 134
n50x8192-coef-inner-2048, 16, 775, 653, 19, 1463, 134
n50x8192-coef-inner-2048, 16, 785, 654, 19, 1474, 134
n50x8192-coef-inner-2048, 16, 771, 646, 19, 1452, 134
n50x8192-coef-inner-2048, 16, 776, 652, 19, 1463, 134
n50x8192-coef-inner-2048, 21, 773, 676, 19, 1489, 134
n50x8192-coef-inner-2048, 16, 766, 647, 19, 1448, 134
n50x8192-coef-inner-2048, 16, 773, 655, 19, 1463, 134
n50x8192-coef-inner-2048, 16, 766, 646, 18, 1446, 134
n50x8192-coef-inner-2048, 20, 772, 647, 19, 1458, 134
n50x8192-coef-inner-2048, 16, 763, 640, 18, 1437, 134
n50x8192-coef-inner-2048, 16, 781, 649, 28, 1474, 134
n50x8192-coef-inner-2048, 177, 969, 655, 18, 1819, 134
n50x8192-coef-inner-2048, 17, 782, 645, 18, 1462, 134
n50x8192-coef-inner-2048, 16, 773, 649, 18, 1456, 134
n50x8192-coef-inner-2048, 20, 773, 655, 19, 1467, 134
n50x8192-coef-inner-2048, 16, 768, 649, 18, 1451, 134
n50x8192-coef-inner-2048, 16, 762, 652, 19, 1449, 134
n50x8192-coef-inner-2048, 16, 766, 643, 19, 1444, 134
n50x8192-coef-inner-2048, 16, 779, 646, 18, 1459, 134
n50x8192-coef-inner-2048, 16, 771, 697, 24, 1508, 134
n50x8192-coef-inner-2048, 16, 771, 671, 19, 1477, 134
n50x8192-coef-inner-2048, 16, 856, 713, 18, 1603, 134
n50x8192-coef-inner-2048, 16, 759, 639, 18, 1432, 134
n50x8192-coef-inner-2048, 16, 835, 694, 18, 1563, 134
n50x8192-coef-inner-2048, 16, 754, 637, 19, 1426, 134
n50x8192-coef-inner-2048, 16, 768, 642, 19, 1445, 134
n50x8192-coef-inner-2048, 23, 788, 675, 19, 1505, 134
n50x8192-coef-inner-2048, 16, 758, 649, 18, 1441, 134
n50x8192-coef-inner-2048, 16, 756, 644, 18, 1434, 134
n50x8192-coef-inner-2048, 16, 760, 640, 18, 1434, 134
n50x8192-coef-inner-2048, 16, 753, 641, 19, 1429, 134
n50x8192-coef-inner-2048, 16, 761, 646, 19, 1442, 134
n50x8192-coef-inner-2048, 16, 759, 635, 18, 1428, 134
n50x8192-coef-inner-2048, 16, 766, 652, 19, 1453, 134
n50x8192-coef-inner-2048, 16, 756, 638, 19, 1429, 134
n50x8192-coef-inner-2048, 17, 762, 640, 19, 1438, 134
n50x8192-coef-inner-2048, 16, 764, 647, 19, 1446, 134
n50x8192-coef-inner-2048, 16, 765, 653, 20, 1454, 134
n50x8192-coef-inner-2048, 16, 752, 641, 19, 1428, 134
n50x8192-coef-inner-2048, 16, 763, 663, 18, 1460, 134
n50x8192-coef-inner-2048, 16, 755, 643, 18, 1432, 134
n50x8192-coef-inner-2048, 16, 772, 665, 25, 1478, 134
n50x8192-coef-inner-2048, 16, 757, 639, 19, 1431, 134
n50x8192-coef-inner-2048, 16, 783, 668, 19, 1486, 134
n50x8192-coef-inner-2048, 16, 754, 655, 18, 1443, 134
n50x8192-coef-inner-2048, 16, 762, 662, 19, 1459, 134
n50x8192-coef-inner-2048, 16, 780, 677, 19, 1492, 134
n50x8192-coef-inner-2048, 17, 773, 645, 20, 1455, 134
n50x8192-coef-inner-2048, 17, 758, 661, 19, 1455, 134
n50x8192-coef-inner-2048, 16, 768, 643, 19, 1446, 134
n50x8192-coef-inner-2048, 16, 759, 644, 19, 1438, 134
n50x8192-coef-inner-2048, 16, 758, 638, 19, 1431, 134
n50x8192-coef-inner-2048, 16, 759, 645, 19, 1439, 134
n50x8192-coef-inner-2048, 22, 761, 645, 19, 1447, 134
n50x8192-coef-inner-2048, 19, 777, 649, 19, 1464, 134
n50x8192-coef-inner-2048, 16, 767, 636, 19, 1438, 134
n50x8192-coef-inner-2048, 16, 760, 648, 19, 1443, 134
n50x8192-coef-inner-2048, 17, 763, 640, 18, 1438, 134
n50x8192-coef-inner-2048, 16, 756, 642, 18, 1432, 134
n50x8192-coef-inner-2048, 16, 760, 644, 19, 1439, 134
n50x8192-coef-inner-2048, 16, 763, 646, 23, 1448, 134
n50x8192-coef-inner-2048, 16, 758, 640, 19, 1433, 134
n50x8192-coef-inner-2048, 16, 764, 639, 19, 1438, 134
n50x8192-coef-inner-2048, 23, 753, 716, 23, 1515, 134
n50x8192-coef-inner-2048, 16, 758, 637, 19, 1430, 134
n50x8192-coef-inner-2048, 17, 762, 637, 19, 1435, 134
n50x8192-coef-inner-2048, 16, 757, 641, 19, 1433, 134
n50x8192-coef-inner-2048, 16, 755, 638, 18, 1427, 134
n50x8192-coef-inner-2048, 16, 760, 637, 18, 1431, 134
n50x8192-coef-inner-2048, 19, 765, 642, 19, 1445, 134
n50x8192-coef-inner-2048, 16, 754, 647, 18, 1435, 134
n50x8192-coef-inner-2048, 16, 753, 637, 18, 1424, 134
n50x8192-coef-inner-2048, 16, 758, 634, 18, 1426, 134
n50x8192-coef-inner-2048, 20, 750, 667, 19, 1456, 134
n50x8192-coef-inner-2048, 16, 777, 638, 18, 1449, 134
n50x8192-coef-inner-2048, 18, 772, 653, 19, 1462, 134
n50x8192-coef-inner-2048, 25, 760, 653, 19, 1457, 134
n50x8192-coef-inner-2048, 16, 756, 643, 19, 1434, 134
n50x8192-coef-inner-2048, 16, 776, 638, 18, 1448, 134
n50x8192-coef-inner-2048, 16, 767, 652, 18, 1453, 134
n50x8192-coef-inner-2048, 16, 756, 641, 19, 1432, 134
n50x8192-coef-inner-2048, 19, 775, 644, 18, 1456, 134
n50x8192-coef-inner-2048, 16, 765, 645, 19, 1445, 134
n50x8192-coef-inner-2048, 16, 755, 645, 18, 1434, 134
n50x8192-coef-inner-2048, 16, 756, 641, 18, 1431, 134
n50x8192-coef-inner-2048, 16, 773, 647, 19, 1455, 134
n50x8192-coef-inner-2048, 18, 765, 656, 19, 1458, 134
n50x8192-coef-inner-2048, 16, 763, 649, 19, 1447, 134
n100x8192-coef-inner-2048, 24, 1559, 1366, 49, 2998, 268
n100x8192-coef-inner-2048, 16, 1526, 1299, 39, 2880, 268
n100x8192-coef-inner-2048, 16, 1554, 1299, 39, 2908, 268
n100x8192-coef-inner-2048, 16, 1556, 1309, 39, 2920, 268
n100x8192-coef-inner-2048, 17, 1523, 1295, 40, 2875, 268
n100x8192-coef-inner-2048, 22, 1541, 1305, 39, 2907, 268
n100x8192-coef-inner-2048, 16, 1550, 1350, 40, 2956, 268
n100x8192-coef-inner-2048, 16, 1546, 1300, 38, 2900, 268
n100x8192-coef-inner-2048, 16, 1527, 1298, 40, 2881, 268
n100x8192-coef-inner-2048, 16, 1542, 1303, 39, 2900, 268
n100x8192-coef-inner-2048, 24, 1565, 1363, 39, 2991, 268
n100x8192-coef-inner-2048, 19, 1533, 1299, 39, 2890, 268
n100x8192-coef-inner-2048, 20, 1549, 1294, 39, 2902, 268
n100x8192-coef-inner-2048, 29, 1547, 1351, 39, 2966, 268
n100x8192-coef-inner-2048, 16, 1555, 1475, 49, 3095, 268
n100x8192-coef-inner-2048, 16, 1540, 1310, 38, 2904, 268
n100x8192-coef-inner-2048, 16, 1541, 1309, 39, 2905, 268
n100x8192-coef-inner-2048, 16, 1528, 1290, 39, 2873, 268
n100x8192-coef-inner-2048, 16, 1524, 1301, 40, 2881, 268
n100x8192-coef-inner-2048, 16, 1543, 1320, 39, 2918, 268
n100x8192-coef-inner-2048, 18, 1535, 1309, 39, 2901, 268
n100x8192-coef-inner-2048, 16, 1525, 1301, 39, 2881, 268
n100x8192-coef-inner-2048, 19, 1551, 1354, 39, 2963, 268
n100x8192-coef-inner-2048, 16, 1523, 1299, 40, 2878, 268
n100x8192-coef-inner-2048, 16, 1563, 1297, 43, 2919, 268
n100x8192-coef-inner-2048, 17, 1520, 1294, 39, 2870, 268
n100x8192-coef-inner-2048, 16, 1516, 1282, 39, 2853, 268
n100x8192-coef-inner-2048, 19, 1520, 1296, 40, 2875, 268
n100x8192-coef-inner-2048, 16, 1529, 1286, 39, 2870, 268
n100x8192-coef-inner-2048, 17, 1539, 1299, 39, 2894, 268
n100x8192-coef-inner-2048, 16, 1549, 1292, 39, 2896, 268
n100x8192-coef-inner-2048, 16, 1522, 1294, 39, 2871, 268
n100x8192-coef-inner-2048, 16, 1533, 1283, 40, 2872, 268
n100x8192-coef-inner-2048, 16, 1537, 1298, 44, 2895, 268
n100x8192-coef-inner-2048, 18, 1521, 1299, 40, 2878, 268
n100x8192-coef-inner-2048, 16, 1547, 1350, 40, 2953, 268
n100x8192-coef-inner-2048, 41, 1523, 1363, 40, 2967, 268
n100x8192-coef-inner-2048, 17, 1542, 1304, 40, 2903, 268
n100x8192-coef-inner-2048, 16, 1531, 1293, 40, 2880, 268
n100x8192-coef-inner-2048, 18, 1527, 1298, 40, 2883, 268
n100x8192-coef-inner-2048, 17, 1533, 1302, 39, 2891, 268
n100x8192-coef-inner-2048, 16, 1528, 1286, 39, 2869, 268
n100x8192-coef-inner-2048, 20, 1563, 1308, 39, 2930, 268
n100x8192-coef-inner-2048, 16, 1523, 1282, 39, 2860, 268
n100x8192-coef-inner-2048, 17, 1518, 1302, 39, 2876, 268
n100x8192-coef-inner-2048, 16, 1516, 1291, 39, 2862, 268
n100x8192-coef-inner-2048, 16, 1520, 1303, 39, 2878, 268
n100x8192-coef-inner-2048, 16, 1527, 1291, 40, 2874, 268
n100x8192-coef-inner-2048, 16, 1518, 1289, 48, 2871, 268
n100x8192-coef-inner-2048, 16, 1522, 1304, 39, 2881, 268
n100x8192-coef-inner-2048, 16, 1513, 1287, 40, 2856, 268
n100x8192-coef-inner-2048, 16, 1527, 1286, 39, 2868, 268
n100x8192-coef-inner-2048, 16, 1536, 1280, 38, 2870, 268
n100x8192-coef-inner-2048, 16, 1508, 1293, 39, 2856, 268
n100x8192-coef-inner-2048, 16, 1520, 1287, 44, 2867, 268
n100x8192-coef-inner-2048, 18, 1553, 1282, 40, 2893, 268
n100x8192-coef-inner-2048, 16, 1517, 1277, 38, 2848, 268
n100x8192-coef-inner-2048, 16, 1535, 1295, 40, 2886, 268
n100x8192-coef-inner-2048, 16, 1519, 1285, 39, 2859, 268
n100x8192-coef-inner-2048, 16, 1522, 1290, 39, 2867, 268
n100x8192-coef-inner-2048, 16, 1537, 1284, 39, 2876, 268
n100x8192-coef-inner-2048, 16, 1527, 1342, 39, 2924, 268
n100x8192-coef-inner-2048, 17, 1519, 1333, 40, 2909, 268
n100x8192-coef-inner-2048, 16, 1528, 1293, 40, 2877, 268
n100x8192-coef-inner-2048, 21, 1525, 1335, 39, 2920, 268
n100x8192-coef-inner-2048, 18, 1559, 1293, 39, 2909, 268
n100x8192-coef-inner-2048, 16, 1514, 1286, 38, 2854, 268
n100x8192-coef-inner-2048, 16, 1518, 1307, 38, 2879, 268
n100x8192-coef-inner-2048, 16, 1512, 1292, 40, 2860, 268
n100x8192-coef-inner-2048, 16, 1526, 1301, 39, 2882, 268
n100x8192-coef-inner-2048, 17, 1537, 1295, 39, 2888, 268
n100x8192-coef-inner-2048, 16, 1543, 1292, 39, 2890, 268
n100x8192-coef-inner-2048, 16, 1552, 1299, 40, 2907, 268
n100x8192-coef-inner-2048, 16, 1545, 1297, 39, 2897, 268
n100x8192-coef-inner-2048, 16, 1542, 1293, 40, 2891, 268
n100x8192-coef-inner-2048, 19, 1540, 1313, 38, 2910, 268
n100x8192-coef-inner-2048, 18, 1533, 1307, 40, 2898, 268
n100x8192-coef-inner-2048, 16, 1556, 1334, 47, 2953, 268
n100x8192-coef-inner-2048, 17, 1547, 1299, 40, 2903, 268
n100x8192-coef-inner-2048, 17, 1550, 1303, 39, 2909, 268
n100x8192-coef-inner-2048, 32, 1530, 1310, 39, 2911, 268
n100x8192-coef-inner-2048, 16, 1551, 1298, 40, 2905, 268
n100x8192-coef-inner-2048, 17, 1523, 1308, 40, 2888, 268
n100x8192-coef-inner-2048, 16, 1530, 1285, 39, 2870, 268
n100x8192-coef-inner-2048, 16, 1527, 1303, 40, 2886, 268
n100x8192-coef-inner-2048, 20, 1527, 1328, 39, 2914, 268
n100x8192-coef-inner-2048, 16, 1527, 1289, 39, 2871, 268
n100x8192-coef-inner-2048, 20, 1523, 1293, 39, 2875, 268
n100x8192-coef-inner-2048, 16, 1537, 1294, 39, 2886, 268
n100x8192-coef-inner-2048, 18, 1530, 1301, 39, 2888, 268
n100x8192-coef-inner-2048, 20, 1538, 1297, 39, 2894, 268
n100x8192-coef-inner-2048, 16, 1522, 1295, 39, 2872, 268
n100x8192-coef-inner-2048, 17, 1534, 1279, 44, 2874, 268
n100x8192-coef-inner-2048, 16, 1522, 1276, 38, 2852, 268
n100x8192-coef-inner-2048, 16, 1516, 1293, 39, 2864, 268
n100x8192-coef-inner-2048, 18, 1513, 1347, 39, 2917, 268
n100x8192-coef-inner-2048, 16, 1524, 1312, 39, 2891, 268
n100x8192-coef-inner-2048, 16, 1524, 1315, 40, 2895, 268
n100x8192-coef-inner-2048, 17, 1532, 1294, 39, 2882, 268
n100x8192-coef-inner-2048, 16, 1517, 1293, 40, 2866, 268
n250x8192-coef-inner-2048, 17, 389, 338, 9, 753, 68
n250x8192-coef-inner-2048, 16, 389, 339, 9, 753, 68
n250x8192-coef-inner-2048, 16, 389, 322, 9, 736, 68
n250x8192-coef-inner-2048, 16, 391, 329, 9, 745, 68
n250x8192-coef-inner-2048, 16, 380, 326, 8, 730, 68
n250x8192-coef-inner-2048, 17, 396, 323, 8, 744, 68
n250x8192-coef-inner-2048, 18, 389, 326, 9, 742, 68
n250x8192-coef-inner-2048, 21, 391, 324, 9, 745, 68
n250x8192-coef-inner-2048, 19, 382, 333, 9, 743, 68
n250x8192-coef-inner-2048, 21, 389, 336, 9, 755, 68
n250x8192-coef-inner-2048, 16, 391, 337, 9, 753, 68
n250x8192-coef-inner-2048, 16, 383, 331, 9, 739, 68
n250x8192-coef-inner-2048, 16, 389, 334, 9, 748, 68
n250x8192-coef-inner-2048, 16, 390, 320, 9, 735, 68
n250x8192-coef-inner-2048, 17, 390, 335, 9, 751, 68
n250x8192-coef-inner-2048, 16, 378, 328, 9, 731, 68
n250x8192-coef-inner-2048, 25, 389, 321, 9, 744, 68
n250x8192-coef-inner-2048, 16, 389, 324, 9, 738, 68
n250x8192-coef-inner-2048, 16, 389, 336, 9, 750, 68
n250x8192-coef-inner-2048, 21, 386, 331, 9, 747, 68
n250x8192-coef-inner-2048, 16, 388, 325, 9, 738, 68
n250x8192-coef-inner-2048, 16, 392, 325, 13, 746, 68
n250x8192-coef-inner-2048, 16, 383, 331, 8, 738, 68
n250x8192-coef-inner-2048, 18, 386, 332, 9, 745, 68
n250x8192-coef-inner-2048, 16, 388, 323, 9, 736, 68
n250x8192-coef-inner-2048, 16, 391, 333, 9, 749, 68
n250x8192-coef-inner-2048, 16, 381, 332, 9, 738, 68
n250x8192-coef-inner-2048, 20, 393, 332, 9, 754, 68
n250x8192-coef-inner-2048, 20, 391, 322, 11, 744, 68
n250x8192-coef-inner-2048, 16, 384, 332, 9, 741, 68
n250x8192-coef-inner-2048, 16, 381, 328, 9, 734, 68
n250x8192-coef-inner-2048, 16, 388, 320, 9, 733, 68
n250x8192-coef-inner-2048, 16, 388, 330, 9, 743, 68
n250x8192-coef-inner-2048, 16, 381, 328, 9, 734, 68
n250x8192-coef-inner-2048, 16, 393, 320, 9, 738, 68
n250x8192-coef-inner-2048, 16, 389, 316, 8, 729, 68
n250x8192-coef-inner-2048, 16, 391, 338, 9, 754, 68
n250x8192-coef-inner-2048, 16, 383, 340, 8, 747, 68
n250x8192-coef-inner-2048, 18, 386, 319, 8, 731, 68
n250x8192-coef-inner-2048, 16, 384, 322, 9, 731, 68
n250x8192-coef-inner-2048, 23, 382, 329, 9, 743, 68
n250x8192-coef-inner-2048, 20, 380, 343, 8, 751, 68
n250x8192-coef-inner-2048, 16, 381, 319, 9, 725, 68
n250x8192-coef-inner-2048, 17, 384, 321, 11, 733, 68
n250x8192-coef-inner-2048, 16, 381, 326, 8, 731, 68
n250x8192-coef-inner-2048, 16, 380, 326, 9, 731, 68
n250x8192-coef-inner-2048, 16, 386, 324, 9, 735, 68
n250x8192-coef-inner-2048, 16, 383, 327, 10, 736, 68
n250x8192-coef-inner-2048, 16, 378, 324, 9, 727, 68
n250x8192-coef-inner-2048, 16, 382, 334, 9, 741, 68
n250x8192-coef-inner-2048, 16, 388, 324, 9, 737, 68
n250x8192-coef-inner-2048, 16, 387, 330, 9, 742, 68
n250x8192-coef-inner-2048, 16, 382, 330, 9, 737, 68
n250x8192-coef-inner-2048, 17, 385, 331, 9, 742, 68
n250x8192-coef-inner-2048, 16, 389, 319, 9, 733, 68
n250x8192-coef-inner-2048, 16, 388, 335, 9, 748, 68
n250x8192-coef-inner-2048, 17, 382, 329, 8, 736, 68
n250x8192-coef-inner-2048, 16, 387, 320, 9, 732, 68
n250x8192-coef-inner-2048, 21, 386, 336, 9, 752, 68
n250x8192-coef-inner-2048, 25, 379, 339, 9, 752, 68
n250x8192-coef-inner-2048, 20, 383, 342, 8, 753, 68
n250x8192-coef-inner-2048, 16, 390, 323, 8, 737, 68
n250x8192-coef-inner-2048, 17, 391, 331, 9, 748, 68
n250x8192-coef-inner-2048, 16, 381, 341, 9, 747, 68
n250x8192-coef-inner-2048, 16, 385, 322, 9, 732, 68
n250x8192-coef-inner-2048, 16, 388, 325, 9, 738, 68
n250x8192-coef-inner-2048, 16, 389, 328, 9, 742, 68
n250x8192-coef-inner-2048, 16, 382, 320, 9, 727, 68
n250x8192-coef-inner-2048, 16, 379, 333, 8, 736, 68
n250x8192-coef-inner-2048, 16, 379, 340, 8, 743, 68
n250x8192-coef-inner-2048, 17, 384, 334, 9, 744, 68
n250x8192-coef-inner-2048, 16, 384, 325, 18, 743, 68
n250x8192-coef-inner-2048, 23, 380, 332, 9, 744, 68
n250x8192-coef-inner-2048, 16, 381, 326, 9, 732, 68
n250x8192-coef-inner-2048, 18, 387, 321, 9, 735, 68
n250x8192-coef-inner-2048, 27, 379, 335, 9, 750, 68
n250x8192-coef-inner-2048, 16, 379, 326, 9, 730, 68
n250x8192-coef-inner-2048, 25, 382, 336, 9, 752, 68
n250x8192-coef-inner-2048, 16, 380, 318, 9, 723, 68
n250x8192-coef-inner-2048, 16, 385, 330, 9, 740, 68
n250x8192-coef-inner-2048, 16, 388, 324, 8, 736, 68
n250x8192-coef-inner-2048, 16, 378, 318, 8, 720, 68
n250x8192-coef-inner-2048, 18, 382, 321, 9, 730, 68
n250x8192-coef-inner-2048, 16, 383, 321, 9, 729, 68
n250x8192-coef-inner-2048, 20, 379, 329, 9, 737, 68
n250x8192-coef-inner-2048, 16, 381, 321, 9, 727, 68
n250x8192-coef-inner-2048, 16, 384, 321, 9, 730, 68
n250x8192-coef-inner-2048, 16, 385, 316, 8, 725, 68
n250x8192-coef-inner-2048, 16, 384, 325, 9, 734, 68
n250x8192-coef-inner-2048, 18, 385, 329, 8, 740, 68
n250x8192-coef-inner-2048, 16, 377, 324, 9, 726, 68
n250x8192-coef-inner-2048, 17, 383, 324, 9, 733, 68
n250x8192-coef-inner-2048, 16, 378, 325, 9, 728, 68
n250x8192-coef-inner-2048, 16, 380, 320, 9, 725, 68
n250x8192-coef-inner-2048, 16, 380, 319, 9, 724, 68
n250x8192-coef-inner-2048, 16, 388, 322, 8, 734, 68
n250x8192-coef-inner-2048, 16, 394, 323, 9, 742, 68
n250x8192-coef-inner-2048, 16, 380, 322, 8, 726, 68
n250x8192-coef-inner-2048, 17, 384, 323, 9, 733, 68
n250x8192-coef-inner-2048, 17, 378, 322, 8, 725, 68
n500x8192-coef-inner-2048, 16, 7757, 6753, 230, 14756, 1334
n500x8192-coef-inner-2048, 16, 7635, 6532, 202, 14385, 1334
n500x8192-coef-inner-2048, 18, 7709, 6874, 208, 14809, 1334
n500x8192-coef-inner-2048, 16, 7691, 6482, 200, 14389, 1334
n500x8192-coef-inner-2048, 16, 7568, 6463, 202, 14249, 1334
n500x8192-coef-inner-2048, 16, 7627, 6453, 202, 14298, 1334
n500x8192-coef-inner-2048, 16, 7608, 6541, 205, 14370, 1334
n500x8192-coef-inner-2048, 16, 7844, 7095, 205, 15160, 1334
n500x8192-coef-inner-2048, 17, 7821, 6546, 213, 14597, 1334
n500x8192-coef-inner-2048, 16, 7630, 6543, 203, 14392, 1334
n500x8192-coef-inner-2048, 18, 7832, 6621, 213, 14684, 1334
n500x8192-coef-inner-2048, 16, 7651, 6528, 204, 14399, 1334
n500x8192-coef-inner-2048, 18, 7611, 6770, 204, 14603, 1334
n500x8192-coef-inner-2048, 18, 7613, 6859, 206, 14696, 1334
n500x8192-coef-inner-2048, 16, 7694, 6654, 212, 14576, 1334
n500x8192-coef-inner-2048, 16, 7820, 6670, 208, 14714, 1334
n500x8192-coef-inner-2048, 16, 7665, 6639, 209, 14529, 1334
n500x8192-coef-inner-2048, 16, 7754, 6689, 205, 14664, 1334
n500x8192-coef-inner-2048, 16, 7667, 6540, 204, 14427, 1334
n500x8192-coef-inner-2048, 16, 7692, 6540, 202, 14450, 1334
n500x8192-coef-inner-2048, 16, 7646, 6579, 205, 14446, 1334
n500x8192-coef-inner-2048, 21, 7705, 6883, 203, 14812, 1334
n500x8192-coef-inner-2048, 16, 7660, 6540, 202, 14418, 1334
n500x8192-coef-inner-2048, 16, 7606, 6520, 205, 14347, 1334
n500x8192-coef-inner-2048, 16, 7616, 6549, 209, 14390, 1334
n500x8192-coef-inner-2048, 16, 7620, 6567, 205, 14408, 1334
n500x8192-coef-inner-2048, 16, 7763, 6566, 204, 14549, 1334
n500x8192-coef-inner-2048, 16, 7647, 6559, 203, 14425, 1334
n500x8192-coef-inner-2048, 16, 7681, 6523, 207, 14427, 1334
n500x8192-coef-inner-2048, 21, 7767, 6584, 206, 14578, 1334
n500x8192-coef-inner-2048, 17, 7715, 6589, 205, 14526, 1334
n500x8192-coef-inner-2048, 16, 7662, 6531, 206, 14415, 1334
n500x8192-coef-inner-2048, 17, 7617, 6558, 203, 14395, 1334
n500x8192-coef-inner-2048, 16, 7621, 6454, 202, 14293, 1334
n500x8192-coef-inner-2048, 16, 7646, 6664, 212, 14538, 1334
n500x8192-coef-inner-2048, 16, 7609, 6588, 202, 14415, 1334
n500x8192-coef-inner-2048, 16, 7642, 6771, 204, 14633, 1334
n500x8192-coef-inner-2048, 16, 7617, 6512, 207, 14352, 1334
n500x8192-coef-inner-2048, 16, 7654, 6541, 203, 14414, 1334
n500x8192-coef-inner-2048, 16, 7649, 6507, 204, 14376, 1334
n500x8192-coef-inner-2048, 16, 7619, 6779, 207, 14621, 1334
n500x8192-coef-inner-2048, 16, 7649, 6610, 200, 14475, 1334
n500x8192-coef-inner-2048, 16, 7691, 6534, 211, 14452, 1334
n500x8192-coef-inner-2048, 16, 7724, 6811, 206, 14757, 1334
n500x8192-coef-inner-2048, 16, 7680, 6510, 204, 14410, 1334
n500x8192-coef-inner-2048, 16, 7687, 6565, 203, 14471, 1334
n500x8192-coef-inner-2048, 18, 7563, 6714, 202, 14497, 1334
n500x8192-coef-inner-2048, 16, 7679, 6782, 201, 14678, 1334
n500x8192-coef-inner-2048, 19, 7714, 6561, 211, 14505, 1334
n500x8192-coef-inner-2048, 16, 7735, 6608, 203, 14562, 1334
n500x8192-coef-inner-2048, 16, 7673, 6585, 203, 14477, 1334
n500x8192-coef-inner-2048, 16, 7648, 6582, 203, 14449, 1334
n500x8192-coef-inner-2048, 16, 7605, 6549, 200, 14370, 1334
n500x8192-coef-inner-2048, 16, 7593, 6476, 202, 14287, 1334
n500x8192-coef-inner-2048, 16, 7625, 6533, 203, 14377, 1334
n500x8192-coef-inner-2048, 16, 7657, 6636, 201, 14510, 1334
n500x8192-coef-inner-2048, 16, 7640, 6512, 204, 14372, 1334
n500x8192-coef-inner-2048, 16, 7643, 6515, 203, 14377, 1334
n500x8192-coef-inner-2048, 16, 7627, 6535, 201, 14379, 1334
n500x8192-coef-inner-2048, 16, 7759, 6881, 203, 14859, 1334
n500x8192-coef-inner-2048, 17, 7610, 6554, 202, 14383, 1334
n500x8192-coef-inner-2048, 16, 7654, 6569, 203, 14442, 1334
n500x8192-coef-inner-2048, 16, 7634, 6535, 212, 14397, 1334
n500x8192-coef-inner-2048, 16, 7680, 6599, 204, 14499, 1334
n500x8192-coef-inner-2048, 16, 7702, 6532, 206, 14456, 1334
n500x8192-coef-inner-2048, 16, 7597, 6462, 200, 14275, 1334
n500x8192-coef-inner-2048, 16, 7625, 6775, 205, 14621, 1334
n500x8192-coef-inner-2048, 19, 7663, 6504, 205, 14391, 1334
n500x8192-coef-inner-2048, 16, 7614, 6549, 203, 14382, 1334
n500x8192-coef-inner-2048, 23, 7664, 6792, 204, 14683, 1334
n500x8192-coef-inner-2048, 16, 7694, 6612, 198, 14520, 1334
n500x8192-coef-inner-2048, 21, 7696, 6756, 205, 14678, 1334
n500x8192-coef-inner-2048, 16, 7703, 6517, 202, 14438, 1334
n500x8192-coef-inner-2048, 16, 7616, 6530, 201, 14363, 1334
n500x8192-coef-inner-2048, 16, 7559, 6484, 202, 14261, 1334
n500x8192-coef-inner-2048, 16, 7635, 6757, 214, 14622, 1334
n500x8192-coef-inner-2048, 16, 7629, 6536, 202, 14383, 1334
n500x8192-coef-inner-2048, 18, 7638, 6782, 203, 14641, 1334
n500x8192-coef-inner-2048, 16, 7664, 6578, 202, 14460, 1334
n500x8192-coef-inner-2048, 16, 7635, 6501, 206, 14358, 1334
n500x8192-coef-inner-2048, 16, 7602, 6508, 203, 14329, 1334
n500x8192-coef-inner-2048, 17, 7621, 6761, 202, 14601, 1334
n500x8192-coef-inner-2048, 18, 7633, 6548, 203, 14402, 1334
n500x8192-coef-inner-2048, 16, 7655, 6501, 208, 14380, 1334
n500x8192-coef-inner-2048, 16, 7686, 6556, 205, 14463, 1334
n500x8192-coef-inner-2048, 16, 7593, 6481, 201, 14291, 1334
n500x8192-coef-inner-2048, 16, 7662, 6506, 204, 14388, 1334
n500x8192-coef-inner-2048, 16, 7614, 6503, 203, 14336, 1334
n500x8192-coef-inner-2048, 16, 7570, 6669, 203, 14458, 1334
n500x8192-coef-inner-2048, 16, 7566, 6474, 200, 14256, 1334
n500x8192-coef-inner-2048, 16, 7646, 6745, 208, 14615, 1334
n500x8192-coef-inner-2048, 17, 7690, 6524, 203, 14434, 1334
n500x8192-coef-inner-2048, 18, 7630, 6553, 204, 14405, 1334
n500x8192-coef-inner-2048, 18, 7749, 6513, 210, 14490, 1334
n500x8192-coef-inner-2048, 16, 7597, 6687, 221, 14521, 1334
n500x8192-coef-inner-2048, 16, 7982, 6533, 216, 14747, 1334
n500x8192-coef-inner-2048, 16, 7616, 6511, 203, 14346, 1334
n500x8192-coef-inner-2048, 16, 7656, 6488, 201, 14361, 1334
n500x8192-coef-inner-2048, 16, 7666, 6523, 202, 14407, 1334
n500x8192-coef-inner-2048, 16, 7616, 6576, 203, 14411, 1334
n1000x8192-coef-inner-2048, 17, 15946, 13163, 478, 29604, 2668
n1000x8192-coef-inner-2048, 16, 15392, 13624, 411, 29443, 2668
n1000x8192-coef-inner-2048, 16, 21896, 13418, 418, 35748, 2668
n1000x8192-coef-inner-2048, 19, 15135, 13458, 410, 29022, 2668
n1000x8192-coef-inner-2048, 16, 15295, 12995, 413, 28719, 2668
n1000x8192-coef-inner-2048, 18, 15244, 13158, 413, 28833, 2668
n1000x8192-coef-inner-2048, 16, 15181, 12857, 413, 28467, 2668
n1000x8192-coef-inner-2048, 16, 15194, 13059, 419, 28688, 2668
n1000x8192-coef-inner-2048, 16, 15238, 12950, 411, 28615, 2668
n1000x8192-coef-inner-2048, 16, 15314, 13484, 413, 29227, 2668
n1000x8192-coef-inner-2048, 16, 15634, 13121, 412, 29183, 2668
n1000x8192-coef-inner-2048, 16, 15221, 13039, 424, 28700, 2668
n1000x8192-coef-inner-2048, 16, 15245, 12954, 405, 28620, 2668
n1000x8192-coef-inner-2048, 16, 15226, 12982, 410, 28634, 2668
n1000x8192-coef-inner-2048, 16, 15313, 12928, 410, 28667, 2668
n1000x8192-coef-inner-2048, 16, 15203, 13203, 422, 28844, 2668
n1000x8192-coef-inner-2048, 16, 15264, 13020, 412, 28712, 2668
n1000x8192-coef-inner-2048, 17, 15502, 13797, 417, 29733, 2668
n1000x8192-coef-inner-2048, 16, 15307, 12967, 411, 28701, 2668
n1000x8192-coef-inner-2048, 16, 15223, 13035, 406, 28680, 2668
n1000x8192-coef-inner-2048, 16, 15350, 13054, 430, 28850, 2668
n1000x8192-coef-inner-2048, 16, 15517, 13065, 421, 29019, 2668
n1000x8192-coef-inner-2048, 16, 15182, 12930, 405, 28533, 2668
n1000x8192-coef-inner-2048, 16, 15289, 13136, 424, 28865, 2668
n1000x8192-coef-inner-2048, 16, 15600, 13075, 421, 29112, 2668
n1000x8192-coef-inner-2048, 16, 15300, 13165, 419, 28900, 2668
n1000x8192-coef-inner-2048, 16, 15515, 13167, 423, 29121, 2668
n1000x8192-coef-inner-2048, 16, 15347, 13090, 417, 28870, 2668
n1000x8192-coef-inner-2048, 16, 15335, 13087, 422, 28860, 2668
n1000x8192-coef-inner-2048, 16, 15279, 13053, 411, 28759, 2668
n1000x8192-coef-inner-2048, 16, 15324, 13037, 413, 28790, 2668
n1000x8192-coef-inner-2048, 16, 15354, 13440, 427, 29237, 2668
n1000x8192-coef-inner-2048, 16, 15369, 13677, 415, 29477, 2668
n1000x8192-coef-inner-2048, 16, 15373, 13088, 420, 28897, 2668
n1000x8192-coef-inner-2048, 17, 15189, 13451, 410, 29067, 2668
n1000x8192-coef-inner-2048, 16, 15179, 13097, 416, 28708, 2668
n1000x8192-coef-inner-2048, 16, 15306, 13106, 412, 28840, 2668
n1000x8192-coef-inner-2048, 16, 15458, 13303, 422, 29199, 2668
n1000x8192-coef-inner-2048, 16, 15628, 13254, 427, 29325, 2668
n1000x8192-coef-inner-2048, 16, 15322, 13122, 412, 28872, 2668
n1000x8192-coef-inner-2048, 16, 15548, 13218, 470, 29252, 2668
n1000x8192-coef-inner-2048, 23, 15284, 13707, 417, 29431, 2668
n1000x8192-coef-inner-2048, 16, 15779, 13511, 421, 29727, 2668
n1000x8192-coef-inner-2048, 17, 15607, 13218, 417, 29259, 2668
n1000x8192-coef-inner-2048, 16, 15453, 13182, 413, 29064, 2668
n1000x8192-coef-inner-2048, 16, 15467, 13295, 414, 29192, 2668
n1000x8192-coef-inner-2048, 16, 15464, 13772, 417, 29669, 2668
n1000x8192-coef-inner-2048, 16, 15507, 13192, 430, 29145, 2668
n1000x8192-coef-inner-2048, 17, 15614, 13749, 414, 29794, 2668
n1000x8192-coef-inner-2048, 16, 15580, 13859, 428, 29883, 2668
n1000x8192-coef-inner-2048, 16, 15826, 13364, 424, 29630, 2668
n1000x8192-coef-inner-2048, 16, 15543, 13220, 415, 29194, 2668
n1000x8192-coef-inner-2048, 23, 15670, 14040, 418, 30151, 2668
n1000x8192-coef-inner-2048, 20, 15693, 13582, 429, 29724, 2668
n1000x8192-coef-inner-2048, 16, 15990, 13584, 431, 30021, 2668
n1000x8192-coef-inner-2048, 18, 15813, 13571, 435, 29837, 2668
n1000x8192-coef-inner-2048, 16, 15776, 13579, 416, 29787, 2668
n1000x8192-coef-inner-2048, 16, 15496, 13401, 414, 29327, 2668
n1000x8192-coef-inner-2048, 19, 15722, 13845, 419, 30005, 2668
n1000x8192-coef-inner-2048, 17, 15499, 14001, 423, 29940, 2668
n1000x8192-coef-inner-2048, 26, 15601, 13252, 417, 29296, 2668
n1000x8192-coef-inner-2048, 16, 15525, 13169, 416, 29126, 2668
n1000x8192-coef-inner-2048, 17, 15478, 13142, 412, 29049, 2668
n1000x8192-coef-inner-2048, 16, 15409, 13059, 409, 28893, 2668
n1000x8192-coef-inner-2048, 16, 15576, 13254, 427, 29273, 2668
n1000x8192-coef-inner-2048, 16, 15436, 13286, 416, 29154, 2668
n1000x8192-coef-inner-2048, 16, 15754, 13041, 414, 29225, 2668
n1000x8192-coef-inner-2048, 16, 15569, 13181, 436, 29202, 2668
n1000x8192-coef-inner-2048, 17, 15550, 13259, 418, 29244, 2668
n1000x8192-coef-inner-2048, 19, 15542, 13680, 424, 29665, 2668
n1000x8192-coef-inner-2048, 16, 15661, 13196, 406, 29279, 2668
n1000x8192-coef-inner-2048, 16, 15457, 13383, 431, 29287, 2668
n1000x8192-coef-inner-2048, 17, 15722, 13405, 429, 29573, 2668
n1000x8192-coef-inner-2048, 16, 15616, 13318, 433, 29383, 2668
n1000x8192-coef-inner-2048, 16, 15800, 13214, 425, 29455, 2668
n1000x8192-coef-inner-2048, 18, 15544, 13037, 418, 29017, 2668
n1000x8192-coef-inner-2048, 16, 15505, 13125, 410, 29056, 2668
n1000x8192-coef-inner-2048, 17, 15236, 13086, 418, 28757, 2668
n1000x8192-coef-inner-2048, 16, 15515, 13676, 412, 29619, 2668
n1000x8192-coef-inner-2048, 16, 15546, 13143, 413, 29118, 2668
n1000x8192-coef-inner-2048, 16, 15476, 13549, 412, 29453, 2668
n1000x8192-coef-inner-2048, 16, 15456, 13663, 421, 29556, 2668
n1000x8192-coef-inner-2048, 16, 15411, 13544, 418, 29389, 2668
n1000x8192-coef-inner-2048, 20, 15561, 13658, 418, 29657, 2668
n1000x8192-coef-inner-2048, 16, 15389, 13177, 420, 29002, 2668
n1000x8192-coef-inner-2048, 16, 15570, 13135, 412, 29133, 2668
n1000x8192-coef-inner-2048, 19, 15501, 13628, 409, 29557, 2668
n1000x8192-coef-inner-2048, 16, 15548, 13062, 426, 29052, 2668
n1000x8192-coef-inner-2048, 16, 15402, 13736, 424, 29578, 2668
n1000x8192-coef-inner-2048, 16, 15789, 13367, 425, 29597, 2668
n1000x8192-coef-inner-2048, 16, 15430, 13166, 418, 29030, 2668
n1000x8192-coef-inner-2048, 16, 15763, 13173, 422, 29374, 2668
n1000x8192-coef-inner-2048, 20, 15536, 13166, 413, 29135, 2668
n1000x8192-coef-inner-2048, 18, 15348, 13107, 415, 28888, 2668
n1000x8192-coef-inner-2048, 18, 15427, 13117, 418, 28980, 2668
n1000x8192-coef-inner-2048, 17, 15496, 13742, 416, 29671, 2668
n1000x8192-coef-inner-2048, 19, 15441, 13190, 423, 29073, 2668
n1000x8192-coef-inner-2048, 16, 15440, 13218, 415, 29089, 2668
n1000x8192-coef-inner-2048, 16, 15711, 13290, 418, 29435, 2668
n1000x8192-coef-inner-2048, 16, 15623, 13226, 415, 29280, 2668
n8192-coef-inner-2048, 16, 73, 32, 0, 121, 4
n8192-coef-inner-2048, 28, 17, 21, 0, 66, 4
n8192-coef-inner-2048, 25, 17, 22, 0, 64, 4
n8192-coef-inner-2048, 16, 24, 14, 5, 59, 4
n8192-coef-inner-2048, 16, 23, 16, 0, 55, 4
n8192-coef-inner-2048, 16, 22, 15, 0, 53, 4
n8192-coef-inner-2048, 20, 17, 20, 0, 57, 4
n8192-coef-inner-2048, 16, 24, 14, 0, 54, 4
n8192-coef-inner-2048, 18, 22, 14, 0, 54, 4
n8192-coef-inner-2048, 16, 17, 14, 0, 47, 4
n8192-coef-inner-2048, 16, 17, 14, 0, 47, 4
n8192-coef-inner-2048, 16, 17, 14, 0, 47, 4
n8192-coef-inner-2048, 16, 16, 14, 0, 46, 4
n8192-coef-inner-2048, 16, 17, 14, 0, 47, 4
n8192-coef-inner-2048, 16, 17, 14, 0, 47, 4
n8192-coef-inner-2048, 16, 18, 13, 0, 47, 4
n8192-coef-inner-2048, 19, 17, 14, 0, 50, 4
n8192-coef-inner-2048, 18, 17, 13, 0, 48, 4
n8192-coef-inner-2048, 37, 21, 16, 0, 74, 4
n8192-coef-inner-2048, 16, 17, 14, 0, 47, 4
n8192-coef-inner-2048, 19, 16, 14, 0, 49, 4
n8192-coef-inner-2048, 16, 17, 14, 0, 47, 4
n8192-coef-inner-2048, 16, 17, 14, 0, 47, 4
n8192-coef-inner-2048, 16, 17, 14, 0, 47, 4
n8192-coef-inner-2048, 16, 17, 14, 0, 47, 4
n8192-coef-inner-2048, 17, 16, 13, 0, 46, 4
n8192-coef-inner-2048, 19, 17, 14, 0, 50, 4
n8192-coef-inner-2048, 16, 17, 14, 0, 47, 4
n8192-coef-inner-2048, 16, 34, 14, 0, 64, 4
n8192-coef-inner-2048, 39, 50, 158, 0, 247, 4
n8192-coef-inner-2048, 27, 17, 14, 0, 58, 4
n8192-coef-inner-2048, 17, 18, 17, 0, 52, 4
n8192-coef-inner-2048, 16, 17, 16, 0, 49, 4
n8192-coef-inner-2048, 16, 17, 13, 0, 46, 4
n8192-coef-inner-2048, 16, 17, 13, 0, 46, 4
n8192-coef-inner-2048, 25, 19, 14, 0, 58, 4
n8192-coef-inner-2048, 16, 17, 13, 0, 46, 4
n8192-coef-inner-2048, 16, 17, 14, 0, 47, 4
n8192-coef-inner-2048, 17, 16, 14, 0, 47, 4
n8192-coef-inner-2048, 16, 17, 13, 0, 46, 4
n8192-coef-inner-2048, 16, 16, 13, 0, 45, 4
n8192-coef-inner-2048, 16, 16, 14, 0, 46, 4
n8192-coef-inner-2048, 16, 16, 13, 0, 45, 4
n8192-coef-inner-2048, 16, 17, 13, 0, 46, 4
n8192-coef-inner-2048, 18, 17, 14, 0, 49, 4
n8192-coef-inner-2048, 16, 17, 16, 0, 49, 4
n8192-coef-inner-2048, 28, 17, 13, 0, 58, 4
n8192-coef-inner-2048, 16, 17, 13, 0, 46, 4
n8192-coef-inner-2048, 20, 16, 14, 0, 50, 4
n8192-coef-inner-2048, 16, 17, 14, 0, 47, 4
n8192-coef-inner-2048, 16, 17, 13, 0, 46, 4
n8192-coef-inner-2048, 16, 17, 13, 0, 46, 4
n8192-coef-inner-2048, 16, 17, 14, 0, 47, 4
n8192-coef-inner-2048, 16, 16, 14, 0, 46, 4
n8192-coef-inner-2048, 16, 17, 13, 0, 46, 4
n8192-coef-inner-2048, 16, 17, 13, 0, 46, 4
n8192-coef-inner-2048, 18, 18, 13, 0, 49, 4
n8192-coef-inner-2048, 16, 16, 13, 0, 45, 4
n8192-coef-inner-2048, 19, 16, 13, 0, 48, 4
n8192-coef-inner-2048, 16, 17, 14, 0, 47, 4
n8192-coef-inner-2048, 20, 16, 14, 0, 50, 4
n8192-coef-inner-2048, 16, 17, 13, 0, 46, 4
n8192-coef-inner-2048, 20, 17, 14, 0, 51, 4
n8192-coef-inner-2048, 16, 17, 13, 0, 46, 4
n8192-coef-inner-2048, 16, 17, 14, 0, 47, 4
n8192-coef-inner-2048, 16, 17, 13, 0, 46, 4
n8192-coef-inner-2048, 24, 16, 14, 0, 54, 4
n8192-coef-inner-2048, 22, 17, 14, 0, 53, 4
n8192-coef-inner-2048, 16, 16, 13, 0, 45, 4
n8192-coef-inner-2048, 16, 16, 13, 0, 45, 4
n8192-coef-inner-2048, 16, 17, 13, 0, 46, 4
n8192-coef-inner-2048, 16, 17, 13, 0, 46, 4
n8192-coef-inner-2048, 16, 17, 13, 0, 46, 4
n8192-coef-inner-2048, 16, 17, 13, 0, 46, 4
n8192-coef-inner-2048, 20, 17, 14, 0, 51, 4
n8192-coef-inner-2048, 16, 17, 13, 0, 46, 4
n8192-coef-inner-2048, 24, 16, 14, 0, 54, 4
n8192-coef-inner-2048, 16, 17, 13, 0, 46, 4
n8192-coef-inner-2048, 17, 17, 14, 0, 48, 4
n8192-coef-inner-2048, 16, 17, 14, 0, 47, 4
n8192-coef-inner-2048, 16, 17, 13, 0, 46, 4
n8192-coef-inner-2048, 19, 17, 14, 0, 50, 4
n8192-coef-inner-2048, 16, 16, 14, 0, 46, 4
n8192-coef-inner-2048, 20, 16, 14, 0, 50, 4
n8192-coef-inner-2048, 16, 16, 13, 0, 45, 4
n8192-coef-inner-2048, 16, 17, 13, 0, 46, 4
n8192-coef-inner-2048, 16, 17, 13, 0, 46, 4
n8192-coef-inner-2048, 16, 17, 13, 0, 46, 4
n8192-coef-inner-2048, 16, 17, 14, 0, 47, 4
n8192-coef-inner-2048, 16, 17, 14, 0, 47, 4
n8192-coef-inner-2048, 16, 17, 13, 0, 46, 4
n8192-coef-inner-2048, 16, 17, 13, 0, 46, 4
n8192-coef-inner-2048, 16, 17, 14, 0, 47, 4
n8192-coef-inner-2048, 16, 17, 13, 0, 46, 4
n8192-coef-inner-2048, 16, 17, 13, 0, 46, 4
n8192-coef-inner-2048, 16, 17, 14, 0, 47, 4
n8192-coef-inner-2048, 16, 16, 13, 0, 45, 4
n8192-coef-inner-2048, 16, 17, 14, 0, 47, 4
n8192-coef-inner-2048, 16, 17, 14, 0, 47, 4
n8192-coef-inner-2048, 17, 17, 13, 0, 47, 4
n10x8192-coef-inner-2048, 23, 151, 124, 3, 301, 28
n10x8192-coef-inner-2048, 16, 154, 127, 3, 300, 28
n10x8192-coef-inner-2048, 16, 151, 126, 3, 296, 28
n10x8192-coef-inner-2048, 16, 151, 128, 3, 298, 28
n10x8192-coef-inner-2048, 16, 150, 141, 3, 310, 28
n10x8192-coef-inner-2048, 16, 154, 124, 3, 297, 28
n10x8192-coef-inner-2048, 16, 151, 126, 3, 296, 28
n10x8192-coef-inner-2048, 19, 152, 126, 3, 300, 28
n10x8192-coef-inner-2048, 16, 150, 125, 3, 294, 28
n10x8192-coef-inner-2048, 16, 153, 127, 3, 299, 28
n10x8192-coef-inner-2048, 20, 151, 130, 3, 304, 28
n10x8192-coef-inner-2048, 19, 151, 131, 3, 304, 28
n10x8192-coef-inner-2048, 16, 151, 127, 3, 297, 28
n10x8192-coef-inner-2048, 19, 153, 125, 3, 300, 28
n10x8192-coef-inner-2048, 16, 151, 128, 3, 298, 28
n10x8192-coef-inner-2048, 16, 152, 124, 3, 295, 28
n10x8192-coef-inner-2048, 16, 151, 125, 3, 295, 28
n10x8192-coef-inner-2048, 17, 152, 129, 3, 301, 28
n10x8192-coef-inner-2048, 16, 150, 125, 3, 294, 28
n10x8192-coef-inner-2048, 16, 151, 126, 3, 296, 28
n10x8192-coef-inner-2048, 16, 151, 128, 5, 300, 28
n10x8192-coef-inner-2048, 16, 151, 126, 3, 296, 28
n10x8192-coef-inner-2048, 21, 151, 127, 3, 302, 28
n10x8192-coef-inner-2048, 16, 150, 124, 3, 293, 28
n10x8192-coef-inner-2048, 16, 150, 127, 3, 296, 28
n10x8192-coef-inner-2048, 16, 151, 125, 3, 295, 28
n10x8192-coef-inner-2048, 17, 150, 128, 3, 298, 28
n10x8192-coef-inner-2048, 16, 151, 126, 3, 296, 28
n10x8192-coef-inner-2048, 16, 151, 128, 3, 298, 28
n10x8192-coef-inner-2048, 16, 151, 125, 3, 295, 28
n10x8192-coef-inner-2048, 16, 150, 129, 3, 298, 28
n10x8192-coef-inner-2048, 16, 153, 125, 3, 297, 28
n10x8192-coef-inner-2048, 16, 150, 126, 3, 295, 28
n10x8192-coef-inner-2048, 16, 151, 126, 3, 296, 28
n10x8192-coef-inner-2048, 16, 151, 124, 3, 294, 28
n10x8192-coef-inner-2048, 16, 151, 125, 3, 295, 28
n10x8192-coef-inner-2048, 22, 152, 125, 3, 302, 28
n10x8192-coef-inner-2048, 16, 151, 125, 3, 295, 28
n10x8192-coef-inner-2048, 16, 153, 124, 3, 296, 28
n10x8192-coef-inner-2048, 16, 149, 125, 3, 293, 28
n10x8192-coef-inner-2048, 16, 153, 125, 3, 297, 28
n10x8192-coef-inner-2048, 16, 151, 124, 3, 294, 28
n10x8192-coef-inner-2048, 16, 153, 125, 3, 297, 28
n10x8192-coef-inner-2048, 20, 150, 130, 3, 303, 28
n10x8192-coef-inner-2048, 16, 153, 125, 3, 297, 28
n10x8192-coef-inner-2048, 16, 150, 125, 3, 294, 28
n10x8192-coef-inner-2048, 16, 152, 124, 3, 295, 28
n10x8192-coef-inner-2048, 16, 150, 127, 3, 296, 28
n10x8192-coef-inner-2048, 16, 151, 125, 3, 295, 28
n10x8192-coef-inner-2048, 16, 150, 124, 3, 293, 28
n10x8192-coef-inner-2048, 17, 150, 130, 3, 300, 28
n10x8192-coef-inner-2048, 16, 151, 125, 3, 295, 28
n10x8192-coef-inner-2048, 16, 151, 125, 3, 295, 28
n10x8192-coef-inner-2048, 16, 150, 126, 3, 295, 28
n10x8192-coef-inner-2048, 19, 151, 126, 3, 299, 28
n10x8192-coef-inner-2048, 18, 150, 132, 3, 303, 28
n10x8192-coef-inner-2048, 16, 149, 125, 3, 293, 28
n10x8192-coef-inner-2048, 16, 151, 127, 3, 297, 28
n10x8192-coef-inner-2048, 16, 152, 126, 3, 297, 28
n10x8192-coef-inner-2048, 21, 151, 127, 3, 302, 28
n10x8192-coef-inner-2048, 16, 150, 125, 3, 294, 28
n10x8192-coef-inner-2048, 16, 150, 127, 3, 296, 28
n10x8192-coef-inner-2048, 20, 150, 124, 3, 297, 28
n10x8192-coef-inner-2048, 16, 151, 128, 3, 298, 28
n10x8192-coef-inner-2048, 16, 150, 124, 3, 293, 28
n10x8192-coef-inner-2048, 23, 151, 129, 3, 306, 28
n10x8192-coef-inner-2048, 16, 151, 124, 3, 294, 28
n10x8192-coef-inner-2048, 16, 152, 126, 3, 297, 28
n10x8192-coef-inner-2048, 16, 149, 124, 3, 292, 28
n10x8192-coef-inner-2048, 16, 151, 126, 3, 296, 28
n10x8192-coef-inner-2048, 16, 151, 124, 3, 294, 28
n10x8192-coef-inner-2048, 20, 151, 129, 3, 303, 28
n10x8192-coef-inner-2048, 23, 150, 131, 3, 307, 28
n10x8192-coef-inner-2048, 16, 152, 125, 3, 296, 28
n10x8192-coef-inner-2048, 24, 150, 124, 3, 301, 28
n10x8192-coef-inner-2048, 16, 153, 126, 3, 298, 28
n10x8192-coef-inner-2048, 16, 150, 125, 3, 294, 28
n10x8192-coef-inner-2048, 16, 153, 125, 3, 297, 28
n10x8192-coef-inner-2048, 16, 150, 125, 3, 294, 28
n10x8192-coef-inner-2048, 17, 151, 126, 3, 297, 28
n10x8192-coef-inner-2048, 16, 151, 124, 5, 296, 28
n10x8192-coef-inner-2048, 20, 150, 125, 3, 298, 28
n10x8192-coef-inner-2048, 16, 150, 127, 3, 296, 28
n10x8192-coef-inner-2048, 16, 151, 125, 3, 295, 28
n10x8192-coef-inner-2048, 16, 151, 127, 3, 297, 28
n10x8192-coef-inner-2048, 16, 151, 124, 3, 294, 28
n10x8192-coef-inner-2048, 16, 149, 126, 3, 294, 28
n10x8192-coef-inner-2048, 16, 150, 124, 3, 293, 28
n10x8192-coef-inner-2048, 16, 151, 127, 3, 297, 28
n10x8192-coef-inner-2048, 16, 150, 126, 3, 295, 28
n10x8192-coef-inner-2048, 16, 150, 126, 3, 295, 28
n10x8192-coef-inner-2048, 16, 151, 125, 3, 295, 28
n10x8192-coef-inner-2048, 16, 151, 130, 3, 300, 28
n10x8192-coef-inner-2048, 16, 149, 124, 3, 292, 28
n10x8192-coef-inner-2048, 16, 150, 126, 3, 295, 28
n10x8192-coef-inner-2048, 16, 149, 124, 3, 292, 28
n10x8192-coef-inner-2048, 16, 154, 125, 3, 298, 28
n10x8192-coef-inner-2048, 16, 149, 124, 3, 292, 28
n10x8192-coef-inner-2048, 16, 151, 125, 3, 295, 28
n10x8192-coef-inner-2048, 19, 150, 125, 3, 297, 28
n25x8192-coef-inner-2048, 17, 378, 316, 9, 720, 68
n25x8192-coef-inner-2048, 19, 375, 328, 9, 731, 68
n25x8192-coef-inner-2048, 16, 380, 311, 9, 716, 68
n25x8192-coef-inner-2048, 16, 376, 311, 9, 712, 68
n25x8192-coef-inner-2048, 16, 377, 318, 9, 720, 68
n25x8192-coef-inner-2048, 19, 376, 326, 9, 730, 68
n25x8192-coef-inner-2048, 16, 389, 318, 9, 732, 68
n25x8192-coef-inner-2048, 16, 377, 314, 9, 716, 68
n25x8192-coef-inner-2048, 16, 379, 319, 9, 723, 68
n25x8192-coef-inner-2048, 17, 382, 321, 9, 729, 68
n25x8192-coef-inner-2048, 16, 383, 321, 9, 729, 68
n25x8192-coef-inner-2048, 18, 379, 332, 9, 738, 68
n25x8192-coef-inner-2048, 16, 384, 317, 9, 726, 68
n25x8192-coef-inner-2048, 16, 381, 319, 9, 725, 68
n25x8192-coef-inner-2048, 16, 383, 321, 9, 729, 68
n25x8192-coef-inner-2048, 16, 377, 318, 9, 720, 68
n25x8192-coef-inner-2048, 24, 381, 322, 9, 736, 68
n25x8192-coef-inner-2048, 16, 376, 317, 9, 718, 68
n25x8192-coef-inner-2048, 16, 378, 313, 9, 716, 68
n25x8192-coef-inner-2048, 26, 377, 334, 9, 746, 68
n25x8192-coef-inner-2048, 20, 397, 319, 10, 746, 68
n25x8192-coef-inner-2048, 16, 379, 323, 9, 727, 68
n25x8192-coef-inner-2048, 16, 380, 319, 9, 724, 68
n25x8192-coef-inner-2048, 16, 382, 316, 9, 723, 68
n25x8192-coef-inner-2048, 16, 375, 317, 9, 717, 68
n25x8192-coef-inner-2048, 16, 379, 314, 8, 717, 68
n25x8192-coef-inner-2048, 16, 378, 316, 9, 719, 68
n25x8192-coef-inner-2048, 16, 378, 316, 8, 718, 68
n25x8192-coef-inner-2048, 16, 375, 313, 9, 713, 68
n25x8192-coef-inner-2048, 16, 375, 314, 9, 714, 68
n25x8192-coef-inner-2048, 16, 378, 316, 9, 719, 68
n25x8192-coef-inner-2048, 16, 379, 320, 9, 724, 68
n25x8192-coef-inner-2048, 16, 379, 313, 9, 717, 68
n25x8192-coef-inner-2048, 16, 379, 318, 9, 722, 68
n25x8192-coef-inner-2048, 20, 376, 329, 9, 734, 68
n25x8192-coef-inner-2048, 17, 379, 318, 9, 723, 68
n25x8192-coef-inner-2048, 16, 377, 321, 9, 723, 68
n25x8192-coef-inner-2048, 16, 380, 314, 9, 719, 68
n25x8192-coef-inner-2048, 16, 379, 315, 9, 719, 68
n25x8192-coef-inner-2048, 16, 378, 316, 9, 719, 68
n25x8192-coef-inner-2048, 16, 377, 315, 9, 717, 68
n25x8192-coef-inner-2048, 16, 377, 317, 9, 719, 68
n25x8192-coef-inner-2048, 16, 378, 318, 9, 721, 68
n25x8192-coef-inner-2048, 16, 376, 315, 8, 715, 68
n25x8192-coef-inner-2048, 17, 376, 327, 9, 729, 68
n25x8192-coef-inner-2048, 16, 380, 321, 9, 726, 68
n25x8192-coef-inner-2048, 19, 380, 338, 9, 746, 68
n25x8192-coef-inner-2048, 17, 377, 330, 9, 733, 68
n25x8192-coef-inner-2048, 16, 377, 314, 9, 716, 68
n25x8192-coef-inner-2048, 16, 377, 314, 9, 716, 68
n25x8192-coef-inner-2048, 16, 380, 313, 9, 718, 68
n25x8192-coef-inner-2048, 16, 378, 316, 9, 719, 68
n25x8192-coef-inner-2048, 16, 377, 316, 9, 718, 68
n25x8192-coef-inner-2048, 16, 382, 313, 9, 720, 68
n25x8192-coef-inner-2048, 16, 375, 320, 9, 720, 68
n25x8192-coef-inner-2048, 16, 375, 320, 9, 720, 68
n25x8192-coef-inner-2048, 17, 377, 316, 9, 719, 68
n25x8192-coef-inner-2048, 19, 379, 313, 8, 719, 68
n25x8192-coef-inner-2048, 16, 375, 313, 8, 712, 68
n25x8192-coef-inner-2048, 16, 377, 318, 9, 720, 68
n25x8192-coef-inner-2048, 16, 380, 314, 9, 719, 68
n25x8192-coef-inner-2048, 16, 378, 310, 9, 713, 68
n25x8192-coef-inner-2048, 16, 375, 315, 9, 715, 68
n25x8192-coef-inner-2048, 16, 380, 319, 8, 723, 68
n25x8192-coef-inner-2048, 16, 375, 314, 8, 713, 68
n25x8192-coef-inner-2048, 17, 376, 318, 9, 720, 68
n25x8192-coef-inner-2048, 16, 376, 314, 8, 714, 68
n25x8192-coef-inner-2048, 16, 379, 311, 9, 715, 68
n25x8192-coef-inner-2048, 16, 377, 317, 9, 719, 68
n25x8192-coef-inner-2048, 16, 376, 312, 9, 713, 68
n25x8192-coef-inner-2048, 16, 378, 316, 9, 719, 68
n25x8192-coef-inner-2048, 16, 379, 313, 9, 717, 68
n25x8192-coef-inner-2048, 19, 379, 316, 9, 723, 68
n25x8192-coef-inner-2048, 16, 377, 313, 9, 715, 68
n25x8192-coef-inner-2048, 16, 376, 312, 9, 713, 68
n25x8192-coef-inner-2048, 19, 375, 312, 9, 715, 68
n25x8192-coef-inner-2048, 16, 376, 313, 8, 713, 68
n25x8192-coef-inner-2048, 16, 375, 311, 9, 711, 68
n25x8192-coef-inner-2048, 16, 375, 311, 8, 710, 68
n25x8192-coef-inner-2048, 16, 375, 313, 9, 713, 68
n25x8192-coef-inner-2048, 16, 376, 315, 9, 716, 68
n25x8192-coef-inner-2048, 16, 375, 314, 9, 714, 68
n25x8192-coef-inner-2048, 16, 377, 311, 9, 713, 68
n25x8192-coef-inner-2048, 17, 380, 326, 9, 732, 68
n25x8192-coef-inner-2048, 16, 374, 312, 8, 710, 68
n25x8192-coef-inner-2048, 16, 377, 312, 9, 714, 68
n25x8192-coef-inner-2048, 16, 377, 314, 9, 716, 68
n25x8192-coef-inner-2048, 20, 379, 315, 8, 722, 68
n25x8192-coef-inner-2048, 16, 377, 315, 9, 717, 68
n25x8192-coef-inner-2048, 16, 376, 314, 8, 714, 68
n25x8192-coef-inner-2048, 22, 376, 327, 9, 734, 68
n25x8192-coef-inner-2048, 21, 378, 327, 9, 735, 68
n25x8192-coef-inner-2048, 16, 379, 312, 8, 715, 68
n25x8192-coef-inner-2048, 28, 373, 327, 9, 737, 68
n25x8192-coef-inner-2048, 16, 376, 314, 9, 715, 68
n25x8192-coef-inner-2048, 17, 375, 317, 9, 718, 68
n25x8192-coef-inner-2048, 17, 377, 311, 9, 714, 68
n25x8192-coef-inner-2048, 25, 379, 316, 9, 729, 68
n25x8192-coef-inner-2048, 17, 378, 312, 9, 716, 68
n25x8192-coef-inner-2048, 22, 375, 313, 9, 719, 68
n50x8192-coef-inner-2048, 17, 767, 629, 19, 1432, 134
n50x8192-coef-inner-2048, 16, 759, 637, 18, 1430, 134
n50x8192-coef-inner-2048, 16, 756, 626, 18, 1416, 134
n50x8192-coef-inner-2048, 16, 755, 630, 19, 1420, 134
n50x8192-coef-inner-2048, 16, 755, 629, 19, 1419, 134
n50x8192-coef-inner-2048, 17, 757, 627, 18, 1419, 134
n50x8192-coef-inner-2048, 19, 764, 629, 21, 1433, 134
n50x8192-coef-inner-2048, 16, 770, 627, 18, 1431, 134
n50x8192-coef-inner-2048, 16, 754, 638, 19, 1427, 134
n50x8192-coef-inner-2048, 17, 762, 629, 19, 1427, 134
n50x8192-coef-inner-2048, 16, 756, 636, 19, 1427, 134
n50x8192-coef-inner-2048, 16, 760, 632, 19, 1427, 134
n50x8192-coef-inner-2048, 16, 753, 625, 18, 1412, 134
n50x8192-coef-inner-2048, 19, 755, 665, 19, 1458, 134
n50x8192-coef-inner-2048, 16, 758, 637, 19, 1430, 134
n50x8192-coef-inner-2048, 16, 758, 637, 21, 1432, 134
n50x8192-coef-inner-2048, 16, 755, 626, 19, 1416, 134
n50x8192-coef-inner-2048, 16, 750, 622, 18, 1406, 134
n50x8192-coef-inner-2048, 19, 762, 631, 18, 1430, 134
n50x8192-coef-inner-2048, 18, 758, 627, 18, 1421, 134
n50x8192-coef-inner-2048, 16, 759, 631, 19, 1425, 134
n50x8192-coef-inner-2048, 16, 759, 631, 18, 1424, 134
n50x8192-coef-inner-2048, 16, 758, 635, 19, 1428, 134
n50x8192-coef-inner-2048, 16, 757, 626, 18, 1417, 134
n50x8192-coef-inner-2048, 16, 753, 624, 19, 1412, 134
n50x8192-coef-inner-2048, 16, 753, 635, 19, 1423, 134
n50x8192-coef-inner-2048, 16, 758, 630, 19, 1423, 134
n50x8192-coef-inner-2048, 16, 761, 628, 19, 1424, 134
n50x8192-coef-inner-2048, 16, 759, 632, 18, 1425, 134
n50x8192-coef-inner-2048, 16, 757, 630, 19, 1422, 134
n50x8192-coef-inner-2048, 16, 755, 631, 18, 1420, 134
n50x8192-coef-inner-2048, 22, 754, 655, 19, 1450, 134
n50x8192-coef-inner-2048, 16, 756, 626, 18, 1416, 134
n50x8192-coef-inner-2048, 16, 750, 628, 18, 1412, 134
n50x8192-coef-inner-2048, 16, 762, 626, 19, 1423, 134
n50x8192-coef-inner-2048, 16, 750, 633, 19, 1418, 134
n50x8192-coef-inner-2048, 16, 756, 632, 19, 1423, 134
n50x8192-coef-inner-2048, 16, 755, 633, 19, 1423, 134
n50x8192-coef-inner-2048, 16, 752, 618, 19, 1405, 134
n50x8192-coef-inner-2048, 16, 750, 625, 18, 1409, 134
n50x8192-coef-inner-2048, 21, 756, 636, 19, 1432, 134
n50x8192-coef-inner-2048, 16, 771, 627, 18, 1432, 134
n50x8192-coef-inner-2048, 16, 757, 630, 19, 1422, 134
n50x8192-coef-inner-2048, 22, 752, 657, 18, 1449, 134
n50x8192-coef-inner-2048, 16, 753, 631, 19, 1419, 134
n50x8192-coef-inner-2048, 16, 751, 626, 18, 1411, 134
n50x8192-coef-inner-2048, 16, 751, 628, 19, 1414, 134
n50x8192-coef-inner-2048, 16, 751, 623, 19, 1409, 134
n50x8192-coef-inner-2048, 16, 749, 624, 19, 1408, 134
n50x8192-coef-inner-2048, 16, 752, 624, 19, 1411, 134
n50x8192-coef-inner-2048, 16, 752, 619, 18, 1405, 134
n50x8192-coef-inner-2048, 16, 749, 625, 19, 1409, 134
n50x8192-coef-inner-2048, 16, 750, 626, 18, 1410, 134
n50x8192-coef-inner-2048, 16, 748, 627, 19, 1410, 134
n50x8192-coef-inner-2048, 16, 754, 632, 19, 1421, 134
n50x8192-coef-inner-2048, 16, 752, 629, 18, 1415, 134
n50x8192-coef-inner-2048, 16, 756, 623, 18, 1413, 134
n50x8192-coef-inner-2048, 16, 756, 626, 18, 1416, 134
n50x8192-coef-inner-2048, 16, 748, 628, 18, 1410, 134
n50x8192-coef-inner-2048, 16, 748, 620, 19, 1403, 134
n50x8192-coef-inner-2048, 16, 755, 623, 18, 1412, 134
n50x8192-coef-inner-2048, 22, 752, 656, 18, 1448, 134
n50x8192-coef-inner-2048, 16, 752, 621, 19, 1408, 134
n50x8192-coef-inner-2048, 16, 749, 629, 18, 1412, 134
n50x8192-coef-inner-2048, 16, 753, 629, 18, 1416, 134
n50x8192-coef-inner-2048, 16, 748, 622, 19, 1405, 134
n50x8192-coef-inner-2048, 16, 746, 621, 18, 1401, 134
n50x8192-coef-inner-2048, 16, 751, 623, 19, 1409, 134
n50x8192-coef-inner-2048, 16, 752, 626, 19, 1413, 134
n50x8192-coef-inner-2048, 16, 749, 628, 19, 1412, 134
n50x8192-coef-inner-2048, 16, 748, 623, 19, 1406, 134
n50x8192-coef-inner-2048, 16, 747, 624, 18, 1405, 134
n50x8192-coef-inner-2048, 16, 751, 625, 18, 1410, 134
n50x8192-coef-inner-2048, 27, 749, 650, 19, 1445, 134
n50x8192-coef-inner-2048, 16, 746, 619, 18, 1399, 134
n50x8192-coef-inner-2048, 16, 757, 624, 19, 1416, 134
n50x8192-coef-inner-2048, 18, 752, 631, 19, 1420, 134
n50x8192-coef-inner-2048, 16, 755, 629, 18, 1418, 134
n50x8192-coef-inner-2048, 21, 756, 652, 19, 1448, 134
n50x8192-coef-inner-2048, 16, 751, 623, 18, 1408, 134
n50x8192-coef-inner-2048, 16, 752, 630, 18, 1416, 134
n50x8192-coef-inner-2048, 16, 746, 620, 19, 1401, 134
n50x8192-coef-inner-2048, 20, 751, 643, 18, 1432, 134
n50x8192-coef-inner-2048, 16, 755, 627, 19, 1417, 134
n50x8192-coef-inner-2048, 16, 759, 634, 18, 1427, 134
n50x8192-coef-inner-2048, 16, 752, 626, 18, 1412, 134
n50x8192-coef-inner-2048, 16, 750, 630, 18, 1414, 134
n50x8192-coef-inner-2048, 16, 751, 629, 19, 1415, 134
n50x8192-coef-inner-2048, 23, 762, 667, 18, 1470, 134
n50x8192-coef-inner-2048, 25, 769, 628, 19, 1441, 134
n50x8192-coef-inner-2048, 16, 753, 629, 18, 1416, 134
n50x8192-coef-inner-2048, 16, 757, 635, 19, 1427, 134
n50x8192-coef-inner-2048, 16, 758, 626, 18, 1418, 134
n50x8192-coef-inner-2048, 16, 750, 627, 18, 1411, 134
n50x8192-coef-inner-2048, 16, 754, 623, 18, 1411, 134
n50x8192-coef-inner-2048, 16, 754, 624, 18, 1412, 134
n50x8192-coef-inner-2048, 18, 758, 629, 18, 1423, 134
n50x8192-coef-inner-2048, 16, 754, 626, 19, 1415, 134
n50x8192-coef-inner-2048, 16, 754, 630, 18, 1418, 134
n50x8192-coef-inner-2048, 16, 755, 623, 19, 1413, 134
n100x8192-coef-inner-2048, 16, 1504, 1255, 39, 2814, 268
n100x8192-coef-inner-2048, 16, 1508, 1258, 38, 2820, 268
n100x8192-coef-inner-2048, 16, 1508, 1261, 38, 2823, 268
n100x8192-coef-inner-2048, 16, 1507, 1258, 38, 2819, 268
n100x8192-coef-inner-2048, 16, 1512, 1262, 41, 2831, 268
n100x8192-coef-inner-2048, 16, 1514, 1266, 38, 2834, 268
n100x8192-coef-inner-2048, 17, 1520, 1264, 39, 2840, 268
n100x8192-coef-inner-2048, 16, 1510, 1280, 39, 2845, 268
n100x8192-coef-inner-2048, 16, 1514, 1260, 38, 2828, 268
n100x8192-coef-inner-2048, 16, 1513, 1268, 38, 2835, 268
n100x8192-coef-inner-2048, 20, 1506, 1256, 40, 2822, 268
n100x8192-coef-inner-2048, 16, 1506, 1277, 38, 2837, 268
n100x8192-coef-inner-2048, 16, 1518, 1257, 38, 2829, 268
n100x8192-coef-inner-2048, 16, 1518, 1273, 38, 2845, 268
n100x8192-coef-inner-2048, 16, 1510, 1269, 38, 2833, 268
n100x8192-coef-inner-2048, 16, 1515, 1261, 39, 2831, 268
n100x8192-coef-inner-2048, 20, 1514, 1264, 41, 2839, 268
n100x8192-coef-inner-2048, 23, 1509, 1305, 38, 2875, 268
n100x8192-coef-inner-2048, 26, 1506, 1296, 38, 2866, 268
n100x8192-coef-inner-2048, 17, 1506, 1259, 38, 2820, 268
n100x8192-coef-inner-2048, 16, 1509, 1257, 38, 2820, 268
n100x8192-coef-inner-2048, 16, 1508, 1258, 38, 2820, 268
n100x8192-coef-inner-2048, 17, 1503, 1255, 38, 2813, 268
n100x8192-coef-inner-2048, 16, 1496, 1244, 38, 2794, 268
n100x8192-coef-inner-2048, 16, 1501, 1248, 38, 2803, 268
n100x8192-coef-inner-2048, 16, 1512, 1261, 38, 2827, 268
n100x8192-coef-inner-2048, 18, 1512, 1300, 38, 2868, 268
n100x8192-coef-inner-2048, 16, 1511, 1254, 39, 2820, 268
n100x8192-coef-inner-2048, 16, 1497, 1249, 38, 2800, 268
n100x8192-coef-inner-2048, 16, 1504, 1259, 38, 2817, 268
n100x8192-coef-inner-2048, 16, 1505, 1256, 38, 2815, 268
n100x8192-coef-inner-2048, 16, 1505, 1265, 38, 2824, 268
n100x8192-coef-inner-2048, 16, 1505, 1269, 38, 2828, 268
n100x8192-coef-inner-2048, 25, 1509, 1263, 39, 2836, 268
n100x8192-coef-inner-2048, 20, 1505, 1247, 38, 2810, 268
n100x8192-coef-inner-2048, 16, 1506, 1256, 40, 2818, 268
n100x8192-coef-inner-2048, 16, 1506, 1265, 38, 2825, 268
n100x8192-coef-inner-2048, 16, 1505, 1263, 39, 2823, 268
n100x8192-coef-inner-2048, 16, 1506, 1256, 38, 2816, 268
n100x8192-coef-inner-2048, 16, 1508, 1259, 39, 2822, 268
n100x8192-coef-inner-2048, 16, 1510, 1280, 39, 2845, 268
n100x8192-coef-inner-2048, 16, 1502, 1253, 40, 2811, 268
n100x8192-coef-inner-2048, 20, 1507, 1256, 38, 2821, 268
n100x8192-coef-inner-2048, 16, 1507, 1255, 38, 2816, 268
n100x8192-coef-inner-2048, 19, 1509, 1266, 38, 2832, 268
n100x8192-coef-inner-2048, 16, 1504, 1267, 39, 2826, 268
n100x8192-coef-inner-2048, 16, 1504, 1250, 38, 2808, 268
n100x8192-coef-inner-2048, 16, 1504, 1247, 38, 2805, 268
n100x8192-coef-inner-2048, 17, 1501, 1244, 38, 2800, 268
n100x8192-coef-inner-2048, 16, 1498, 1257, 37, 2808, 268
n100x8192-coef-inner-2048, 17, 1502, 1254, 39, 2812, 268
n100x8192-coef-inner-2048, 16, 1502, 1254, 38, 2810, 268
n100x8192-coef-inner-2048, 16, 1512, 1248, 38, 2814, 268
n100x8192-coef-inner-2048, 16, 1518, 1264, 39, 2837, 268
n100x8192-coef-inner-2048, 16, 1504, 1253, 38, 2811, 268
n100x8192-coef-inner-2048, 16, 1508, 1260, 39, 2823, 268
n100x8192-coef-inner-2048, 16, 1511, 1270, 39, 2836, 268
n100x8192-coef-inner-2048, 16, 1505, 1266, 38, 2825, 268
n100x8192-coef-inner-2048, 16, 1516, 1259, 39, 2830, 268
n100x8192-coef-inner-2048, 16, 1504, 1255, 38, 2813, 268
n100x8192-coef-inner-2048, 16, 1505, 1254, 38, 2813, 268
n100x8192-coef-inner-2048, 16, 1513, 1252, 39, 2820, 268
n100x8192-coef-inner-2048, 16, 1501, 1255, 39, 2811, 268
n100x8192-coef-inner-2048, 16, 1503, 1252, 38, 2809, 268
n100x8192-coef-inner-2048, 16, 1505, 1255, 38, 2814, 268
n100x8192-coef-inner-2048, 16, 1498, 1253, 38, 2805, 268
n100x8192-coef-inner-2048, 16, 1503, 1259, 39, 2817, 268
n100x8192-coef-inner-2048, 20, 1500, 1314, 39, 2873, 268
n100x8192-coef-inner-2048, 16, 1503, 1262, 39, 2820, 268
n100x8192-coef-inner-2048, 16, 1507, 1249, 39, 2811, 268
n100x8192-coef-inner-2048, 24, 1511, 1303, 38, 2876, 268
n100x8192-coef-inner-2048, 16, 1507, 1275, 38, 2836, 268
n100x8192-coef-inner-2048, 16, 1504, 1251, 39, 2810, 268
n100x8192-coef-inner-2048, 16, 1502, 1259, 38, 2815, 268
n100x8192-coef-inner-2048, 18, 1516, 1263, 38, 2835, 268
n100x8192-coef-inner-2048, 17, 1500, 1259, 38, 2814, 268
n100x8192-coef-inner-2048, 16, 1516, 1274, 38, 2844, 268
n100x8192-coef-inner-2048, 16, 1515, 1265, 39, 2835, 268
n100x8192-coef-inner-2048, 21, 1517, 1275, 39, 2852, 268
n100x8192-coef-inner-2048, 23, 1509, 1260, 38, 2830, 268
n100x8192-coef-inner-2048, 16, 1504, 1264, 39, 2823, 268
n100x8192-coef-inner-2048, 16, 1506, 1262, 39, 2823, 268
n100x8192-coef-inner-2048, 16, 1504, 1250, 38, 2808, 268
n100x8192-coef-inner-2048, 16, 1505, 1251, 38, 2810, 268
n100x8192-coef-inner-2048, 20, 1525, 1275, 40, 2860, 268
n100x8192-coef-inner-2048, 16, 1511, 1257, 38, 2822, 268
n100x8192-coef-inner-2048, 18, 1503, 1258, 39, 2818, 268
n100x8192-coef-inner-2048, 16, 1519, 1257, 39, 2831, 268
n100x8192-coef-inner-2048, 16, 1506, 1258, 38, 2818, 268
n100x8192-coef-inner-2048, 16, 1503, 1245, 38, 2802, 268
n100x8192-coef-inner-2048, 16, 1494, 1238, 38, 2786, 268
n100x8192-coef-inner-2048, 16, 1504, 1257, 37, 2814, 268
n100x8192-coef-inner-2048, 16, 1505, 1249, 38, 2808, 268
n100x8192-coef-inner-2048, 16, 1497, 1260, 38, 2811, 268
n100x8192-coef-inner-2048, 18, 1514, 1278, 38, 2848, 268
n100x8192-coef-inner-2048, 17, 1507, 1249, 38, 2811, 268
n100x8192-coef-inner-2048, 16, 1502, 1253, 38, 2809, 268
n100x8192-coef-inner-2048, 17, 1510, 1273, 39, 2839, 268
n100x8192-coef-inner-2048, 16, 1508, 1262, 38, 2824, 268
n100x8192-coef-inner-2048, 16, 1508, 1251, 37, 2812, 268
n250x8192-coef-inner-2048, 16, 375, 325, 9, 725, 68
n250x8192-coef-inner-2048, 16, 376, 315, 9, 716, 68
n250x8192-coef-inner-2048, 16, 377, 313, 9, 715, 68
n250x8192-coef-inner-2048, 16, 377, 310, 9, 712, 68
n250x8192-coef-inner-2048, 16, 376, 314, 8, 714, 68
n250x8192-coef-inner-2048, 21, 377, 316, 9, 723, 68
n250x8192-coef-inner-2048, 18, 379, 324, 9, 730, 68
n250x8192-coef-inner-2048, 16, 379, 312, 9, 716, 68
n250x8192-coef-inner-2048, 21, 377, 333, 8, 739, 68
n250x8192-coef-inner-2048, 16, 375, 315, 9, 715, 68
n250x8192-coef-inner-2048, 16, 379, 315, 8, 718, 68
n250x8192-coef-inner-2048, 16, 378, 315, 9, 718, 68
n250x8192-coef-inner-2048, 16, 377, 317, 9, 719, 68
n250x8192-coef-inner-2048, 16, 375, 316, 9, 716, 68
n250x8192-coef-inner-2048, 28, 377, 326, 9, 740, 68
n250x8192-coef-inner-2048, 16, 380, 313, 9, 718, 68
n250x8192-coef-inner-2048, 16, 380, 316, 9, 721, 68
n250x8192-coef-inner-2048, 16, 375, 316, 8, 715, 68
n250x8192-coef-inner-2048, 16, 374, 315, 9, 714, 68
n250x8192-coef-inner-2048, 16, 381, 316, 9, 722, 68
n250x8192-coef-inner-2048, 16, 379, 315, 8, 718, 68
n250x8192-coef-inner-2048, 20, 377, 319, 9, 725, 68
n250x8192-coef-inner-2048, 16, 380, 318, 9, 723, 68
n250x8192-coef-inner-2048, 18, 380, 326, 9, 733, 68
n250x8192-coef-inner-2048, 16, 383, 314, 9, 722, 68
n250x8192-coef-inner-2048, 16, 375, 313, 8, 712, 68
n250x8192-coef-inner-2048, 16, 378, 314, 9, 717, 68
n250x8192-coef-inner-2048, 16, 377, 312, 9, 714, 68
n250x8192-coef-inner-2048, 16, 375, 315, 8, 714, 68
n250x8192-coef-inner-2048, 16, 378, 316, 9, 719, 68
n250x8192-coef-inner-2048, 16, 377, 315, 9, 717, 68
n250x8192-coef-inner-2048, 17, 381, 319, 9, 726, 68
n250x8192-coef-inner-2048, 16, 381, 319, 9, 725, 68
n250x8192-coef-inner-2048, 17, 380, 317, 9, 723, 68
n250x8192-coef-inner-2048, 17, 379, 319, 9, 724, 68
n250x8192-coef-inner-2048, 16, 381, 313, 9, 719, 68
n250x8192-coef-inner-2048, 16, 378, 315, 8, 717, 68
n250x8192-coef-inner-2048, 17, 379, 314, 9, 719, 68
n250x8192-coef-inner-2048, 16, 376, 317, 9, 718, 68
n250x8192-coef-inner-2048, 16, 379, 316, 9, 720, 68
n250x8192-coef-inner-2048, 16, 378, 313, 9, 716, 68
n250x8192-coef-inner-2048, 16, 379, 312, 9, 716, 68
n250x8192-coef-inner-2048, 21, 376, 329, 9, 735, 68
n250x8192-coef-inner-2048, 16, 377, 315, 8, 716, 68
n250x8192-coef-inner-2048, 16, 379, 314, 9, 718, 68
n250x8192-coef-inner-2048, 16, 378, 317, 9, 720, 68
n250x8192-coef-inner-2048, 16, 388, 322, 9, 735, 68
n250x8192-coef-inner-2048, 18, 376, 314, 8, 716, 68
n250x8192-coef-inner-2048, 16, 378, 316, 9, 719, 68
n250x8192-coef-inner-2048, 16, 381, 315, 9, 721, 68
n250x8192-coef-inner-2048, 24, 380, 327, 9, 740, 68
n250x8192-coef-inner-2048, 24, 383, 333, 9, 749, 68
n250x8192-coef-inner-2048, 16, 378, 316, 9, 719, 68
n250x8192-coef-inner-2048, 17, 380, 315, 9, 721, 68
n250x8192-coef-inner-2048, 16, 382, 315, 9, 722, 68
n250x8192-coef-inner-2048, 16, 383, 318, 9, 726, 68
n250x8192-coef-inner-2048, 16, 379, 316, 8, 719, 68
n250x8192-coef-inner-2048, 16, 381, 312, 9, 718, 68
n250x8192-coef-inner-2048, 16, 376, 316, 9, 717, 68
n250x8192-coef-inner-2048, 16, 380, 317, 9, 722, 68
n250x8192-coef-inner-2048, 16, 392, 326, 9, 743, 68
n250x8192-coef-inner-2048, 28, 378, 312, 9, 727, 68
n250x8192-coef-inner-2048, 16, 381, 316, 9, 722, 68
n250x8192-coef-inner-2048, 16, 382, 315, 9, 722, 68
n250x8192-coef-inner-2048, 20, 376, 313, 9, 718, 68
n250x8192-coef-inner-2048, 16, 375, 319, 9, 719, 68
n250x8192-coef-inner-2048, 16, 380, 317, 9, 722, 68
n250x8192-coef-inner-2048, 16, 377, 315, 8, 716, 68
n250x8192-coef-inner-2048, 16, 377, 313, 9, 715, 68
n250x8192-coef-inner-2048, 16, 378, 312, 9, 715, 68
n250x8192-coef-inner-2048, 16, 375, 314, 8, 713, 68
n250x8192-coef-inner-2048, 20, 380, 316, 9, 725, 68
n250x8192-coef-inner-2048, 19, 380, 313, 9, 721, 68
n250x8192-coef-inner-2048, 16, 378, 319, 9, 722, 68
n250x8192-coef-inner-2048, 16, 380, 315, 9, 720, 68
n250x8192-coef-inner-2048, 16, 377, 315, 9, 717, 68
n250x8192-coef-inner-2048, 16, 375, 317, 9, 717, 68
n250x8192-coef-inner-2048, 16, 378, 316, 9, 719, 68
n250x8192-coef-inner-2048, 16, 376, 310, 9, 711, 68
n250x8192-coef-inner-2048, 16, 385, 314, 9, 724, 68
n250x8192-coef-inner-2048, 16, 375, 312, 9, 712, 68
n250x8192-coef-inner-2048, 16, 378, 311, 9, 714, 68
n250x8192-coef-inner-2048, 16, 376, 315, 9, 716, 68
n250x8192-coef-inner-2048, 20, 380, 313, 8, 721, 68
n250x8192-coef-inner-2048, 16, 375, 313, 9, 713, 68
n250x8192-coef-inner-2048, 16, 378, 315, 8, 717, 68
n250x8192-coef-inner-2048, 16, 378, 316, 9, 719, 68
n250x8192-coef-inner-2048, 17, 377, 314, 9, 717, 68
n250x8192-coef-inner-2048, 16, 374, 312, 9, 711, 68
n250x8192-coef-inner-2048, 16, 376, 312, 9, 713, 68
n250x8192-coef-inner-2048, 16, 379, 314, 9, 718, 68
n250x8192-coef-inner-2048, 16, 379, 318, 9, 722, 68
n250x8192-coef-inner-2048, 16, 379, 312, 9, 716, 68
n250x8192-coef-inner-2048, 16, 379, 314, 9, 718, 68
n250x8192-coef-inner-2048, 16, 378, 315, 8, 717, 68
n250x8192-coef-inner-2048, 17, 378, 324, 9, 728, 68
n250x8192-coef-inner-2048, 16, 384, 315, 9, 724, 68
n250x8192-coef-inner-2048, 16, 380, 313, 9, 718, 68
n250x8192-coef-inner-2048, 16, 375, 310, 9, 710, 68
n250x8192-coef-inner-2048, 17, 377, 313, 9, 716, 68
n500x8192-coef-inner-2048, 26, 7526, 6556, 202, 14310, 1334
n500x8192-coef-inner-2048, 16, 7559, 6343, 210, 14128, 1334
n500x8192-coef-inner-2048, 16, 7585, 6414, 200, 14215, 1334
n500x8192-coef-inner-2048, 16, 7562, 6332, 196, 14106, 1334
n500x8192-coef-inner-2048, 16, 7526, 6308, 198, 14048, 1334
n500x8192-coef-inner-2048, 25, 7515, 6611, 198, 14349, 1334
n500x8192-coef-inner-2048, 16, 7543, 6356, 198, 14113, 1334
n500x8192-coef-inner-2048, 16, 7536, 6288, 201, 14041, 1334
n500x8192-coef-inner-2048, 16, 7505, 6307, 196, 14024, 1334
n500x8192-coef-inner-2048, 16, 7516, 6314, 198, 14044, 1334
n500x8192-coef-inner-2048, 16, 7563, 6338, 199, 14116, 1334
n500x8192-coef-inner-2048, 16, 7483, 6276, 199, 13974, 1334
n500x8192-coef-inner-2048, 16, 7503, 6270, 198, 13987, 1334
n500x8192-coef-inner-2048, 16, 7520, 6313, 200, 14049, 1334
n500x8192-coef-inner-2048, 16, 7514, 6354, 199, 14083, 1334
n500x8192-coef-inner-2048, 16, 7525, 6325, 201, 14067, 1334
n500x8192-coef-inner-2048, 16, 7558, 6374, 196, 14144, 1334
n500x8192-coef-inner-2048, 16, 7537, 6333, 198, 14084, 1334
n500x8192-coef-inner-2048, 16, 7520, 6322, 196, 14054, 1334
n500x8192-coef-inner-2048, 16, 7521, 6291, 197, 14025, 1334
n500x8192-coef-inner-2048, 19, 7571, 6383, 199, 14172, 1334
n500x8192-coef-inner-2048, 16, 7503, 6273, 197, 13989, 1334
n500x8192-coef-inner-2048, 16, 7503, 6292, 198, 14009, 1334
n500x8192-coef-inner-2048, 16, 7517, 6321, 198, 14052, 1334
n500x8192-coef-inner-2048, 16, 7517, 6337, 197, 14067, 1334
n500x8192-coef-inner-2048, 16, 7510, 6291, 198, 14015, 1334
n500x8192-coef-inner-2048, 16, 7515, 6299, 199, 14029, 1334
n500x8192-coef-inner-2048, 16, 7521, 6319, 195, 14051, 1334
n500x8192-coef-inner-2048, 18, 7492, 6548, 196, 14254, 1334
n500x8192-coef-inner-2048, 16, 7505, 6308, 196, 14025, 1334
n500x8192-coef-inner-2048, 16, 7512, 6312, 198, 14038, 1334
n500x8192-coef-inner-2048, 16, 7524, 6316, 198, 14054, 1334
n500x8192-coef-inner-2048, 16, 7527, 6304, 196, 14043, 1334
n500x8192-coef-inner-2048, 16, 7487, 6248, 199, 13950, 1334
n500x8192-coef-inner-2048, 16, 7473, 6294, 198, 13981, 1334
n500x8192-coef-inner-2048, 16, 7514, 6543, 198, 14271, 1334
n500x8192-coef-inner-2048, 16, 7500, 6262, 198, 13976, 1334
n500x8192-coef-inner-2048, 21, 7553, 6320, 200, 14094, 1334
n500x8192-coef-inner-2048, 16, 7515, 6304, 196, 14031, 1334
n500x8192-coef-inner-2048, 17, 7598, 6294, 201, 14110, 1334
n500x8192-coef-inner-2048, 16, 7528, 6283, 196, 14023, 1334
n500x8192-coef-inner-2048, 16, 7510, 6320, 198, 14044, 1334
n500x8192-coef-inner-2048, 16, 7517, 6241, 209, 13983, 1334
n500x8192-coef-inner-2048, 16, 7525, 6386, 199, 14126, 1334
n500x8192-coef-inner-2048, 16, 7529, 6355, 195, 14095, 1334
n500x8192-coef-inner-2048, 16, 7507, 6301, 195, 14019, 1334
n500x8192-coef-inner-2048, 16, 7496, 6291, 196, 13999, 1334
n500x8192-coef-inner-2048, 16, 7513, 6318, 197, 14044, 1334
n500x8192-coef-inner-2048, 16, 7500, 6516, 196, 14228, 1334
n500x8192-coef-inner-2048, 16, 7523, 6305, 198, 14042, 1334
n500x8192-coef-inner-2048, 16, 7530, 6306, 197, 14049, 1334
n500x8192-coef-inner-2048, 16, 7527, 6285, 197, 14025, 1334
n500x8192-coef-inner-2048, 16, 7595, 6565, 197, 14373, 1334
n500x8192-coef-inner-2048, 16, 7514, 6286, 196, 14012, 1334
n500x8192-coef-inner-2048, 16, 7501, 6292, 196, 14005, 1334
n500x8192-coef-inner-2048, 16, 7497, 6276, 198, 13987, 1334
n500x8192-coef-inner-2048, 16, 7541, 6312, 198, 14067, 1334
n500x8192-coef-inner-2048, 17, 7538, 6288, 197, 14040, 1334
n500x8192-coef-inner-2048, 16, 7503, 6415, 198, 14132, 1334
n500x8192-coef-inner-2048, 19, 7499, 6574, 197, 14289, 1334
n500x8192-coef-inner-2048, 16, 7538, 6308, 198, 14060, 1334
n500x8192-coef-inner-2048, 16, 7514, 6270, 198, 13998, 1334
n500x8192-coef-inner-2048, 18, 7521, 6288, 195, 14022, 1334
n500x8192-coef-inner-2048, 18, 7481, 6591, 196, 14286, 1334
n500x8192-coef-inner-2048, 16, 7545, 6368, 196, 14125, 1334
n500x8192-coef-inner-2048, 16, 7574, 6309, 198, 14097, 1334
n500x8192-coef-inner-2048, 16, 7533, 6893, 199, 14641, 1334
n500x8192-coef-inner-2048, 16, 7576, 6390, 199, 14181, 1334
n500x8192-coef-inner-2048, 16, 7581, 6409, 200, 14206, 1334
n500x8192-coef-inner-2048, 16, 7607, 6393, 199, 14215, 1334
n500x8192-coef-inner-2048, 19, 7550, 6638, 196, 14403, 1334
n500x8192-coef-inner-2048, 16, 7550, 6327, 198, 14091, 1334
n500x8192-coef-inner-2048, 19, 7625, 6487, 197, 14328, 1334
n500x8192-coef-inner-2048, 16, 7571, 6468, 197, 14252, 1334
n500x8192-coef-inner-2048, 16, 7541, 6346, 199, 14102, 1334
n500x8192-coef-inner-2048, 16, 7533, 6312, 197, 14058, 1334
n500x8192-coef-inner-2048, 16, 7513, 6334, 197, 14060, 1334
n500x8192-coef-inner-2048, 16, 7514, 6344, 198, 14072, 1334
n500x8192-coef-inner-2048, 16, 7570, 6307, 198, 14091, 1334
n500x8192-coef-inner-2048, 16, 7503, 6308, 199, 14026, 1334
n500x8192-coef-inner-2048, 16, 7534, 6284, 197, 14031, 1334
n500x8192-coef-inner-2048, 25, 7545, 6334, 202, 14106, 1334
n500x8192-coef-inner-2048, 16, 7538, 6320, 198, 14072, 1334
n500x8192-coef-inner-2048, 16, 7526, 6319, 197, 14058, 1334
n500x8192-coef-inner-2048, 16, 7520, 6339, 202, 14077, 1334
n500x8192-coef-inner-2048, 16, 7560, 6359, 202, 14137, 1334
n500x8192-coef-inner-2048, 16, 7595, 6342, 199, 14152, 1334
n500x8192-coef-inner-2048, 16, 7573, 6349, 197, 14135, 1334
n500x8192-coef-inner-2048, 16, 7554, 6300, 199, 14069, 1334
n500x8192-coef-inner-2048, 16, 7532, 6332, 202, 14082, 1334
n500x8192-coef-inner-2048, 23, 7553, 6334, 198, 14108, 1334
n500x8192-coef-inner-2048, 16, 7551, 6331, 198, 14096, 1334
n500x8192-coef-inner-2048, 17, 7544, 6344, 197, 14102, 1334
n500x8192-coef-inner-2048, 16, 7528, 6351, 195, 14090, 1334
n500x8192-coef-inner-2048, 16, 7612, 6327, 195, 14150, 1334
n500x8192-coef-inner-2048, 16, 7533, 6365, 197, 14111, 1334
n500x8192-coef-inner-2048, 16, 7506, 6304, 199, 14025, 1334
n500x8192-coef-inner-2048, 16, 7549, 6494, 196, 14255, 1334
n500x8192-coef-inner-2048, 16, 7515, 6440, 198, 14169, 1334
n500x8192-coef-inner-2048, 24, 7538, 6319, 199, 14080, 1334
n1000x8192-coef-inner-2048, 16, 15120, 12638, 392, 28166, 2668
n1000x8192-coef-inner-2048, 17, 15146, 12652, 399, 28214, 2668
n1000x8192-coef-inner-2048, 19, 14962, 13035, 402, 28418, 2668
n1000x8192-coef-inner-2048, 17, 15069, 12691, 415, 28192, 2668
n1000x8192-coef-inner-2048, 16, 15063, 12672, 404, 28155, 2668
n1000x8192-coef-inner-2048, 18, 15167, 14078, 402, 29665, 2668
n1000x8192-coef-inner-2048, 19, 15003, 13152, 399, 28573, 2668
n1000x8192-coef-inner-2048, 16, 15074, 12733, 400, 28223, 2668
n1000x8192-coef-inner-2048, 16, 15005, 12626, 399, 28046, 2668
n1000x8192-coef-inner-2048, 16, 14998, 12587, 396, 27997, 2668
n1000x8192-coef-inner-2048, 16, 15021, 12686, 399, 28122, 2668
n1000x8192-coef-inner-2048, 24, 15077, 13159, 400, 28660, 2668
n1000x8192-coef-inner-2048, 16, 15058, 12617, 404, 28095, 2668
n1000x8192-coef-inner-2048, 23, 15069, 13159, 399, 28650, 2668
n1000x8192-coef-inner-2048, 16, 15067, 12678, 406, 28167, 2668
n1000x8192-coef-inner-2048, 16, 15064, 12594, 400, 28074, 2668
n1000x8192-coef-inner-2048, 18, 15048, 12621, 400, 28087, 2668
n1000x8192-coef-inner-2048, 16, 15063, 12567, 403, 28049, 2668
n1000x8192-coef-inner-2048, 21, 15072, 12592, 403, 28088, 2668
n1000x8192-coef-inner-2048, 16, 15029, 12710, 399, 28154, 2668
n1000x8192-coef-inner-2048, 16, 15045, 12599, 402, 28062, 2668
n1000x8192-coef-inner-2048, 17, 15105, 12719, 404, 28245, 2668
n1000x8192-coef-inner-2048, 16, 15008, 12566, 399, 27989, 2668
n1000x8192-coef-inner-2048, 28, 15080, 12820, 406, 28334, 2668
n1000x8192-coef-inner-2048, 17, 15150, 12717, 401, 28285, 2668
n1000x8192-coef-inner-2048, 16, 15064, 12880, 399, 28359, 2668
n1000x8192-coef-inner-2048, 17, 15022, 13139, 402, 28580, 2668
n1000x8192-coef-inner-2048, 16, 15027, 12639, 400, 28082, 2668
n1000x8192-coef-inner-2048, 16, 15054, 12601, 400, 28071, 2668
n1000x8192-coef-inner-2048, 16, 14987, 12565, 403, 27971, 2668
n1000x8192-coef-inner-2048, 28, 15010, 13160, 398, 28596, 2668
n1000x8192-coef-inner-2048, 24, 15006, 13133, 402, 28565, 2668
n1000x8192-coef-inner-2048, 27, 15188, 12605, 401, 28221, 2668
n1000x8192-coef-inner-2048, 16, 15023, 12601, 400, 28040, 2668
n1000x8192-coef-inner-2048, 16, 15121, 13182, 403, 28722, 2668
n1000x8192-coef-inner-2048, 16, 15086, 12590, 396, 28088, 2668
n1000x8192-coef-inner-2048, 18, 15027, 13160, 403, 28608, 2668
n1000x8192-coef-inner-2048, 16, 15014, 12663, 402, 28095, 2668
n1000x8192-coef-inner-2048, 16, 15044, 12540, 394, 27994, 2668
n1000x8192-coef-inner-2048, 19, 15016, 13039, 399, 28473, 2668
n1000x8192-coef-inner-2048, 16, 15034, 12983, 399, 28432, 2668
n1000x8192-coef-inner-2048, 16, 15025, 12631, 399, 28071, 2668
n1000x8192-coef-inner-2048, 16, 15091, 13173, 404, 28684, 2668
n1000x8192-coef-inner-2048, 16, 15028, 12517, 396, 27957, 2668
n1000x8192-coef-inner-2048, 19, 15000, 13105, 412, 28536, 2668
n1000x8192-coef-inner-2048, 16, 15042, 12684, 396, 28138, 2668
n1000x8192-coef-inner-2048, 16, 15059, 13129, 401, 28605, 2668
n1000x8192-coef-inner-2048, 16, 15019, 12647, 404, 28086, 2668
n1000x8192-coef-inner-2048, 23, 15039, 12860, 408, 28330, 2668
n1000x8192-coef-inner-2048, 16, 15043, 12619, 400, 28078, 2668
n1000x8192-coef-inner-2048, 16, 15009, 12627, 408, 28060, 2668
n1000x8192-coef-inner-2048, 16, 15010, 12546, 404, 27976, 2668
n1000x8192-coef-inner-2048, 16, 15017, 12801, 401, 28235, 2668
n1000x8192-coef-inner-2048, 16, 15094, 12697, 402, 28209, 2668
n1000x8192-coef-inner-2048, 16, 15032, 12695, 401, 28144, 2668
n1000x8192-coef-inner-2048, 16, 15078, 12599, 400, 28093, 2668
n1000x8192-coef-inner-2048, 20, 15007, 12614, 413, 28054, 2668
n1000x8192-coef-inner-2048, 17, 15038, 13157, 399, 28611, 2668
n1000x8192-coef-inner-2048, 16, 15061, 12635, 396, 28108, 2668
n1000x8192-coef-inner-2048, 16, 15099, 12597, 403, 28115, 2668
n1000x8192-coef-inner-2048, 20, 15092, 12611, 402, 28125, 2668
n1000x8192-coef-inner-2048, 22, 14993, 12593, 399, 28007, 2668
n1000x8192-coef-inner-2048, 16, 15016, 12647, 399, 28078, 2668
n1000x8192-coef-inner-2048, 16, 15044, 12564, 396, 28020, 2668
n1000x8192-coef-inner-2048, 16, 15000, 12569, 391, 27976, 2668
n1000x8192-coef-inner-2048, 16, 15007, 13094, 398, 28515, 2668
n1000x8192-coef-inner-2048, 16, 15035, 12622, 396, 28069, 2668
n1000x8192-coef-inner-2048, 16, 15049, 12677, 400, 28142, 2668
n1000x8192-coef-inner-2048, 21, 15111, 12691, 401, 28224, 2668
n1000x8192-coef-inner-2048, 16, 15048, 13155, 391, 28610, 2668
n1000x8192-coef-inner-2048, 16, 14953, 12496, 400, 27865, 2668
n1000x8192-coef-inner-2048, 19, 15009, 12648, 405, 28081, 2668
n1000x8192-coef-inner-2048, 17, 15067, 12705, 403, 28192, 2668
n1000x8192-coef-inner-2048, 16, 15035, 12621, 398, 28070, 2668
n1000x8192-coef-inner-2048, 16, 15111, 12670, 403, 28200, 2668
n1000x8192-coef-inner-2048, 17, 15067, 12681, 399, 28164, 2668
n1000x8192-coef-inner-2048, 18, 15068, 12584, 397, 28067, 2668
n1000x8192-coef-inner-2048, 16, 15008, 12624, 402, 28050, 2668
n1000x8192-coef-inner-2048, 16, 15160, 12656, 403, 28235, 2668
n1000x8192-coef-inner-2048, 19, 15137, 12741, 416, 28313, 2668
n1000x8192-coef-inner-2048, 16, 15069, 12533, 394, 28012, 2668
n1000x8192-coef-inner-2048, 16, 15033, 12573, 393, 28015, 2668
n1000x8192-coef-inner-2048, 16, 15122, 12637, 397, 28172, 2668
n1000x8192-coef-inner-2048, 19, 15083, 13206, 407, 28715, 2668
n1000x8192-coef-inner-2048, 16, 15139, 12538, 396, 28089, 2668
n1000x8192-coef-inner-2048, 16, 14994, 12606, 394, 28010, 2668
n1000x8192-coef-inner-2048, 19, 15159, 12755, 399, 28332, 2668
n1000x8192-coef-inner-2048, 16, 15061, 12692, 403, 28172, 2668
n1000x8192-coef-inner-2048, 16, 15059, 13161, 401, 28637, 2668
n1000x8192-coef-inner-2048, 16, 15075, 12659, 402, 28152, 2668
n1000x8192-coef-inner-2048, 20, 15076, 12908, 407, 28411, 2668
n1000x8192-coef-inner-2048, 16, 15089, 12623, 405, 28133, 2668
n1000x8192-coef-inner-2048, 19, 15074, 13218, 402, 28713, 2668
n1000x8192-coef-inner-2048, 16, 15137, 12750, 420, 28323, 2668
n1000x8192-coef-inner-2048, 16, 15121, 13206, 404, 28747, 2668
n1000x8192-coef-inner-2048, 16, 15121, 12668, 397, 28202, 2668
n1000x8192-coef-inner-2048, 16, 15181, 12760, 398, 28355, 2668
n1000x8192-coef-inner-2048, 16, 15081, 12649, 400, 28146, 2668
n1000x8192-coef-inner-2048, 16, 15112, 13147, 402, 28677, 2668
n1000x8192-coef-inner-2048, 16, 15098, 12646, 404, 28164, 2668
