n8192-slot-inner-2048, 63, 8, 13, 0, 11, 95, 13655
n8192-slot-inner-2048, 63, 8, 13, 0, 11, 95, 13655
n8192-slot-inner-2048, 63, 8, 13, 0, 11, 95, 13655
n8192-slot-inner-2048, 63, 9, 13, 0, 11, 96, 13655
n8192-slot-inner-2048, 63, 8, 13, 0, 13, 97, 13655
n8192-slot-inner-2048, 67, 8, 13, 0, 11, 99, 13655
n8192-slot-inner-2048, 70, 8, 13, 0, 10, 101, 13655
n8192-slot-inner-2048, 63, 8, 13, 0, 10, 94, 13655
n8192-slot-inner-2048, 69, 8, 13, 0, 10, 100, 13655
n8192-slot-inner-2048, 64, 8, 13, 0, 11, 96, 13655
n8192-slot-inner-2048, 65, 8, 13, 0, 11, 97, 13655
n8192-slot-inner-2048, 63, 8, 13, 0, 11, 95, 13655
n8192-slot-inner-2048, 66, 8, 13, 0, 11, 98, 13655
n8192-slot-inner-2048, 64, 8, 13, 0, 11, 96, 13655
n8192-slot-inner-2048, 63, 8, 13, 0, 10, 94, 13655
n8192-slot-inner-2048, 64, 9, 12, 0, 11, 96, 13655
n8192-slot-inner-2048, 64, 8, 13, 0, 10, 95, 13655
n8192-slot-inner-2048, 65, 8, 13, 0, 10, 96, 13655
n8192-slot-inner-2048, 64, 8, 13, 0, 10, 95, 13655
n8192-slot-inner-2048, 63, 8, 13, 0, 11, 95, 13655
n8192-slot-inner-2048, 64, 9, 13, 0, 10, 96, 13655
n8192-slot-inner-2048, 64, 8, 13, 0, 11, 96, 13655
n8192-slot-inner-2048, 67, 8, 13, 0, 11, 99, 13655
n8192-slot-inner-2048, 63, 8, 13, 0, 10, 94, 13655
n8192-slot-inner-2048, 64, 8, 13, 0, 11, 96, 13655
n8192-slot-inner-2048, 64, 8, 13, 0, 11, 96, 13655
n8192-slot-inner-2048, 64, 9, 13, 0, 11, 97, 13655
n8192-slot-inner-2048, 64, 9, 15, 0, 11, 99, 13655
n8192-slot-inner-2048, 64, 8, 13, 0, 10, 95, 13655
n8192-slot-inner-2048, 65, 8, 13, 0, 10, 96, 13655
n8192-slot-inner-2048, 63, 8, 13, 0, 11, 95, 13655
n8192-slot-inner-2048, 64, 9, 13, 0, 10, 96, 13655
n8192-slot-inner-2048, 63, 9, 13, 0, 11, 96, 13655
n8192-slot-inner-2048, 66, 8, 13, 0, 10, 97, 13655
n8192-slot-inner-2048, 64, 8, 13, 0, 11, 96, 13655
n8192-slot-inner-2048, 64, 9, 13, 0, 11, 97, 13655
n8192-slot-inner-2048, 63, 8, 13, 0, 10, 94, 13655
n8192-slot-inner-2048, 63, 8, 13, 0, 10, 94, 13655
n8192-slot-inner-2048, 63, 8, 13, 0, 10, 94, 13655
n8192-slot-inner-2048, 65, 8, 13, 0, 11, 97, 13655
n8192-slot-inner-2048, 63, 9, 13, 0, 10, 95, 13655
n8192-slot-inner-2048, 64, 8, 13, 0, 11, 96, 13655
n8192-slot-inner-2048, 64, 8, 13, 0, 10, 95, 13655
n8192-slot-inner-2048, 63, 8, 13, 0, 11, 95, 13655
n8192-slot-inner-2048, 64, 8, 13, 0, 11, 96, 13655
n8192-slot-inner-2048, 67, 8, 13, 0, 10, 98, 13655
n8192-slot-inner-2048, 64, 9, 14, 0, 11, 98, 13655
n8192-slot-inner-2048, 64, 9, 13, 0, 11, 97, 13655
n8192-slot-inner-2048, 64, 8, 13, 0, 11, 96, 13655
n8192-slot-inner-2048, 64, 8, 13, 0, 11, 96, 13655
n8192-slot-inner-2048, 66, 8, 15, 0, 11, 100, 13655
n8192-slot-inner-2048, 64, 9, 13, 0, 11, 97, 13655
n8192-slot-inner-2048, 63, 8, 13, 0, 11, 95, 13655
n8192-slot-inner-2048, 65, 9, 13, 0, 11, 98, 13655
n8192-slot-inner-2048, 63, 8, 13, 0, 11, 95, 13655
n8192-slot-inner-2048, 64, 9, 13, 0, 11, 97, 13655
n8192-slot-inner-2048, 66, 8, 13, 0, 11, 98, 13655
n8192-slot-inner-2048, 65, 8, 13, 0, 11, 97, 13655
n8192-slot-inner-2048, 64, 8, 13, 0, 11, 96, 13655
n8192-slot-inner-2048, 63, 9, 13, 0, 11, 96, 13655
n8192-slot-inner-2048, 64, 8, 13, 0, 11, 96, 13655
n8192-slot-inner-2048, 63, 8, 13, 0, 10, 94, 13655
n8192-slot-inner-2048, 65, 8, 13, 0, 11, 97, 13655
n8192-slot-inner-2048, 64, 8, 13, 0, 11, 96, 13655
n8192-slot-inner-2048, 63, 8, 13, 0, 11, 95, 13655
n8192-slot-inner-2048, 64, 8, 13, 0, 11, 96, 13655
n8192-slot-inner-2048, 64, 8, 13, 0, 11, 96, 13655
n8192-slot-inner-2048, 64, 9, 13, 0, 13, 99, 13655
n8192-slot-inner-2048, 64, 8, 13, 0, 11, 96, 13655
n8192-slot-inner-2048, 64, 8, 13, 0, 11, 96, 13655
n8192-slot-inner-2048, 63, 8, 13, 0, 11, 95, 13655
n8192-slot-inner-2048, 63, 8, 13, 0, 11, 95, 13655
n8192-slot-inner-2048, 64, 8, 13, 0, 10, 95, 13655
n8192-slot-inner-2048, 63, 10, 13, 0, 11, 97, 13655
n8192-slot-inner-2048, 67, 9, 14, 0, 11, 101, 13655
n8192-slot-inner-2048, 68, 8, 13, 0, 10, 99, 13655
n8192-slot-inner-2048, 64, 8, 13, 0, 11, 96, 13655
n8192-slot-inner-2048, 68, 8, 13, 0, 11, 100, 13655
n8192-slot-inner-2048, 63, 9, 13, 0, 11, 96, 13655
n8192-slot-inner-2048, 72, 8, 13, 0, 10, 103, 13655
n8192-slot-inner-2048, 63, 8, 13, 0, 11, 95, 13655
n8192-slot-inner-2048, 64, 8, 13, 0, 11, 96, 13655
n8192-slot-inner-2048, 64, 8, 13, 0, 11, 96, 13655
n8192-slot-inner-2048, 64, 8, 13, 0, 10, 95, 13655
n8192-slot-inner-2048, 64, 8, 13, 0, 11, 96, 13655
n8192-slot-inner-2048, 66, 8, 13, 0, 11, 98, 13655
n8192-slot-inner-2048, 63, 8, 13, 0, 10, 94, 13655
n8192-slot-inner-2048, 63, 8, 13, 0, 11, 95, 13655
n8192-slot-inner-2048, 64, 8, 13, 0, 12, 97, 13655
n8192-slot-inner-2048, 64, 8, 13, 0, 11, 96, 13655
n8192-slot-inner-2048, 64, 10, 13, 0, 11, 98, 13655
n8192-slot-inner-2048, 63, 9, 13, 0, 11, 96, 13655
n8192-slot-inner-2048, 66, 9, 13, 0, 11, 99, 13655
n8192-slot-inner-2048, 64, 8, 13, 0, 11, 96, 13655
n8192-slot-inner-2048, 63, 8, 13, 0, 11, 95, 13655
n8192-slot-inner-2048, 64, 8, 13, 0, 11, 96, 13655
n8192-slot-inner-2048, 67, 9, 13, 0, 11, 100, 13655
n8192-slot-inner-2048, 67, 9, 13, 0, 11, 100, 13655
n8192-slot-inner-2048, 63, 8, 13, 0, 11, 95, 13655
n8192-slot-inner-2048, 64, 8, 13, 0, 11, 96, 13655
n10x8192-slot-inner-2048, 64, 75, 124, 3, 9, 275, 136535
n10x8192-slot-inner-2048, 63, 76, 124, 3, 9, 275, 136535
n10x8192-slot-inner-2048, 63, 75, 124, 3, 9, 274, 136535
n10x8192-slot-inner-2048, 64, 75, 124, 3, 9, 275, 136535
n10x8192-slot-inner-2048, 66, 75, 125, 3, 9, 278, 136535
n10x8192-slot-inner-2048, 63, 75, 124, 3, 9, 274, 136535
n10x8192-slot-inner-2048, 63, 75, 123, 3, 9, 273, 136535
n10x8192-slot-inner-2048, 64, 75, 127, 3, 10, 279, 136535
n10x8192-slot-inner-2048, 63, 75, 124, 3, 9, 274, 136535
n10x8192-slot-inner-2048, 64, 75, 125, 3, 9, 276, 136535
n10x8192-slot-inner-2048, 64, 75, 124, 3, 9, 275, 136535
n10x8192-slot-inner-2048, 64, 76, 124, 3, 9, 276, 136535
n10x8192-slot-inner-2048, 64, 75, 123, 3, 9, 274, 136535
n10x8192-slot-inner-2048, 63, 75, 125, 3, 9, 275, 136535
n10x8192-slot-inner-2048, 64, 76, 125, 3, 9, 277, 136535
n10x8192-slot-inner-2048, 64, 75, 124, 3, 9, 275, 136535
n10x8192-slot-inner-2048, 64, 76, 124, 3, 9, 276, 136535
n10x8192-slot-inner-2048, 67, 77, 129, 3, 9, 285, 136535
n10x8192-slot-inner-2048, 64, 76, 123, 3, 9, 275, 136535
n10x8192-slot-inner-2048, 67, 75, 132, 3, 9, 286, 136535
n10x8192-slot-inner-2048, 67, 75, 130, 3, 9, 284, 136535
n10x8192-slot-inner-2048, 63, 76, 124, 3, 9, 275, 136535
n10x8192-slot-inner-2048, 63, 75, 125, 3, 9, 275, 136535
n10x8192-slot-inner-2048, 64, 75, 123, 3, 9, 274, 136535
n10x8192-slot-inner-2048, 67, 75, 124, 3, 9, 278, 136535
n10x8192-slot-inner-2048, 65, 76, 124, 3, 9, 277, 136535
n10x8192-slot-inner-2048, 63, 75, 124, 3, 9, 274, 136535
n10x8192-slot-inner-2048, 64, 75, 124, 3, 9, 275, 136535
n10x8192-slot-inner-2048, 65, 76, 125, 3, 9, 278, 136535
n10x8192-slot-inner-2048, 65, 76, 125, 3, 9, 278, 136535
n10x8192-slot-inner-2048, 63, 75, 123, 3, 9, 273, 136535
n10x8192-slot-inner-2048, 72, 76, 130, 3, 9, 290, 136535
n10x8192-slot-inner-2048, 64, 75, 125, 3, 9, 276, 136535
n10x8192-slot-inner-2048, 65, 75, 124, 3, 9, 276, 136535
n10x8192-slot-inner-2048, 64, 75, 124, 3, 9, 275, 136535
n10x8192-slot-inner-2048, 64, 76, 126, 3, 9, 278, 136535
n10x8192-slot-inner-2048, 63, 76, 124, 3, 9, 275, 136535
n10x8192-slot-inner-2048, 64, 76, 126, 3, 9, 278, 136535
n10x8192-slot-inner-2048, 65, 76, 128, 3, 10, 282, 136535
n10x8192-slot-inner-2048, 69, 77, 132, 3, 9, 290, 136535
n10x8192-slot-inner-2048, 63, 75, 126, 3, 9, 276, 136535
n10x8192-slot-inner-2048, 65, 77, 128, 3, 10, 283, 136535
n10x8192-slot-inner-2048, 64, 76, 126, 3, 9, 278, 136535
n10x8192-slot-inner-2048, 71, 76, 133, 3, 9, 292, 136535
n10x8192-slot-inner-2048, 66, 80, 130, 4, 11, 291, 136535
n10x8192-slot-inner-2048, 66, 80, 129, 3, 10, 288, 136535
n10x8192-slot-inner-2048, 66, 78, 130, 3, 10, 287, 136535
n10x8192-slot-inner-2048, 69, 77, 125, 3, 9, 283, 136535
n10x8192-slot-inner-2048, 64, 75, 125, 3, 9, 276, 136535
n10x8192-slot-inner-2048, 63, 75, 126, 3, 9, 276, 136535
n10x8192-slot-inner-2048, 64, 76, 126, 3, 9, 278, 136535
n10x8192-slot-inner-2048, 63, 75, 125, 3, 9, 275, 136535
n10x8192-slot-inner-2048, 63, 76, 124, 3, 9, 275, 136535
n10x8192-slot-inner-2048, 65, 75, 125, 3, 9, 277, 136535
n10x8192-slot-inner-2048, 63, 75, 125, 3, 9, 275, 136535
n10x8192-slot-inner-2048, 64, 76, 126, 3, 9, 278, 136535
n10x8192-slot-inner-2048, 63, 75, 123, 3, 9, 273, 136535
n10x8192-slot-inner-2048, 66, 76, 124, 3, 9, 278, 136535
n10x8192-slot-inner-2048, 65, 76, 126, 3, 10, 280, 136535
n10x8192-slot-inner-2048, 64, 76, 125, 3, 9, 277, 136535
n10x8192-slot-inner-2048, 64, 75, 126, 3, 10, 278, 136535
n10x8192-slot-inner-2048, 68, 76, 125, 3, 9, 281, 136535
n10x8192-slot-inner-2048, 63, 75, 124, 3, 9, 274, 136535
n10x8192-slot-inner-2048, 64, 75, 125, 3, 9, 276, 136535
n10x8192-slot-inner-2048, 64, 75, 126, 3, 9, 277, 136535
n10x8192-slot-inner-2048, 63, 75, 125, 3, 9, 275, 136535
n10x8192-slot-inner-2048, 64, 75, 124, 3, 9, 275, 136535
n10x8192-slot-inner-2048, 63, 75, 124, 3, 9, 274, 136535
n10x8192-slot-inner-2048, 64, 76, 125, 3, 9, 277, 136535
n10x8192-slot-inner-2048, 63, 75, 125, 3, 9, 275, 136535
n10x8192-slot-inner-2048, 64, 76, 130, 3, 9, 282, 136535
n10x8192-slot-inner-2048, 64, 75, 125, 3, 9, 276, 136535
n10x8192-slot-inner-2048, 64, 76, 127, 3, 9, 279, 136535
n10x8192-slot-inner-2048, 64, 76, 125, 3, 9, 277, 136535
n10x8192-slot-inner-2048, 69, 76, 125, 3, 10, 283, 136535
n10x8192-slot-inner-2048, 65, 77, 125, 3, 10, 280, 136535
n10x8192-slot-inner-2048, 64, 79, 128, 3, 9, 283, 136535
n10x8192-slot-inner-2048, 64, 76, 125, 3, 9, 277, 136535
n10x8192-slot-inner-2048, 63, 75, 127, 3, 9, 277, 136535
n10x8192-slot-inner-2048, 64, 77, 127, 3, 10, 281, 136535
n10x8192-slot-inner-2048, 63, 75, 124, 3, 9, 274, 136535
n10x8192-slot-inner-2048, 63, 75, 123, 3, 9, 273, 136535
n10x8192-slot-inner-2048, 64, 76, 127, 3, 9, 279, 136535
n10x8192-slot-inner-2048, 64, 76, 126, 3, 9, 278, 136535
n10x8192-slot-inner-2048, 64, 75, 124, 3, 9, 275, 136535
n10x8192-slot-inner-2048, 63, 76, 124, 3, 9, 275, 136535
n10x8192-slot-inner-2048, 64, 75, 125, 3, 9, 276, 136535
n10x8192-slot-inner-2048, 63, 75, 123, 3, 9, 273, 136535
n10x8192-slot-inner-2048, 63, 75, 124, 3, 9, 274, 136535
n10x8192-slot-inner-2048, 63, 75, 124, 3, 9, 274, 136535
n10x8192-slot-inner-2048, 64, 76, 126, 3, 9, 278, 136535
n10x8192-slot-inner-2048, 63, 77, 125, 3, 10, 278, 136535
n10x8192-slot-inner-2048, 65, 77, 126, 3, 9, 280, 136535
n10x8192-slot-inner-2048, 65, 76, 125, 3, 9, 278, 136535
n10x8192-slot-inner-2048, 63, 76, 125, 3, 9, 276, 136535
n10x8192-slot-inner-2048, 63, 75, 126, 3, 9, 276, 136535
n10x8192-slot-inner-2048, 64, 76, 125, 3, 9, 277, 136535
n10x8192-slot-inner-2048, 64, 76, 124, 3, 9, 276, 136535
n10x8192-slot-inner-2048, 64, 75, 123, 3, 9, 274, 136535
n10x8192-slot-inner-2048, 66, 75, 127, 3, 9, 280, 136535
n25x8192-slot-inner-2048, 65, 189, 311, 9, 9, 583, 341335
n25x8192-slot-inner-2048, 63, 188, 316, 9, 9, 585, 341335
n25x8192-slot-inner-2048, 64, 188, 312, 8, 9, 581, 341335
n25x8192-slot-inner-2048, 63, 188, 314, 9, 9, 583, 341335
n25x8192-slot-inner-2048, 64, 188, 317, 9, 9, 587, 341335
n25x8192-slot-inner-2048, 64, 187, 310, 8, 9, 578, 341335
n25x8192-slot-inner-2048, 63, 190, 311, 9, 10, 583, 341335
n25x8192-slot-inner-2048, 63, 188, 310, 9, 9, 579, 341335
n25x8192-slot-inner-2048, 64, 189, 312, 8, 9, 582, 341335
n25x8192-slot-inner-2048, 67, 186, 322, 9, 9, 593, 341335
n25x8192-slot-inner-2048, 64, 189, 313, 9, 9, 584, 341335
n25x8192-slot-inner-2048, 63, 188, 312, 8, 9, 580, 341335
n25x8192-slot-inner-2048, 63, 187, 310, 9, 9, 578, 341335
n25x8192-slot-inner-2048, 63, 187, 311, 9, 9, 579, 341335
n25x8192-slot-inner-2048, 67, 187, 330, 9, 9, 602, 341335
n25x8192-slot-inner-2048, 64, 189, 313, 9, 9, 584, 341335
n25x8192-slot-inner-2048, 63, 187, 314, 8, 10, 582, 341335
n25x8192-slot-inner-2048, 64, 188, 312, 9, 9, 582, 341335
n25x8192-slot-inner-2048, 64, 190, 312, 8, 9, 583, 341335
n25x8192-slot-inner-2048, 65, 187, 327, 9, 9, 597, 341335
n25x8192-slot-inner-2048, 63, 189, 326, 9, 9, 596, 341335
n25x8192-slot-inner-2048, 66, 187, 311, 8, 9, 581, 341335
n25x8192-slot-inner-2048, 65, 189, 314, 9, 9, 586, 341335
n25x8192-slot-inner-2048, 63, 188, 312, 9, 9, 581, 341335
n25x8192-slot-inner-2048, 63, 187, 312, 9, 9, 580, 341335
n25x8192-slot-inner-2048, 63, 187, 314, 8, 9, 581, 341335
n25x8192-slot-inner-2048, 64, 186, 312, 9, 10, 581, 341335
n25x8192-slot-inner-2048, 63, 189, 315, 9, 9, 585, 341335
n25x8192-slot-inner-2048, 65, 191, 311, 8, 9, 584, 341335
n25x8192-slot-inner-2048, 63, 187, 313, 9, 9, 581, 341335
n25x8192-slot-inner-2048, 64, 188, 312, 8, 10, 582, 341335
n25x8192-slot-inner-2048, 68, 188, 323, 9, 9, 597, 341335
n25x8192-slot-inner-2048, 67, 187, 309, 8, 9, 580, 341335
n25x8192-slot-inner-2048, 64, 187, 313, 9, 9, 582, 341335
n25x8192-slot-inner-2048, 64, 189, 312, 9, 9, 583, 341335
n25x8192-slot-inner-2048, 64, 187, 314, 9, 10, 584, 341335
n25x8192-slot-inner-2048, 70, 190, 313, 9, 9, 591, 341335
n25x8192-slot-inner-2048, 64, 187, 315, 9, 10, 585, 341335
n25x8192-slot-inner-2048, 64, 186, 313, 8, 9, 580, 341335
n25x8192-slot-inner-2048, 63, 188, 312, 8, 9, 580, 341335
n25x8192-slot-inner-2048, 63, 187, 310, 9, 9, 578, 341335
n25x8192-slot-inner-2048, 64, 189, 313, 9, 9, 584, 341335
n25x8192-slot-inner-2048, 63, 186, 312, 8, 10, 579, 341335
n25x8192-slot-inner-2048, 64, 188, 312, 8, 9, 581, 341335
n25x8192-slot-inner-2048, 64, 191, 316, 9, 10, 590, 341335
n25x8192-slot-inner-2048, 63, 189, 319, 8, 9, 588, 341335
n25x8192-slot-inner-2048, 65, 189, 314, 8, 10, 586, 341335
n25x8192-slot-inner-2048, 63, 189, 313, 9, 9, 583, 341335
n25x8192-slot-inner-2048, 68, 188, 313, 9, 9, 587, 341335
n25x8192-slot-inner-2048, 63, 187, 312, 8, 9, 579, 341335
n25x8192-slot-inner-2048, 64, 188, 311, 8, 9, 580, 341335
n25x8192-slot-inner-2048, 63, 187, 314, 9, 9, 582, 341335
n25x8192-slot-inner-2048, 63, 190, 319, 9, 10, 591, 341335
n25x8192-slot-inner-2048, 64, 187, 312, 8, 9, 580, 341335
n25x8192-slot-inner-2048, 63, 191, 313, 8, 9, 584, 341335
n25x8192-slot-inner-2048, 63, 187, 312, 8, 9, 579, 341335
n25x8192-slot-inner-2048, 63, 188, 311, 8, 9, 579, 341335
n25x8192-slot-inner-2048, 63, 187, 310, 9, 9, 578, 341335
n25x8192-slot-inner-2048, 63, 188, 309, 8, 9, 577, 341335
n25x8192-slot-inner-2048, 63, 188, 309, 8, 9, 577, 341335
n25x8192-slot-inner-2048, 63, 188, 311, 9, 9, 580, 341335
n25x8192-slot-inner-2048, 63, 187, 312, 8, 9, 579, 341335
n25x8192-slot-inner-2048, 64, 188, 311, 9, 9, 581, 341335
n25x8192-slot-inner-2048, 64, 190, 309, 8, 9, 580, 341335
n25x8192-slot-inner-2048, 64, 188, 310, 8, 9, 579, 341335
n25x8192-slot-inner-2048, 64, 187, 309, 8, 9, 577, 341335
n25x8192-slot-inner-2048, 63, 187, 312, 8, 9, 579, 341335
n25x8192-slot-inner-2048, 72, 187, 311, 8, 9, 587, 341335
n25x8192-slot-inner-2048, 63, 186, 310, 9, 9, 577, 341335
n25x8192-slot-inner-2048, 69, 191, 315, 9, 9, 593, 341335
n25x8192-slot-inner-2048, 63, 189, 314, 8, 9, 583, 341335
n25x8192-slot-inner-2048, 64, 188, 308, 8, 9, 577, 341335
n25x8192-slot-inner-2048, 65, 190, 310, 8, 9, 582, 341335
n25x8192-slot-inner-2048, 63, 186, 311, 9, 9, 578, 341335
n25x8192-slot-inner-2048, 64, 189, 311, 9, 9, 582, 341335
n25x8192-slot-inner-2048, 63, 186, 309, 8, 9, 575, 341335
n25x8192-slot-inner-2048, 67, 188, 315, 9, 10, 589, 341335
n25x8192-slot-inner-2048, 64, 187, 312, 9, 9, 581, 341335
n25x8192-slot-inner-2048, 64, 187, 310, 8, 9, 578, 341335
n25x8192-slot-inner-2048, 65, 188, 324, 8, 9, 594, 341335
n25x8192-slot-inner-2048, 64, 188, 316, 9, 9, 586, 341335
n25x8192-slot-inner-2048, 64, 187, 311, 9, 9, 580, 341335
n25x8192-slot-inner-2048, 63, 188, 310, 9, 9, 579, 341335
n25x8192-slot-inner-2048, 63, 186, 310, 9, 9, 577, 341335
n25x8192-slot-inner-2048, 64, 190, 312, 9, 9, 584, 341335
n25x8192-slot-inner-2048, 64, 187, 313, 9, 9, 582, 341335
n25x8192-slot-inner-2048, 64, 189, 317, 9, 10, 589, 341335
n25x8192-slot-inner-2048, 65, 188, 312, 9, 9, 583, 341335
n25x8192-slot-inner-2048, 64, 188, 308, 9, 9, 578, 341335
n25x8192-slot-inner-2048, 64, 188, 311, 8, 9, 580, 341335
n25x8192-slot-inner-2048, 64, 186, 313, 8, 9, 580, 341335
n25x8192-slot-inner-2048, 65, 190, 310, 8, 9, 582, 341335
n25x8192-slot-inner-2048, 64, 188, 311, 9, 9, 581, 341335
n25x8192-slot-inner-2048, 63, 188, 318, 9, 9, 587, 341335
n25x8192-slot-inner-2048, 64, 189, 314, 9, 9, 585, 341335
n25x8192-slot-inner-2048, 70, 186, 323, 8, 9, 596, 341335
n25x8192-slot-inner-2048, 64, 189, 314, 9, 9, 585, 341335
n25x8192-slot-inner-2048, 63, 188, 314, 9, 10, 584, 341335
n25x8192-slot-inner-2048, 63, 187, 311, 9, 9, 579, 341335
n25x8192-slot-inner-2048, 64, 187, 312, 8, 9, 580, 341335
n50x8192-slot-inner-2048, 64, 375, 624, 18, 9, 1090, 682666
n50x8192-slot-inner-2048, 63, 372, 626, 18, 9, 1088, 682666
n50x8192-slot-inner-2048, 63, 372, 617, 18, 9, 1079, 682666
n50x8192-slot-inner-2048, 65, 376, 620, 18, 9, 1088, 682666
n50x8192-slot-inner-2048, 64, 375, 620, 18, 9, 1086, 682666
n50x8192-slot-inner-2048, 63, 373, 617, 18, 9, 1080, 682666
n50x8192-slot-inner-2048, 63, 373, 616, 18, 9, 1079, 682666
n50x8192-slot-inner-2048, 67, 372, 622, 18, 9, 1088, 682666
n50x8192-slot-inner-2048, 64, 377, 621, 18, 9, 1089, 682666
n50x8192-slot-inner-2048, 63, 374, 618, 20, 10, 1085, 682666
n50x8192-slot-inner-2048, 63, 375, 620, 20, 9, 1087, 682666
n50x8192-slot-inner-2048, 63, 373, 621, 18, 9, 1084, 682666
n50x8192-slot-inner-2048, 64, 375, 617, 20, 10, 1086, 682666
n50x8192-slot-inner-2048, 65, 379, 622, 18, 9, 1093, 682666
n50x8192-slot-inner-2048, 64, 374, 615, 19, 9, 1081, 682666
n50x8192-slot-inner-2048, 63, 372, 619, 18, 9, 1081, 682666
n50x8192-slot-inner-2048, 64, 375, 618, 18, 9, 1084, 682666
n50x8192-slot-inner-2048, 63, 375, 624, 18, 10, 1090, 682666
n50x8192-slot-inner-2048, 66, 373, 624, 19, 9, 1091, 682666
n50x8192-slot-inner-2048, 64, 374, 624, 18, 9, 1089, 682666
n50x8192-slot-inner-2048, 64, 377, 618, 18, 9, 1086, 682666
n50x8192-slot-inner-2048, 64, 376, 629, 19, 9, 1097, 682666
n50x8192-slot-inner-2048, 68, 377, 621, 18, 9, 1093, 682666
n50x8192-slot-inner-2048, 68, 375, 619, 18, 9, 1089, 682666
n50x8192-slot-inner-2048, 63, 376, 620, 18, 9, 1086, 682666
n50x8192-slot-inner-2048, 63, 375, 618, 18, 9, 1083, 682666
n50x8192-slot-inner-2048, 63, 373, 620, 18, 9, 1083, 682666
n50x8192-slot-inner-2048, 63, 375, 633, 18, 9, 1098, 682666
n50x8192-slot-inner-2048, 64, 373, 617, 18, 9, 1081, 682666
n50x8192-slot-inner-2048, 63, 376, 617, 18, 9, 1083, 682666
n50x8192-slot-inner-2048, 65, 371, 626, 18, 10, 1090, 682666
n50x8192-slot-inner-2048, 64, 375, 623, 18, 9, 1089, 682666
n50x8192-slot-inner-2048, 73, 372, 645, 19, 9, 1118, 682666
n50x8192-slot-inner-2048, 63, 371, 613, 18, 9, 1074, 682666
n50x8192-slot-inner-2048, 63, 374, 622, 18, 9, 1086, 682666
n50x8192-slot-inner-2048, 63, 372, 622, 18, 10, 1085, 682666
n50x8192-slot-inner-2048, 64, 377, 617, 18, 10, 1086, 682666
n50x8192-slot-inner-2048, 63, 375, 619, 18, 9, 1084, 682666
n50x8192-slot-inner-2048, 64, 375, 619, 18, 10, 1086, 682666
n50x8192-slot-inner-2048, 65, 381, 636, 18, 9, 1109, 682666
n50x8192-slot-inner-2048, 64, 374, 627, 18, 9, 1092, 682666
n50x8192-slot-inner-2048, 64, 373, 619, 18, 9, 1083, 682666
n50x8192-slot-inner-2048, 75, 373, 645, 19, 9, 1121, 682666
n50x8192-slot-inner-2048, 63, 379, 619, 18, 10, 1089, 682666
n50x8192-slot-inner-2048, 64, 377, 618, 18, 9, 1086, 682666
n50x8192-slot-inner-2048, 65, 376, 624, 18, 9, 1092, 682666
n50x8192-slot-inner-2048, 64, 378, 618, 20, 9, 1089, 682666
n50x8192-slot-inner-2048, 64, 375, 629, 18, 10, 1096, 682666
n50x8192-slot-inner-2048, 64, 379, 623, 18, 10, 1094, 682666
n50x8192-slot-inner-2048, 63, 373, 619, 18, 10, 1083, 682666
n50x8192-slot-inner-2048, 63, 375, 620, 18, 9, 1085, 682666
n50x8192-slot-inner-2048, 64, 374, 620, 18, 9, 1085, 682666
n50x8192-slot-inner-2048, 64, 377, 614, 18, 9, 1082, 682666
n50x8192-slot-inner-2048, 65, 378, 629, 19, 10, 1101, 682666
n50x8192-slot-inner-2048, 63, 375, 619, 18, 9, 1084, 682666
n50x8192-slot-inner-2048, 64, 371, 619, 18, 9, 1081, 682666
n50x8192-slot-inner-2048, 64, 374, 619, 18, 9, 1084, 682666
n50x8192-slot-inner-2048, 70, 375, 626, 18, 10, 1099, 682666
n50x8192-slot-inner-2048, 64, 373, 618, 18, 9, 1082, 682666
n50x8192-slot-inner-2048, 68, 373, 621, 18, 9, 1089, 682666
n50x8192-slot-inner-2048, 63, 374, 625, 19, 9, 1090, 682666
n50x8192-slot-inner-2048, 64, 377, 627, 20, 10, 1098, 682666
n50x8192-slot-inner-2048, 64, 373, 619, 18, 10, 1084, 682666
n50x8192-slot-inner-2048, 63, 372, 620, 18, 9, 1082, 682666
n50x8192-slot-inner-2048, 64, 377, 622, 20, 10, 1093, 682666
n50x8192-slot-inner-2048, 64, 372, 619, 18, 9, 1082, 682666
n50x8192-slot-inner-2048, 63, 372, 621, 18, 9, 1083, 682666
n50x8192-slot-inner-2048, 63, 375, 619, 18, 9, 1084, 682666
n50x8192-slot-inner-2048, 68, 375, 640, 18, 9, 1110, 682666
n50x8192-slot-inner-2048, 64, 374, 619, 18, 9, 1084, 682666
n50x8192-slot-inner-2048, 64, 372, 632, 18, 9, 1095, 682666
n50x8192-slot-inner-2048, 63, 375, 625, 18, 9, 1090, 682666
n50x8192-slot-inner-2048, 64, 373, 626, 18, 9, 1090, 682666
n50x8192-slot-inner-2048, 63, 373, 621, 18, 9, 1084, 682666
n50x8192-slot-inner-2048, 63, 375, 623, 18, 9, 1088, 682666
n50x8192-slot-inner-2048, 63, 376, 624, 19, 9, 1091, 682666
n50x8192-slot-inner-2048, 75, 375, 642, 18, 10, 1120, 682666
n50x8192-slot-inner-2048, 63, 375, 621, 18, 9, 1086, 682666
n50x8192-slot-inner-2048, 70, 372, 643, 18, 9, 1112, 682666
n50x8192-slot-inner-2048, 64, 374, 619, 18, 9, 1084, 682666
n50x8192-slot-inner-2048, 70, 375, 659, 18, 9, 1131, 682666
n50x8192-slot-inner-2048, 63, 373, 619, 18, 9, 1082, 682666
n50x8192-slot-inner-2048, 64, 376, 621, 19, 10, 1090, 682666
n50x8192-slot-inner-2048, 63, 375, 622, 18, 9, 1087, 682666
n50x8192-slot-inner-2048, 74, 375, 648, 18, 9, 1124, 682666
n50x8192-slot-inner-2048, 63, 378, 620, 18, 9, 1088, 682666
n50x8192-slot-inner-2048, 64, 374, 623, 18, 9, 1088, 682666
n50x8192-slot-inner-2048, 64, 380, 620, 18, 9, 1091, 682666
n50x8192-slot-inner-2048, 64, 376, 619, 18, 9, 1086, 682666
n50x8192-slot-inner-2048, 64, 373, 618, 18, 9, 1082, 682666
n50x8192-slot-inner-2048, 64, 375, 620, 18, 9, 1086, 682666
n50x8192-slot-inner-2048, 64, 374, 617, 18, 9, 1082, 682666
n50x8192-slot-inner-2048, 67, 377, 622, 18, 9, 1093, 682666
n50x8192-slot-inner-2048, 63, 376, 621, 18, 9, 1087, 682666
n50x8192-slot-inner-2048, 63, 372, 615, 18, 9, 1077, 682666
n50x8192-slot-inner-2048, 63, 374, 620, 18, 9, 1084, 682666
n50x8192-slot-inner-2048, 63, 373, 620, 18, 9, 1083, 682666
n50x8192-slot-inner-2048, 71, 374, 645, 18, 9, 1117, 682666
n50x8192-slot-inner-2048, 63, 373, 616, 18, 9, 1079, 682666
n50x8192-slot-inner-2048, 63, 375, 621, 18, 9, 1086, 682666
n100x8192-slot-inner-2048, 64, 745, 1249, 38, 10, 2106, 1.36534e+06
n100x8192-slot-inner-2048, 63, 748, 1248, 38, 10, 2107, 1.36534e+06
n100x8192-slot-inner-2048, 63, 746, 1244, 37, 10, 2100, 1.36534e+06
n100x8192-slot-inner-2048, 63, 749, 1261, 38, 10, 2121, 1.36534e+06
n100x8192-slot-inner-2048, 65, 753, 1259, 37, 10, 2124, 1.36534e+06
n100x8192-slot-inner-2048, 64, 753, 1248, 38, 10, 2113, 1.36534e+06
n100x8192-slot-inner-2048, 64, 749, 1255, 39, 10, 2117, 1.36534e+06
n100x8192-slot-inner-2048, 64, 752, 1244, 38, 10, 2108, 1.36534e+06
n100x8192-slot-inner-2048, 64, 755, 1248, 38, 10, 2115, 1.36534e+06
n100x8192-slot-inner-2048, 63, 753, 1240, 38, 10, 2104, 1.36534e+06
n100x8192-slot-inner-2048, 64, 748, 1243, 37, 10, 2102, 1.36534e+06
n100x8192-slot-inner-2048, 64, 747, 1254, 38, 10, 2113, 1.36534e+06
n100x8192-slot-inner-2048, 64, 751, 1244, 39, 10, 2108, 1.36534e+06
n100x8192-slot-inner-2048, 64, 753, 1245, 38, 10, 2110, 1.36534e+06
n100x8192-slot-inner-2048, 64, 748, 1257, 37, 10, 2116, 1.36534e+06
n100x8192-slot-inner-2048, 63, 753, 1243, 37, 9, 2105, 1.36534e+06
n100x8192-slot-inner-2048, 63, 748, 1252, 39, 10, 2112, 1.36534e+06
n100x8192-slot-inner-2048, 65, 754, 1246, 38, 10, 2113, 1.36534e+06
n100x8192-slot-inner-2048, 63, 751, 1240, 38, 10, 2102, 1.36534e+06
n100x8192-slot-inner-2048, 67, 749, 1297, 40, 10, 2163, 1.36534e+06
n100x8192-slot-inner-2048, 65, 754, 1234, 38, 10, 2101, 1.36534e+06
n100x8192-slot-inner-2048, 63, 749, 1246, 38, 10, 2106, 1.36534e+06
n100x8192-slot-inner-2048, 67, 751, 1243, 37, 10, 2108, 1.36534e+06
n100x8192-slot-inner-2048, 64, 748, 1244, 38, 10, 2104, 1.36534e+06
n100x8192-slot-inner-2048, 63, 748, 1247, 38, 10, 2106, 1.36534e+06
n100x8192-slot-inner-2048, 63, 749, 1240, 40, 10, 2102, 1.36534e+06
n100x8192-slot-inner-2048, 64, 748, 1244, 38, 10, 2104, 1.36534e+06
n100x8192-slot-inner-2048, 65, 747, 1238, 40, 10, 2100, 1.36534e+06
n100x8192-slot-inner-2048, 63, 747, 1245, 39, 10, 2104, 1.36534e+06
n100x8192-slot-inner-2048, 75, 752, 1298, 38, 10, 2173, 1.36534e+06
n100x8192-slot-inner-2048, 65, 751, 1250, 39, 10, 2115, 1.36534e+06
n100x8192-slot-inner-2048, 65, 756, 1253, 38, 10, 2122, 1.36534e+06
n100x8192-slot-inner-2048, 66, 749, 1243, 38, 10, 2106, 1.36534e+06
n100x8192-slot-inner-2048, 63, 749, 1243, 41, 10, 2106, 1.36534e+06
n100x8192-slot-inner-2048, 63, 762, 1248, 38, 10, 2121, 1.36534e+06
n100x8192-slot-inner-2048, 65, 770, 1248, 38, 10, 2131, 1.36534e+06
n100x8192-slot-inner-2048, 63, 751, 1242, 38, 10, 2104, 1.36534e+06
n100x8192-slot-inner-2048, 63, 745, 1251, 38, 10, 2107, 1.36534e+06
n100x8192-slot-inner-2048, 63, 754, 1251, 39, 10, 2117, 1.36534e+06
n100x8192-slot-inner-2048, 65, 752, 1240, 41, 10, 2108, 1.36534e+06
n100x8192-slot-inner-2048, 68, 753, 1259, 38, 10, 2128, 1.36534e+06
n100x8192-slot-inner-2048, 65, 750, 1241, 38, 10, 2104, 1.36534e+06
n100x8192-slot-inner-2048, 64, 750, 1248, 38, 10, 2110, 1.36534e+06
n100x8192-slot-inner-2048, 64, 753, 1248, 37, 10, 2112, 1.36534e+06
n100x8192-slot-inner-2048, 64, 748, 1254, 38, 10, 2114, 1.36534e+06
n100x8192-slot-inner-2048, 65, 755, 1257, 39, 10, 2126, 1.36534e+06
n100x8192-slot-inner-2048, 64, 750, 1240, 38, 10, 2102, 1.36534e+06
n100x8192-slot-inner-2048, 65, 750, 1248, 37, 10, 2110, 1.36534e+06
n100x8192-slot-inner-2048, 63, 748, 1240, 37, 10, 2098, 1.36534e+06
n100x8192-slot-inner-2048, 63, 750, 1255, 37, 10, 2115, 1.36534e+06
n100x8192-slot-inner-2048, 64, 754, 1252, 38, 10, 2118, 1.36534e+06
n100x8192-slot-inner-2048, 64, 753, 1252, 41, 10, 2120, 1.36534e+06
n100x8192-slot-inner-2048, 64, 758, 1253, 38, 10, 2123, 1.36534e+06
n100x8192-slot-inner-2048, 71, 760, 1250, 39, 10, 2130, 1.36534e+06
n100x8192-slot-inner-2048, 64, 758, 1245, 37, 10, 2114, 1.36534e+06
n100x8192-slot-inner-2048, 64, 751, 1240, 38, 10, 2103, 1.36534e+06
n100x8192-slot-inner-2048, 68, 748, 1243, 39, 10, 2108, 1.36534e+06
n100x8192-slot-inner-2048, 63, 749, 1244, 38, 10, 2104, 1.36534e+06
n100x8192-slot-inner-2048, 64, 750, 1255, 37, 9, 2115, 1.36534e+06
n100x8192-slot-inner-2048, 64, 755, 1250, 37, 10, 2116, 1.36534e+06
n100x8192-slot-inner-2048, 64, 752, 1254, 38, 10, 2118, 1.36534e+06
n100x8192-slot-inner-2048, 63, 749, 1274, 38, 9, 2133, 1.36534e+06
n100x8192-slot-inner-2048, 64, 746, 1247, 38, 10, 2105, 1.36534e+06
n100x8192-slot-inner-2048, 63, 753, 1255, 38, 10, 2119, 1.36534e+06
n100x8192-slot-inner-2048, 63, 748, 1237, 38, 10, 2096, 1.36534e+06
n100x8192-slot-inner-2048, 63, 750, 1239, 41, 10, 2103, 1.36534e+06
n100x8192-slot-inner-2048, 64, 748, 1241, 38, 10, 2101, 1.36534e+06
n100x8192-slot-inner-2048, 64, 749, 1250, 39, 10, 2112, 1.36534e+06
n100x8192-slot-inner-2048, 63, 749, 1241, 38, 10, 2101, 1.36534e+06
n100x8192-slot-inner-2048, 66, 752, 1252, 38, 10, 2118, 1.36534e+06
n100x8192-slot-inner-2048, 64, 746, 1298, 38, 9, 2155, 1.36534e+06
n100x8192-slot-inner-2048, 63, 751, 1244, 37, 10, 2105, 1.36534e+06
n100x8192-slot-inner-2048, 66, 755, 1259, 40, 10, 2130, 1.36534e+06
n100x8192-slot-inner-2048, 67, 753, 1255, 38, 10, 2123, 1.36534e+06
n100x8192-slot-inner-2048, 64, 754, 1244, 38, 10, 2110, 1.36534e+06
n100x8192-slot-inner-2048, 63, 752, 1242, 38, 10, 2105, 1.36534e+06
n100x8192-slot-inner-2048, 63, 747, 1247, 38, 10, 2105, 1.36534e+06
n100x8192-slot-inner-2048, 74, 750, 1296, 38, 10, 2168, 1.36534e+06
n100x8192-slot-inner-2048, 63, 749, 1238, 38, 10, 2098, 1.36534e+06
n100x8192-slot-inner-2048, 64, 749, 1241, 38, 10, 2102, 1.36534e+06
n100x8192-slot-inner-2048, 63, 749, 1244, 38, 10, 2104, 1.36534e+06
n100x8192-slot-inner-2048, 63, 751, 1251, 39, 10, 2114, 1.36534e+06
n100x8192-slot-inner-2048, 63, 750, 1249, 38, 10, 2110, 1.36534e+06
n100x8192-slot-inner-2048, 63, 750, 1248, 38, 10, 2109, 1.36534e+06
n100x8192-slot-inner-2048, 68, 749, 1241, 38, 10, 2106, 1.36534e+06
n100x8192-slot-inner-2048, 64, 749, 2035, 62, 10, 2920, 1.36534e+06
n100x8192-slot-inner-2048, 74, 889, 1300, 38, 10, 2311, 1.36534e+06
n100x8192-slot-inner-2048, 66, 750, 1256, 38, 10, 2120, 1.36534e+06
n100x8192-slot-inner-2048, 64, 751, 1264, 39, 10, 2128, 1.36534e+06
n100x8192-slot-inner-2048, 64, 746, 1243, 41, 10, 2104, 1.36534e+06
n100x8192-slot-inner-2048, 67, 749, 1261, 38, 10, 2125, 1.36534e+06
n100x8192-slot-inner-2048, 64, 750, 1243, 37, 10, 2104, 1.36534e+06
n100x8192-slot-inner-2048, 63, 747, 1242, 38, 10, 2100, 1.36534e+06
n100x8192-slot-inner-2048, 64, 750, 1254, 38, 10, 2116, 1.36534e+06
n100x8192-slot-inner-2048, 63, 751, 1254, 38, 10, 2116, 1.36534e+06
n100x8192-slot-inner-2048, 64, 756, 1243, 38, 10, 2111, 1.36534e+06
n100x8192-slot-inner-2048, 63, 746, 1250, 38, 10, 2107, 1.36534e+06
n100x8192-slot-inner-2048, 63, 750, 1244, 41, 10, 2108, 1.36534e+06
n100x8192-slot-inner-2048, 64, 748, 1241, 37, 10, 2100, 1.36534e+06
n100x8192-slot-inner-2048, 64, 752, 1246, 39, 10, 2111, 1.36534e+06
n250x8192-slot-inner-2048, 64, 189, 312, 9, 10, 584, 341335
n250x8192-slot-inner-2048, 64, 189, 309, 9, 10, 581, 341335
n250x8192-slot-inner-2048, 64, 189, 308, 8, 9, 578, 341335
n250x8192-slot-inner-2048, 68, 189, 311, 9, 9, 586, 341335
n250x8192-slot-inner-2048, 64, 187, 313, 9, 9, 582, 341335
n250x8192-slot-inner-2048, 64, 187, 313, 8, 9, 581, 341335
n250x8192-slot-inner-2048, 65, 187, 312, 9, 9, 582, 341335
n250x8192-slot-inner-2048, 63, 189, 310, 9, 9, 580, 341335
n250x8192-slot-inner-2048, 66, 189, 312, 8, 9, 584, 341335
n250x8192-slot-inner-2048, 64, 188, 312, 9, 10, 583, 341335
n250x8192-slot-inner-2048, 63, 187, 314, 8, 9, 581, 341335
n250x8192-slot-inner-2048, 64, 188, 312, 9, 10, 583, 341335
n250x8192-slot-inner-2048, 64, 187, 309, 9, 9, 578, 341335
n250x8192-slot-inner-2048, 66, 187, 312, 9, 9, 583, 341335
n250x8192-slot-inner-2048, 63, 190, 315, 9, 9, 586, 341335
n250x8192-slot-inner-2048, 64, 190, 313, 9, 9, 585, 341335
n250x8192-slot-inner-2048, 63, 187, 311, 9, 9, 579, 341335
n250x8192-slot-inner-2048, 63, 189, 311, 9, 10, 582, 341335
n250x8192-slot-inner-2048, 64, 188, 321, 9, 9, 591, 341335
n250x8192-slot-inner-2048, 64, 189, 312, 9, 9, 583, 341335
n250x8192-slot-inner-2048, 63, 188, 311, 9, 9, 580, 341335
n250x8192-slot-inner-2048, 75, 189, 313, 9, 9, 595, 341335
n250x8192-slot-inner-2048, 63, 188, 310, 9, 9, 579, 341335
n250x8192-slot-inner-2048, 63, 187, 312, 9, 9, 580, 341335
n250x8192-slot-inner-2048, 69, 189, 315, 9, 10, 592, 341335
n250x8192-slot-inner-2048, 65, 189, 311, 8, 9, 582, 341335
n250x8192-slot-inner-2048, 64, 186, 310, 9, 9, 578, 341335
n250x8192-slot-inner-2048, 64, 188, 313, 9, 9, 583, 341335
n250x8192-slot-inner-2048, 64, 187, 313, 8, 9, 581, 341335
n250x8192-slot-inner-2048, 64, 189, 308, 9, 9, 579, 341335
n250x8192-slot-inner-2048, 63, 187, 311, 9, 10, 580, 341335
n250x8192-slot-inner-2048, 64, 187, 313, 9, 9, 582, 341335
n250x8192-slot-inner-2048, 63, 187, 313, 9, 9, 581, 341335
n250x8192-slot-inner-2048, 63, 186, 311, 8, 9, 577, 341335
n250x8192-slot-inner-2048, 64, 186, 311, 9, 9, 579, 341335
n250x8192-slot-inner-2048, 64, 189, 312, 9, 9, 583, 341335
n250x8192-slot-inner-2048, 64, 188, 315, 9, 10, 586, 341335
n250x8192-slot-inner-2048, 64, 189, 311, 9, 9, 582, 341335
n250x8192-slot-inner-2048, 63, 188, 312, 9, 9, 581, 341335
n250x8192-slot-inner-2048, 64, 188, 314, 8, 9, 583, 341335
n250x8192-slot-inner-2048, 70, 190, 324, 8, 9, 601, 341335
n250x8192-slot-inner-2048, 64, 188, 315, 9, 10, 586, 341335
n250x8192-slot-inner-2048, 66, 188, 310, 8, 9, 581, 341335
n250x8192-slot-inner-2048, 64, 191, 310, 9, 9, 583, 341335
n250x8192-slot-inner-2048, 65, 187, 323, 9, 9, 593, 341335
n250x8192-slot-inner-2048, 63, 189, 313, 8, 9, 582, 341335
n250x8192-slot-inner-2048, 64, 187, 309, 9, 9, 578, 341335
n250x8192-slot-inner-2048, 63, 186, 309, 9, 9, 576, 341335
n250x8192-slot-inner-2048, 63, 188, 311, 9, 9, 580, 341335
n250x8192-slot-inner-2048, 63, 188, 312, 9, 9, 581, 341335
n250x8192-slot-inner-2048, 64, 189, 313, 9, 9, 584, 341335
n250x8192-slot-inner-2048, 63, 186, 314, 9, 9, 581, 341335
n250x8192-slot-inner-2048, 64, 188, 311, 9, 9, 581, 341335
n250x8192-slot-inner-2048, 63, 187, 314, 10, 9, 583, 341335
n250x8192-slot-inner-2048, 64, 188, 310, 9, 10, 581, 341335
n250x8192-slot-inner-2048, 64, 188, 310, 9, 9, 580, 341335
n250x8192-slot-inner-2048, 63, 188, 314, 9, 10, 584, 341335
n250x8192-slot-inner-2048, 64, 189, 322, 9, 9, 593, 341335
n250x8192-slot-inner-2048, 64, 188, 312, 9, 9, 582, 341335
n250x8192-slot-inner-2048, 63, 188, 317, 9, 9, 586, 341335
n250x8192-slot-inner-2048, 64, 188, 312, 9, 9, 582, 341335
n250x8192-slot-inner-2048, 64, 189, 314, 9, 9, 585, 341335
n250x8192-slot-inner-2048, 63, 188, 310, 8, 9, 578, 341335
n250x8192-slot-inner-2048, 63, 187, 315, 9, 9, 583, 341335
n250x8192-slot-inner-2048, 71, 188, 308, 9, 9, 585, 341335
n250x8192-slot-inner-2048, 63, 188, 312, 9, 9, 581, 341335
n250x8192-slot-inner-2048, 64, 188, 315, 9, 10, 586, 341335
n250x8192-slot-inner-2048, 63, 186, 309, 8, 9, 575, 341335
n250x8192-slot-inner-2048, 63, 188, 314, 9, 10, 584, 341335
n250x8192-slot-inner-2048, 71, 188, 315, 9, 9, 592, 341335
n250x8192-slot-inner-2048, 64, 194, 312, 8, 9, 587, 341335
n250x8192-slot-inner-2048, 63, 188, 315, 8, 9, 583, 341335
n250x8192-slot-inner-2048, 63, 188, 315, 9, 9, 584, 341335
n250x8192-slot-inner-2048, 64, 188, 313, 9, 9, 583, 341335
n250x8192-slot-inner-2048, 70, 188, 328, 9, 9, 604, 341335
n250x8192-slot-inner-2048, 63, 188, 323, 9, 9, 592, 341335
n250x8192-slot-inner-2048, 68, 191, 314, 9, 9, 591, 341335
n250x8192-slot-inner-2048, 64, 189, 311, 9, 9, 582, 341335
n250x8192-slot-inner-2048, 65, 188, 315, 9, 9, 586, 341335
n250x8192-slot-inner-2048, 67, 187, 311, 9, 9, 583, 341335
n250x8192-slot-inner-2048, 63, 186, 311, 9, 9, 578, 341335
n250x8192-slot-inner-2048, 64, 187, 309, 9, 9, 578, 341335
n250x8192-slot-inner-2048, 64, 189, 309, 9, 9, 580, 341335
n250x8192-slot-inner-2048, 63, 188, 309, 8, 9, 577, 341335
n250x8192-slot-inner-2048, 65, 190, 313, 9, 9, 586, 341335
n250x8192-slot-inner-2048, 63, 187, 313, 9, 9, 581, 341335
n250x8192-slot-inner-2048, 63, 187, 311, 9, 9, 579, 341335
n250x8192-slot-inner-2048, 64, 187, 307, 9, 9, 576, 341335
n250x8192-slot-inner-2048, 64, 189, 315, 9, 9, 586, 341335
n250x8192-slot-inner-2048, 65, 187, 311, 9, 9, 581, 341335
n250x8192-slot-inner-2048, 68, 187, 321, 9, 9, 594, 341335
n250x8192-slot-inner-2048, 64, 189, 311, 9, 9, 582, 341335
n250x8192-slot-inner-2048, 64, 187, 312, 9, 10, 582, 341335
n250x8192-slot-inner-2048, 64, 188, 310, 9, 9, 580, 341335
n250x8192-slot-inner-2048, 63, 188, 311, 9, 10, 581, 341335
n250x8192-slot-inner-2048, 64, 191, 311, 9, 9, 584, 341335
n250x8192-slot-inner-2048, 63, 188, 312, 9, 9, 581, 341335
n250x8192-slot-inner-2048, 63, 187, 313, 8, 9, 580, 341335
n250x8192-slot-inner-2048, 64, 187, 313, 9, 9, 582, 341335
n250x8192-slot-inner-2048, 66, 189, 311, 9, 9, 584, 341335
n500x8192-slot-inner-2048, 63, 3759, 6223, 194, 12, 10251, 6.82667e+06
n500x8192-slot-inner-2048, 87, 3731, 6487, 195, 12, 10512, 6.82667e+06
n500x8192-slot-inner-2048, 67, 3760, 6252, 193, 13, 10285, 6.82667e+06
n500x8192-slot-inner-2048, 64, 3741, 6254, 192, 13, 10264, 6.82667e+06
n500x8192-slot-inner-2048, 64, 3732, 6211, 192, 13, 10212, 6.82667e+06
n500x8192-slot-inner-2048, 64, 3747, 6244, 208, 13, 10276, 6.82667e+06
n500x8192-slot-inner-2048, 63, 3738, 6254, 198, 13, 10266, 6.82667e+06
n500x8192-slot-inner-2048, 63, 3735, 6239, 211, 13, 10261, 6.82667e+06
n500x8192-slot-inner-2048, 69, 3755, 6416, 195, 13, 10448, 6.82667e+06
n500x8192-slot-inner-2048, 64, 3741, 6247, 198, 13, 10263, 6.82667e+06
n500x8192-slot-inner-2048, 64, 3735, 6224, 197, 12, 10232, 6.82667e+06
n500x8192-slot-inner-2048, 65, 3758, 6243, 197, 12, 10275, 6.82667e+06
n500x8192-slot-inner-2048, 63, 3737, 6223, 204, 12, 10239, 6.82667e+06
n500x8192-slot-inner-2048, 68, 3731, 6498, 208, 13, 10518, 6.82667e+06
n500x8192-slot-inner-2048, 63, 3747, 6311, 196, 13, 10330, 6.82667e+06
n500x8192-slot-inner-2048, 63, 3737, 6224, 194, 12, 10230, 6.82667e+06
n500x8192-slot-inner-2048, 64, 3747, 6234, 193, 12, 10250, 6.82667e+06
n500x8192-slot-inner-2048, 64, 3745, 6223, 196, 12, 10240, 6.82667e+06
n500x8192-slot-inner-2048, 64, 3735, 6235, 197, 13, 10244, 6.82667e+06
n500x8192-slot-inner-2048, 64, 3758, 6239, 199, 13, 10273, 6.82667e+06
n500x8192-slot-inner-2048, 65, 3773, 6507, 194, 12, 10551, 6.82667e+06
n500x8192-slot-inner-2048, 63, 3737, 6295, 195, 12, 10302, 6.82667e+06
n500x8192-slot-inner-2048, 67, 3765, 6278, 195, 12, 10317, 6.82667e+06
n500x8192-slot-inner-2048, 64, 3740, 6234, 193, 13, 10244, 6.82667e+06
n500x8192-slot-inner-2048, 64, 3740, 6264, 199, 13, 10280, 6.82667e+06
n500x8192-slot-inner-2048, 67, 3770, 6327, 197, 12, 10373, 6.82667e+06
n500x8192-slot-inner-2048, 63, 3769, 6223, 193, 13, 10261, 6.82667e+06
n500x8192-slot-inner-2048, 63, 3733, 6225, 194, 13, 10228, 6.82667e+06
n500x8192-slot-inner-2048, 64, 3757, 6246, 196, 12, 10275, 6.82667e+06
n500x8192-slot-inner-2048, 64, 3748, 6226, 195, 12, 10245, 6.82667e+06
n500x8192-slot-inner-2048, 63, 3725, 6285, 197, 12, 10282, 6.82667e+06
n500x8192-slot-inner-2048, 64, 3750, 6225, 195, 13, 10247, 6.82667e+06
n500x8192-slot-inner-2048, 64, 3747, 6226, 200, 12, 10249, 6.82667e+06
n500x8192-slot-inner-2048, 63, 3736, 6241, 197, 14, 10251, 6.82667e+06
n500x8192-slot-inner-2048, 64, 3729, 6243, 200, 13, 10249, 6.82667e+06
n500x8192-slot-inner-2048, 69, 3756, 6239, 193, 13, 10270, 6.82667e+06
n500x8192-slot-inner-2048, 64, 3743, 6256, 201, 13, 10277, 6.82667e+06
n500x8192-slot-inner-2048, 63, 3750, 6263, 195, 13, 10284, 6.82667e+06
n500x8192-slot-inner-2048, 64, 3770, 6222, 194, 12, 10262, 6.82667e+06
n500x8192-slot-inner-2048, 63, 3734, 6258, 197, 13, 10265, 6.82667e+06
n500x8192-slot-inner-2048, 63, 3730, 6233, 195, 12, 10233, 6.82667e+06
n500x8192-slot-inner-2048, 64, 3730, 6255, 196, 13, 10258, 6.82667e+06
n500x8192-slot-inner-2048, 63, 3758, 6253, 196, 15, 10285, 6.82667e+06
n500x8192-slot-inner-2048, 63, 3738, 6199, 196, 13, 10209, 6.82667e+06
n500x8192-slot-inner-2048, 64, 3748, 6215, 196, 12, 10235, 6.82667e+06
n500x8192-slot-inner-2048, 65, 3753, 6218, 195, 12, 10243, 6.82667e+06
n500x8192-slot-inner-2048, 64, 3735, 6242, 193, 13, 10247, 6.82667e+06
n500x8192-slot-inner-2048, 68, 3730, 6223, 195, 13, 10229, 6.82667e+06
n500x8192-slot-inner-2048, 64, 3739, 6247, 194, 13, 10257, 6.82667e+06
n500x8192-slot-inner-2048, 63, 3738, 6227, 195, 13, 10236, 6.82667e+06
n500x8192-slot-inner-2048, 65, 3735, 6237, 201, 13, 10251, 6.82667e+06
n500x8192-slot-inner-2048, 63, 3732, 6209, 200, 13, 10217, 6.82667e+06
n500x8192-slot-inner-2048, 64, 3748, 6221, 199, 13, 10245, 6.82667e+06
n500x8192-slot-inner-2048, 63, 3733, 6248, 194, 13, 10251, 6.82667e+06
n500x8192-slot-inner-2048, 63, 3748, 6245, 201, 14, 10271, 6.82667e+06
n500x8192-slot-inner-2048, 65, 3733, 6234, 195, 12, 10239, 6.82667e+06
n500x8192-slot-inner-2048, 68, 3737, 6253, 196, 13, 10267, 6.82667e+06
n500x8192-slot-inner-2048, 63, 3731, 6215, 193, 13, 10215, 6.82667e+06
n500x8192-slot-inner-2048, 64, 3733, 6247, 196, 13, 10253, 6.82667e+06
n500x8192-slot-inner-2048, 65, 3786, 6261, 195, 13, 10320, 6.82667e+06
n500x8192-slot-inner-2048, 64, 3738, 6258, 194, 13, 10267, 6.82667e+06
n500x8192-slot-inner-2048, 63, 3740, 6223, 198, 13, 10237, 6.82667e+06
n500x8192-slot-inner-2048, 65, 3763, 6230, 196, 12, 10266, 6.82667e+06
n500x8192-slot-inner-2048, 67, 3760, 6307, 199, 13, 10346, 6.82667e+06
n500x8192-slot-inner-2048, 63, 3740, 6284, 199, 14, 10300, 6.82667e+06
n500x8192-slot-inner-2048, 65, 3785, 6272, 196, 13, 10331, 6.82667e+06
n500x8192-slot-inner-2048, 67, 3742, 6223, 197, 13, 10242, 6.82667e+06
n500x8192-slot-inner-2048, 64, 3738, 6247, 198, 12, 10259, 6.82667e+06
n500x8192-slot-inner-2048, 70, 3759, 6487, 196, 12, 10524, 6.82667e+06
n500x8192-slot-inner-2048, 63, 3755, 6233, 191, 12, 10254, 6.82667e+06
n500x8192-slot-inner-2048, 63, 3740, 6275, 194, 12, 10284, 6.82667e+06
n500x8192-slot-inner-2048, 63, 3747, 6463, 194, 12, 10479, 6.82667e+06
n500x8192-slot-inner-2048, 63, 3736, 6217, 195, 12, 10223, 6.82667e+06
n500x8192-slot-inner-2048, 65, 3738, 6211, 195, 14, 10223, 6.82667e+06
n500x8192-slot-inner-2048, 63, 3736, 6206, 196, 12, 10213, 6.82667e+06
n500x8192-slot-inner-2048, 69, 3753, 6273, 198, 13, 10306, 6.82667e+06
n500x8192-slot-inner-2048, 64, 3744, 6256, 195, 13, 10272, 6.82667e+06
n500x8192-slot-inner-2048, 66, 3770, 6239, 200, 12, 10287, 6.82667e+06
n500x8192-slot-inner-2048, 63, 3746, 6316, 194, 12, 10331, 6.82667e+06
n500x8192-slot-inner-2048, 66, 3740, 6492, 196, 13, 10507, 6.82667e+06
n500x8192-slot-inner-2048, 64, 3735, 6216, 194, 13, 10222, 6.82667e+06
n500x8192-slot-inner-2048, 65, 3733, 6484, 196, 13, 10491, 6.82667e+06
n500x8192-slot-inner-2048, 63, 3747, 6253, 199, 13, 10275, 6.82667e+06
n500x8192-slot-inner-2048, 64, 3746, 6230, 196, 13, 10249, 6.82667e+06
n500x8192-slot-inner-2048, 64, 3744, 6228, 211, 13, 10260, 6.82667e+06
n500x8192-slot-inner-2048, 64, 3733, 6207, 196, 13, 10213, 6.82667e+06
n500x8192-slot-inner-2048, 63, 3736, 6223, 196, 13, 10231, 6.82667e+06
n500x8192-slot-inner-2048, 64, 3729, 6253, 195, 13, 10254, 6.82667e+06
n500x8192-slot-inner-2048, 64, 3776, 6230, 195, 12, 10277, 6.82667e+06
n500x8192-slot-inner-2048, 64, 3727, 6217, 196, 13, 10217, 6.82667e+06
n500x8192-slot-inner-2048, 66, 3725, 6219, 198, 13, 10221, 6.82667e+06
n500x8192-slot-inner-2048, 68, 3745, 6255, 195, 13, 10276, 6.82667e+06
n500x8192-slot-inner-2048, 64, 3754, 6250, 198, 12, 10278, 6.82667e+06
n500x8192-slot-inner-2048, 63, 3742, 6216, 206, 12, 10239, 6.82667e+06
n500x8192-slot-inner-2048, 63, 3736, 6253, 195, 13, 10260, 6.82667e+06
n500x8192-slot-inner-2048, 66, 3758, 6200, 192, 13, 10229, 6.82667e+06
n500x8192-slot-inner-2048, 63, 3726, 6208, 195, 12, 10204, 6.82667e+06
n500x8192-slot-inner-2048, 63, 3733, 6218, 197, 12, 10223, 6.82667e+06
n500x8192-slot-inner-2048, 64, 3734, 6221, 196, 12, 10227, 6.82667e+06
n500x8192-slot-inner-2048, 64, 3762, 6251, 196, 13, 10286, 6.82667e+06
n1000x8192-slot-inner-2048, 64, 7522, 12510, 392, 9, 20497, 1.36533e+07
n1000x8192-slot-inner-2048, 63, 7492, 12588, 394, 15, 20552, 1.36533e+07
n1000x8192-slot-inner-2048, 67, 7477, 12467, 395, 17, 20423, 1.36533e+07
n1000x8192-slot-inner-2048, 63, 7492, 12522, 401, 10, 20488, 1.36533e+07
n1000x8192-slot-inner-2048, 64, 7510, 12508, 393, 15, 20490, 1.36533e+07
n1000x8192-slot-inner-2048, 68, 7585, 12644, 404, 10, 20711, 1.36533e+07
n1000x8192-slot-inner-2048, 64, 7469, 12591, 399, 10, 20533, 1.36533e+07
n1000x8192-slot-inner-2048, 65, 7520, 12491, 392, 9, 20477, 1.36533e+07
n1000x8192-slot-inner-2048, 67, 7457, 13041, 401, 10, 20976, 1.36533e+07
n1000x8192-slot-inner-2048, 66, 7499, 13055, 404, 10, 21034, 1.36533e+07
n1000x8192-slot-inner-2048, 67, 7550, 12599, 402, 10, 20628, 1.36533e+07
n1000x8192-slot-inner-2048, 64, 7533, 12596, 402, 10, 20605, 1.36533e+07
n1000x8192-slot-inner-2048, 67, 7474, 13038, 412, 10, 21001, 1.36533e+07
n1000x8192-slot-inner-2048, 63, 7487, 12537, 391, 15, 20493, 1.36533e+07
n1000x8192-slot-inner-2048, 64, 7503, 12530, 396, 9, 20502, 1.36533e+07
n1000x8192-slot-inner-2048, 64, 7499, 12588, 402, 10, 20563, 1.36533e+07
n1000x8192-slot-inner-2048, 64, 7484, 12531, 407, 14, 20500, 1.36533e+07
n1000x8192-slot-inner-2048, 64, 7502, 12535, 398, 10, 20509, 1.36533e+07
n1000x8192-slot-inner-2048, 63, 7485, 12551, 410, 10, 20519, 1.36533e+07
n1000x8192-slot-inner-2048, 68, 7508, 12488, 399, 10, 20473, 1.36533e+07
n1000x8192-slot-inner-2048, 63, 7472, 12473, 404, 10, 20422, 1.36533e+07
n1000x8192-slot-inner-2048, 73, 9719, 12550, 398, 10, 22750, 1.36533e+07
n1000x8192-slot-inner-2048, 63, 7503, 12978, 408, 10, 20962, 1.36533e+07
n1000x8192-slot-inner-2048, 71, 7525, 12666, 416, 10, 20688, 1.36533e+07
n1000x8192-slot-inner-2048, 63, 7532, 12630, 410, 17, 20652, 1.36533e+07
n1000x8192-slot-inner-2048, 65, 7507, 12511, 397, 9, 20489, 1.36533e+07
n1000x8192-slot-inner-2048, 64, 7488, 12514, 420, 10, 20496, 1.36533e+07
n1000x8192-slot-inner-2048, 63, 7481, 12495, 395, 10, 20444, 1.36533e+07
n1000x8192-slot-inner-2048, 64, 7535, 12595, 399, 10, 20603, 1.36533e+07
n1000x8192-slot-inner-2048, 64, 7494, 12560, 396, 10, 20524, 1.36533e+07
n1000x8192-slot-inner-2048, 65, 7484, 12500, 398, 10, 20457, 1.36533e+07
n1000x8192-slot-inner-2048, 67, 7518, 12534, 405, 10, 20534, 1.36533e+07
n1000x8192-slot-inner-2048, 68, 7507, 12533, 405, 17, 20530, 1.36533e+07
n1000x8192-slot-inner-2048, 64, 7480, 12507, 404, 10, 20465, 1.36533e+07
n1000x8192-slot-inner-2048, 64, 7468, 12428, 394, 9, 20363, 1.36533e+07
n1000x8192-slot-inner-2048, 65, 7554, 12510, 397, 10, 20536, 1.36533e+07
n1000x8192-slot-inner-2048, 63, 7475, 12437, 401, 10, 20386, 1.36533e+07
n1000x8192-slot-inner-2048, 65, 7492, 12447, 396, 15, 20415, 1.36533e+07
n1000x8192-slot-inner-2048, 63, 7475, 12477, 407, 9, 20431, 1.36533e+07
n1000x8192-slot-inner-2048, 64, 7487, 12442, 396, 9, 20398, 1.36533e+07
n1000x8192-slot-inner-2048, 64, 7487, 12530, 406, 10, 20497, 1.36533e+07
n1000x8192-slot-inner-2048, 66, 7510, 12481, 402, 10, 20469, 1.36533e+07
n1000x8192-slot-inner-2048, 64, 7460, 12493, 401, 10, 20428, 1.36533e+07
n1000x8192-slot-inner-2048, 64, 7478, 12990, 400, 9, 20941, 1.36533e+07
n1000x8192-slot-inner-2048, 63, 7479, 12980, 397, 9, 20928, 1.36533e+07
n1000x8192-slot-inner-2048, 64, 7471, 12964, 399, 9, 20907, 1.36533e+07
n1000x8192-slot-inner-2048, 64, 7478, 12517, 397, 10, 20466, 1.36533e+07
n1000x8192-slot-inner-2048, 65, 7494, 12442, 396, 10, 20407, 1.36533e+07
n1000x8192-slot-inner-2048, 72, 7457, 12960, 395, 16, 20900, 1.36533e+07
n1000x8192-slot-inner-2048, 65, 7487, 12491, 402, 10, 20455, 1.36533e+07
n1000x8192-slot-inner-2048, 65, 7488, 12620, 1564, 14, 21751, 1.36533e+07
n1000x8192-slot-inner-2048, 63, 7464, 12485, 395, 9, 20416, 1.36533e+07
n1000x8192-slot-inner-2048, 64, 7485, 12518, 402, 10, 20479, 1.36533e+07
n1000x8192-slot-inner-2048, 64, 7472, 12449, 400, 9, 20394, 1.36533e+07
n1000x8192-slot-inner-2048, 64, 7480, 12486, 396, 16, 20442, 1.36533e+07
n1000x8192-slot-inner-2048, 63, 7485, 12531, 400, 10, 20489, 1.36533e+07
n1000x8192-slot-inner-2048, 63, 7547, 12538, 403, 10, 20561, 1.36533e+07
n1000x8192-slot-inner-2048, 65, 7497, 12524, 392, 15, 20493, 1.36533e+07
n1000x8192-slot-inner-2048, 63, 7486, 12560, 418, 10, 20537, 1.36533e+07
n1000x8192-slot-inner-2048, 65, 7485, 12416, 395, 15, 20376, 1.36533e+07
n1000x8192-slot-inner-2048, 63, 7468, 12502, 413, 16, 20462, 1.36533e+07
n1000x8192-slot-inner-2048, 65, 7512, 12519, 403, 10, 20509, 1.36533e+07
n1000x8192-slot-inner-2048, 64, 7478, 12440, 397, 9, 20388, 1.36533e+07
n1000x8192-slot-inner-2048, 65, 7477, 12560, 411, 10, 20523, 1.36533e+07
n1000x8192-slot-inner-2048, 65, 7483, 12433, 395, 10, 20386, 1.36533e+07
n1000x8192-slot-inner-2048, 63, 7480, 12519, 401, 10, 20473, 1.36533e+07
n1000x8192-slot-inner-2048, 67, 7487, 12519, 399, 10, 20482, 1.36533e+07
n1000x8192-slot-inner-2048, 64, 7463, 12553, 398, 10, 20488, 1.36533e+07
n1000x8192-slot-inner-2048, 65, 7494, 12466, 403, 9, 20437, 1.36533e+07
n1000x8192-slot-inner-2048, 63, 7463, 12458, 398, 10, 20392, 1.36533e+07
n1000x8192-slot-inner-2048, 66, 7475, 12486, 406, 9, 20442, 1.36533e+07
n1000x8192-slot-inner-2048, 63, 7464, 12510, 391, 16, 20444, 1.36533e+07
n1000x8192-slot-inner-2048, 65, 7508, 12841, 399, 9, 20822, 1.36533e+07
n1000x8192-slot-inner-2048, 66, 7504, 12530, 410, 16, 20526, 1.36533e+07
n1000x8192-slot-inner-2048, 66, 7459, 12413, 396, 10, 20344, 1.36533e+07
n1000x8192-slot-inner-2048, 66, 7474, 12493, 408, 10, 20451, 1.36533e+07
n1000x8192-slot-inner-2048, 63, 7471, 12478, 399, 10, 20421, 1.36533e+07
n1000x8192-slot-inner-2048, 65, 7488, 12509, 409, 10, 20481, 1.36533e+07
n1000x8192-slot-inner-2048, 64, 7494, 12572, 405, 10, 20545, 1.36533e+07
n1000x8192-slot-inner-2048, 65, 7480, 12962, 404, 9, 20920, 1.36533e+07
n1000x8192-slot-inner-2048, 64, 7536, 12511, 394, 16, 20521, 1.36533e+07
n1000x8192-slot-inner-2048, 64, 7500, 12559, 396, 10, 20529, 1.36533e+07
n1000x8192-slot-inner-2048, 67, 7492, 12422, 400, 10, 20391, 1.36533e+07
n1000x8192-slot-inner-2048, 65, 7491, 12551, 390, 18, 20515, 1.36533e+07
n1000x8192-slot-inner-2048, 75, 7491, 13022, 400, 9, 20997, 1.36533e+07
n1000x8192-slot-inner-2048, 70, 7475, 12486, 402, 10, 20443, 1.36533e+07
n1000x8192-slot-inner-2048, 69, 7528, 12623, 405, 10, 20635, 1.36533e+07
n1000x8192-slot-inner-2048, 65, 7505, 12546, 396, 16, 20528, 1.36533e+07
n1000x8192-slot-inner-2048, 71, 7484, 12967, 407, 10, 20939, 1.36533e+07
n1000x8192-slot-inner-2048, 63, 7486, 12493, 391, 16, 20449, 1.36533e+07
n1000x8192-slot-inner-2048, 65, 7504, 12537, 404, 9, 20519, 1.36533e+07
n1000x8192-slot-inner-2048, 68, 7484, 12538, 406, 10, 20506, 1.36533e+07
n1000x8192-slot-inner-2048, 66, 7497, 12522, 402, 9, 20496, 1.36533e+07
n1000x8192-slot-inner-2048, 64, 7507, 12498, 399, 10, 20478, 1.36533e+07
n1000x8192-slot-inner-2048, 64, 7480, 12552, 406, 16, 20518, 1.36533e+07
n1000x8192-slot-inner-2048, 67, 7526, 12592, 398, 10, 20593, 1.36533e+07
n1000x8192-slot-inner-2048, 66, 7513, 12544, 400, 19, 20542, 1.36533e+07
n1000x8192-slot-inner-2048, 65, 7476, 12519, 396, 10, 20466, 1.36533e+07
n1000x8192-slot-inner-2048, 66, 7495, 12505, 407, 17, 20490, 1.36533e+07
n1000x8192-slot-inner-2048, 64, 7483, 12435, 398, 9, 20389, 1.36533e+07
