type, setup, encryption, homomorphic, decryption, plaintext, total, value

n10x8192-slot-inner-4096, 180, 92, 209, 0, 0, 481, 136535
n10x8192-slot-inner-4096, 158, 86, 174, 0, 0, 418, 136535
n10x8192-slot-inner-4096, 136, 86, 172, 0, 0, 394, 136535
n10x8192-slot-inner-4096, 136, 80, 166, 0, 0, 382, 136535
n10x8192-slot-inner-4096, 136, 80, 167, 0, 0, 383, 136535
n10x8192-slot-inner-4096, 133, 81, 167, 0, 0, 381, 136535
n10x8192-slot-inner-4096, 137, 79, 163, 0, 0, 379, 136535
n10x8192-slot-inner-4096, 144, 81, 168, 0, 0, 393, 136535
n10x8192-slot-inner-4096, 142, 85, 173, 0, 0, 400, 136535
n10x8192-slot-inner-4096, 148, 85, 199, 0, 0, 432, 136535
n10x8192-slot-inner-4096, 143, 84, 188, 0, 0, 415, 136535
n10x8192-slot-inner-4096, 149, 84, 164, 0, 0, 397, 136535
n10x8192-slot-inner-4096, 134, 79, 173, 0, 0, 386, 136535
n10x8192-slot-inner-4096, 136, 80, 171, 0, 0, 387, 136535
n10x8192-slot-inner-4096, 142, 80, 174, 0, 0, 396, 136535
n10x8192-slot-inner-4096, 135, 81, 181, 0, 0, 397, 136535
n10x8192-slot-inner-4096, 150, 87, 193, 0, 0, 430, 136535
n10x8192-slot-inner-4096, 156, 89, 192, 0, 0, 437, 136535
n10x8192-slot-inner-4096, 140, 84, 197, 0, 0, 421, 136535
n10x8192-slot-inner-4096, 145, 92, 220, 0, 0, 457, 136535
n10x8192-slot-inner-4096, 160, 96, 196, 0, 0, 452, 136535
n10x8192-slot-inner-4096, 141, 79, 164, 0, 0, 384, 136535
n10x8192-slot-inner-4096, 133, 80, 175, 0, 0, 388, 136535
n10x8192-slot-inner-4096, 137, 82, 171, 0, 0, 390, 136535
n10x8192-slot-inner-4096, 146, 84, 173, 0, 0, 403, 136535
n10x8192-slot-inner-4096, 133, 89, 169, 0, 0, 391, 136535
n10x8192-slot-inner-4096, 133, 79, 167, 0, 0, 379, 136535
n10x8192-slot-inner-4096, 135, 81, 167, 0, 0, 383, 136535
n10x8192-slot-inner-4096, 134, 82, 169, 0, 0, 385, 136535
n10x8192-slot-inner-4096, 136, 81, 169, 0, 0, 386, 136535
n10x8192-slot-inner-4096, 148, 84, 173, 0, 0, 405, 136535
n10x8192-slot-inner-4096, 144, 88, 190, 0, 0, 422, 136535
n10x8192-slot-inner-4096, 136, 84, 193, 0, 0, 413, 136535
n10x8192-slot-inner-4096, 140, 82, 168, 0, 0, 390, 136535
n10x8192-slot-inner-4096, 152, 83, 167, 0, 0, 402, 136535
n10x8192-slot-inner-4096, 141, 83, 169, 0, 0, 393, 136535
n10x8192-slot-inner-4096, 147, 85, 176, 0, 0, 408, 136535
n10x8192-slot-inner-4096, 139, 79, 165, 0, 0, 383, 136535
n10x8192-slot-inner-4096, 135, 80, 174, 0, 0, 389, 136535
n10x8192-slot-inner-4096, 131, 80, 166, 0, 0, 377, 136535
n10x8192-slot-inner-4096, 141, 80, 170, 0, 0, 391, 136535
n10x8192-slot-inner-4096, 138, 81, 171, 0, 0, 390, 136535
n10x8192-slot-inner-4096, 134, 80, 167, 0, 0, 381, 136535
n10x8192-slot-inner-4096, 151, 86, 185, 0, 0, 422, 136535
n10x8192-slot-inner-4096, 134, 78, 169, 0, 0, 381, 136535
n10x8192-slot-inner-4096, 131, 78, 165, 0, 0, 374, 136535
n10x8192-slot-inner-4096, 141, 78, 163, 0, 0, 382, 136535
n10x8192-slot-inner-4096, 145, 84, 179, 0, 0, 408, 136535
n10x8192-slot-inner-4096, 134, 79, 164, 0, 0, 377, 136535
n10x8192-slot-inner-4096, 140, 82, 167, 0, 0, 389, 136535
n10x8192-slot-inner-4096, 136, 81, 178, 0, 0, 395, 136535
n10x8192-slot-inner-4096, 142, 83, 171, 0, 0, 396, 136535
n10x8192-slot-inner-4096, 144, 78, 167, 1, 0, 390, 136535
n10x8192-slot-inner-4096, 139, 85, 207, 0, 0, 431, 136535
n10x8192-slot-inner-4096, 135, 78, 166, 0, 0, 379, 136535
n10x8192-slot-inner-4096, 135, 79, 165, 0, 0, 379, 136535
n10x8192-slot-inner-4096, 138, 82, 173, 0, 0, 393, 136535
n10x8192-slot-inner-4096, 137, 81, 167, 1, 0, 386, 136535
n10x8192-slot-inner-4096, 144, 82, 167, 0, 0, 393, 136535
n10x8192-slot-inner-4096, 134, 82, 191, 0, 0, 407, 136535
n10x8192-slot-inner-4096, 158, 93, 195, 0, 0, 446, 136535
n10x8192-slot-inner-4096, 154, 84, 191, 0, 0, 429, 136535
n10x8192-slot-inner-4096, 155, 94, 224, 0, 0, 473, 136535
n10x8192-slot-inner-4096, 159, 113, 190, 0, 0, 462, 136535
n10x8192-slot-inner-4096, 151, 91, 193, 0, 0, 435, 136535
n10x8192-slot-inner-4096, 175, 89, 195, 0, 0, 459, 136535
n10x8192-slot-inner-4096, 199, 89, 180, 0, 0, 468, 136535
n10x8192-slot-inner-4096, 145, 79, 163, 0, 0, 387, 136535
n10x8192-slot-inner-4096, 136, 81, 175, 0, 0, 392, 136535
n10x8192-slot-inner-4096, 134, 83, 189, 0, 0, 406, 136535
n10x8192-slot-inner-4096, 143, 85, 170, 0, 0, 398, 136535
n10x8192-slot-inner-4096, 144, 81, 178, 0, 0, 403, 136535
n10x8192-slot-inner-4096, 138, 80, 164, 0, 0, 382, 136535
n10x8192-slot-inner-4096, 139, 80, 170, 0, 0, 389, 136535
n10x8192-slot-inner-4096, 131, 78, 172, 0, 0, 381, 136535
n10x8192-slot-inner-4096, 135, 79, 167, 0, 0, 381, 136535
n10x8192-slot-inner-4096, 140, 79, 167, 0, 0, 386, 136535
n10x8192-slot-inner-4096, 132, 78, 173, 0, 0, 383, 136535
n10x8192-slot-inner-4096, 142, 84, 171, 0, 0, 397, 136535
n10x8192-slot-inner-4096, 142, 80, 170, 0, 0, 392, 136535
n10x8192-slot-inner-4096, 135, 80, 181, 0, 0, 396, 136535
n10x8192-slot-inner-4096, 142, 84, 169, 0, 0, 395, 136535
n10x8192-slot-inner-4096, 151, 95, 191, 0, 0, 437, 136535
n10x8192-slot-inner-4096, 142, 93, 168, 0, 0, 403, 136535
n10x8192-slot-inner-4096, 142, 85, 178, 0, 0, 405, 136535
n10x8192-slot-inner-4096, 135, 80, 170, 0, 0, 385, 136535
n10x8192-slot-inner-4096, 133, 86, 182, 0, 0, 401, 136535
n10x8192-slot-inner-4096, 137, 80, 174, 0, 0, 391, 136535
n10x8192-slot-inner-4096, 135, 81, 165, 0, 0, 381, 136535
n10x8192-slot-inner-4096, 134, 83, 171, 0, 0, 388, 136535
n10x8192-slot-inner-4096, 133, 79, 175, 0, 0, 387, 136535
n10x8192-slot-inner-4096, 133, 81, 165, 0, 0, 379, 136535
n10x8192-slot-inner-4096, 144, 85, 174, 0, 0, 403, 136535
n10x8192-slot-inner-4096, 133, 79, 176, 0, 0, 388, 136535
n10x8192-slot-inner-4096, 134, 79, 165, 0, 0, 378, 136535
n10x8192-slot-inner-4096, 139, 89, 191, 0, 0, 419, 136535
n10x8192-slot-inner-4096, 143, 89, 185, 0, 0, 417, 136535
n10x8192-slot-inner-4096, 133, 79, 166, 0, 0, 378, 136535
n10x8192-slot-inner-4096, 152, 85, 167, 0, 0, 404, 136535
n10x8192-slot-inner-4096, 132, 79, 173, 0, 0, 384, 136535
n25x8192-slot-inner-4096, 158, 247, 375, 0, 0, 780, 341335
n25x8192-slot-inner-4096, 142, 205, 373, 0, 0, 720, 341335
n25x8192-slot-inner-4096, 143, 206, 377, 0, 0, 726, 341335
n25x8192-slot-inner-4096, 132, 193, 375, 0, 0, 700, 341335
n25x8192-slot-inner-4096, 147, 221, 383, 0, 0, 751, 341335
n25x8192-slot-inner-4096, 135, 201, 380, 0, 0, 716, 341335
n25x8192-slot-inner-4096, 143, 198, 376, 0, 0, 717, 341335
n25x8192-slot-inner-4096, 132, 196, 374, 0, 0, 702, 341335
n25x8192-slot-inner-4096, 137, 198, 373, 0, 0, 708, 341335
n25x8192-slot-inner-4096, 137, 203, 372, 0, 0, 712, 341335
n25x8192-slot-inner-4096, 146, 205, 378, 0, 0, 729, 341335
n25x8192-slot-inner-4096, 144, 211, 410, 0, 0, 765, 341335
n25x8192-slot-inner-4096, 133, 198, 366, 0, 0, 697, 341335
n25x8192-slot-inner-4096, 134, 198, 371, 0, 0, 703, 341335
n25x8192-slot-inner-4096, 139, 204, 369, 0, 0, 712, 341335
n25x8192-slot-inner-4096, 143, 196, 364, 0, 0, 703, 341335
n25x8192-slot-inner-4096, 135, 200, 371, 0, 0, 706, 341335
n25x8192-slot-inner-4096, 136, 202, 389, 0, 0, 727, 341335
n25x8192-slot-inner-4096, 132, 197, 364, 0, 0, 693, 341335
n25x8192-slot-inner-4096, 149, 220, 420, 0, 0, 789, 341335
n25x8192-slot-inner-4096, 140, 205, 372, 0, 0, 717, 341335
n25x8192-slot-inner-4096, 142, 204, 377, 0, 0, 723, 341335
n25x8192-slot-inner-4096, 143, 202, 379, 0, 0, 724, 341335
n25x8192-slot-inner-4096, 144, 205, 370, 0, 0, 719, 341335
n25x8192-slot-inner-4096, 135, 194, 361, 0, 0, 690, 341335
n25x8192-slot-inner-4096, 135, 202, 392, 0, 0, 729, 341335
n25x8192-slot-inner-4096, 136, 207, 368, 0, 0, 711, 341335
n25x8192-slot-inner-4096, 134, 197, 369, 0, 0, 700, 341335
n25x8192-slot-inner-4096, 139, 197, 369, 0, 0, 705, 341335
n25x8192-slot-inner-4096, 142, 207, 372, 0, 0, 721, 341335
n25x8192-slot-inner-4096, 142, 207, 408, 0, 0, 757, 341335
n25x8192-slot-inner-4096, 136, 200, 370, 0, 0, 706, 341335
n25x8192-slot-inner-4096, 144, 211, 377, 0, 0, 732, 341335
n25x8192-slot-inner-4096, 135, 208, 397, 0, 0, 740, 341335
n25x8192-slot-inner-4096, 136, 196, 370, 0, 0, 702, 341335
n25x8192-slot-inner-4096, 137, 195, 367, 0, 0, 699, 341335
n25x8192-slot-inner-4096, 136, 198, 372, 0, 0, 706, 341335
n25x8192-slot-inner-4096, 133, 193, 364, 0, 0, 690, 341335
n25x8192-slot-inner-4096, 135, 195, 371, 0, 0, 701, 341335
n25x8192-slot-inner-4096, 138, 198, 368, 0, 0, 704, 341335
n25x8192-slot-inner-4096, 134, 193, 390, 0, 0, 717, 341335
n25x8192-slot-inner-4096, 138, 203, 374, 0, 0, 715, 341335
n25x8192-slot-inner-4096, 131, 193, 358, 0, 0, 682, 341335
n25x8192-slot-inner-4096, 131, 194, 359, 0, 0, 684, 341335
n25x8192-slot-inner-4096, 131, 194, 366, 0, 0, 691, 341335
n25x8192-slot-inner-4096, 134, 198, 367, 0, 0, 699, 341335
n25x8192-slot-inner-4096, 138, 200, 374, 0, 0, 712, 341335
n25x8192-slot-inner-4096, 140, 207, 374, 0, 0, 721, 341335
n25x8192-slot-inner-4096, 132, 198, 408, 0, 0, 738, 341335
n25x8192-slot-inner-4096, 137, 197, 370, 0, 0, 704, 341335
n25x8192-slot-inner-4096, 142, 206, 377, 0, 0, 725, 341335
n25x8192-slot-inner-4096, 144, 208, 374, 0, 0, 726, 341335
n25x8192-slot-inner-4096, 135, 194, 376, 0, 0, 705, 341335
n25x8192-slot-inner-4096, 152, 226, 385, 0, 0, 763, 341335
n25x8192-slot-inner-4096, 131, 194, 366, 0, 0, 691, 341335
n25x8192-slot-inner-4096, 131, 198, 364, 0, 0, 693, 341335
n25x8192-slot-inner-4096, 137, 202, 370, 0, 0, 709, 341335
n25x8192-slot-inner-4096, 134, 200, 364, 0, 0, 698, 341335
n25x8192-slot-inner-4096, 145, 212, 373, 0, 0, 730, 341335
n25x8192-slot-inner-4096, 132, 202, 380, 0, 0, 714, 341335
n25x8192-slot-inner-4096, 135, 203, 362, 0, 0, 700, 341335
n25x8192-slot-inner-4096, 132, 195, 362, 0, 0, 689, 341335
n25x8192-slot-inner-4096, 137, 193, 363, 0, 0, 693, 341335
n25x8192-slot-inner-4096, 137, 197, 366, 0, 0, 700, 341335
n25x8192-slot-inner-4096, 135, 198, 363, 0, 0, 696, 341335
n25x8192-slot-inner-4096, 141, 209, 414, 0, 0, 764, 341335
n25x8192-slot-inner-4096, 150, 198, 373, 0, 0, 721, 341335
n25x8192-slot-inner-4096, 140, 201, 373, 0, 0, 714, 341335
n25x8192-slot-inner-4096, 137, 199, 370, 0, 0, 706, 341335
n25x8192-slot-inner-4096, 143, 207, 378, 0, 0, 728, 341335
n25x8192-slot-inner-4096, 133, 198, 368, 0, 0, 699, 341335
n25x8192-slot-inner-4096, 138, 211, 397, 0, 0, 746, 341335
n25x8192-slot-inner-4096, 137, 197, 370, 0, 0, 704, 341335
n25x8192-slot-inner-4096, 145, 210, 384, 0, 0, 739, 341335
n25x8192-slot-inner-4096, 134, 198, 377, 0, 0, 709, 341335
n25x8192-slot-inner-4096, 146, 214, 387, 0, 0, 747, 341335
n25x8192-slot-inner-4096, 135, 198, 369, 0, 0, 702, 341335
n25x8192-slot-inner-4096, 143, 209, 377, 0, 0, 729, 341335
n25x8192-slot-inner-4096, 138, 214, 412, 0, 0, 764, 341335
n25x8192-slot-inner-4096, 133, 194, 376, 0, 0, 703, 341335
n25x8192-slot-inner-4096, 135, 199, 375, 0, 0, 709, 341335
n25x8192-slot-inner-4096, 145, 198, 363, 0, 0, 706, 341335
n25x8192-slot-inner-4096, 146, 209, 372, 0, 0, 727, 341335
n25x8192-slot-inner-4096, 137, 196, 370, 0, 0, 703, 341335
n25x8192-slot-inner-4096, 139, 206, 406, 0, 0, 751, 341335
n25x8192-slot-inner-4096, 144, 211, 378, 0, 0, 733, 341335
n25x8192-slot-inner-4096, 132, 198, 373, 0, 0, 703, 341335
n25x8192-slot-inner-4096, 135, 197, 373, 0, 0, 705, 341335
n25x8192-slot-inner-4096, 133, 195, 361, 0, 0, 689, 341335
n25x8192-slot-inner-4096, 136, 204, 366, 0, 0, 706, 341335
n25x8192-slot-inner-4096, 138, 198, 369, 0, 0, 705, 341335
n25x8192-slot-inner-4096, 134, 199, 374, 0, 0, 707, 341335
n25x8192-slot-inner-4096, 139, 194, 362, 0, 0, 695, 341335
n25x8192-slot-inner-4096, 136, 194, 381, 0, 0, 711, 341335
n25x8192-slot-inner-4096, 135, 200, 380, 0, 0, 715, 341335
n25x8192-slot-inner-4096, 135, 194, 364, 0, 0, 693, 341335
n25x8192-slot-inner-4096, 133, 196, 362, 0, 0, 691, 341335
n25x8192-slot-inner-4096, 138, 204, 412, 0, 0, 754, 341335
n25x8192-slot-inner-4096, 148, 210, 379, 0, 0, 737, 341335
n25x8192-slot-inner-4096, 135, 195, 362, 0, 0, 692, 341335
