type, setup, encryption, homomorphic, decryption, plaintext, total, value

n10x8192-coef-sum-512, 25, 140, 5, 0, 0, 170, 81921
n10x8192-coef-sum-512, 10, 140, 6, 0, 0, 156, 81921
n10x8192-coef-sum-512, 9, 149, 5, 0, 0, 163, 81921
n10x8192-coef-sum-512, 9, 144, 6, 0, 0, 159, 81921
n10x8192-coef-sum-512, 9, 142, 5, 0, 0, 156, 81921
n10x8192-coef-sum-512, 10, 140, 5, 0, 0, 155, 81921
n10x8192-coef-sum-512, 9, 144, 5, 0, 0, 158, 81921
n10x8192-coef-sum-512, 9, 205, 5, 0, 0, 219, 81921
n10x8192-coef-sum-512, 148, 195, 5, 0, 0, 348, 81921
n10x8192-coef-sum-512, 9, 138, 5, 0, 0, 152, 81921
n10x8192-coef-sum-512, 9, 140, 5, 0, 0, 154, 81921
n10x8192-coef-sum-512, 9, 136, 5, 0, 0, 150, 81921
n10x8192-coef-sum-512, 9, 137, 5, 0, 0, 151, 81921
n10x8192-coef-sum-512, 9, 137, 5, 0, 0, 151, 81921
n10x8192-coef-sum-512, 9, 137, 4, 0, 0, 150, 81921
n10x8192-coef-sum-512, 9, 138, 5, 0, 0, 152, 81921
n10x8192-coef-sum-512, 9, 137, 5, 0, 0, 151, 81921
n10x8192-coef-sum-512, 9, 136, 5, 0, 0, 150, 81921
n10x8192-coef-sum-512, 9, 137, 5, 0, 0, 151, 81921
n10x8192-coef-sum-512, 9, 141, 5, 0, 0, 155, 81921
n10x8192-coef-sum-512, 9, 138, 5, 0, 0, 152, 81921
n10x8192-coef-sum-512, 9, 138, 5, 0, 0, 152, 81921
n10x8192-coef-sum-512, 9, 139, 5, 0, 0, 153, 81921
n10x8192-coef-sum-512, 9, 137, 5, 0, 0, 151, 81921
n10x8192-coef-sum-512, 9, 138, 5, 0, 0, 152, 81921
n10x8192-coef-sum-512, 9, 138, 5, 0, 0, 152, 81921
n10x8192-coef-sum-512, 9, 141, 5, 0, 0, 155, 81921
n10x8192-coef-sum-512, 9, 138, 5, 0, 0, 152, 81921
n10x8192-coef-sum-512, 9, 137, 5, 0, 0, 151, 81921
n10x8192-coef-sum-512, 9, 136, 5, 0, 0, 150, 81921
n10x8192-coef-sum-512, 9, 139, 5, 0, 0, 153, 81921
n10x8192-coef-sum-512, 9, 136, 5, 0, 0, 150, 81921
n10x8192-coef-sum-512, 9, 137, 5, 0, 0, 151, 81921
n10x8192-coef-sum-512, 9, 140, 5, 0, 0, 154, 81921
n10x8192-coef-sum-512, 9, 139, 5, 0, 0, 153, 81921
n10x8192-coef-sum-512, 9, 137, 5, 0, 0, 151, 81921
n10x8192-coef-sum-512, 9, 136, 5, 0, 0, 150, 81921
n10x8192-coef-sum-512, 9, 138, 5, 0, 0, 152, 81921
n10x8192-coef-sum-512, 9, 137, 5, 0, 0, 151, 81921
n10x8192-coef-sum-512, 9, 138, 5, 0, 0, 152, 81921
n10x8192-coef-sum-512, 9, 138, 5, 0, 0, 152, 81921
n10x8192-coef-sum-512, 9, 139, 5, 0, 0, 153, 81921
n10x8192-coef-sum-512, 9, 138, 5, 0, 0, 152, 81921
n10x8192-coef-sum-512, 9, 136, 5, 0, 0, 150, 81921
n10x8192-coef-sum-512, 9, 140, 5, 0, 0, 154, 81921
n10x8192-coef-sum-512, 9, 137, 5, 0, 0, 151, 81921
n10x8192-coef-sum-512, 9, 137, 5, 0, 0, 151, 81921
n10x8192-coef-sum-512, 9, 136, 5, 0, 0, 150, 81921
n10x8192-coef-sum-512, 9, 139, 5, 0, 0, 153, 81921
n10x8192-coef-sum-512, 9, 137, 5, 0, 0, 151, 81921
n10x8192-coef-sum-512, 9, 139, 5, 0, 0, 153, 81921
n10x8192-coef-sum-512, 9, 138, 5, 0, 0, 152, 81921
n10x8192-coef-sum-512, 10, 138, 5, 0, 0, 153, 81921
n10x8192-coef-sum-512, 9, 139, 5, 0, 0, 153, 81921
n10x8192-coef-sum-512, 9, 136, 5, 0, 0, 150, 81921
n10x8192-coef-sum-512, 9, 138, 5, 0, 0, 152, 81921
n10x8192-coef-sum-512, 9, 137, 5, 0, 0, 151, 81921
n10x8192-coef-sum-512, 9, 137, 5, 0, 0, 151, 81921
n10x8192-coef-sum-512, 9, 136, 5, 0, 0, 150, 81921
n10x8192-coef-sum-512, 9, 140, 5, 0, 0, 154, 81921
n10x8192-coef-sum-512, 9, 137, 5, 0, 0, 151, 81921
n10x8192-coef-sum-512, 9, 139, 5, 0, 0, 153, 81921
n10x8192-coef-sum-512, 10, 138, 5, 0, 0, 153, 81921
n10x8192-coef-sum-512, 9, 137, 5, 0, 0, 151, 81921
n10x8192-coef-sum-512, 9, 137, 5, 0, 0, 151, 81921
n10x8192-coef-sum-512, 9, 137, 5, 0, 0, 151, 81921
n10x8192-coef-sum-512, 9, 139, 5, 0, 0, 153, 81921
n10x8192-coef-sum-512, 9, 138, 5, 0, 0, 152, 81921
n10x8192-coef-sum-512, 9, 138, 5, 0, 0, 152, 81921
n10x8192-coef-sum-512, 9, 138, 5, 0, 0, 152, 81921
n10x8192-coef-sum-512, 10, 155, 6, 0, 0, 171, 81921
n10x8192-coef-sum-512, 9, 140, 5, 0, 0, 154, 81921
n10x8192-coef-sum-512, 9, 137, 5, 0, 0, 151, 81921
n10x8192-coef-sum-512, 9, 141, 5, 0, 0, 155, 81921
n10x8192-coef-sum-512, 9, 138, 5, 0, 0, 152, 81921
n10x8192-coef-sum-512, 9, 137, 6, 0, 0, 152, 81921
n10x8192-coef-sum-512, 9, 138, 5, 0, 0, 152, 81921
n10x8192-coef-sum-512, 9, 140, 5, 0, 0, 154, 81921
n10x8192-coef-sum-512, 9, 137, 5, 0, 0, 151, 81921
n10x8192-coef-sum-512, 9, 137, 5, 0, 0, 151, 81921
n10x8192-coef-sum-512, 9, 137, 5, 0, 0, 151, 81921
n10x8192-coef-sum-512, 9, 141, 5, 0, 0, 155, 81921
n10x8192-coef-sum-512, 9, 137, 5, 0, 0, 151, 81921
n10x8192-coef-sum-512, 9, 138, 5, 0, 0, 152, 81921
n10x8192-coef-sum-512, 9, 140, 5, 0, 0, 154, 81921
n10x8192-coef-sum-512, 9, 138, 5, 0, 0, 152, 81921
n10x8192-coef-sum-512, 9, 137, 5, 0, 0, 151, 81921
n10x8192-coef-sum-512, 9, 139, 5, 0, 0, 153, 81921
n10x8192-coef-sum-512, 9, 140, 6, 0, 0, 155, 81921
n10x8192-coef-sum-512, 9, 138, 5, 0, 0, 152, 81921
n10x8192-coef-sum-512, 9, 137, 5, 0, 0, 151, 81921
n10x8192-coef-sum-512, 9, 137, 5, 0, 0, 151, 81921
n10x8192-coef-sum-512, 9, 137, 5, 0, 0, 151, 81921
n10x8192-coef-sum-512, 9, 137, 5, 0, 0, 151, 81921
n10x8192-coef-sum-512, 9, 137, 5, 0, 0, 151, 81921
n10x8192-coef-sum-512, 9, 139, 5, 0, 0, 153, 81921
n10x8192-coef-sum-512, 9, 138, 5, 0, 0, 152, 81921
n10x8192-coef-sum-512, 9, 138, 5, 0, 0, 152, 81921
n10x8192-coef-sum-512, 9, 136, 5, 0, 0, 150, 81921
n10x8192-coef-sum-512, 9, 140, 5, 0, 0, 154, 81921
n10x8192-coef-sum-1024, 20, 133, 4, 0, 0, 157, 81921
n10x8192-coef-sum-1024, 12, 133, 4, 0, 0, 149, 81921
n10x8192-coef-sum-1024, 13, 133, 6, 0, 0, 152, 81921
n10x8192-coef-sum-1024, 19, 132, 4, 0, 0, 155, 81921
n10x8192-coef-sum-1024, 13, 133, 4, 0, 0, 150, 81921
n10x8192-coef-sum-1024, 13, 133, 4, 0, 0, 150, 81921
n10x8192-coef-sum-1024, 13, 135, 4, 0, 0, 152, 81921
n10x8192-coef-sum-1024, 13, 133, 4, 0, 0, 150, 81921
n10x8192-coef-sum-1024, 12, 133, 4, 0, 0, 149, 81921
n10x8192-coef-sum-1024, 13, 133, 4, 0, 0, 150, 81921
n10x8192-coef-sum-1024, 13, 135, 4, 0, 0, 152, 81921
n10x8192-coef-sum-1024, 13, 133, 4, 0, 0, 150, 81921
n10x8192-coef-sum-1024, 13, 133, 4, 0, 0, 150, 81921
n10x8192-coef-sum-1024, 13, 132, 4, 0, 0, 149, 81921
n10x8192-coef-sum-1024, 12, 133, 4, 0, 0, 149, 81921
n10x8192-coef-sum-1024, 12, 133, 4, 0, 0, 149, 81921
n10x8192-coef-sum-1024, 13, 132, 4, 0, 0, 149, 81921
n10x8192-coef-sum-1024, 13, 135, 4, 0, 0, 152, 81921
n10x8192-coef-sum-1024, 13, 133, 4, 0, 0, 150, 81921
n10x8192-coef-sum-1024, 13, 133, 4, 0, 0, 150, 81921
n10x8192-coef-sum-1024, 13, 133, 4, 0, 0, 150, 81921
n10x8192-coef-sum-1024, 13, 135, 4, 0, 0, 152, 81921
n10x8192-coef-sum-1024, 13, 134, 4, 0, 0, 151, 81921
n10x8192-coef-sum-1024, 12, 134, 4, 0, 0, 150, 81921
n10x8192-coef-sum-1024, 13, 133, 4, 0, 0, 150, 81921
n10x8192-coef-sum-1024, 14, 133, 4, 0, 0, 151, 81921
n10x8192-coef-sum-1024, 12, 134, 4, 0, 0, 150, 81921
n10x8192-coef-sum-1024, 13, 134, 4, 0, 0, 151, 81921
n10x8192-coef-sum-1024, 13, 135, 4, 0, 0, 152, 81921
n10x8192-coef-sum-1024, 13, 133, 4, 0, 0, 150, 81921
n10x8192-coef-sum-1024, 16, 134, 4, 0, 0, 154, 81921
n10x8192-coef-sum-1024, 13, 132, 4, 0, 0, 149, 81921
n10x8192-coef-sum-1024, 19, 135, 4, 0, 0, 158, 81921
n10x8192-coef-sum-1024, 13, 133, 4, 0, 0, 150, 81921
n10x8192-coef-sum-1024, 21, 132, 4, 0, 0, 157, 81921
n10x8192-coef-sum-1024, 13, 132, 4, 0, 0, 149, 81921
n10x8192-coef-sum-1024, 12, 133, 4, 0, 0, 149, 81921
n10x8192-coef-sum-1024, 13, 134, 4, 0, 0, 151, 81921
n10x8192-coef-sum-1024, 13, 133, 4, 0, 0, 150, 81921
n10x8192-coef-sum-1024, 13, 134, 4, 0, 0, 151, 81921
n10x8192-coef-sum-1024, 12, 134, 4, 0, 0, 150, 81921
n10x8192-coef-sum-1024, 13, 134, 4, 0, 0, 151, 81921
n10x8192-coef-sum-1024, 13, 133, 4, 0, 0, 150, 81921
n10x8192-coef-sum-1024, 15, 135, 4, 0, 0, 154, 81921
n10x8192-coef-sum-1024, 12, 132, 4, 0, 0, 148, 81921
n10x8192-coef-sum-1024, 13, 133, 4, 0, 0, 150, 81921
n10x8192-coef-sum-1024, 13, 134, 4, 0, 0, 151, 81921
n10x8192-coef-sum-1024, 12, 133, 4, 0, 0, 149, 81921
n10x8192-coef-sum-1024, 12, 133, 4, 0, 0, 149, 81921
n10x8192-coef-sum-1024, 13, 133, 4, 0, 0, 150, 81921
n10x8192-coef-sum-1024, 13, 135, 4, 0, 0, 152, 81921
n10x8192-coef-sum-1024, 14, 133, 4, 0, 0, 151, 81921
n10x8192-coef-sum-1024, 13, 132, 4, 0, 0, 149, 81921
n10x8192-coef-sum-1024, 12, 133, 4, 0, 0, 149, 81921
n10x8192-coef-sum-1024, 13, 135, 4, 0, 0, 152, 81921
n10x8192-coef-sum-1024, 13, 133, 4, 0, 0, 150, 81921
n10x8192-coef-sum-1024, 13, 133, 4, 0, 0, 150, 81921
n10x8192-coef-sum-1024, 13, 132, 4, 0, 0, 149, 81921
n10x8192-coef-sum-1024, 14, 133, 4, 0, 0, 151, 81921
n10x8192-coef-sum-1024, 16, 132, 4, 0, 0, 152, 81921
n10x8192-coef-sum-1024, 13, 133, 4, 0, 0, 150, 81921
n10x8192-coef-sum-1024, 12, 136, 4, 0, 0, 152, 81921
n10x8192-coef-sum-1024, 12, 133, 4, 0, 0, 149, 81921
n10x8192-coef-sum-1024, 12, 133, 4, 0, 0, 149, 81921
n10x8192-coef-sum-1024, 12, 133, 4, 0, 0, 149, 81921
n10x8192-coef-sum-1024, 12, 136, 4, 0, 0, 152, 81921
n10x8192-coef-sum-1024, 13, 134, 4, 0, 0, 151, 81921
n10x8192-coef-sum-1024, 13, 135, 4, 0, 0, 152, 81921
n10x8192-coef-sum-1024, 12, 134, 4, 0, 0, 150, 81921
n10x8192-coef-sum-1024, 13, 136, 4, 0, 0, 153, 81921
n10x8192-coef-sum-1024, 13, 132, 4, 0, 0, 149, 81921
n10x8192-coef-sum-1024, 13, 135, 4, 0, 0, 152, 81921
n10x8192-coef-sum-1024, 13, 137, 4, 0, 0, 154, 81921
n10x8192-coef-sum-1024, 12, 133, 4, 0, 0, 149, 81921
n10x8192-coef-sum-1024, 13, 133, 4, 0, 0, 150, 81921
n10x8192-coef-sum-1024, 13, 132, 4, 0, 0, 149, 81921
n10x8192-coef-sum-1024, 13, 135, 4, 0, 0, 152, 81921
n10x8192-coef-sum-1024, 13, 133, 4, 0, 0, 150, 81921
n10x8192-coef-sum-1024, 13, 134, 4, 0, 0, 151, 81921
n10x8192-coef-sum-1024, 12, 133, 4, 0, 0, 149, 81921
n10x8192-coef-sum-1024, 13, 135, 4, 0, 0, 152, 81921
n10x8192-coef-sum-1024, 12, 133, 4, 0, 0, 149, 81921
n10x8192-coef-sum-1024, 13, 132, 4, 0, 0, 149, 81921
n10x8192-coef-sum-1024, 12, 135, 4, 0, 0, 151, 81921
n10x8192-coef-sum-1024, 13, 133, 4, 0, 0, 150, 81921
n10x8192-coef-sum-1024, 13, 133, 4, 0, 0, 150, 81921
n10x8192-coef-sum-1024, 13, 134, 4, 0, 0, 151, 81921
n10x8192-coef-sum-1024, 13, 137, 4, 0, 0, 154, 81921
n10x8192-coef-sum-1024, 13, 132, 4, 0, 0, 149, 81921
n10x8192-coef-sum-1024, 19, 131, 4, 0, 0, 154, 81921
n10x8192-coef-sum-1024, 13, 133, 4, 0, 0, 150, 81921
n10x8192-coef-sum-1024, 12, 134, 4, 0, 0, 150, 81921
n10x8192-coef-sum-1024, 18, 133, 4, 0, 0, 155, 81921
n10x8192-coef-sum-1024, 14, 132, 4, 0, 0, 150, 81921
n10x8192-coef-sum-1024, 12, 135, 4, 0, 0, 151, 81921
n10x8192-coef-sum-1024, 13, 134, 4, 0, 0, 151, 81921
n10x8192-coef-sum-1024, 12, 133, 4, 0, 0, 149, 81921
n10x8192-coef-sum-1024, 18, 133, 4, 0, 0, 155, 81921
n10x8192-coef-sum-1024, 13, 136, 4, 0, 0, 153, 81921
n10x8192-coef-sum-1024, 14, 132, 4, 0, 0, 150, 81921
n10x8192-coef-sum-2048, 18, 133, 4, 0, 0, 155, 81921
n10x8192-coef-sum-2048, 17, 132, 3, 0, 0, 152, 81921
n10x8192-coef-sum-2048, 20, 134, 4, 0, 0, 158, 81921
n10x8192-coef-sum-2048, 18, 133, 3, 0, 0, 154, 81921
n10x8192-coef-sum-2048, 17, 133, 3, 0, 0, 153, 81921
n10x8192-coef-sum-2048, 17, 134, 3, 0, 0, 154, 81921
n10x8192-coef-sum-2048, 18, 132, 3, 0, 0, 153, 81921
n10x8192-coef-sum-2048, 18, 134, 3, 0, 0, 155, 81921
n10x8192-coef-sum-2048, 22, 133, 3, 0, 0, 158, 81921
n10x8192-coef-sum-2048, 18, 133, 3, 0, 0, 154, 81921
n10x8192-coef-sum-2048, 17, 134, 3, 0, 0, 154, 81921
n10x8192-coef-sum-2048, 18, 133, 3, 0, 0, 154, 81921
n10x8192-coef-sum-2048, 17, 134, 3, 0, 0, 154, 81921
n10x8192-coef-sum-2048, 17, 132, 3, 0, 0, 152, 81921
n10x8192-coef-sum-2048, 18, 133, 3, 0, 0, 154, 81921
n10x8192-coef-sum-2048, 18, 134, 3, 0, 0, 155, 81921
n10x8192-coef-sum-2048, 18, 136, 3, 0, 0, 157, 81921
n10x8192-coef-sum-2048, 18, 133, 4, 0, 0, 155, 81921
n10x8192-coef-sum-2048, 18, 133, 4, 0, 0, 155, 81921
n10x8192-coef-sum-2048, 17, 132, 3, 0, 0, 152, 81921
n10x8192-coef-sum-2048, 17, 132, 3, 0, 0, 152, 81921
n10x8192-coef-sum-2048, 17, 132, 4, 0, 0, 153, 81921
n10x8192-coef-sum-2048, 18, 134, 3, 0, 0, 155, 81921
n10x8192-coef-sum-2048, 17, 136, 3, 0, 0, 156, 81921
n10x8192-coef-sum-2048, 17, 132, 3, 0, 0, 152, 81921
n10x8192-coef-sum-2048, 18, 132, 3, 0, 0, 153, 81921
n10x8192-coef-sum-2048, 17, 134, 3, 0, 0, 154, 81921
n10x8192-coef-sum-2048, 18, 135, 4, 0, 0, 157, 81921
n10x8192-coef-sum-2048, 18, 134, 4, 0, 0, 156, 81921
n10x8192-coef-sum-2048, 17, 133, 3, 0, 0, 153, 81921
n10x8192-coef-sum-2048, 17, 134, 3, 0, 0, 154, 81921
n10x8192-coef-sum-2048, 18, 136, 3, 0, 0, 157, 81921
n10x8192-coef-sum-2048, 18, 134, 3, 0, 0, 155, 81921
n10x8192-coef-sum-2048, 17, 133, 3, 0, 0, 153, 81921
n10x8192-coef-sum-2048, 17, 135, 3, 0, 0, 155, 81921
n10x8192-coef-sum-2048, 17, 132, 3, 0, 0, 152, 81921
n10x8192-coef-sum-2048, 17, 132, 3, 0, 0, 152, 81921
n10x8192-coef-sum-2048, 17, 133, 3, 0, 0, 153, 81921
n10x8192-coef-sum-2048, 17, 134, 3, 0, 0, 154, 81921
n10x8192-coef-sum-2048, 18, 132, 3, 0, 0, 153, 81921
n10x8192-coef-sum-2048, 19, 134, 3, 0, 0, 156, 81921
n10x8192-coef-sum-2048, 17, 133, 3, 0, 0, 153, 81921
n10x8192-coef-sum-2048, 17, 133, 4, 0, 0, 154, 81921
n10x8192-coef-sum-2048, 18, 134, 3, 0, 0, 155, 81921
n10x8192-coef-sum-2048, 17, 134, 3, 0, 0, 154, 81921
n10x8192-coef-sum-2048, 17, 134, 3, 0, 0, 154, 81921
n10x8192-coef-sum-2048, 18, 133, 3, 0, 0, 154, 81921
n10x8192-coef-sum-2048, 18, 134, 3, 0, 0, 155, 81921
n10x8192-coef-sum-2048, 17, 135, 3, 0, 0, 155, 81921
n10x8192-coef-sum-2048, 18, 132, 3, 0, 0, 153, 81921
n10x8192-coef-sum-2048, 18, 134, 3, 0, 0, 155, 81921
n10x8192-coef-sum-2048, 17, 134, 3, 0, 0, 154, 81921
n10x8192-coef-sum-2048, 17, 135, 3, 0, 0, 155, 81921
n10x8192-coef-sum-2048, 21, 133, 4, 0, 0, 158, 81921
n10x8192-coef-sum-2048, 18, 133, 3, 0, 0, 154, 81921
n10x8192-coef-sum-2048, 18, 135, 3, 0, 0, 156, 81921
n10x8192-coef-sum-2048, 22, 133, 3, 0, 0, 158, 81921
n10x8192-coef-sum-2048, 17, 133, 4, 0, 0, 154, 81921
n10x8192-coef-sum-2048, 17, 133, 3, 0, 0, 153, 81921
n10x8192-coef-sum-2048, 17, 134, 3, 0, 0, 154, 81921
n10x8192-coef-sum-2048, 17, 132, 3, 0, 0, 152, 81921
n10x8192-coef-sum-2048, 18, 133, 3, 0, 0, 154, 81921
n10x8192-coef-sum-2048, 17, 134, 3, 0, 0, 154, 81921
n10x8192-coef-sum-2048, 18, 133, 3, 0, 0, 154, 81921
n10x8192-coef-sum-2048, 18, 134, 3, 0, 0, 155, 81921
n10x8192-coef-sum-2048, 17, 133, 3, 0, 0, 153, 81921
n10x8192-coef-sum-2048, 17, 135, 3, 0, 0, 155, 81921
n10x8192-coef-sum-2048, 17, 132, 3, 0, 0, 152, 81921
n10x8192-coef-sum-2048, 17, 132, 3, 0, 0, 152, 81921
n10x8192-coef-sum-2048, 18, 132, 3, 0, 0, 153, 81921
n10x8192-coef-sum-2048, 23, 135, 3, 0, 0, 161, 81921
n10x8192-coef-sum-2048, 18, 133, 4, 0, 0, 155, 81921
n10x8192-coef-sum-2048, 18, 132, 4, 0, 0, 154, 81921
n10x8192-coef-sum-2048, 19, 134, 3, 0, 0, 156, 81921
n10x8192-coef-sum-2048, 17, 134, 3, 0, 0, 154, 81921
n10x8192-coef-sum-2048, 18, 133, 3, 0, 0, 154, 81921
n10x8192-coef-sum-2048, 17, 132, 3, 0, 0, 152, 81921
n10x8192-coef-sum-2048, 17, 135, 3, 0, 0, 155, 81921
n10x8192-coef-sum-2048, 17, 133, 3, 0, 0, 153, 81921
n10x8192-coef-sum-2048, 17, 132, 3, 0, 0, 152, 81921
n10x8192-coef-sum-2048, 17, 132, 3, 0, 0, 152, 81921
n10x8192-coef-sum-2048, 18, 133, 3, 0, 0, 154, 81921
n10x8192-coef-sum-2048, 18, 132, 3, 0, 0, 153, 81921
n10x8192-coef-sum-2048, 17, 133, 3, 0, 0, 153, 81921
n10x8192-coef-sum-2048, 18, 134, 3, 0, 0, 155, 81921
n10x8192-coef-sum-2048, 18, 133, 4, 0, 0, 155, 81921
n10x8192-coef-sum-2048, 17, 133, 3, 0, 0, 153, 81921
n10x8192-coef-sum-2048, 18, 133, 3, 0, 0, 154, 81921
n10x8192-coef-sum-2048, 18, 136, 4, 0, 0, 158, 81921
n10x8192-coef-sum-2048, 18, 133, 3, 0, 0, 154, 81921
n10x8192-coef-sum-2048, 17, 134, 4, 0, 0, 155, 81921
n10x8192-coef-sum-2048, 22, 134, 3, 0, 0, 159, 81921
n10x8192-coef-sum-2048, 26, 134, 3, 0, 0, 163, 81921
n10x8192-coef-sum-2048, 17, 132, 3, 0, 0, 152, 81921
n10x8192-coef-sum-2048, 17, 150, 3, 0, 0, 170, 81921
n10x8192-coef-sum-2048, 18, 133, 3, 0, 0, 154, 81921
n10x8192-coef-sum-2048, 17, 133, 3, 0, 0, 153, 81921
n10x8192-coef-sum-2048, 17, 132, 3, 0, 0, 152, 81921
n10x8192-coef-sum-2048, 17, 135, 3, 0, 0, 155, 81921
n10x8192-coef-sum-2048, 18, 133, 3, 0, 0, 154, 81921
n10x8192-coef-sum-4096, 35, 135, 3, 0, 0, 173, 81921
n10x8192-coef-sum-4096, 33, 134, 3, 0, 0, 170, 81921
n10x8192-coef-sum-4096, 35, 136, 3, 0, 0, 174, 81921
n10x8192-coef-sum-4096, 32, 134, 3, 0, 0, 169, 81921
n10x8192-coef-sum-4096, 34, 135, 3, 0, 0, 172, 81921
n10x8192-coef-sum-4096, 34, 133, 3, 0, 0, 170, 81921
n10x8192-coef-sum-4096, 30, 134, 3, 0, 0, 167, 81921
n10x8192-coef-sum-4096, 34, 135, 3, 0, 0, 172, 81921
n10x8192-coef-sum-4096, 33, 134, 3, 0, 0, 170, 81921
n10x8192-coef-sum-4096, 30, 136, 3, 0, 0, 169, 81921
n10x8192-coef-sum-4096, 30, 134, 3, 0, 0, 167, 81921
n10x8192-coef-sum-4096, 30, 134, 3, 0, 0, 167, 81921
n10x8192-coef-sum-4096, 34, 135, 3, 0, 0, 172, 81921
n10x8192-coef-sum-4096, 33, 134, 3, 0, 0, 170, 81921
n10x8192-coef-sum-4096, 33, 136, 3, 0, 0, 172, 81921
n10x8192-coef-sum-4096, 30, 134, 3, 0, 0, 167, 81921
n10x8192-coef-sum-4096, 30, 135, 3, 0, 0, 168, 81921
n10x8192-coef-sum-4096, 33, 133, 3, 0, 0, 169, 81921
n10x8192-coef-sum-4096, 31, 134, 3, 0, 0, 168, 81921
n10x8192-coef-sum-4096, 30, 134, 3, 0, 0, 167, 81921
n10x8192-coef-sum-4096, 30, 134, 3, 0, 0, 167, 81921
n10x8192-coef-sum-4096, 33, 135, 3, 0, 0, 171, 81921
n10x8192-coef-sum-4096, 30, 134, 3, 0, 0, 167, 81921
n10x8192-coef-sum-4096, 37, 133, 3, 0, 0, 173, 81921
n10x8192-coef-sum-4096, 31, 135, 3, 0, 0, 169, 81921
n10x8192-coef-sum-4096, 32, 135, 3, 0, 0, 170, 81921
n10x8192-coef-sum-4096, 37, 134, 3, 0, 0, 174, 81921
n10x8192-coef-sum-4096, 31, 134, 3, 0, 0, 168, 81921
n10x8192-coef-sum-4096, 40, 134, 3, 0, 0, 177, 81921
n10x8192-coef-sum-4096, 33, 135, 3, 0, 0, 171, 81921
n10x8192-coef-sum-4096, 33, 134, 3, 0, 0, 170, 81921
n10x8192-coef-sum-4096, 31, 135, 3, 0, 0, 169, 81921
n10x8192-coef-sum-4096, 30, 134, 3, 0, 0, 167, 81921
n10x8192-coef-sum-4096, 30, 135, 3, 0, 0, 168, 81921
n10x8192-coef-sum-4096, 30, 135, 3, 0, 0, 168, 81921
n10x8192-coef-sum-4096, 32, 134, 3, 0, 0, 169, 81921
n10x8192-coef-sum-4096, 30, 135, 3, 0, 0, 168, 81921
n10x8192-coef-sum-4096, 33, 133, 3, 0, 0, 169, 81921
n10x8192-coef-sum-4096, 39, 134, 3, 0, 0, 176, 81921
n10x8192-coef-sum-4096, 34, 133, 3, 0, 0, 170, 81921
n10x8192-coef-sum-4096, 30, 135, 3, 0, 0, 168, 81921
n10x8192-coef-sum-4096, 33, 134, 3, 0, 0, 170, 81921
n10x8192-coef-sum-4096, 30, 134, 3, 0, 0, 167, 81921
n10x8192-coef-sum-4096, 34, 133, 3, 0, 0, 170, 81921
n10x8192-coef-sum-4096, 34, 135, 3, 0, 0, 172, 81921
n10x8192-coef-sum-4096, 37, 133, 3, 0, 0, 173, 81921
n10x8192-coef-sum-4096, 31, 134, 3, 0, 0, 168, 81921
n10x8192-coef-sum-4096, 38, 134, 3, 0, 0, 175, 81921
n10x8192-coef-sum-4096, 34, 134, 3, 0, 0, 171, 81921
n10x8192-coef-sum-4096, 30, 134, 3, 0, 0, 167, 81921
n10x8192-coef-sum-4096, 34, 133, 3, 0, 0, 170, 81921
n10x8192-coef-sum-4096, 31, 135, 3, 0, 0, 169, 81921
n10x8192-coef-sum-4096, 30, 134, 3, 0, 0, 167, 81921
n10x8192-coef-sum-4096, 33, 135, 3, 0, 0, 171, 81921
n10x8192-coef-sum-4096, 31, 134, 3, 0, 0, 168, 81921
n10x8192-coef-sum-4096, 30, 134, 3, 0, 0, 167, 81921
n10x8192-coef-sum-4096, 30, 134, 3, 0, 0, 167, 81921
n10x8192-coef-sum-4096, 36, 135, 3, 0, 0, 174, 81921
n10x8192-coef-sum-4096, 37, 133, 3, 0, 0, 173, 81921
n10x8192-coef-sum-4096, 31, 135, 3, 0, 0, 169, 81921
n10x8192-coef-sum-4096, 36, 133, 3, 0, 0, 172, 81921
n10x8192-coef-sum-4096, 34, 135, 3, 0, 0, 172, 81921
n10x8192-coef-sum-4096, 33, 135, 3, 0, 0, 171, 81921
n10x8192-coef-sum-4096, 37, 134, 3, 0, 0, 174, 81921
n10x8192-coef-sum-4096, 38, 134, 3, 0, 0, 175, 81921
n10x8192-coef-sum-4096, 34, 134, 3, 0, 0, 171, 81921
n10x8192-coef-sum-4096, 30, 134, 3, 0, 0, 167, 81921
n10x8192-coef-sum-4096, 30, 133, 3, 0, 0, 166, 81921
n10x8192-coef-sum-4096, 42, 134, 3, 0, 0, 179, 81921
n10x8192-coef-sum-4096, 30, 134, 3, 0, 0, 167, 81921
n10x8192-coef-sum-4096, 34, 135, 3, 0, 0, 172, 81921
n10x8192-coef-sum-4096, 33, 135, 3, 0, 0, 171, 81921
n10x8192-coef-sum-4096, 32, 133, 3, 0, 0, 168, 81921
n10x8192-coef-sum-4096, 30, 134, 3, 0, 0, 167, 81921
n10x8192-coef-sum-4096, 30, 134, 3, 0, 0, 167, 81921
n10x8192-coef-sum-4096, 30, 135, 3, 0, 0, 168, 81921
n10x8192-coef-sum-4096, 32, 134, 3, 0, 0, 169, 81921
n10x8192-coef-sum-4096, 30, 133, 3, 0, 0, 166, 81921
n10x8192-coef-sum-4096, 34, 134, 3, 0, 0, 171, 81921
n10x8192-coef-sum-4096, 30, 135, 3, 0, 0, 168, 81921
n10x8192-coef-sum-4096, 32, 136, 3, 0, 0, 171, 81921
n10x8192-coef-sum-4096, 32, 134, 3, 0, 0, 169, 81921
n10x8192-coef-sum-4096, 34, 135, 3, 0, 0, 172, 81921
n10x8192-coef-sum-4096, 30, 134, 3, 0, 0, 167, 81921
n10x8192-coef-sum-4096, 36, 134, 3, 0, 0, 173, 81921
n10x8192-coef-sum-4096, 30, 134, 3, 0, 0, 167, 81921
n10x8192-coef-sum-4096, 30, 135, 3, 0, 0, 168, 81921
n10x8192-coef-sum-4096, 30, 135, 3, 0, 0, 168, 81921
n10x8192-coef-sum-4096, 34, 136, 3, 0, 0, 173, 81921
n10x8192-coef-sum-4096, 35, 134, 3, 0, 0, 172, 81921
n10x8192-coef-sum-4096, 34, 135, 3, 0, 0, 172, 81921
n10x8192-coef-sum-4096, 30, 134, 3, 0, 0, 167, 81921
n10x8192-coef-sum-4096, 30, 135, 3, 0, 0, 168, 81921
n10x8192-coef-sum-4096, 31, 134, 3, 0, 0, 168, 81921
n10x8192-coef-sum-4096, 30, 134, 3, 0, 0, 167, 81921
n10x8192-coef-sum-4096, 38, 134, 3, 0, 0, 175, 81921
n10x8192-coef-sum-4096, 34, 135, 3, 0, 0, 172, 81921
n10x8192-coef-sum-4096, 33, 134, 3, 0, 0, 170, 81921
n10x8192-coef-sum-4096, 31, 133, 3, 0, 0, 167, 81921
n10x8192-coef-sum-4096, 38, 134, 3, 0, 0, 175, 81921
n10x8192-coef-sum-8192, 55, 140, 2, 1, 0, 198, 81921
n10x8192-coef-sum-8192, 58, 144, 2, 1, 0, 205, 81921
n10x8192-coef-sum-8192, 59, 140, 2, 1, 0, 202, 81921
n10x8192-coef-sum-8192, 60, 141, 2, 1, 0, 204, 81921
n10x8192-coef-sum-8192, 58, 140, 2, 1, 0, 201, 81921
n10x8192-coef-sum-8192, 67, 140, 2, 1, 0, 210, 81921
n10x8192-coef-sum-8192, 56, 141, 2, 1, 0, 200, 81921
n10x8192-coef-sum-8192, 58, 139, 2, 1, 0, 200, 81921
n10x8192-coef-sum-8192, 57, 139, 2, 1, 0, 199, 81921
n10x8192-coef-sum-8192, 57, 139, 2, 1, 0, 199, 81921
n10x8192-coef-sum-8192, 57, 141, 2, 1, 0, 201, 81921
n10x8192-coef-sum-8192, 62, 141, 2, 1, 0, 206, 81921
n10x8192-coef-sum-8192, 59, 140, 2, 1, 0, 202, 81921
n10x8192-coef-sum-8192, 59, 140, 2, 1, 0, 202, 81921
n10x8192-coef-sum-8192, 56, 140, 2, 1, 0, 199, 81921
n10x8192-coef-sum-8192, 60, 141, 2, 1, 0, 204, 81921
n10x8192-coef-sum-8192, 58, 141, 2, 1, 0, 202, 81921
n10x8192-coef-sum-8192, 59, 140, 2, 1, 0, 202, 81921
n10x8192-coef-sum-8192, 60, 141, 2, 1, 0, 204, 81921
n10x8192-coef-sum-8192, 59, 141, 2, 1, 0, 203, 81921
n10x8192-coef-sum-8192, 58, 140, 2, 1, 0, 201, 81921
n10x8192-coef-sum-8192, 60, 141, 2, 1, 0, 204, 81921
n10x8192-coef-sum-8192, 58, 140, 2, 1, 0, 201, 81921
n10x8192-coef-sum-8192, 56, 142, 2, 1, 0, 201, 81921
n10x8192-coef-sum-8192, 57, 142, 2, 1, 0, 202, 81921
n10x8192-coef-sum-8192, 58, 141, 2, 1, 0, 202, 81921
n10x8192-coef-sum-8192, 56, 140, 2, 1, 0, 199, 81921
n10x8192-coef-sum-8192, 59, 141, 2, 1, 0, 203, 81921
n10x8192-coef-sum-8192, 63, 141, 2, 1, 0, 207, 81921
n10x8192-coef-sum-8192, 58, 141, 2, 1, 0, 202, 81921
n10x8192-coef-sum-8192, 59, 141, 2, 1, 0, 203, 81921
n10x8192-coef-sum-8192, 62, 140, 2, 1, 0, 205, 81921
n10x8192-coef-sum-8192, 56, 140, 2, 1, 0, 199, 81921
n10x8192-coef-sum-8192, 56, 140, 2, 1, 0, 199, 81921
n10x8192-coef-sum-8192, 60, 141, 2, 1, 0, 204, 81921
n10x8192-coef-sum-8192, 58, 141, 2, 1, 0, 202, 81921
n10x8192-coef-sum-8192, 59, 142, 2, 1, 0, 204, 81921
n10x8192-coef-sum-8192, 58, 141, 2, 1, 0, 202, 81921
n10x8192-coef-sum-8192, 59, 141, 2, 1, 0, 203, 81921
n10x8192-coef-sum-8192, 59, 141, 2, 1, 0, 203, 81921
n10x8192-coef-sum-8192, 60, 141, 2, 1, 0, 204, 81921
n10x8192-coef-sum-8192, 55, 140, 2, 1, 0, 198, 81921
n10x8192-coef-sum-8192, 56, 140, 2, 1, 0, 199, 81921
n10x8192-coef-sum-8192, 60, 141, 2, 1, 0, 204, 81921
n10x8192-coef-sum-8192, 56, 141, 2, 1, 0, 200, 81921
n10x8192-coef-sum-8192, 58, 141, 2, 1, 0, 202, 81921
n10x8192-coef-sum-8192, 62, 141, 2, 1, 0, 206, 81921
n10x8192-coef-sum-8192, 62, 140, 2, 1, 0, 205, 81921
n10x8192-coef-sum-8192, 60, 141, 2, 1, 0, 204, 81921
n10x8192-coef-sum-8192, 60, 142, 2, 1, 0, 205, 81921
n10x8192-coef-sum-8192, 58, 140, 2, 1, 0, 201, 81921
n10x8192-coef-sum-8192, 60, 142, 2, 1, 0, 205, 81921
n10x8192-coef-sum-8192, 57, 141, 2, 1, 0, 201, 81921
n10x8192-coef-sum-8192, 55, 140, 2, 1, 0, 198, 81921
n10x8192-coef-sum-8192, 57, 140, 2, 1, 0, 200, 81921
n10x8192-coef-sum-8192, 56, 141, 2, 1, 0, 200, 81921
n10x8192-coef-sum-8192, 60, 140, 2, 1, 0, 203, 81921
n10x8192-coef-sum-8192, 60, 141, 2, 1, 0, 204, 81921
n10x8192-coef-sum-8192, 63, 140, 2, 1, 0, 206, 81921
n10x8192-coef-sum-8192, 59, 140, 2, 1, 0, 202, 81921
n10x8192-coef-sum-8192, 60, 140, 2, 1, 0, 203, 81921
n10x8192-coef-sum-8192, 60, 140, 2, 1, 0, 203, 81921
n10x8192-coef-sum-8192, 64, 141, 2, 1, 0, 208, 81921
n10x8192-coef-sum-8192, 59, 142, 2, 1, 0, 204, 81921
n10x8192-coef-sum-8192, 57, 140, 2, 1, 0, 200, 81921
n10x8192-coef-sum-8192, 56, 141, 2, 1, 0, 200, 81921
n10x8192-coef-sum-8192, 55, 142, 2, 1, 0, 200, 81921
n10x8192-coef-sum-8192, 58, 142, 2, 1, 0, 203, 81921
n10x8192-coef-sum-8192, 56, 140, 2, 1, 0, 199, 81921
n10x8192-coef-sum-8192, 58, 140, 2, 1, 0, 201, 81921
n10x8192-coef-sum-8192, 60, 142, 2, 1, 0, 205, 81921
n10x8192-coef-sum-8192, 56, 141, 2, 1, 0, 200, 81921
n10x8192-coef-sum-8192, 57, 140, 2, 1, 0, 200, 81921
n10x8192-coef-sum-8192, 59, 141, 2, 1, 0, 203, 81921
n10x8192-coef-sum-8192, 59, 139, 2, 1, 0, 201, 81921
n10x8192-coef-sum-8192, 57, 140, 2, 1, 0, 200, 81921
n10x8192-coef-sum-8192, 63, 140, 2, 1, 0, 206, 81921
n10x8192-coef-sum-8192, 56, 140, 2, 1, 0, 199, 81921
n10x8192-coef-sum-8192, 56, 139, 2, 1, 0, 198, 81921
n10x8192-coef-sum-8192, 57, 139, 2, 1, 0, 199, 81921
n10x8192-coef-sum-8192, 57, 140, 2, 1, 0, 200, 81921
n10x8192-coef-sum-8192, 60, 141, 2, 1, 0, 204, 81921
n10x8192-coef-sum-8192, 59, 140, 2, 1, 0, 202, 81921
n10x8192-coef-sum-8192, 59, 140, 2, 1, 0, 202, 81921
n10x8192-coef-sum-8192, 56, 140, 2, 1, 0, 199, 81921
n10x8192-coef-sum-8192, 56, 141, 2, 1, 0, 200, 81921
n10x8192-coef-sum-8192, 59, 141, 2, 1, 0, 203, 81921
n10x8192-coef-sum-8192, 59, 139, 2, 1, 0, 201, 81921
n10x8192-coef-sum-8192, 55, 140, 2, 1, 0, 198, 81921
n10x8192-coef-sum-8192, 61, 140, 2, 1, 0, 204, 81921
n10x8192-coef-sum-8192, 59, 141, 2, 1, 0, 203, 81921
n10x8192-coef-sum-8192, 59, 140, 2, 1, 0, 202, 81921
n10x8192-coef-sum-8192, 59, 144, 2, 1, 0, 206, 81921
n10x8192-coef-sum-8192, 59, 141, 2, 1, 0, 203, 81921
n10x8192-coef-sum-8192, 56, 146, 2, 1, 0, 205, 81921
n10x8192-coef-sum-8192, 57, 140, 2, 1, 0, 200, 81921
n10x8192-coef-sum-8192, 56, 140, 2, 1, 0, 199, 81921
n10x8192-coef-sum-8192, 56, 141, 2, 1, 0, 200, 81921
n10x8192-coef-sum-8192, 59, 140, 2, 1, 0, 202, 81921
n10x8192-coef-sum-8192, 57, 140, 2, 1, 0, 200, 81921
n10x8192-slot-sum-512, 18, 78, 7, 0, 0, 103, 81921
n10x8192-slot-sum-512, 18, 78, 8, 0, 0, 104, 81921
n10x8192-slot-sum-512, 18, 77, 7, 0, 0, 102, 81921
n10x8192-slot-sum-512, 18, 78, 7, 0, 0, 103, 81921
n10x8192-slot-sum-512, 17, 77, 7, 0, 0, 101, 81921
n10x8192-slot-sum-512, 17, 77, 7, 0, 0, 101, 81921
n10x8192-slot-sum-512, 18, 76, 7, 0, 0, 101, 81921
n10x8192-slot-sum-512, 18, 78, 7, 0, 0, 103, 81921
n10x8192-slot-sum-512, 18, 77, 7, 0, 0, 102, 81921
n10x8192-slot-sum-512, 18, 78, 7, 0, 0, 103, 81921
n10x8192-slot-sum-512, 18, 79, 7, 0, 0, 104, 81921
n10x8192-slot-sum-512, 18, 77, 7, 0, 0, 102, 81921
n10x8192-slot-sum-512, 18, 76, 7, 0, 0, 101, 81921
n10x8192-slot-sum-512, 18, 77, 7, 0, 0, 102, 81921
n10x8192-slot-sum-512, 17, 77, 7, 0, 0, 101, 81921
n10x8192-slot-sum-512, 18, 78, 7, 0, 0, 103, 81921
n10x8192-slot-sum-512, 18, 76, 7, 0, 0, 101, 81921
n10x8192-slot-sum-512, 18, 78, 8, 0, 0, 104, 81921
n10x8192-slot-sum-512, 18, 78, 7, 0, 0, 103, 81921
n10x8192-slot-sum-512, 18, 77, 7, 0, 0, 102, 81921
n10x8192-slot-sum-512, 18, 77, 7, 0, 0, 102, 81921
n10x8192-slot-sum-512, 18, 78, 7, 0, 0, 103, 81921
n10x8192-slot-sum-512, 18, 78, 7, 0, 0, 103, 81921
n10x8192-slot-sum-512, 18, 78, 7, 0, 0, 103, 81921
n10x8192-slot-sum-512, 18, 77, 7, 0, 0, 102, 81921
n10x8192-slot-sum-512, 17, 76, 7, 0, 0, 100, 81921
n10x8192-slot-sum-512, 18, 77, 7, 0, 0, 102, 81921
n10x8192-slot-sum-512, 18, 78, 7, 0, 0, 103, 81921
n10x8192-slot-sum-512, 18, 77, 7, 0, 0, 102, 81921
n10x8192-slot-sum-512, 18, 77, 7, 0, 0, 102, 81921
n10x8192-slot-sum-512, 18, 77, 7, 0, 0, 102, 81921
n10x8192-slot-sum-512, 18, 78, 7, 0, 0, 103, 81921
n10x8192-slot-sum-512, 18, 78, 7, 0, 0, 103, 81921
n10x8192-slot-sum-512, 18, 77, 7, 0, 0, 102, 81921
n10x8192-slot-sum-512, 18, 78, 7, 0, 0, 103, 81921
n10x8192-slot-sum-512, 18, 77, 7, 0, 0, 102, 81921
n10x8192-slot-sum-512, 18, 77, 7, 0, 0, 102, 81921
n10x8192-slot-sum-512, 17, 77, 7, 0, 0, 101, 81921
n10x8192-slot-sum-512, 18, 77, 7, 0, 0, 102, 81921
n10x8192-slot-sum-512, 18, 78, 7, 0, 0, 103, 81921
n10x8192-slot-sum-512, 18, 77, 7, 0, 0, 102, 81921
n10x8192-slot-sum-512, 18, 77, 7, 0, 0, 102, 81921
n10x8192-slot-sum-512, 18, 78, 7, 0, 0, 103, 81921
n10x8192-slot-sum-512, 18, 78, 7, 0, 0, 103, 81921
n10x8192-slot-sum-512, 18, 77, 7, 0, 0, 102, 81921
n10x8192-slot-sum-512, 18, 78, 8, 0, 0, 104, 81921
n10x8192-slot-sum-512, 18, 77, 7, 0, 0, 102, 81921
n10x8192-slot-sum-512, 18, 77, 7, 0, 0, 102, 81921
n10x8192-slot-sum-512, 18, 78, 7, 0, 0, 103, 81921
n10x8192-slot-sum-512, 18, 77, 7, 0, 0, 102, 81921
n10x8192-slot-sum-512, 18, 78, 8, 0, 0, 104, 81921
n10x8192-slot-sum-512, 18, 78, 7, 0, 0, 103, 81921
n10x8192-slot-sum-512, 18, 77, 7, 0, 0, 102, 81921
n10x8192-slot-sum-512, 18, 77, 7, 0, 0, 102, 81921
n10x8192-slot-sum-512, 18, 77, 7, 0, 0, 102, 81921
n10x8192-slot-sum-512, 18, 77, 7, 0, 0, 102, 81921
n10x8192-slot-sum-512, 17, 77, 7, 0, 0, 101, 81921
n10x8192-slot-sum-512, 18, 76, 7, 0, 0, 101, 81921
n10x8192-slot-sum-512, 18, 77, 7, 0, 0, 102, 81921
n10x8192-slot-sum-512, 18, 77, 7, 0, 0, 102, 81921
n10x8192-slot-sum-512, 18, 77, 8, 0, 0, 103, 81921
n10x8192-slot-sum-512, 18, 78, 7, 0, 0, 103, 81921
n10x8192-slot-sum-512, 18, 78, 7, 0, 0, 103, 81921
n10x8192-slot-sum-512, 18, 77, 7, 0, 0, 102, 81921
n10x8192-slot-sum-512, 18, 77, 7, 0, 0, 102, 81921
n10x8192-slot-sum-512, 18, 77, 7, 0, 0, 102, 81921
n10x8192-slot-sum-512, 18, 77, 7, 0, 0, 102, 81921
n10x8192-slot-sum-512, 18, 77, 7, 0, 0, 102, 81921
n10x8192-slot-sum-512, 18, 77, 7, 0, 0, 102, 81921
n10x8192-slot-sum-512, 18, 78, 7, 0, 0, 103, 81921
n10x8192-slot-sum-512, 18, 79, 7, 0, 0, 104, 81921
n10x8192-slot-sum-512, 18, 77, 7, 0, 0, 102, 81921
n10x8192-slot-sum-512, 18, 77, 7, 0, 0, 102, 81921
n10x8192-slot-sum-512, 18, 77, 7, 0, 0, 102, 81921
n10x8192-slot-sum-512, 18, 78, 7, 0, 0, 103, 81921
n10x8192-slot-sum-512, 21, 77, 7, 0, 0, 105, 81921
n10x8192-slot-sum-512, 18, 78, 7, 0, 0, 103, 81921
n10x8192-slot-sum-512, 18, 78, 7, 0, 0, 103, 81921
n10x8192-slot-sum-512, 18, 78, 7, 0, 0, 103, 81921
n10x8192-slot-sum-512, 18, 77, 7, 0, 0, 102, 81921
n10x8192-slot-sum-512, 18, 77, 7, 0, 0, 102, 81921
n10x8192-slot-sum-512, 18, 77, 8, 0, 0, 103, 81921
n10x8192-slot-sum-512, 18, 77, 7, 0, 0, 102, 81921
n10x8192-slot-sum-512, 18, 77, 7, 0, 0, 102, 81921
n10x8192-slot-sum-512, 18, 77, 8, 0, 0, 103, 81921
n10x8192-slot-sum-512, 18, 77, 7, 0, 0, 102, 81921
n10x8192-slot-sum-512, 18, 78, 7, 0, 0, 103, 81921
n10x8192-slot-sum-512, 18, 78, 7, 0, 0, 103, 81921
n10x8192-slot-sum-512, 18, 77, 7, 0, 0, 102, 81921
n10x8192-slot-sum-512, 18, 78, 7, 0, 0, 103, 81921
n10x8192-slot-sum-512, 18, 78, 7, 0, 0, 103, 81921
n10x8192-slot-sum-512, 18, 77, 7, 0, 0, 102, 81921
n10x8192-slot-sum-512, 18, 77, 7, 0, 0, 102, 81921
n10x8192-slot-sum-512, 18, 78, 7, 0, 0, 103, 81921
n10x8192-slot-sum-512, 18, 77, 7, 0, 0, 102, 81921
n10x8192-slot-sum-512, 18, 76, 7, 0, 0, 101, 81921
n10x8192-slot-sum-512, 18, 76, 7, 0, 0, 101, 81921
n10x8192-slot-sum-512, 18, 77, 7, 0, 0, 102, 81921
n10x8192-slot-sum-512, 18, 77, 7, 0, 0, 102, 81921
n10x8192-slot-sum-512, 18, 76, 7, 0, 0, 101, 81921
n10x8192-slot-sum-1024, 36, 74, 8, 0, 0, 118, 81921
n10x8192-slot-sum-1024, 31, 75, 9, 0, 0, 115, 81921
n10x8192-slot-sum-1024, 31, 74, 8, 0, 0, 113, 81921
n10x8192-slot-sum-1024, 32, 75, 8, 0, 0, 115, 81921
n10x8192-slot-sum-1024, 38, 74, 8, 0, 0, 120, 81921
n10x8192-slot-sum-1024, 36, 75, 8, 0, 0, 119, 81921
n10x8192-slot-sum-1024, 31, 74, 8, 0, 0, 113, 81921
n10x8192-slot-sum-1024, 32, 74, 8, 0, 0, 114, 81921
n10x8192-slot-sum-1024, 31, 74, 8, 0, 0, 113, 81921
n10x8192-slot-sum-1024, 31, 74, 8, 0, 0, 113, 81921
n10x8192-slot-sum-1024, 37, 74, 8, 0, 0, 119, 81921
n10x8192-slot-sum-1024, 31, 75, 8, 0, 0, 114, 81921
n10x8192-slot-sum-1024, 32, 75, 8, 0, 0, 115, 81921
n10x8192-slot-sum-1024, 32, 74, 8, 0, 0, 114, 81921
n10x8192-slot-sum-1024, 31, 74, 8, 0, 0, 113, 81921
n10x8192-slot-sum-1024, 31, 75, 9, 0, 0, 115, 81921
n10x8192-slot-sum-1024, 32, 74, 8, 0, 0, 114, 81921
n10x8192-slot-sum-1024, 32, 74, 8, 0, 0, 114, 81921
n10x8192-slot-sum-1024, 31, 75, 8, 0, 0, 114, 81921
n10x8192-slot-sum-1024, 32, 75, 8, 0, 0, 115, 81921
n10x8192-slot-sum-1024, 31, 74, 8, 0, 0, 113, 81921
n10x8192-slot-sum-1024, 31, 74, 8, 0, 0, 113, 81921
n10x8192-slot-sum-1024, 32, 74, 8, 0, 0, 114, 81921
n10x8192-slot-sum-1024, 32, 75, 8, 0, 0, 115, 81921
n10x8192-slot-sum-1024, 31, 74, 8, 0, 0, 113, 81921
n10x8192-slot-sum-1024, 31, 76, 8, 0, 0, 115, 81921
n10x8192-slot-sum-1024, 31, 75, 8, 0, 0, 114, 81921
n10x8192-slot-sum-1024, 31, 75, 8, 0, 0, 114, 81921
n10x8192-slot-sum-1024, 31, 74, 8, 0, 0, 113, 81921
n10x8192-slot-sum-1024, 33, 74, 8, 0, 0, 115, 81921
n10x8192-slot-sum-1024, 31, 74, 8, 0, 0, 113, 81921
n10x8192-slot-sum-1024, 31, 75, 8, 0, 0, 114, 81921
n10x8192-slot-sum-1024, 31, 74, 8, 0, 0, 113, 81921
n10x8192-slot-sum-1024, 37, 74, 8, 0, 0, 119, 81921
n10x8192-slot-sum-1024, 31, 75, 9, 0, 0, 115, 81921
n10x8192-slot-sum-1024, 33, 74, 8, 0, 0, 115, 81921
n10x8192-slot-sum-1024, 31, 75, 8, 0, 0, 114, 81921
n10x8192-slot-sum-1024, 32, 74, 8, 0, 0, 114, 81921
n10x8192-slot-sum-1024, 31, 74, 8, 0, 0, 113, 81921
n10x8192-slot-sum-1024, 31, 74, 8, 0, 0, 113, 81921
n10x8192-slot-sum-1024, 31, 75, 8, 0, 0, 114, 81921
n10x8192-slot-sum-1024, 31, 75, 8, 0, 0, 114, 81921
n10x8192-slot-sum-1024, 32, 75, 8, 0, 0, 115, 81921
n10x8192-slot-sum-1024, 31, 74, 8, 0, 0, 113, 81921
n10x8192-slot-sum-1024, 32, 74, 8, 0, 0, 114, 81921
n10x8192-slot-sum-1024, 31, 74, 8, 0, 0, 113, 81921
n10x8192-slot-sum-1024, 31, 74, 8, 0, 0, 113, 81921
n10x8192-slot-sum-1024, 31, 74, 8, 0, 0, 113, 81921
n10x8192-slot-sum-1024, 32, 75, 8, 0, 0, 115, 81921
n10x8192-slot-sum-1024, 31, 76, 8, 0, 0, 115, 81921
n10x8192-slot-sum-1024, 31, 76, 8, 0, 0, 115, 81921
n10x8192-slot-sum-1024, 31, 75, 8, 0, 0, 114, 81921
n10x8192-slot-sum-1024, 33, 75, 8, 0, 0, 116, 81921
n10x8192-slot-sum-1024, 31, 74, 8, 0, 0, 113, 81921
n10x8192-slot-sum-1024, 37, 74, 8, 0, 0, 119, 81921
n10x8192-slot-sum-1024, 31, 74, 8, 0, 0, 113, 81921
n10x8192-slot-sum-1024, 31, 75, 8, 0, 0, 114, 81921
n10x8192-slot-sum-1024, 32, 75, 8, 0, 0, 115, 81921
n10x8192-slot-sum-1024, 31, 75, 9, 0, 0, 115, 81921
n10x8192-slot-sum-1024, 32, 75, 21, 0, 0, 128, 81921
n10x8192-slot-sum-1024, 31, 74, 8, 0, 0, 113, 81921
n10x8192-slot-sum-1024, 32, 75, 8, 0, 0, 115, 81921
n10x8192-slot-sum-1024, 32, 76, 8, 0, 0, 116, 81921
n10x8192-slot-sum-1024, 32, 75, 8, 0, 0, 115, 81921
n10x8192-slot-sum-1024, 32, 76, 8, 0, 0, 116, 81921
n10x8192-slot-sum-1024, 31, 75, 8, 0, 0, 114, 81921
n10x8192-slot-sum-1024, 31, 75, 8, 0, 0, 114, 81921
n10x8192-slot-sum-1024, 31, 74, 8, 0, 0, 113, 81921
n10x8192-slot-sum-1024, 31, 75, 8, 0, 0, 114, 81921
n10x8192-slot-sum-1024, 31, 75, 8, 0, 0, 114, 81921
n10x8192-slot-sum-1024, 31, 74, 8, 0, 0, 113, 81921
n10x8192-slot-sum-1024, 32, 74, 8, 0, 0, 114, 81921
n10x8192-slot-sum-1024, 31, 75, 8, 0, 0, 114, 81921
n10x8192-slot-sum-1024, 32, 76, 8, 0, 0, 116, 81921
n10x8192-slot-sum-1024, 36, 76, 8, 0, 0, 120, 81921
n10x8192-slot-sum-1024, 31, 74, 8, 0, 0, 113, 81921
n10x8192-slot-sum-1024, 32, 75, 8, 0, 0, 115, 81921
n10x8192-slot-sum-1024, 31, 74, 8, 0, 0, 113, 81921
n10x8192-slot-sum-1024, 31, 75, 8, 0, 0, 114, 81921
n10x8192-slot-sum-1024, 32, 75, 8, 0, 0, 115, 81921
n10x8192-slot-sum-1024, 32, 75, 8, 0, 0, 115, 81921
n10x8192-slot-sum-1024, 31, 75, 8, 0, 0, 114, 81921
n10x8192-slot-sum-1024, 31, 75, 8, 0, 0, 114, 81921
n10x8192-slot-sum-1024, 32, 75, 8, 0, 0, 115, 81921
n10x8192-slot-sum-1024, 31, 74, 8, 0, 0, 113, 81921
n10x8192-slot-sum-1024, 31, 75, 8, 0, 0, 114, 81921
n10x8192-slot-sum-1024, 31, 74, 8, 0, 0, 113, 81921
n10x8192-slot-sum-1024, 31, 75, 8, 0, 0, 114, 81921
n10x8192-slot-sum-1024, 32, 74, 8, 0, 0, 114, 81921
n10x8192-slot-sum-1024, 31, 75, 8, 0, 0, 114, 81921
n10x8192-slot-sum-1024, 34, 74, 8, 0, 0, 116, 81921
n10x8192-slot-sum-1024, 32, 75, 8, 0, 0, 115, 81921
n10x8192-slot-sum-1024, 31, 74, 8, 0, 0, 113, 81921
n10x8192-slot-sum-1024, 33, 74, 8, 0, 0, 115, 81921
n10x8192-slot-sum-1024, 32, 76, 9, 0, 0, 117, 81921
n10x8192-slot-sum-1024, 36, 74, 8, 0, 0, 118, 81921
n10x8192-slot-sum-1024, 32, 75, 8, 0, 0, 115, 81921
n10x8192-slot-sum-1024, 31, 75, 8, 0, 0, 114, 81921
n10x8192-slot-sum-1024, 32, 74, 8, 0, 0, 114, 81921
n10x8192-slot-sum-1024, 31, 74, 8, 0, 0, 113, 81921
n10x8192-slot-sum-2048, 60, 75, 12, 0, 0, 147, 81921
n10x8192-slot-sum-2048, 60, 75, 12, 0, 0, 147, 81921
n10x8192-slot-sum-2048, 59, 75, 12, 0, 0, 146, 81921
n10x8192-slot-sum-2048, 58, 74, 12, 0, 0, 144, 81921
n10x8192-slot-sum-2048, 59, 75, 12, 0, 0, 146, 81921
n10x8192-slot-sum-2048, 59, 75, 12, 0, 0, 146, 81921
n10x8192-slot-sum-2048, 59, 75, 12, 0, 0, 146, 81921
n10x8192-slot-sum-2048, 59, 75, 12, 0, 0, 146, 81921
n10x8192-slot-sum-2048, 58, 74, 12, 0, 0, 144, 81921
n10x8192-slot-sum-2048, 59, 75, 12, 0, 0, 146, 81921
n10x8192-slot-sum-2048, 59, 75, 12, 0, 0, 146, 81921
n10x8192-slot-sum-2048, 59, 75, 12, 0, 0, 146, 81921
n10x8192-slot-sum-2048, 63, 75, 12, 0, 0, 150, 81921
n10x8192-slot-sum-2048, 59, 75, 12, 0, 0, 146, 81921
n10x8192-slot-sum-2048, 62, 74, 12, 0, 0, 148, 81921
n10x8192-slot-sum-2048, 59, 75, 12, 0, 0, 146, 81921
n10x8192-slot-sum-2048, 58, 75, 12, 0, 0, 145, 81921
n10x8192-slot-sum-2048, 59, 75, 12, 0, 0, 146, 81921
n10x8192-slot-sum-2048, 59, 75, 12, 0, 0, 146, 81921
n10x8192-slot-sum-2048, 58, 74, 12, 0, 0, 144, 81921
n10x8192-slot-sum-2048, 58, 75, 12, 0, 0, 145, 81921
n10x8192-slot-sum-2048, 63, 75, 12, 0, 0, 150, 81921
n10x8192-slot-sum-2048, 59, 75, 12, 0, 0, 146, 81921
n10x8192-slot-sum-2048, 59, 75, 12, 0, 0, 146, 81921
n10x8192-slot-sum-2048, 59, 75, 12, 0, 0, 146, 81921
n10x8192-slot-sum-2048, 62, 75, 12, 0, 0, 149, 81921
n10x8192-slot-sum-2048, 59, 75, 12, 0, 0, 146, 81921
n10x8192-slot-sum-2048, 59, 76, 12, 0, 0, 147, 81921
n10x8192-slot-sum-2048, 60, 75, 12, 0, 0, 147, 81921
n10x8192-slot-sum-2048, 59, 76, 13, 0, 0, 148, 81921
n10x8192-slot-sum-2048, 59, 75, 12, 0, 0, 146, 81921
n10x8192-slot-sum-2048, 59, 76, 12, 0, 0, 147, 81921
n10x8192-slot-sum-2048, 69, 76, 12, 0, 0, 157, 81921
n10x8192-slot-sum-2048, 59, 74, 12, 0, 0, 145, 81921
n10x8192-slot-sum-2048, 59, 76, 12, 0, 0, 147, 81921
n10x8192-slot-sum-2048, 64, 76, 12, 0, 0, 152, 81921
n10x8192-slot-sum-2048, 59, 75, 12, 0, 0, 146, 81921
n10x8192-slot-sum-2048, 59, 75, 12, 0, 0, 146, 81921
n10x8192-slot-sum-2048, 58, 74, 12, 0, 0, 144, 81921
n10x8192-slot-sum-2048, 59, 75, 12, 0, 0, 146, 81921
n10x8192-slot-sum-2048, 59, 76, 12, 0, 0, 147, 81921
n10x8192-slot-sum-2048, 59, 75, 12, 0, 0, 146, 81921
n10x8192-slot-sum-2048, 59, 75, 12, 0, 0, 146, 81921
n10x8192-slot-sum-2048, 59, 75, 12, 0, 0, 146, 81921
n10x8192-slot-sum-2048, 59, 75, 12, 0, 0, 146, 81921
n10x8192-slot-sum-2048, 59, 76, 12, 0, 0, 147, 81921
n10x8192-slot-sum-2048, 59, 75, 12, 0, 0, 146, 81921
n10x8192-slot-sum-2048, 59, 75, 12, 0, 0, 146, 81921
n10x8192-slot-sum-2048, 59, 75, 12, 0, 0, 146, 81921
n10x8192-slot-sum-2048, 59, 76, 12, 0, 0, 147, 81921
n10x8192-slot-sum-2048, 59, 75, 12, 0, 0, 146, 81921
n10x8192-slot-sum-2048, 60, 76, 12, 0, 0, 148, 81921
n10x8192-slot-sum-2048, 59, 75, 12, 0, 0, 146, 81921
n10x8192-slot-sum-2048, 63, 75, 12, 0, 0, 150, 81921
n10x8192-slot-sum-2048, 59, 75, 12, 0, 0, 146, 81921
n10x8192-slot-sum-2048, 59, 75, 12, 0, 0, 146, 81921
n10x8192-slot-sum-2048, 59, 74, 12, 0, 0, 145, 81921
n10x8192-slot-sum-2048, 59, 76, 12, 0, 0, 147, 81921
n10x8192-slot-sum-2048, 59, 75, 12, 0, 0, 146, 81921
n10x8192-slot-sum-2048, 59, 76, 12, 0, 0, 147, 81921
n10x8192-slot-sum-2048, 59, 75, 12, 0, 0, 146, 81921
n10x8192-slot-sum-2048, 58, 75, 12, 0, 0, 145, 81921
n10x8192-slot-sum-2048, 60, 75, 12, 0, 0, 147, 81921
n10x8192-slot-sum-2048, 59, 75, 12, 0, 0, 146, 81921
n10x8192-slot-sum-2048, 59, 75, 12, 0, 0, 146, 81921
n10x8192-slot-sum-2048, 59, 75, 12, 0, 0, 146, 81921
n10x8192-slot-sum-2048, 59, 75, 12, 0, 0, 146, 81921
n10x8192-slot-sum-2048, 60, 75, 12, 0, 0, 147, 81921
n10x8192-slot-sum-2048, 59, 76, 12, 0, 0, 147, 81921
n10x8192-slot-sum-2048, 59, 75, 12, 0, 0, 146, 81921
n10x8192-slot-sum-2048, 58, 75, 12, 0, 0, 145, 81921
n10x8192-slot-sum-2048, 62, 75, 12, 0, 0, 149, 81921
n10x8192-slot-sum-2048, 60, 76, 12, 0, 0, 148, 81921
n10x8192-slot-sum-2048, 63, 76, 12, 0, 0, 151, 81921
n10x8192-slot-sum-2048, 59, 78, 12, 0, 0, 149, 81921
n10x8192-slot-sum-2048, 59, 75, 12, 0, 0, 146, 81921
n10x8192-slot-sum-2048, 63, 75, 12, 0, 0, 150, 81921
n10x8192-slot-sum-2048, 58, 75, 12, 0, 0, 145, 81921
n10x8192-slot-sum-2048, 60, 75, 12, 0, 0, 147, 81921
n10x8192-slot-sum-2048, 60, 76, 12, 0, 0, 148, 81921
n10x8192-slot-sum-2048, 60, 75, 12, 0, 0, 147, 81921
n10x8192-slot-sum-2048, 59, 75, 12, 0, 0, 146, 81921
n10x8192-slot-sum-2048, 59, 75, 12, 0, 0, 146, 81921
n10x8192-slot-sum-2048, 59, 75, 12, 0, 0, 146, 81921
n10x8192-slot-sum-2048, 59, 75, 12, 0, 0, 146, 81921
n10x8192-slot-sum-2048, 59, 75, 12, 0, 0, 146, 81921
n10x8192-slot-sum-2048, 59, 75, 12, 0, 0, 146, 81921
n10x8192-slot-sum-2048, 63, 75, 12, 0, 0, 150, 81921
n10x8192-slot-sum-2048, 60, 74, 12, 0, 0, 146, 81921
n10x8192-slot-sum-2048, 59, 75, 12, 0, 0, 146, 81921
n10x8192-slot-sum-2048, 59, 76, 12, 0, 0, 147, 81921
n10x8192-slot-sum-2048, 62, 76, 12, 0, 0, 150, 81921
n10x8192-slot-sum-2048, 59, 75, 12, 0, 0, 146, 81921
n10x8192-slot-sum-2048, 58, 75, 12, 0, 0, 145, 81921
n10x8192-slot-sum-2048, 60, 75, 12, 0, 0, 147, 81921
n10x8192-slot-sum-2048, 59, 75, 12, 0, 0, 146, 81921
n10x8192-slot-sum-2048, 59, 75, 12, 0, 0, 146, 81921
n10x8192-slot-sum-2048, 59, 75, 12, 0, 0, 146, 81921
n10x8192-slot-sum-2048, 59, 75, 12, 0, 0, 146, 81921
n10x8192-slot-sum-2048, 59, 75, 12, 0, 0, 146, 81921
n10x8192-slot-sum-4096, 122, 77, 21, 0, 0, 220, 81921
n10x8192-slot-sum-4096, 125, 78, 22, 0, 0, 225, 81921
n10x8192-slot-sum-4096, 124, 77, 21, 0, 0, 222, 81921
n10x8192-slot-sum-4096, 127, 78, 21, 0, 0, 226, 81921
n10x8192-slot-sum-4096, 130, 78, 21, 0, 0, 229, 81921
n10x8192-slot-sum-4096, 126, 77, 21, 0, 0, 224, 81921
n10x8192-slot-sum-4096, 125, 78, 21, 0, 0, 224, 81921
n10x8192-slot-sum-4096, 126, 77, 22, 0, 0, 225, 81921
n10x8192-slot-sum-4096, 124, 78, 22, 0, 0, 224, 81921
n10x8192-slot-sum-4096, 124, 78, 22, 0, 0, 224, 81921
n10x8192-slot-sum-4096, 123, 77, 21, 0, 0, 221, 81921
n10x8192-slot-sum-4096, 129, 78, 21, 0, 0, 228, 81921
n10x8192-slot-sum-4096, 123, 77, 21, 0, 0, 221, 81921
n10x8192-slot-sum-4096, 124, 77, 21, 0, 0, 222, 81921
n10x8192-slot-sum-4096, 122, 78, 21, 0, 0, 221, 81921
n10x8192-slot-sum-4096, 126, 79, 22, 0, 0, 227, 81921
n10x8192-slot-sum-4096, 123, 78, 21, 0, 0, 222, 81921
n10x8192-slot-sum-4096, 124, 77, 21, 0, 0, 222, 81921
n10x8192-slot-sum-4096, 123, 77, 21, 0, 0, 221, 81921
n10x8192-slot-sum-4096, 128, 82, 22, 0, 0, 232, 81921
n10x8192-slot-sum-4096, 135, 78, 22, 0, 0, 235, 81921
n10x8192-slot-sum-4096, 130, 78, 21, 0, 0, 229, 81921
n10x8192-slot-sum-4096, 124, 78, 21, 0, 0, 223, 81921
n10x8192-slot-sum-4096, 123, 78, 21, 0, 0, 222, 81921
n10x8192-slot-sum-4096, 123, 78, 21, 0, 0, 222, 81921
n10x8192-slot-sum-4096, 123, 78, 22, 0, 0, 223, 81921
n10x8192-slot-sum-4096, 123, 78, 22, 0, 0, 223, 81921
n10x8192-slot-sum-4096, 126, 77, 22, 0, 0, 225, 81921
n10x8192-slot-sum-4096, 127, 78, 22, 0, 0, 227, 81921
n10x8192-slot-sum-4096, 126, 78, 21, 0, 0, 225, 81921
n10x8192-slot-sum-4096, 127, 77, 21, 0, 0, 225, 81921
n10x8192-slot-sum-4096, 125, 79, 22, 0, 0, 226, 81921
n10x8192-slot-sum-4096, 124, 78, 22, 0, 0, 224, 81921
n10x8192-slot-sum-4096, 127, 78, 22, 0, 0, 227, 81921
n10x8192-slot-sum-4096, 125, 78, 21, 0, 0, 224, 81921
n10x8192-slot-sum-4096, 123, 80, 21, 0, 0, 224, 81921
n10x8192-slot-sum-4096, 124, 78, 22, 0, 0, 224, 81921
n10x8192-slot-sum-4096, 126, 77, 21, 0, 0, 224, 81921
n10x8192-slot-sum-4096, 125, 78, 21, 0, 0, 224, 81921
n10x8192-slot-sum-4096, 123, 77, 21, 0, 0, 221, 81921
n10x8192-slot-sum-4096, 122, 78, 22, 0, 0, 222, 81921
n10x8192-slot-sum-4096, 125, 78, 22, 0, 0, 225, 81921
n10x8192-slot-sum-4096, 122, 77, 21, 0, 0, 220, 81921
n10x8192-slot-sum-4096, 124, 78, 21, 0, 0, 223, 81921
n10x8192-slot-sum-4096, 124, 78, 21, 0, 0, 223, 81921
n10x8192-slot-sum-4096, 128, 79, 22, 0, 0, 229, 81921
n10x8192-slot-sum-4096, 124, 78, 22, 0, 0, 224, 81921
n10x8192-slot-sum-4096, 126, 78, 21, 0, 0, 225, 81921
n10x8192-slot-sum-4096, 124, 77, 21, 0, 0, 222, 81921
n10x8192-slot-sum-4096, 128, 77, 21, 0, 0, 226, 81921
n10x8192-slot-sum-4096, 123, 77, 21, 0, 0, 221, 81921
n10x8192-slot-sum-4096, 123, 77, 21, 0, 0, 221, 81921
n10x8192-slot-sum-4096, 125, 78, 22, 0, 0, 225, 81921
n10x8192-slot-sum-4096, 125, 79, 22, 0, 0, 226, 81921
n10x8192-slot-sum-4096, 124, 78, 21, 0, 0, 223, 81921
n10x8192-slot-sum-4096, 121, 77, 21, 0, 0, 219, 81921
n10x8192-slot-sum-4096, 122, 78, 21, 0, 0, 221, 81921
n10x8192-slot-sum-4096, 126, 78, 22, 0, 0, 226, 81921
n10x8192-slot-sum-4096, 130, 77, 21, 0, 0, 228, 81921
n10x8192-slot-sum-4096, 131, 77, 21, 0, 0, 229, 81921
n10x8192-slot-sum-4096, 123, 78, 22, 0, 0, 223, 81921
n10x8192-slot-sum-4096, 123, 77, 21, 0, 0, 221, 81921
n10x8192-slot-sum-4096, 124, 77, 22, 0, 0, 223, 81921
n10x8192-slot-sum-4096, 123, 78, 21, 0, 0, 222, 81921
n10x8192-slot-sum-4096, 126, 77, 21, 0, 0, 224, 81921
n10x8192-slot-sum-4096, 125, 78, 22, 0, 0, 225, 81921
n10x8192-slot-sum-4096, 123, 77, 21, 0, 0, 221, 81921
n10x8192-slot-sum-4096, 126, 77, 21, 0, 0, 224, 81921
n10x8192-slot-sum-4096, 125, 77, 21, 0, 0, 223, 81921
n10x8192-slot-sum-4096, 122, 77, 22, 0, 0, 221, 81921
n10x8192-slot-sum-4096, 125, 78, 21, 0, 0, 224, 81921
n10x8192-slot-sum-4096, 123, 77, 21, 0, 0, 221, 81921
n10x8192-slot-sum-4096, 125, 77, 22, 0, 0, 224, 81921
n10x8192-slot-sum-4096, 122, 78, 21, 0, 0, 221, 81921
n10x8192-slot-sum-4096, 123, 77, 21, 0, 0, 221, 81921
n10x8192-slot-sum-4096, 125, 77, 21, 0, 0, 223, 81921
n10x8192-slot-sum-4096, 123, 78, 22, 0, 0, 223, 81921
n10x8192-slot-sum-4096, 128, 78, 21, 0, 0, 227, 81921
n10x8192-slot-sum-4096, 123, 77, 21, 0, 0, 221, 81921
n10x8192-slot-sum-4096, 130, 78, 21, 0, 0, 229, 81921
n10x8192-slot-sum-4096, 131, 78, 21, 0, 0, 230, 81921
n10x8192-slot-sum-4096, 127, 78, 21, 0, 0, 226, 81921
n10x8192-slot-sum-4096, 122, 78, 21, 0, 0, 221, 81921
n10x8192-slot-sum-4096, 123, 77, 21, 0, 0, 221, 81921
n10x8192-slot-sum-4096, 125, 77, 21, 0, 0, 223, 81921
n10x8192-slot-sum-4096, 121, 77, 21, 0, 0, 219, 81921
n10x8192-slot-sum-4096, 122, 77, 21, 0, 0, 220, 81921
n10x8192-slot-sum-4096, 123, 77, 21, 0, 0, 221, 81921
n10x8192-slot-sum-4096, 122, 77, 21, 0, 0, 220, 81921
n10x8192-slot-sum-4096, 125, 77, 21, 0, 0, 223, 81921
n10x8192-slot-sum-4096, 126, 77, 21, 0, 0, 224, 81921
n10x8192-slot-sum-4096, 125, 78, 22, 0, 0, 225, 81921
n10x8192-slot-sum-4096, 123, 77, 21, 0, 0, 221, 81921
n10x8192-slot-sum-4096, 122, 77, 21, 0, 0, 220, 81921
n10x8192-slot-sum-4096, 125, 78, 22, 0, 0, 225, 81921
n10x8192-slot-sum-4096, 127, 78, 22, 0, 0, 227, 81921
n10x8192-slot-sum-4096, 122, 77, 21, 0, 0, 220, 81921
n10x8192-slot-sum-4096, 122, 78, 21, 0, 0, 221, 81921
n10x8192-slot-sum-4096, 130, 78, 22, 0, 0, 230, 81921
n10x8192-slot-sum-4096, 129, 78, 22, 0, 0, 229, 81921
n10x8192-slot-sum-8192, 263, 81, 63, 1, 0, 408, 81921
n10x8192-slot-sum-8192, 264, 82, 63, 1, 0, 410, 81921
n10x8192-slot-sum-8192, 265, 83, 63, 1, 0, 412, 81921
n10x8192-slot-sum-8192, 265, 82, 63, 1, 0, 411, 81921
n10x8192-slot-sum-8192, 264, 83, 65, 1, 0, 413, 81921
n10x8192-slot-sum-8192, 266, 83, 63, 1, 0, 413, 81921
n10x8192-slot-sum-8192, 267, 81, 66, 1, 0, 415, 81921
n10x8192-slot-sum-8192, 266, 81, 63, 1, 0, 411, 81921
n10x8192-slot-sum-8192, 264, 82, 63, 1, 0, 410, 81921
n10x8192-slot-sum-8192, 264, 82, 63, 1, 0, 410, 81921
n10x8192-slot-sum-8192, 262, 85, 65, 1, 0, 413, 81921
n10x8192-slot-sum-8192, 265, 82, 63, 1, 0, 411, 81921
n10x8192-slot-sum-8192, 267, 82, 64, 1, 0, 414, 81921
n10x8192-slot-sum-8192, 261, 81, 63, 1, 0, 406, 81921
n10x8192-slot-sum-8192, 269, 81, 63, 1, 0, 414, 81921
n10x8192-slot-sum-8192, 269, 81, 63, 1, 0, 414, 81921
n10x8192-slot-sum-8192, 268, 81, 63, 1, 0, 413, 81921
n10x8192-slot-sum-8192, 263, 81, 63, 1, 0, 408, 81921
n10x8192-slot-sum-8192, 269, 82, 66, 1, 0, 418, 81921
n10x8192-slot-sum-8192, 263, 81, 64, 1, 0, 409, 81921
n10x8192-slot-sum-8192, 263, 81, 63, 1, 0, 408, 81921
n10x8192-slot-sum-8192, 265, 82, 64, 1, 0, 412, 81921
n10x8192-slot-sum-8192, 268, 81, 64, 1, 0, 414, 81921
n10x8192-slot-sum-8192, 264, 81, 63, 1, 0, 409, 81921
n10x8192-slot-sum-8192, 264, 82, 64, 1, 0, 411, 81921
n10x8192-slot-sum-8192, 266, 82, 64, 1, 0, 413, 81921
n10x8192-slot-sum-8192, 260, 81, 63, 1, 0, 405, 81921
n10x8192-slot-sum-8192, 266, 82, 63, 1, 0, 412, 81921
n10x8192-slot-sum-8192, 263, 82, 64, 1, 0, 410, 81921
n10x8192-slot-sum-8192, 267, 81, 64, 1, 0, 413, 81921
n10x8192-slot-sum-8192, 267, 82, 67, 1, 0, 417, 81921
n10x8192-slot-sum-8192, 263, 81, 63, 1, 0, 408, 81921
n10x8192-slot-sum-8192, 262, 83, 64, 1, 0, 410, 81921
n10x8192-slot-sum-8192, 263, 82, 63, 1, 0, 409, 81921
n10x8192-slot-sum-8192, 261, 82, 64, 1, 0, 408, 81921
n10x8192-slot-sum-8192, 272, 81, 63, 1, 0, 417, 81921
n10x8192-slot-sum-8192, 264, 82, 63, 1, 0, 410, 81921
n10x8192-slot-sum-8192, 264, 81, 64, 1, 0, 410, 81921
n10x8192-slot-sum-8192, 265, 81, 64, 1, 0, 411, 81921
n10x8192-slot-sum-8192, 266, 83, 63, 1, 0, 413, 81921
n10x8192-slot-sum-8192, 269, 82, 63, 1, 0, 415, 81921
n10x8192-slot-sum-8192, 266, 83, 64, 1, 0, 414, 81921
n10x8192-slot-sum-8192, 265, 82, 63, 1, 0, 411, 81921
n10x8192-slot-sum-8192, 266, 82, 66, 1, 0, 415, 81921
n10x8192-slot-sum-8192, 270, 83, 66, 1, 0, 420, 81921
n10x8192-slot-sum-8192, 267, 83, 66, 1, 0, 417, 81921
n10x8192-slot-sum-8192, 266, 82, 65, 1, 0, 414, 81921
n10x8192-slot-sum-8192, 265, 81, 63, 1, 0, 410, 81921
n10x8192-slot-sum-8192, 263, 82, 63, 1, 0, 409, 81921
n10x8192-slot-sum-8192, 269, 81, 63, 1, 0, 414, 81921
n10x8192-slot-sum-8192, 265, 82, 63, 1, 0, 411, 81921
n10x8192-slot-sum-8192, 265, 82, 65, 1, 0, 413, 81921
n10x8192-slot-sum-8192, 265, 81, 63, 1, 0, 410, 81921
n10x8192-slot-sum-8192, 262, 83, 66, 1, 0, 412, 81921
n10x8192-slot-sum-8192, 272, 82, 64, 1, 0, 419, 81921
n10x8192-slot-sum-8192, 263, 82, 64, 1, 0, 410, 81921
n10x8192-slot-sum-8192, 266, 83, 63, 1, 0, 413, 81921
n10x8192-slot-sum-8192, 264, 82, 64, 1, 0, 411, 81921
n10x8192-slot-sum-8192, 265, 82, 64, 1, 0, 412, 81921
n10x8192-slot-sum-8192, 264, 82, 64, 1, 0, 411, 81921
n10x8192-slot-sum-8192, 265, 82, 65, 1, 0, 413, 81921
n10x8192-slot-sum-8192, 264, 81, 64, 1, 0, 410, 81921
n10x8192-slot-sum-8192, 266, 83, 64, 1, 0, 414, 81921
n10x8192-slot-sum-8192, 275, 82, 64, 1, 0, 422, 81921
n10x8192-slot-sum-8192, 264, 82, 64, 1, 0, 411, 81921
n10x8192-slot-sum-8192, 261, 82, 64, 1, 0, 408, 81921
n10x8192-slot-sum-8192, 266, 81, 63, 1, 0, 411, 81921
n10x8192-slot-sum-8192, 263, 82, 66, 1, 0, 412, 81921
n10x8192-slot-sum-8192, 266, 82, 63, 1, 0, 412, 81921
n10x8192-slot-sum-8192, 271, 83, 65, 1, 0, 420, 81921
n10x8192-slot-sum-8192, 268, 84, 63, 1, 0, 416, 81921
n10x8192-slot-sum-8192, 263, 82, 66, 1, 0, 412, 81921
n10x8192-slot-sum-8192, 269, 82, 64, 1, 0, 416, 81921
n10x8192-slot-sum-8192, 265, 83, 66, 1, 0, 415, 81921
n10x8192-slot-sum-8192, 270, 83, 65, 1, 0, 419, 81921
n10x8192-slot-sum-8192, 264, 82, 64, 1, 0, 411, 81921
n10x8192-slot-sum-8192, 266, 83, 64, 1, 0, 414, 81921
n10x8192-slot-sum-8192, 271, 82, 63, 1, 0, 417, 81921
n10x8192-slot-sum-8192, 264, 81, 64, 1, 0, 410, 81921
n10x8192-slot-sum-8192, 262, 82, 65, 1, 0, 410, 81921
n10x8192-slot-sum-8192, 262, 81, 64, 1, 0, 408, 81921
n10x8192-slot-sum-8192, 264, 82, 67, 1, 0, 414, 81921
n10x8192-slot-sum-8192, 266, 82, 63, 1, 0, 412, 81921
n10x8192-slot-sum-8192, 268, 82, 63, 1, 0, 414, 81921
n10x8192-slot-sum-8192, 263, 82, 63, 1, 0, 409, 81921
n10x8192-slot-sum-8192, 266, 81, 63, 1, 0, 411, 81921
n10x8192-slot-sum-8192, 263, 83, 63, 1, 0, 410, 81921
n10x8192-slot-sum-8192, 266, 81, 63, 1, 0, 411, 81921
n10x8192-slot-sum-8192, 264, 83, 65, 1, 0, 413, 81921
n10x8192-slot-sum-8192, 264, 81, 63, 1, 0, 409, 81921
n10x8192-slot-sum-8192, 267, 82, 63, 1, 0, 413, 81921
n10x8192-slot-sum-8192, 262, 82, 63, 1, 0, 408, 81921
n10x8192-slot-sum-8192, 262, 82, 64, 1, 0, 409, 81921
n10x8192-slot-sum-8192, 267, 81, 63, 1, 0, 412, 81921
n10x8192-slot-sum-8192, 265, 82, 64, 1, 0, 412, 81921
n10x8192-slot-sum-8192, 266, 83, 64, 1, 0, 414, 81921
n10x8192-slot-sum-8192, 263, 82, 67, 1, 0, 413, 81921
n10x8192-slot-sum-8192, 270, 82, 65, 1, 0, 418, 81921
n10x8192-slot-sum-8192, 270, 82, 66, 1, 0, 419, 81921
n10x8192-slot-sum-8192, 261, 81, 62, 1, 0, 405, 81921
n10x8192-slot-inner-512, 19, 77, 147, 0, 0, 243, 136535
n10x8192-slot-inner-512, 19, 78, 148, 0, 0, 245, 136535
n10x8192-slot-inner-512, 19, 78, 147, 0, 0, 244, 136535
n10x8192-slot-inner-512, 19, 77, 147, 0, 0, 243, 136535
n10x8192-slot-inner-512, 19, 78, 147, 0, 0, 244, 136535
n10x8192-slot-inner-512, 19, 77, 145, 0, 0, 241, 136535
n10x8192-slot-inner-512, 19, 77, 147, 0, 0, 243, 136535
n10x8192-slot-inner-512, 19, 77, 150, 0, 0, 246, 136535
n10x8192-slot-inner-512, 19, 78, 149, 0, 0, 246, 136535
n10x8192-slot-inner-512, 19, 78, 147, 0, 0, 244, 136535
n10x8192-slot-inner-512, 19, 76, 147, 0, 0, 242, 136535
n10x8192-slot-inner-512, 19, 77, 146, 0, 0, 242, 136535
n10x8192-slot-inner-512, 19, 77, 147, 0, 0, 243, 136535
n10x8192-slot-inner-512, 19, 78, 147, 0, 0, 244, 136535
n10x8192-slot-inner-512, 19, 78, 147, 0, 0, 244, 136535
n10x8192-slot-inner-512, 18, 77, 146, 0, 0, 241, 136535
n10x8192-slot-inner-512, 19, 78, 147, 0, 0, 244, 136535
n10x8192-slot-inner-512, 19, 77, 147, 0, 0, 243, 136535
n10x8192-slot-inner-512, 19, 77, 146, 0, 0, 242, 136535
n10x8192-slot-inner-512, 19, 78, 149, 0, 0, 246, 136535
n10x8192-slot-inner-512, 19, 78, 148, 0, 0, 245, 136535
n10x8192-slot-inner-512, 19, 77, 147, 0, 0, 243, 136535
n10x8192-slot-inner-512, 19, 77, 145, 0, 0, 241, 136535
n10x8192-slot-inner-512, 19, 77, 148, 0, 0, 244, 136535
n10x8192-slot-inner-512, 19, 77, 148, 0, 0, 244, 136535
n10x8192-slot-inner-512, 19, 77, 147, 0, 0, 243, 136535
n10x8192-slot-inner-512, 19, 77, 148, 0, 0, 244, 136535
n10x8192-slot-inner-512, 19, 77, 152, 0, 0, 248, 136535
n10x8192-slot-inner-512, 19, 77, 146, 0, 0, 242, 136535
n10x8192-slot-inner-512, 19, 77, 146, 0, 0, 242, 136535
n10x8192-slot-inner-512, 19, 77, 146, 0, 0, 242, 136535
n10x8192-slot-inner-512, 19, 77, 147, 0, 0, 243, 136535
n10x8192-slot-inner-512, 19, 77, 147, 0, 0, 243, 136535
n10x8192-slot-inner-512, 19, 78, 147, 0, 0, 244, 136535
n10x8192-slot-inner-512, 19, 78, 147, 0, 0, 244, 136535
n10x8192-slot-inner-512, 19, 78, 147, 0, 0, 244, 136535
n10x8192-slot-inner-512, 19, 77, 147, 0, 0, 243, 136535
n10x8192-slot-inner-512, 19, 77, 145, 0, 0, 241, 136535
n10x8192-slot-inner-512, 19, 78, 146, 0, 0, 243, 136535
n10x8192-slot-inner-512, 19, 78, 147, 0, 0, 244, 136535
n10x8192-slot-inner-512, 18, 76, 146, 0, 0, 240, 136535
n10x8192-slot-inner-512, 19, 77, 146, 0, 0, 242, 136535
n10x8192-slot-inner-512, 19, 77, 146, 0, 0, 242, 136535
n10x8192-slot-inner-512, 19, 78, 147, 0, 0, 244, 136535
n10x8192-slot-inner-512, 19, 77, 147, 0, 0, 243, 136535
n10x8192-slot-inner-512, 19, 77, 147, 0, 0, 243, 136535
n10x8192-slot-inner-512, 19, 77, 149, 0, 0, 245, 136535
n10x8192-slot-inner-512, 20, 77, 147, 0, 0, 244, 136535
n10x8192-slot-inner-512, 19, 78, 148, 0, 0, 245, 136535
n10x8192-slot-inner-512, 26, 76, 152, 0, 0, 254, 136535
n10x8192-slot-inner-512, 19, 77, 147, 0, 0, 243, 136535
n10x8192-slot-inner-512, 19, 77, 148, 0, 0, 244, 136535
n10x8192-slot-inner-512, 19, 77, 147, 0, 0, 243, 136535
n10x8192-slot-inner-512, 19, 78, 147, 0, 0, 244, 136535
n10x8192-slot-inner-512, 19, 77, 147, 0, 0, 243, 136535
n10x8192-slot-inner-512, 19, 77, 147, 0, 0, 243, 136535
n10x8192-slot-inner-512, 19, 78, 147, 0, 0, 244, 136535
n10x8192-slot-inner-512, 19, 77, 147, 0, 0, 243, 136535
n10x8192-slot-inner-512, 19, 77, 148, 0, 0, 244, 136535
n10x8192-slot-inner-512, 18, 77, 147, 0, 0, 242, 136535
n10x8192-slot-inner-512, 19, 78, 147, 0, 0, 244, 136535
n10x8192-slot-inner-512, 19, 78, 146, 0, 0, 243, 136535
n10x8192-slot-inner-512, 19, 77, 147, 0, 0, 243, 136535
n10x8192-slot-inner-512, 19, 77, 147, 0, 0, 243, 136535
n10x8192-slot-inner-512, 19, 79, 148, 0, 0, 246, 136535
n10x8192-slot-inner-512, 19, 77, 148, 0, 0, 244, 136535
n10x8192-slot-inner-512, 19, 79, 149, 0, 0, 247, 136535
n10x8192-slot-inner-512, 19, 78, 148, 0, 0, 245, 136535
n10x8192-slot-inner-512, 19, 78, 148, 0, 0, 245, 136535
n10x8192-slot-inner-512, 19, 78, 149, 0, 0, 246, 136535
n10x8192-slot-inner-512, 19, 77, 147, 0, 0, 243, 136535
n10x8192-slot-inner-512, 19, 77, 148, 0, 0, 244, 136535
n10x8192-slot-inner-512, 19, 79, 151, 0, 0, 249, 136535
n10x8192-slot-inner-512, 19, 78, 147, 0, 0, 244, 136535
n10x8192-slot-inner-512, 19, 78, 148, 0, 0, 245, 136535
n10x8192-slot-inner-512, 19, 78, 146, 0, 0, 243, 136535
n10x8192-slot-inner-512, 19, 77, 147, 0, 0, 243, 136535
n10x8192-slot-inner-512, 19, 77, 146, 0, 0, 242, 136535
n10x8192-slot-inner-512, 19, 78, 148, 0, 0, 245, 136535
n10x8192-slot-inner-512, 19, 80, 150, 0, 0, 249, 136535
n10x8192-slot-inner-512, 19, 77, 147, 0, 0, 243, 136535
n10x8192-slot-inner-512, 19, 77, 148, 0, 0, 244, 136535
n10x8192-slot-inner-512, 19, 77, 146, 0, 0, 242, 136535
n10x8192-slot-inner-512, 19, 78, 149, 0, 0, 246, 136535
n10x8192-slot-inner-512, 19, 77, 146, 0, 0, 242, 136535
n10x8192-slot-inner-512, 19, 81, 149, 0, 0, 249, 136535
n10x8192-slot-inner-512, 19, 77, 148, 0, 0, 244, 136535
n10x8192-slot-inner-512, 19, 77, 148, 0, 0, 244, 136535
n10x8192-slot-inner-512, 19, 77, 148, 0, 0, 244, 136535
n10x8192-slot-inner-512, 19, 78, 148, 0, 0, 245, 136535
n10x8192-slot-inner-512, 19, 78, 149, 0, 0, 246, 136535
n10x8192-slot-inner-512, 19, 77, 146, 0, 0, 242, 136535
n10x8192-slot-inner-512, 19, 77, 152, 0, 0, 248, 136535
n10x8192-slot-inner-512, 19, 77, 147, 0, 0, 243, 136535
n10x8192-slot-inner-512, 19, 79, 149, 0, 0, 247, 136535
n10x8192-slot-inner-512, 19, 77, 148, 0, 0, 244, 136535
n10x8192-slot-inner-512, 19, 77, 147, 0, 0, 243, 136535
n10x8192-slot-inner-512, 19, 77, 147, 0, 0, 243, 136535
n10x8192-slot-inner-512, 19, 79, 148, 0, 0, 246, 136535
n10x8192-slot-inner-512, 19, 77, 146, 0, 0, 242, 136535
n10x8192-slot-inner-1024, 34, 74, 136, 0, 0, 244, 136535
n10x8192-slot-inner-1024, 34, 74, 136, 0, 0, 244, 136535
n10x8192-slot-inner-1024, 33, 74, 136, 0, 0, 243, 136535
n10x8192-slot-inner-1024, 34, 74, 140, 0, 0, 248, 136535
n10x8192-slot-inner-1024, 34, 76, 138, 0, 0, 248, 136535
n10x8192-slot-inner-1024, 33, 75, 136, 0, 0, 244, 136535
n10x8192-slot-inner-1024, 35, 74, 140, 0, 0, 249, 136535
n10x8192-slot-inner-1024, 33, 74, 136, 0, 0, 243, 136535
n10x8192-slot-inner-1024, 33, 74, 137, 0, 0, 244, 136535
n10x8192-slot-inner-1024, 33, 75, 137, 0, 0, 245, 136535
n10x8192-slot-inner-1024, 38, 75, 142, 0, 0, 255, 136535
n10x8192-slot-inner-1024, 33, 75, 136, 0, 0, 244, 136535
n10x8192-slot-inner-1024, 34, 74, 136, 0, 0, 244, 136535
n10x8192-slot-inner-1024, 39, 75, 137, 0, 0, 251, 136535
n10x8192-slot-inner-1024, 34, 75, 138, 0, 0, 247, 136535
n10x8192-slot-inner-1024, 38, 74, 141, 0, 0, 253, 136535
n10x8192-slot-inner-1024, 34, 75, 137, 0, 0, 246, 136535
n10x8192-slot-inner-1024, 33, 74, 136, 0, 0, 243, 136535
n10x8192-slot-inner-1024, 34, 74, 136, 0, 0, 244, 136535
n10x8192-slot-inner-1024, 33, 74, 136, 0, 0, 243, 136535
n10x8192-slot-inner-1024, 34, 75, 138, 0, 0, 247, 136535
n10x8192-slot-inner-1024, 33, 75, 137, 0, 0, 245, 136535
n10x8192-slot-inner-1024, 34, 75, 135, 0, 0, 244, 136535
n10x8192-slot-inner-1024, 33, 74, 135, 0, 0, 242, 136535
n10x8192-slot-inner-1024, 33, 75, 137, 0, 0, 245, 136535
n10x8192-slot-inner-1024, 34, 74, 150, 0, 0, 258, 136535
n10x8192-slot-inner-1024, 33, 74, 136, 0, 0, 243, 136535
n10x8192-slot-inner-1024, 33, 76, 137, 0, 0, 246, 136535
n10x8192-slot-inner-1024, 34, 75, 138, 0, 0, 247, 136535
n10x8192-slot-inner-1024, 33, 75, 136, 0, 0, 244, 136535
n10x8192-slot-inner-1024, 34, 74, 138, 0, 0, 246, 136535
n10x8192-slot-inner-1024, 33, 75, 136, 0, 0, 244, 136535
n10x8192-slot-inner-1024, 34, 76, 138, 0, 0, 248, 136535
n10x8192-slot-inner-1024, 34, 75, 137, 0, 0, 246, 136535
n10x8192-slot-inner-1024, 33, 74, 137, 0, 0, 244, 136535
n10x8192-slot-inner-1024, 34, 75, 137, 0, 0, 246, 136535
n10x8192-slot-inner-1024, 34, 75, 138, 0, 0, 247, 136535
n10x8192-slot-inner-1024, 34, 74, 135, 0, 0, 243, 136535
n10x8192-slot-inner-1024, 33, 74, 137, 0, 0, 244, 136535
n10x8192-slot-inner-1024, 34, 75, 137, 0, 0, 246, 136535
n10x8192-slot-inner-1024, 34, 74, 137, 0, 0, 245, 136535
n10x8192-slot-inner-1024, 34, 74, 138, 0, 0, 246, 136535
n10x8192-slot-inner-1024, 35, 75, 138, 0, 0, 248, 136535
n10x8192-slot-inner-1024, 34, 75, 136, 0, 0, 245, 136535
n10x8192-slot-inner-1024, 34, 77, 137, 0, 0, 248, 136535
n10x8192-slot-inner-1024, 34, 75, 137, 0, 0, 246, 136535
n10x8192-slot-inner-1024, 40, 75, 143, 0, 0, 258, 136535
n10x8192-slot-inner-1024, 34, 74, 136, 0, 0, 244, 136535
n10x8192-slot-inner-1024, 33, 74, 135, 0, 0, 242, 136535
n10x8192-slot-inner-1024, 33, 74, 136, 0, 0, 243, 136535
n10x8192-slot-inner-1024, 33, 74, 137, 0, 0, 244, 136535
n10x8192-slot-inner-1024, 35, 74, 139, 0, 0, 248, 136535
n10x8192-slot-inner-1024, 34, 75, 139, 0, 0, 248, 136535
n10x8192-slot-inner-1024, 34, 75, 135, 0, 0, 244, 136535
n10x8192-slot-inner-1024, 33, 75, 136, 0, 0, 244, 136535
n10x8192-slot-inner-1024, 34, 74, 135, 0, 0, 243, 136535
n10x8192-slot-inner-1024, 34, 74, 136, 0, 0, 244, 136535
n10x8192-slot-inner-1024, 33, 74, 137, 0, 0, 244, 136535
n10x8192-slot-inner-1024, 33, 75, 136, 0, 0, 244, 136535
n10x8192-slot-inner-1024, 35, 75, 136, 0, 0, 246, 136535
n10x8192-slot-inner-1024, 33, 75, 136, 0, 0, 244, 136535
n10x8192-slot-inner-1024, 33, 74, 135, 0, 0, 242, 136535
n10x8192-slot-inner-1024, 34, 75, 137, 0, 0, 246, 136535
n10x8192-slot-inner-1024, 33, 76, 136, 0, 0, 245, 136535
n10x8192-slot-inner-1024, 34, 75, 137, 0, 0, 246, 136535
n10x8192-slot-inner-1024, 33, 74, 136, 0, 0, 243, 136535
n10x8192-slot-inner-1024, 33, 74, 136, 0, 0, 243, 136535
n10x8192-slot-inner-1024, 33, 74, 138, 0, 0, 245, 136535
n10x8192-slot-inner-1024, 35, 75, 137, 0, 0, 247, 136535
n10x8192-slot-inner-1024, 33, 74, 135, 0, 0, 242, 136535
n10x8192-slot-inner-1024, 34, 75, 137, 0, 0, 246, 136535
n10x8192-slot-inner-1024, 33, 74, 137, 0, 0, 244, 136535
n10x8192-slot-inner-1024, 33, 74, 136, 0, 0, 243, 136535
n10x8192-slot-inner-1024, 33, 75, 137, 0, 0, 245, 136535
n10x8192-slot-inner-1024, 34, 76, 137, 0, 0, 247, 136535
n10x8192-slot-inner-1024, 33, 75, 136, 0, 0, 244, 136535
n10x8192-slot-inner-1024, 33, 74, 135, 0, 0, 242, 136535
n10x8192-slot-inner-1024, 33, 74, 137, 0, 0, 244, 136535
n10x8192-slot-inner-1024, 32, 74, 138, 0, 0, 244, 136535
n10x8192-slot-inner-1024, 34, 76, 136, 0, 0, 246, 136535
n10x8192-slot-inner-1024, 34, 74, 136, 0, 0, 244, 136535
n10x8192-slot-inner-1024, 33, 74, 138, 0, 0, 245, 136535
n10x8192-slot-inner-1024, 34, 74, 139, 0, 0, 247, 136535
n10x8192-slot-inner-1024, 34, 75, 138, 0, 0, 247, 136535
n10x8192-slot-inner-1024, 37, 74, 140, 0, 0, 251, 136535
n10x8192-slot-inner-1024, 34, 74, 137, 0, 0, 245, 136535
n10x8192-slot-inner-1024, 33, 76, 136, 0, 0, 245, 136535
n10x8192-slot-inner-1024, 33, 75, 137, 0, 0, 245, 136535
n10x8192-slot-inner-1024, 34, 75, 137, 0, 0, 246, 136535
n10x8192-slot-inner-1024, 35, 75, 141, 0, 0, 251, 136535
n10x8192-slot-inner-1024, 33, 75, 138, 0, 0, 246, 136535
n10x8192-slot-inner-1024, 33, 76, 137, 0, 0, 246, 136535
n10x8192-slot-inner-1024, 35, 75, 138, 0, 0, 248, 136535
n10x8192-slot-inner-1024, 45, 74, 141, 0, 0, 260, 136535
n10x8192-slot-inner-1024, 33, 74, 136, 0, 0, 243, 136535
n10x8192-slot-inner-1024, 34, 76, 137, 0, 0, 247, 136535
n10x8192-slot-inner-1024, 33, 75, 138, 0, 0, 246, 136535
n10x8192-slot-inner-1024, 33, 74, 137, 0, 0, 244, 136535
n10x8192-slot-inner-1024, 34, 76, 143, 0, 0, 253, 136535
n10x8192-slot-inner-1024, 34, 75, 138, 0, 0, 247, 136535
n10x8192-slot-inner-2048, 63, 75, 137, 0, 0, 275, 136535
n10x8192-slot-inner-2048, 63, 75, 138, 0, 0, 276, 136535
n10x8192-slot-inner-2048, 63, 76, 137, 0, 0, 276, 136535
n10x8192-slot-inner-2048, 63, 75, 141, 0, 0, 279, 136535
n10x8192-slot-inner-2048, 63, 75, 138, 0, 0, 276, 136535
n10x8192-slot-inner-2048, 63, 76, 151, 0, 0, 290, 136535
n10x8192-slot-inner-2048, 63, 75, 136, 0, 0, 274, 136535
n10x8192-slot-inner-2048, 63, 75, 140, 0, 0, 278, 136535
n10x8192-slot-inner-2048, 71, 75, 142, 0, 0, 288, 136535
n10x8192-slot-inner-2048, 63, 75, 136, 0, 0, 274, 136535
n10x8192-slot-inner-2048, 63, 77, 137, 0, 0, 277, 136535
n10x8192-slot-inner-2048, 63, 75, 137, 0, 0, 275, 136535
n10x8192-slot-inner-2048, 63, 75, 137, 0, 0, 275, 136535
n10x8192-slot-inner-2048, 64, 78, 136, 0, 0, 278, 136535
n10x8192-slot-inner-2048, 63, 75, 137, 0, 0, 275, 136535
n10x8192-slot-inner-2048, 63, 75, 137, 0, 0, 275, 136535
n10x8192-slot-inner-2048, 64, 75, 137, 0, 0, 276, 136535
n10x8192-slot-inner-2048, 63, 75, 140, 0, 0, 278, 136535
n10x8192-slot-inner-2048, 64, 76, 138, 0, 0, 278, 136535
n10x8192-slot-inner-2048, 64, 75, 137, 0, 0, 276, 136535
n10x8192-slot-inner-2048, 63, 75, 136, 0, 0, 274, 136535
n10x8192-slot-inner-2048, 63, 75, 135, 0, 0, 273, 136535
n10x8192-slot-inner-2048, 63, 78, 139, 0, 0, 280, 136535
n10x8192-slot-inner-2048, 63, 75, 136, 0, 0, 274, 136535
n10x8192-slot-inner-2048, 77, 75, 136, 0, 0, 288, 136535
n10x8192-slot-inner-2048, 63, 75, 139, 0, 0, 277, 136535
n10x8192-slot-inner-2048, 63, 75, 137, 0, 0, 275, 136535
n10x8192-slot-inner-2048, 64, 76, 138, 0, 0, 278, 136535
n10x8192-slot-inner-2048, 63, 75, 136, 0, 0, 274, 136535
n10x8192-slot-inner-2048, 67, 75, 137, 0, 0, 279, 136535
n10x8192-slot-inner-2048, 63, 75, 136, 0, 0, 274, 136535
n10x8192-slot-inner-2048, 64, 75, 138, 0, 0, 277, 136535
n10x8192-slot-inner-2048, 66, 75, 137, 0, 0, 278, 136535
n10x8192-slot-inner-2048, 64, 75, 137, 0, 0, 276, 136535
n10x8192-slot-inner-2048, 64, 75, 136, 0, 0, 275, 136535
n10x8192-slot-inner-2048, 63, 75, 138, 0, 0, 276, 136535
n10x8192-slot-inner-2048, 64, 76, 138, 0, 0, 278, 136535
n10x8192-slot-inner-2048, 66, 76, 137, 0, 0, 279, 136535
n10x8192-slot-inner-2048, 65, 75, 143, 0, 0, 283, 136535
n10x8192-slot-inner-2048, 63, 76, 137, 0, 0, 276, 136535
n10x8192-slot-inner-2048, 66, 76, 138, 0, 0, 280, 136535
n10x8192-slot-inner-2048, 63, 75, 136, 0, 0, 274, 136535
n10x8192-slot-inner-2048, 63, 75, 138, 0, 0, 276, 136535
n10x8192-slot-inner-2048, 64, 91, 139, 0, 0, 294, 136535
n10x8192-slot-inner-2048, 63, 75, 139, 0, 0, 277, 136535
n10x8192-slot-inner-2048, 63, 75, 137, 0, 0, 275, 136535
n10x8192-slot-inner-2048, 75, 75, 138, 0, 0, 288, 136535
n10x8192-slot-inner-2048, 64, 76, 137, 0, 0, 277, 136535
n10x8192-slot-inner-2048, 63, 76, 137, 0, 0, 276, 136535
n10x8192-slot-inner-2048, 63, 75, 137, 0, 0, 275, 136535
n10x8192-slot-inner-2048, 63, 80, 137, 0, 0, 280, 136535
n10x8192-slot-inner-2048, 64, 75, 136, 0, 0, 275, 136535
n10x8192-slot-inner-2048, 63, 75, 140, 0, 0, 278, 136535
n10x8192-slot-inner-2048, 64, 76, 140, 0, 0, 280, 136535
n10x8192-slot-inner-2048, 63, 75, 135, 0, 0, 273, 136535
n10x8192-slot-inner-2048, 63, 75, 136, 0, 0, 274, 136535
n10x8192-slot-inner-2048, 63, 74, 138, 0, 0, 275, 136535
n10x8192-slot-inner-2048, 63, 75, 136, 0, 0, 274, 136535
n10x8192-slot-inner-2048, 66, 75, 141, 0, 0, 282, 136535
n10x8192-slot-inner-2048, 63, 75, 136, 0, 0, 274, 136535
n10x8192-slot-inner-2048, 63, 75, 137, 0, 0, 275, 136535
n10x8192-slot-inner-2048, 63, 77, 139, 0, 0, 279, 136535
n10x8192-slot-inner-2048, 67, 76, 143, 0, 0, 286, 136535
n10x8192-slot-inner-2048, 64, 75, 136, 0, 0, 275, 136535
n10x8192-slot-inner-2048, 70, 75, 143, 0, 0, 288, 136535
n10x8192-slot-inner-2048, 62, 74, 136, 0, 0, 272, 136535
n10x8192-slot-inner-2048, 67, 75, 139, 0, 0, 281, 136535
n10x8192-slot-inner-2048, 63, 75, 138, 0, 0, 276, 136535
n10x8192-slot-inner-2048, 63, 75, 136, 0, 0, 274, 136535
n10x8192-slot-inner-2048, 64, 76, 137, 0, 0, 277, 136535
n10x8192-slot-inner-2048, 64, 77, 138, 0, 0, 279, 136535
n10x8192-slot-inner-2048, 63, 75, 136, 0, 0, 274, 136535
n10x8192-slot-inner-2048, 67, 75, 143, 0, 0, 285, 136535
n10x8192-slot-inner-2048, 63, 75, 139, 0, 0, 277, 136535
n10x8192-slot-inner-2048, 64, 75, 136, 0, 0, 275, 136535
n10x8192-slot-inner-2048, 63, 75, 136, 0, 0, 274, 136535
n10x8192-slot-inner-2048, 63, 75, 136, 0, 0, 274, 136535
n10x8192-slot-inner-2048, 63, 76, 137, 0, 0, 276, 136535
n10x8192-slot-inner-2048, 64, 75, 138, 0, 0, 277, 136535
n10x8192-slot-inner-2048, 63, 75, 139, 0, 0, 277, 136535
n10x8192-slot-inner-2048, 65, 75, 138, 0, 0, 278, 136535
n10x8192-slot-inner-2048, 63, 76, 138, 0, 0, 277, 136535
n10x8192-slot-inner-2048, 64, 75, 137, 0, 0, 276, 136535
n10x8192-slot-inner-2048, 66, 76, 137, 0, 0, 279, 136535
n10x8192-slot-inner-2048, 63, 75, 138, 0, 0, 276, 136535
n10x8192-slot-inner-2048, 69, 75, 142, 0, 0, 286, 136535
n10x8192-slot-inner-2048, 63, 76, 137, 0, 0, 276, 136535
n10x8192-slot-inner-2048, 65, 76, 138, 0, 0, 279, 136535
n10x8192-slot-inner-2048, 64, 75, 136, 0, 0, 275, 136535
n10x8192-slot-inner-2048, 69, 75, 136, 0, 0, 280, 136535
n10x8192-slot-inner-2048, 63, 75, 138, 0, 0, 276, 136535
n10x8192-slot-inner-2048, 64, 75, 138, 0, 0, 277, 136535
n10x8192-slot-inner-2048, 65, 75, 143, 0, 0, 283, 136535
n10x8192-slot-inner-2048, 63, 75, 137, 0, 0, 275, 136535
n10x8192-slot-inner-2048, 64, 76, 137, 0, 0, 277, 136535
n10x8192-slot-inner-2048, 66, 75, 136, 0, 0, 277, 136535
n10x8192-slot-inner-2048, 63, 75, 137, 0, 0, 275, 136535
n10x8192-slot-inner-2048, 64, 75, 137, 0, 0, 276, 136535
n10x8192-slot-inner-2048, 68, 74, 139, 0, 0, 281, 136535
n10x8192-slot-inner-2048, 63, 75, 136, 0, 0, 274, 136535
n10x8192-slot-inner-8192, 283, 83, 210, 1, 0, 577, 136535
n10x8192-slot-inner-8192, 286, 83, 204, 1, 0, 574, 136535
n10x8192-slot-inner-8192, 280, 81, 207, 1, 0, 569, 136535
n10x8192-slot-inner-8192, 279, 82, 207, 1, 0, 569, 136535
n10x8192-slot-inner-8192, 285, 81, 205, 1, 0, 572, 136535
n10x8192-slot-inner-8192, 283, 81, 209, 1, 0, 574, 136535
n10x8192-slot-inner-8192, 280, 81, 205, 1, 0, 567, 136535
n10x8192-slot-inner-8192, 280, 81, 205, 1, 0, 567, 136535
n10x8192-slot-inner-8192, 283, 82, 208, 1, 0, 574, 136535
n10x8192-slot-inner-8192, 279, 82, 206, 1, 0, 568, 136535
n10x8192-slot-inner-8192, 281, 82, 207, 1, 0, 571, 136535
n10x8192-slot-inner-8192, 279, 81, 206, 1, 0, 567, 136535
n10x8192-slot-inner-8192, 283, 82, 207, 1, 0, 573, 136535
n10x8192-slot-inner-8192, 286, 81, 211, 1, 0, 579, 136535
n10x8192-slot-inner-8192, 281, 82, 205, 1, 0, 569, 136535
n10x8192-slot-inner-8192, 286, 82, 205, 1, 0, 574, 136535
n10x8192-slot-inner-8192, 287, 81, 210, 1, 0, 579, 136535
n10x8192-slot-inner-8192, 280, 81, 203, 1, 0, 565, 136535
n10x8192-slot-inner-8192, 280, 82, 207, 1, 0, 570, 136535
n10x8192-slot-inner-8192, 282, 81, 201, 1, 0, 565, 136535
n10x8192-slot-inner-8192, 284, 82, 203, 1, 0, 570, 136535
n10x8192-slot-inner-8192, 280, 82, 212, 1, 0, 575, 136535
n10x8192-slot-inner-8192, 289, 82, 203, 1, 0, 575, 136535
n10x8192-slot-inner-8192, 287, 82, 207, 1, 0, 577, 136535
n10x8192-slot-inner-8192, 282, 82, 203, 1, 0, 568, 136535
n10x8192-slot-inner-8192, 282, 82, 207, 1, 0, 572, 136535
n10x8192-slot-inner-8192, 286, 81, 207, 1, 0, 575, 136535
n10x8192-slot-inner-8192, 285, 82, 206, 1, 0, 574, 136535
n10x8192-slot-inner-8192, 283, 82, 211, 1, 0, 577, 136535
n10x8192-slot-inner-8192, 281, 82, 202, 1, 0, 566, 136535
n10x8192-slot-inner-8192, 286, 82, 205, 1, 0, 574, 136535
n10x8192-slot-inner-8192, 285, 82, 208, 1, 0, 576, 136535
n10x8192-slot-inner-8192, 280, 81, 202, 1, 0, 564, 136535
n10x8192-slot-inner-8192, 280, 81, 206, 1, 0, 568, 136535
n10x8192-slot-inner-8192, 285, 88, 209, 1, 0, 583, 136535
n10x8192-slot-inner-8192, 283, 82, 205, 1, 0, 571, 136535
n10x8192-slot-inner-8192, 282, 82, 207, 1, 0, 572, 136535
n10x8192-slot-inner-8192, 279, 82, 205, 1, 0, 567, 136535
n10x8192-slot-inner-8192, 294, 84, 209, 1, 0, 588, 136535
n10x8192-slot-inner-8192, 282, 88, 205, 1, 0, 576, 136535
n10x8192-slot-inner-8192, 280, 81, 204, 1, 0, 566, 136535
n10x8192-slot-inner-8192, 285, 83, 204, 1, 0, 573, 136535
n10x8192-slot-inner-8192, 281, 81, 205, 1, 0, 568, 136535
n10x8192-slot-inner-8192, 279, 81, 205, 1, 0, 566, 136535
n10x8192-slot-inner-8192, 277, 81, 207, 1, 0, 566, 136535
n10x8192-slot-inner-8192, 282, 82, 212, 1, 0, 577, 136535
n10x8192-slot-inner-8192, 280, 81, 203, 1, 0, 565, 136535
n10x8192-slot-inner-8192, 280, 83, 207, 1, 0, 571, 136535
n10x8192-slot-inner-8192, 284, 81, 212, 1, 0, 578, 136535
n10x8192-slot-inner-8192, 283, 83, 212, 1, 0, 579, 136535
n10x8192-slot-inner-8192, 284, 81, 206, 1, 0, 572, 136535
n10x8192-slot-inner-8192, 281, 82, 208, 1, 0, 572, 136535
n10x8192-slot-inner-8192, 279, 82, 210, 1, 0, 572, 136535
n10x8192-slot-inner-8192, 281, 81, 207, 1, 0, 570, 136535
n10x8192-slot-inner-8192, 282, 82, 212, 1, 0, 577, 136535
n10x8192-slot-inner-8192, 284, 82, 210, 1, 0, 577, 136535
n10x8192-slot-inner-8192, 289, 83, 206, 1, 0, 579, 136535
n10x8192-slot-inner-8192, 280, 82, 204, 1, 0, 567, 136535
n10x8192-slot-inner-8192, 283, 81, 203, 1, 0, 568, 136535
n10x8192-slot-inner-8192, 282, 82, 210, 1, 0, 575, 136535
n10x8192-slot-inner-8192, 285, 81, 202, 1, 0, 569, 136535
n10x8192-slot-inner-8192, 285, 83, 206, 1, 0, 575, 136535
n10x8192-slot-inner-8192, 287, 81, 203, 1, 0, 572, 136535
n10x8192-slot-inner-8192, 286, 83, 209, 1, 0, 579, 136535
n10x8192-slot-inner-8192, 280, 82, 205, 1, 0, 568, 136535
n10x8192-slot-inner-8192, 279, 81, 205, 1, 0, 566, 136535
n10x8192-slot-inner-8192, 281, 82, 205, 1, 0, 569, 136535
n10x8192-slot-inner-8192, 281, 81, 203, 1, 0, 566, 136535
n10x8192-slot-inner-8192, 286, 82, 211, 1, 0, 580, 136535
n10x8192-slot-inner-8192, 283, 82, 206, 1, 0, 572, 136535
n10x8192-slot-inner-8192, 286, 82, 207, 1, 0, 576, 136535
n10x8192-slot-inner-8192, 278, 82, 204, 1, 0, 565, 136535
n10x8192-slot-inner-8192, 285, 81, 202, 1, 0, 569, 136535
n10x8192-slot-inner-8192, 280, 82, 205, 1, 0, 568, 136535
n10x8192-slot-inner-8192, 279, 81, 204, 1, 0, 565, 136535
n10x8192-slot-inner-8192, 282, 83, 206, 1, 0, 572, 136535
n10x8192-slot-inner-8192, 281, 83, 207, 1, 0, 572, 136535
n10x8192-slot-inner-8192, 287, 82, 203, 1, 0, 573, 136535
n10x8192-slot-inner-8192, 284, 84, 210, 1, 0, 579, 136535
n10x8192-slot-inner-8192, 280, 81, 205, 1, 0, 567, 136535
n10x8192-slot-inner-8192, 282, 82, 207, 1, 0, 572, 136535
n10x8192-slot-inner-8192, 291, 82, 205, 1, 0, 579, 136535
n10x8192-slot-inner-8192, 282, 82, 208, 1, 0, 573, 136535
n10x8192-slot-inner-8192, 283, 82, 206, 1, 0, 572, 136535
n10x8192-slot-inner-8192, 281, 81, 203, 1, 0, 566, 136535
n10x8192-slot-inner-8192, 282, 82, 208, 1, 0, 573, 136535
n10x8192-slot-inner-8192, 284, 81, 212, 1, 0, 578, 136535
n10x8192-slot-inner-8192, 281, 82, 203, 1, 0, 567, 136535
n10x8192-slot-inner-8192, 282, 82, 204, 1, 0, 569, 136535
n10x8192-slot-inner-8192, 280, 82, 204, 1, 0, 567, 136535
n10x8192-slot-inner-8192, 287, 82, 205, 1, 0, 575, 136535
n10x8192-slot-inner-8192, 286, 82, 206, 1, 0, 575, 136535
n10x8192-slot-inner-8192, 285, 82, 203, 1, 0, 571, 136535
n10x8192-slot-inner-8192, 285, 83, 206, 1, 0, 575, 136535
n10x8192-slot-inner-8192, 284, 82, 203, 1, 0, 570, 136535
n10x8192-slot-inner-8192, 284, 82, 204, 1, 0, 571, 136535
n10x8192-slot-inner-8192, 280, 81, 202, 1, 0, 564, 136535
n10x8192-slot-inner-8192, 286, 82, 208, 1, 0, 577, 136535
n10x8192-slot-inner-8192, 281, 82, 213, 1, 0, 577, 136535
n10x8192-slot-inner-8192, 294, 82, 207, 1, 0, 584, 136535
n10x8192-coef-inner-512, 9, 271, 144, 0, 0, 424, 136535
n10x8192-coef-inner-512, 9, 275, 145, 0, 0, 429, 136535
n10x8192-coef-inner-512, 9, 271, 146, 0, 0, 426, 136535
n10x8192-coef-inner-512, 9, 273, 145, 0, 0, 427, 136535
n10x8192-coef-inner-512, 9, 272, 143, 0, 0, 424, 136535
n10x8192-coef-inner-512, 9, 278, 146, 0, 0, 433, 136535
n10x8192-coef-inner-512, 9, 273, 145, 0, 0, 427, 136535
n10x8192-coef-inner-512, 9, 273, 146, 0, 0, 428, 136535
n10x8192-coef-inner-512, 9, 271, 142, 0, 0, 422, 136535
n10x8192-coef-inner-512, 9, 272, 146, 0, 0, 427, 136535
n10x8192-coef-inner-512, 9, 272, 144, 0, 0, 425, 136535
n10x8192-coef-inner-512, 9, 272, 145, 0, 0, 426, 136535
n10x8192-coef-inner-512, 9, 270, 143, 0, 0, 422, 136535
n10x8192-coef-inner-512, 9, 275, 146, 0, 0, 430, 136535
n10x8192-coef-inner-512, 9, 272, 145, 0, 0, 426, 136535
n10x8192-coef-inner-512, 9, 274, 144, 0, 0, 427, 136535
n10x8192-coef-inner-512, 9, 271, 143, 0, 0, 423, 136535
n10x8192-coef-inner-512, 9, 273, 142, 0, 0, 424, 136535
n10x8192-coef-inner-512, 9, 271, 144, 0, 0, 424, 136535
n10x8192-coef-inner-512, 9, 275, 145, 0, 0, 429, 136535
n10x8192-coef-inner-512, 9, 274, 145, 0, 0, 428, 136535
n10x8192-coef-inner-512, 9, 272, 145, 0, 0, 426, 136535
n10x8192-coef-inner-512, 9, 272, 144, 0, 0, 425, 136535
n10x8192-coef-inner-512, 9, 271, 145, 0, 0, 425, 136535
n10x8192-coef-inner-512, 9, 273, 144, 0, 0, 426, 136535
n10x8192-coef-inner-512, 9, 274, 144, 0, 0, 427, 136535
n10x8192-coef-inner-512, 9, 273, 143, 0, 0, 425, 136535
n10x8192-coef-inner-512, 9, 271, 142, 0, 0, 422, 136535
n10x8192-coef-inner-512, 9, 275, 145, 0, 0, 429, 136535
n10x8192-coef-inner-512, 9, 271, 143, 0, 0, 423, 136535
n10x8192-coef-inner-512, 9, 270, 146, 0, 0, 425, 136535
n10x8192-coef-inner-512, 9, 271, 143, 0, 0, 423, 136535
n10x8192-coef-inner-512, 9, 273, 144, 0, 0, 426, 136535
n10x8192-coef-inner-512, 9, 274, 144, 0, 0, 427, 136535
n10x8192-coef-inner-512, 9, 272, 146, 0, 0, 427, 136535
n10x8192-coef-inner-512, 9, 273, 145, 0, 0, 427, 136535
n10x8192-coef-inner-512, 9, 272, 143, 0, 0, 424, 136535
n10x8192-coef-inner-512, 9, 275, 146, 0, 0, 430, 136535
n10x8192-coef-inner-512, 9, 273, 144, 0, 0, 426, 136535
n10x8192-coef-inner-512, 9, 273, 145, 0, 0, 427, 136535
n10x8192-coef-inner-512, 9, 274, 145, 0, 0, 428, 136535
n10x8192-coef-inner-512, 9, 276, 144, 0, 0, 429, 136535
n10x8192-coef-inner-512, 9, 272, 143, 0, 0, 424, 136535
n10x8192-coef-inner-512, 9, 273, 145, 0, 0, 427, 136535
n10x8192-coef-inner-512, 9, 275, 144, 0, 0, 428, 136535
n10x8192-coef-inner-512, 9, 274, 143, 0, 0, 426, 136535
n10x8192-coef-inner-512, 9, 275, 145, 0, 0, 429, 136535
n10x8192-coef-inner-512, 9, 274, 144, 0, 0, 427, 136535
n10x8192-coef-inner-512, 9, 271, 146, 0, 0, 426, 136535
n10x8192-coef-inner-512, 9, 275, 144, 0, 0, 428, 136535
n10x8192-coef-inner-512, 9, 272, 146, 0, 0, 427, 136535
n10x8192-coef-inner-512, 9, 272, 143, 0, 0, 424, 136535
n10x8192-coef-inner-512, 9, 272, 145, 0, 0, 426, 136535
n10x8192-coef-inner-512, 9, 273, 144, 0, 0, 426, 136535
n10x8192-coef-inner-512, 9, 274, 144, 0, 0, 427, 136535
n10x8192-coef-inner-512, 9, 274, 146, 0, 0, 429, 136535
n10x8192-coef-inner-512, 9, 274, 144, 0, 0, 427, 136535
n10x8192-coef-inner-512, 9, 277, 151, 0, 0, 437, 136535
n10x8192-coef-inner-512, 9, 273, 143, 0, 0, 425, 136535
n10x8192-coef-inner-512, 9, 272, 146, 0, 0, 427, 136535
n10x8192-coef-inner-512, 9, 272, 144, 0, 0, 425, 136535
n10x8192-coef-inner-512, 9, 272, 145, 0, 0, 426, 136535
n10x8192-coef-inner-512, 9, 271, 144, 0, 0, 424, 136535
n10x8192-coef-inner-512, 9, 271, 142, 0, 0, 422, 136535
n10x8192-coef-inner-512, 9, 273, 144, 0, 0, 426, 136535
n10x8192-coef-inner-512, 9, 274, 146, 0, 0, 429, 136535
n10x8192-coef-inner-512, 9, 277, 144, 0, 0, 430, 136535
n10x8192-coef-inner-512, 9, 272, 144, 0, 0, 425, 136535
n10x8192-coef-inner-512, 9, 272, 144, 0, 0, 425, 136535
n10x8192-coef-inner-512, 9, 274, 147, 0, 0, 430, 136535
n10x8192-coef-inner-512, 9, 272, 142, 0, 0, 423, 136535
n10x8192-coef-inner-512, 9, 274, 144, 0, 0, 427, 136535
n10x8192-coef-inner-512, 9, 273, 143, 0, 0, 425, 136535
n10x8192-coef-inner-512, 9, 273, 145, 0, 0, 427, 136535
n10x8192-coef-inner-512, 9, 273, 145, 0, 0, 427, 136535
n10x8192-coef-inner-512, 9, 273, 145, 0, 0, 427, 136535
n10x8192-coef-inner-512, 9, 276, 144, 0, 0, 429, 136535
n10x8192-coef-inner-512, 9, 273, 147, 0, 0, 429, 136535
n10x8192-coef-inner-512, 9, 274, 144, 0, 0, 427, 136535
n10x8192-coef-inner-512, 8, 274, 144, 0, 0, 426, 136535
n10x8192-coef-inner-512, 9, 272, 145, 0, 0, 426, 136535
n10x8192-coef-inner-512, 9, 272, 143, 0, 0, 424, 136535
n10x8192-coef-inner-512, 9, 273, 145, 0, 0, 427, 136535
n10x8192-coef-inner-512, 9, 275, 145, 0, 0, 429, 136535
n10x8192-coef-inner-512, 9, 272, 145, 0, 0, 426, 136535
n10x8192-coef-inner-512, 9, 271, 144, 0, 0, 424, 136535
n10x8192-coef-inner-512, 8, 272, 144, 0, 0, 424, 136535
n10x8192-coef-inner-512, 9, 274, 143, 0, 0, 426, 136535
n10x8192-coef-inner-512, 9, 272, 144, 0, 0, 425, 136535
n10x8192-coef-inner-512, 9, 275, 144, 0, 0, 428, 136535
n10x8192-coef-inner-512, 9, 273, 145, 0, 0, 427, 136535
n10x8192-coef-inner-512, 9, 274, 145, 0, 0, 428, 136535
n10x8192-coef-inner-512, 9, 272, 145, 0, 0, 426, 136535
n10x8192-coef-inner-512, 9, 272, 146, 0, 0, 427, 136535
n10x8192-coef-inner-512, 9, 273, 145, 0, 0, 427, 136535
n10x8192-coef-inner-512, 9, 272, 143, 0, 0, 424, 136535
n10x8192-coef-inner-512, 9, 275, 146, 0, 0, 430, 136535
n10x8192-coef-inner-512, 9, 272, 143, 0, 0, 424, 136535
n10x8192-coef-inner-512, 9, 271, 144, 0, 0, 424, 136535
n10x8192-coef-inner-512, 9, 272, 144, 0, 0, 425, 136535
n10x8192-coef-inner-1024, 12, 267, 132, 0, 0, 411, 136535
n10x8192-coef-inner-1024, 12, 266, 131, 0, 0, 409, 136535
n10x8192-coef-inner-1024, 12, 266, 130, 0, 0, 408, 136535
n10x8192-coef-inner-1024, 12, 267, 132, 0, 0, 411, 136535
n10x8192-coef-inner-1024, 13, 268, 131, 0, 0, 412, 136535
n10x8192-coef-inner-1024, 12, 266, 131, 0, 0, 409, 136535
n10x8192-coef-inner-1024, 12, 264, 130, 0, 0, 406, 136535
n10x8192-coef-inner-1024, 11, 265, 130, 0, 0, 406, 136535
n10x8192-coef-inner-1024, 12, 268, 132, 0, 0, 412, 136535
n10x8192-coef-inner-1024, 12, 267, 130, 0, 0, 409, 136535
n10x8192-coef-inner-1024, 12, 267, 133, 0, 0, 412, 136535
n10x8192-coef-inner-1024, 12, 264, 132, 0, 0, 408, 136535
n10x8192-coef-inner-1024, 15, 267, 132, 0, 0, 414, 136535
n10x8192-coef-inner-1024, 12, 265, 130, 0, 0, 407, 136535
n10x8192-coef-inner-1024, 14, 265, 132, 0, 0, 411, 136535
n10x8192-coef-inner-1024, 12, 266, 130, 0, 0, 408, 136535
n10x8192-coef-inner-1024, 13, 264, 130, 0, 0, 407, 136535
n10x8192-coef-inner-1024, 18, 269, 131, 0, 0, 418, 136535
n10x8192-coef-inner-1024, 12, 264, 131, 0, 0, 407, 136535
n10x8192-coef-inner-1024, 12, 265, 132, 0, 0, 409, 136535
n10x8192-coef-inner-1024, 11, 267, 131, 0, 0, 409, 136535
n10x8192-coef-inner-1024, 12, 267, 132, 0, 0, 411, 136535
n10x8192-coef-inner-1024, 11, 264, 130, 0, 0, 405, 136535
n10x8192-coef-inner-1024, 13, 264, 136, 0, 0, 413, 136535
n10x8192-coef-inner-1024, 12, 267, 133, 0, 0, 412, 136535
n10x8192-coef-inner-1024, 12, 264, 131, 0, 0, 407, 136535
n10x8192-coef-inner-1024, 13, 268, 132, 0, 0, 413, 136535
n10x8192-coef-inner-1024, 12, 266, 131, 0, 0, 409, 136535
n10x8192-coef-inner-1024, 17, 264, 137, 0, 0, 418, 136535
n10x8192-coef-inner-1024, 12, 266, 131, 0, 0, 409, 136535
n10x8192-coef-inner-1024, 12, 268, 131, 0, 0, 411, 136535
n10x8192-coef-inner-1024, 12, 265, 132, 0, 0, 409, 136535
n10x8192-coef-inner-1024, 15, 265, 135, 0, 0, 415, 136535
n10x8192-coef-inner-1024, 12, 266, 132, 0, 0, 410, 136535
n10x8192-coef-inner-1024, 12, 266, 131, 0, 0, 409, 136535
n10x8192-coef-inner-1024, 11, 265, 131, 0, 0, 407, 136535
n10x8192-coef-inner-1024, 13, 265, 143, 0, 0, 421, 136535
n10x8192-coef-inner-1024, 12, 265, 132, 0, 0, 409, 136535
n10x8192-coef-inner-1024, 12, 265, 132, 0, 0, 409, 136535
n10x8192-coef-inner-1024, 11, 267, 131, 0, 0, 409, 136535
n10x8192-coef-inner-1024, 12, 265, 131, 0, 0, 408, 136535
n10x8192-coef-inner-1024, 11, 266, 132, 0, 0, 409, 136535
n10x8192-coef-inner-1024, 13, 268, 132, 0, 0, 413, 136535
n10x8192-coef-inner-1024, 13, 267, 137, 0, 0, 417, 136535
n10x8192-coef-inner-1024, 12, 265, 130, 0, 0, 407, 136535
n10x8192-coef-inner-1024, 11, 267, 131, 0, 0, 409, 136535
n10x8192-coef-inner-1024, 14, 265, 130, 0, 0, 409, 136535
n10x8192-coef-inner-1024, 12, 265, 131, 0, 0, 408, 136535
n10x8192-coef-inner-1024, 11, 267, 130, 0, 0, 408, 136535
n10x8192-coef-inner-1024, 11, 264, 131, 0, 0, 406, 136535
n10x8192-coef-inner-1024, 15, 264, 135, 0, 0, 414, 136535
n10x8192-coef-inner-1024, 12, 264, 131, 0, 0, 407, 136535
n10x8192-coef-inner-1024, 12, 266, 131, 0, 0, 409, 136535
n10x8192-coef-inner-1024, 11, 266, 130, 0, 0, 407, 136535
n10x8192-coef-inner-1024, 12, 264, 131, 0, 0, 407, 136535
n10x8192-coef-inner-1024, 12, 265, 130, 0, 0, 407, 136535
n10x8192-coef-inner-1024, 12, 265, 130, 0, 0, 407, 136535
n10x8192-coef-inner-1024, 19, 267, 135, 0, 0, 421, 136535
n10x8192-coef-inner-1024, 12, 265, 131, 0, 0, 408, 136535
n10x8192-coef-inner-1024, 12, 266, 132, 0, 0, 410, 136535
n10x8192-coef-inner-1024, 11, 266, 130, 0, 0, 407, 136535
n10x8192-coef-inner-1024, 12, 265, 131, 0, 0, 408, 136535
n10x8192-coef-inner-1024, 12, 265, 131, 0, 0, 408, 136535
n10x8192-coef-inner-1024, 12, 264, 129, 0, 0, 405, 136535
n10x8192-coef-inner-1024, 12, 266, 132, 0, 0, 410, 136535
n10x8192-coef-inner-1024, 12, 265, 131, 0, 0, 408, 136535
n10x8192-coef-inner-1024, 11, 265, 131, 0, 0, 407, 136535
n10x8192-coef-inner-1024, 12, 266, 131, 0, 0, 409, 136535
n10x8192-coef-inner-1024, 12, 265, 130, 0, 0, 407, 136535
n10x8192-coef-inner-1024, 11, 268, 132, 0, 0, 411, 136535
n10x8192-coef-inner-1024, 12, 266, 130, 0, 0, 408, 136535
n10x8192-coef-inner-1024, 12, 265, 132, 0, 0, 409, 136535
n10x8192-coef-inner-1024, 12, 266, 132, 0, 0, 410, 136535
n10x8192-coef-inner-1024, 12, 266, 133, 0, 0, 411, 136535
n10x8192-coef-inner-1024, 12, 266, 132, 0, 0, 410, 136535
n10x8192-coef-inner-1024, 11, 266, 130, 0, 0, 407, 136535
n10x8192-coef-inner-1024, 11, 268, 131, 0, 0, 410, 136535
n10x8192-coef-inner-1024, 17, 264, 135, 0, 0, 416, 136535
n10x8192-coef-inner-1024, 11, 266, 131, 0, 0, 408, 136535
n10x8192-coef-inner-1024, 11, 268, 132, 0, 0, 411, 136535
n10x8192-coef-inner-1024, 12, 265, 133, 0, 0, 410, 136535
n10x8192-coef-inner-1024, 11, 266, 130, 0, 0, 407, 136535
n10x8192-coef-inner-1024, 12, 264, 131, 0, 0, 407, 136535
n10x8192-coef-inner-1024, 12, 267, 132, 0, 0, 411, 136535
n10x8192-coef-inner-1024, 12, 264, 130, 0, 0, 406, 136535
n10x8192-coef-inner-1024, 12, 267, 132, 0, 0, 411, 136535
n10x8192-coef-inner-1024, 12, 264, 131, 0, 0, 407, 136535
n10x8192-coef-inner-1024, 12, 265, 131, 0, 0, 408, 136535
n10x8192-coef-inner-1024, 12, 266, 131, 0, 0, 409, 136535
n10x8192-coef-inner-1024, 13, 267, 132, 0, 0, 412, 136535
n10x8192-coef-inner-1024, 13, 267, 130, 0, 0, 410, 136535
n10x8192-coef-inner-1024, 12, 264, 130, 0, 0, 406, 136535
n10x8192-coef-inner-1024, 12, 266, 132, 0, 0, 410, 136535
n10x8192-coef-inner-1024, 12, 266, 131, 0, 0, 409, 136535
n10x8192-coef-inner-1024, 12, 264, 131, 0, 0, 407, 136535
n10x8192-coef-inner-1024, 11, 266, 131, 0, 0, 408, 136535
n10x8192-coef-inner-1024, 12, 265, 130, 0, 0, 407, 136535
n10x8192-coef-inner-1024, 12, 265, 136, 0, 0, 413, 136535
n10x8192-coef-inner-1024, 12, 266, 131, 0, 0, 409, 136535
n10x8192-coef-inner-1024, 12, 265, 132, 0, 0, 409, 136535
n10x8192-coef-inner-2048, 16, 265, 128, 0, 0, 409, 136535
n10x8192-coef-inner-2048, 18, 265, 127, 0, 0, 410, 136535
n10x8192-coef-inner-2048, 16, 267, 127, 0, 0, 410, 136535
n10x8192-coef-inner-2048, 16, 265, 127, 0, 0, 408, 136535
n10x8192-coef-inner-2048, 16, 266, 128, 0, 0, 410, 136535
n10x8192-coef-inner-2048, 16, 265, 127, 0, 0, 408, 136535
n10x8192-coef-inner-2048, 17, 265, 129, 0, 0, 411, 136535
n10x8192-coef-inner-2048, 16, 267, 127, 0, 0, 410, 136535
n10x8192-coef-inner-2048, 17, 265, 128, 0, 0, 410, 136535
n10x8192-coef-inner-2048, 21, 266, 129, 0, 0, 416, 136535
n10x8192-coef-inner-2048, 16, 266, 127, 0, 0, 409, 136535
n10x8192-coef-inner-2048, 16, 264, 128, 0, 0, 408, 136535
n10x8192-coef-inner-2048, 19, 264, 133, 0, 0, 416, 136535
n10x8192-coef-inner-2048, 16, 265, 129, 0, 0, 410, 136535
n10x8192-coef-inner-2048, 16, 265, 129, 0, 0, 410, 136535
n10x8192-coef-inner-2048, 21, 265, 128, 0, 0, 414, 136535
n10x8192-coef-inner-2048, 16, 266, 128, 0, 0, 410, 136535
n10x8192-coef-inner-2048, 16, 266, 127, 0, 0, 409, 136535
n10x8192-coef-inner-2048, 16, 268, 129, 0, 0, 413, 136535
n10x8192-coef-inner-2048, 16, 267, 127, 0, 0, 410, 136535
n10x8192-coef-inner-2048, 16, 265, 128, 0, 0, 409, 136535
n10x8192-coef-inner-2048, 21, 264, 131, 0, 0, 416, 136535
n10x8192-coef-inner-2048, 16, 265, 126, 0, 0, 407, 136535
n10x8192-coef-inner-2048, 16, 263, 129, 0, 0, 408, 136535
n10x8192-coef-inner-2048, 16, 267, 126, 0, 0, 409, 136535
n10x8192-coef-inner-2048, 16, 266, 129, 0, 0, 411, 136535
n10x8192-coef-inner-2048, 16, 266, 128, 0, 0, 410, 136535
n10x8192-coef-inner-2048, 16, 265, 127, 0, 0, 408, 136535
n10x8192-coef-inner-2048, 17, 266, 132, 0, 0, 415, 136535
n10x8192-coef-inner-2048, 16, 265, 128, 0, 0, 409, 136535
n10x8192-coef-inner-2048, 19, 265, 132, 0, 0, 416, 136535
n10x8192-coef-inner-2048, 16, 264, 127, 0, 0, 407, 136535
n10x8192-coef-inner-2048, 16, 264, 128, 0, 0, 408, 136535
n10x8192-coef-inner-2048, 17, 265, 127, 0, 0, 409, 136535
n10x8192-coef-inner-2048, 16, 265, 127, 0, 0, 408, 136535
n10x8192-coef-inner-2048, 17, 264, 130, 0, 0, 411, 136535
n10x8192-coef-inner-2048, 16, 265, 126, 0, 0, 407, 136535
n10x8192-coef-inner-2048, 16, 264, 129, 0, 0, 409, 136535
n10x8192-coef-inner-2048, 16, 266, 126, 0, 0, 408, 136535
n10x8192-coef-inner-2048, 19, 263, 132, 0, 0, 414, 136535
n10x8192-coef-inner-2048, 16, 265, 127, 0, 0, 408, 136535
n10x8192-coef-inner-2048, 19, 266, 128, 0, 0, 413, 136535
n10x8192-coef-inner-2048, 16, 265, 128, 0, 0, 409, 136535
n10x8192-coef-inner-2048, 16, 263, 127, 0, 0, 406, 136535
n10x8192-coef-inner-2048, 16, 264, 127, 0, 0, 407, 136535
n10x8192-coef-inner-2048, 16, 266, 128, 0, 0, 410, 136535
n10x8192-coef-inner-2048, 16, 265, 126, 0, 0, 407, 136535
n10x8192-coef-inner-2048, 16, 266, 128, 0, 0, 410, 136535
n10x8192-coef-inner-2048, 16, 265, 127, 0, 0, 408, 136535
n10x8192-coef-inner-2048, 16, 265, 128, 0, 0, 409, 136535
n10x8192-coef-inner-2048, 16, 265, 126, 0, 0, 407, 136535
n10x8192-coef-inner-2048, 23, 264, 134, 0, 0, 421, 136535
n10x8192-coef-inner-2048, 16, 265, 127, 0, 0, 408, 136535
n10x8192-coef-inner-2048, 16, 264, 129, 0, 0, 409, 136535
n10x8192-coef-inner-2048, 16, 265, 128, 0, 0, 409, 136535
n10x8192-coef-inner-2048, 16, 265, 128, 0, 0, 409, 136535
n10x8192-coef-inner-2048, 16, 266, 127, 0, 0, 409, 136535
n10x8192-coef-inner-2048, 16, 264, 127, 0, 0, 407, 136535
n10x8192-coef-inner-2048, 16, 264, 128, 0, 0, 408, 136535
n10x8192-coef-inner-2048, 16, 265, 129, 0, 0, 410, 136535
n10x8192-coef-inner-2048, 17, 264, 127, 0, 0, 408, 136535
n10x8192-coef-inner-2048, 16, 265, 128, 0, 0, 409, 136535
n10x8192-coef-inner-2048, 16, 264, 127, 0, 0, 407, 136535
n10x8192-coef-inner-2048, 16, 266, 133, 0, 0, 415, 136535
n10x8192-coef-inner-2048, 16, 266, 128, 0, 0, 410, 136535
n10x8192-coef-inner-2048, 16, 264, 127, 0, 0, 407, 136535
n10x8192-coef-inner-2048, 16, 266, 128, 0, 0, 410, 136535
n10x8192-coef-inner-2048, 16, 265, 127, 0, 0, 408, 136535
n10x8192-coef-inner-2048, 16, 264, 128, 0, 0, 408, 136535
n10x8192-coef-inner-2048, 16, 263, 127, 0, 0, 406, 136535
n10x8192-coef-inner-2048, 16, 266, 130, 0, 0, 412, 136535
n10x8192-coef-inner-2048, 16, 266, 127, 0, 0, 409, 136535
n10x8192-coef-inner-2048, 16, 264, 127, 0, 0, 407, 136535
n10x8192-coef-inner-2048, 16, 265, 129, 0, 0, 410, 136535
n10x8192-coef-inner-2048, 16, 264, 128, 0, 0, 408, 136535
n10x8192-coef-inner-2048, 16, 265, 129, 0, 0, 410, 136535
n10x8192-coef-inner-2048, 16, 265, 128, 0, 0, 409, 136535
n10x8192-coef-inner-2048, 18, 264, 129, 0, 0, 411, 136535
n10x8192-coef-inner-2048, 18, 280, 128, 0, 0, 426, 136535
n10x8192-coef-inner-2048, 16, 265, 126, 0, 0, 407, 136535
n10x8192-coef-inner-2048, 16, 267, 130, 0, 0, 413, 136535
n10x8192-coef-inner-2048, 16, 268, 129, 0, 0, 413, 136535
n10x8192-coef-inner-2048, 16, 264, 129, 0, 0, 409, 136535
n10x8192-coef-inner-2048, 20, 265, 134, 0, 0, 419, 136535
n10x8192-coef-inner-2048, 16, 265, 128, 0, 0, 409, 136535
n10x8192-coef-inner-2048, 16, 266, 127, 0, 0, 409, 136535
n10x8192-coef-inner-2048, 16, 264, 127, 0, 0, 407, 136535
n10x8192-coef-inner-2048, 16, 265, 129, 0, 0, 410, 136535
n10x8192-coef-inner-2048, 16, 264, 127, 0, 0, 407, 136535
n10x8192-coef-inner-2048, 16, 265, 131, 0, 0, 412, 136535
n10x8192-coef-inner-2048, 16, 265, 127, 0, 0, 408, 136535
n10x8192-coef-inner-2048, 16, 265, 127, 0, 0, 408, 136535
n10x8192-coef-inner-2048, 16, 266, 128, 0, 0, 410, 136535
n10x8192-coef-inner-2048, 20, 267, 131, 0, 0, 418, 136535
n10x8192-coef-inner-2048, 16, 265, 129, 0, 0, 410, 136535
n10x8192-coef-inner-2048, 16, 265, 128, 0, 0, 409, 136535
n10x8192-coef-inner-2048, 16, 264, 128, 0, 0, 408, 136535
n10x8192-coef-inner-2048, 16, 266, 127, 0, 0, 409, 136535
n10x8192-coef-inner-2048, 16, 263, 127, 0, 0, 406, 136535
n10x8192-coef-inner-2048, 16, 264, 127, 0, 0, 407, 136535
n10x8192-coef-inner-4096, 27, 267, 129, 0, 0, 423, 136535
n10x8192-coef-inner-4096, 30, 268, 132, 0, 0, 430, 136535
n10x8192-coef-inner-4096, 30, 269, 130, 0, 0, 429, 136535
n10x8192-coef-inner-4096, 28, 268, 130, 0, 0, 426, 136535
n10x8192-coef-inner-4096, 29, 268, 129, 0, 0, 426, 136535
n10x8192-coef-inner-4096, 33, 270, 134, 0, 0, 437, 136535
n10x8192-coef-inner-4096, 30, 268, 128, 0, 0, 426, 136535
n10x8192-coef-inner-4096, 34, 266, 134, 0, 0, 434, 136535
n10x8192-coef-inner-4096, 29, 270, 129, 0, 0, 428, 136535
n10x8192-coef-inner-4096, 27, 267, 129, 0, 0, 423, 136535
n10x8192-coef-inner-4096, 31, 267, 128, 0, 0, 426, 136535
n10x8192-coef-inner-4096, 31, 267, 129, 0, 0, 427, 136535
n10x8192-coef-inner-4096, 27, 267, 131, 0, 0, 425, 136535
n10x8192-coef-inner-4096, 36, 269, 128, 0, 0, 433, 136535
n10x8192-coef-inner-4096, 29, 270, 130, 0, 0, 429, 136535
n10x8192-coef-inner-4096, 30, 269, 135, 0, 0, 434, 136535
n10x8192-coef-inner-4096, 30, 267, 128, 0, 0, 425, 136535
n10x8192-coef-inner-4096, 27, 269, 130, 0, 0, 426, 136535
n10x8192-coef-inner-4096, 27, 270, 129, 0, 0, 426, 136535
n10x8192-coef-inner-4096, 27, 269, 129, 0, 0, 425, 136535
n10x8192-coef-inner-4096, 32, 270, 130, 0, 0, 432, 136535
n10x8192-coef-inner-4096, 34, 268, 133, 0, 0, 435, 136535
n10x8192-coef-inner-4096, 29, 270, 129, 0, 0, 428, 136535
n10x8192-coef-inner-4096, 31, 269, 129, 0, 0, 429, 136535
n10x8192-coef-inner-4096, 31, 270, 134, 0, 0, 435, 136535
n10x8192-coef-inner-4096, 30, 267, 128, 0, 0, 425, 136535
n10x8192-coef-inner-4096, 28, 270, 129, 0, 0, 427, 136535
n10x8192-coef-inner-4096, 28, 269, 129, 0, 0, 426, 136535
n10x8192-coef-inner-4096, 28, 269, 129, 0, 0, 426, 136535
n10x8192-coef-inner-4096, 28, 268, 130, 0, 0, 426, 136535
n10x8192-coef-inner-4096, 29, 271, 129, 0, 0, 429, 136535
n10x8192-coef-inner-4096, 27, 270, 129, 0, 0, 426, 136535
n10x8192-coef-inner-4096, 30, 267, 127, 0, 0, 424, 136535
n10x8192-coef-inner-4096, 28, 268, 130, 0, 0, 426, 136535
n10x8192-coef-inner-4096, 29, 269, 130, 0, 0, 428, 136535
n10x8192-coef-inner-4096, 31, 269, 130, 0, 0, 430, 136535
n10x8192-coef-inner-4096, 31, 267, 129, 0, 0, 427, 136535
n10x8192-coef-inner-4096, 27, 266, 129, 0, 0, 422, 136535
n10x8192-coef-inner-4096, 32, 269, 129, 0, 0, 430, 136535
n10x8192-coef-inner-4096, 27, 269, 130, 0, 0, 426, 136535
n10x8192-coef-inner-4096, 27, 270, 129, 0, 0, 426, 136535
n10x8192-coef-inner-4096, 32, 269, 129, 0, 0, 430, 136535
n10x8192-coef-inner-4096, 37, 269, 131, 0, 0, 437, 136535
n10x8192-coef-inner-4096, 39, 268, 128, 0, 0, 435, 136535
n10x8192-coef-inner-4096, 29, 268, 130, 0, 0, 427, 136535
n10x8192-coef-inner-4096, 28, 269, 129, 0, 0, 426, 136535
n10x8192-coef-inner-4096, 32, 273, 135, 0, 0, 440, 136535
n10x8192-coef-inner-4096, 27, 269, 128, 0, 0, 424, 136535
n10x8192-coef-inner-4096, 27, 267, 130, 0, 0, 424, 136535
n10x8192-coef-inner-4096, 33, 268, 130, 0, 0, 431, 136535
n10x8192-coef-inner-4096, 40, 267, 134, 0, 0, 441, 136535
n10x8192-coef-inner-4096, 37, 269, 135, 0, 0, 441, 136535
n10x8192-coef-inner-4096, 27, 268, 129, 0, 0, 424, 136535
n10x8192-coef-inner-4096, 32, 269, 131, 0, 0, 432, 136535
n10x8192-coef-inner-4096, 31, 267, 128, 0, 0, 426, 136535
n10x8192-coef-inner-4096, 27, 269, 130, 0, 0, 426, 136535
n10x8192-coef-inner-4096, 27, 268, 129, 0, 0, 424, 136535
n10x8192-coef-inner-4096, 27, 270, 130, 0, 0, 427, 136535
n10x8192-coef-inner-4096, 30, 270, 130, 0, 0, 430, 136535
n10x8192-coef-inner-4096, 30, 265, 128, 0, 0, 423, 136535
n10x8192-coef-inner-4096, 37, 268, 130, 0, 0, 435, 136535
n10x8192-coef-inner-4096, 28, 268, 129, 0, 0, 425, 136535
n10x8192-coef-inner-4096, 27, 267, 129, 0, 0, 423, 136535
n10x8192-coef-inner-4096, 29, 270, 128, 0, 0, 427, 136535
n10x8192-coef-inner-4096, 28, 267, 129, 0, 0, 424, 136535
n10x8192-coef-inner-4096, 30, 268, 133, 0, 0, 431, 136535
n10x8192-coef-inner-4096, 29, 267, 128, 0, 0, 424, 136535
n10x8192-coef-inner-4096, 27, 268, 129, 0, 0, 424, 136535
n10x8192-coef-inner-4096, 29, 268, 129, 0, 0, 426, 136535
n10x8192-coef-inner-4096, 30, 268, 128, 0, 0, 426, 136535
n10x8192-coef-inner-4096, 31, 267, 134, 0, 0, 432, 136535
n10x8192-coef-inner-4096, 27, 268, 130, 0, 0, 425, 136535
n10x8192-coef-inner-4096, 31, 269, 129, 0, 0, 429, 136535
n10x8192-coef-inner-4096, 29, 267, 129, 0, 0, 425, 136535
n10x8192-coef-inner-4096, 27, 268, 130, 0, 0, 425, 136535
n10x8192-coef-inner-4096, 29, 267, 127, 0, 0, 423, 136535
n10x8192-coef-inner-4096, 28, 269, 130, 0, 0, 427, 136535
n10x8192-coef-inner-4096, 28, 266, 128, 0, 0, 422, 136535
n10x8192-coef-inner-4096, 27, 268, 129, 0, 0, 424, 136535
n10x8192-coef-inner-4096, 27, 269, 129, 0, 0, 425, 136535
n10x8192-coef-inner-4096, 31, 269, 128, 0, 0, 428, 136535
n10x8192-coef-inner-4096, 27, 269, 128, 0, 0, 424, 136535
n10x8192-coef-inner-4096, 27, 268, 130, 0, 0, 425, 136535
n10x8192-coef-inner-4096, 27, 267, 129, 0, 0, 423, 136535
n10x8192-coef-inner-4096, 30, 267, 128, 0, 0, 425, 136535
n10x8192-coef-inner-4096, 28, 269, 129, 0, 0, 426, 136535
n10x8192-coef-inner-4096, 32, 267, 135, 0, 0, 434, 136535
n10x8192-coef-inner-4096, 32, 268, 130, 0, 0, 430, 136535
n10x8192-coef-inner-4096, 28, 268, 128, 0, 0, 424, 136535
n10x8192-coef-inner-4096, 30, 267, 128, 0, 0, 425, 136535
n10x8192-coef-inner-4096, 39, 266, 134, 0, 0, 439, 136535
n10x8192-coef-inner-4096, 31, 271, 134, 0, 0, 436, 136535
n10x8192-coef-inner-4096, 28, 271, 129, 0, 0, 428, 136535
n10x8192-coef-inner-4096, 27, 269, 138, 0, 0, 434, 136535
n10x8192-coef-inner-4096, 27, 270, 129, 0, 0, 426, 136535
n10x8192-coef-inner-4096, 30, 268, 128, 0, 0, 426, 136535
n10x8192-coef-inner-4096, 30, 270, 130, 0, 0, 430, 136535
n10x8192-coef-inner-4096, 30, 267, 128, 0, 0, 425, 136535
n10x8192-coef-inner-4096, 27, 268, 131, 0, 0, 426, 136535
n10x8192-coef-inner-4096, 27, 270, 129, 0, 0, 426, 136535
n10x8192-coef-inner-8192, 58, 275, 155, 1, 0, 489, 136535
n10x8192-coef-inner-8192, 51, 275, 145, 1, 0, 472, 136535
n10x8192-coef-inner-8192, 53, 276, 150, 1, 0, 480, 136535
n10x8192-coef-inner-8192, 52, 276, 145, 1, 0, 474, 136535
n10x8192-coef-inner-8192, 53, 274, 148, 1, 0, 476, 136535
n10x8192-coef-inner-8192, 54, 277, 146, 1, 0, 478, 136535
n10x8192-coef-inner-8192, 52, 274, 148, 1, 0, 475, 136535
n10x8192-coef-inner-8192, 55, 275, 155, 1, 0, 486, 136535
n10x8192-coef-inner-8192, 51, 275, 148, 1, 0, 475, 136535
n10x8192-coef-inner-8192, 59, 275, 148, 1, 0, 483, 136535
n10x8192-coef-inner-8192, 54, 273, 153, 1, 0, 481, 136535
n10x8192-coef-inner-8192, 52, 276, 144, 1, 0, 473, 136535
n10x8192-coef-inner-8192, 53, 274, 148, 1, 0, 476, 136535
n10x8192-coef-inner-8192, 52, 276, 154, 1, 0, 483, 136535
n10x8192-coef-inner-8192, 51, 276, 149, 1, 0, 477, 136535
n10x8192-coef-inner-8192, 49, 275, 147, 1, 0, 472, 136535
n10x8192-coef-inner-8192, 52, 274, 146, 1, 0, 473, 136535
n10x8192-coef-inner-8192, 49, 276, 153, 1, 0, 479, 136535
n10x8192-coef-inner-8192, 49, 274, 147, 1, 0, 471, 136535
n10x8192-coef-inner-8192, 55, 276, 156, 1, 0, 488, 136535
n10x8192-coef-inner-8192, 55, 275, 144, 1, 0, 475, 136535
n10x8192-coef-inner-8192, 52, 273, 147, 1, 0, 473, 136535
n10x8192-coef-inner-8192, 53, 274, 149, 1, 0, 477, 136535
n10x8192-coef-inner-8192, 51, 277, 150, 1, 0, 479, 136535
n10x8192-coef-inner-8192, 51, 275, 142, 1, 0, 469, 136535
n10x8192-coef-inner-8192, 52, 275, 146, 1, 0, 474, 136535
n10x8192-coef-inner-8192, 49, 273, 147, 1, 0, 470, 136535
n10x8192-coef-inner-8192, 50, 274, 154, 1, 0, 479, 136535
n10x8192-coef-inner-8192, 53, 274, 146, 1, 0, 474, 136535
n10x8192-coef-inner-8192, 50, 273, 146, 1, 0, 470, 136535
n10x8192-coef-inner-8192, 52, 275, 149, 1, 0, 477, 136535
n10x8192-coef-inner-8192, 54, 275, 143, 1, 0, 473, 136535
n10x8192-coef-inner-8192, 52, 274, 146, 1, 0, 473, 136535
n10x8192-coef-inner-8192, 50, 276, 144, 1, 0, 471, 136535
n10x8192-coef-inner-8192, 54, 275, 144, 1, 0, 474, 136535
n10x8192-coef-inner-8192, 51, 274, 147, 1, 0, 473, 136535
n10x8192-coef-inner-8192, 53, 274, 144, 1, 0, 472, 136535
n10x8192-coef-inner-8192, 57, 274, 142, 1, 0, 474, 136535
n10x8192-coef-inner-8192, 49, 273, 148, 1, 0, 471, 136535
n10x8192-coef-inner-8192, 53, 273, 167, 1, 0, 494, 136535
n10x8192-coef-inner-8192, 59, 276, 155, 1, 0, 491, 136535
n10x8192-coef-inner-8192, 53, 273, 142, 1, 0, 469, 136535
n10x8192-coef-inner-8192, 55, 275, 144, 1, 0, 475, 136535
n10x8192-coef-inner-8192, 51, 275, 147, 1, 0, 474, 136535
n10x8192-coef-inner-8192, 52, 277, 149, 1, 0, 479, 136535
n10x8192-coef-inner-8192, 52, 276, 147, 1, 0, 476, 136535
n10x8192-coef-inner-8192, 56, 274, 142, 1, 0, 473, 136535
n10x8192-coef-inner-8192, 52, 273, 149, 1, 0, 475, 136535
n10x8192-coef-inner-8192, 52, 275, 142, 1, 0, 470, 136535
n10x8192-coef-inner-8192, 53, 273, 153, 1, 0, 480, 136535
n10x8192-coef-inner-8192, 52, 275, 148, 1, 0, 476, 136535
n10x8192-coef-inner-8192, 52, 274, 150, 1, 0, 477, 136535
n10x8192-coef-inner-8192, 50, 276, 143, 1, 0, 470, 136535
n10x8192-coef-inner-8192, 51, 275, 143, 1, 0, 470, 136535
n10x8192-coef-inner-8192, 52, 279, 147, 1, 0, 479, 136535
n10x8192-coef-inner-8192, 52, 275, 148, 1, 0, 476, 136535
n10x8192-coef-inner-8192, 52, 274, 148, 1, 0, 475, 136535
n10x8192-coef-inner-8192, 55, 275, 142, 1, 0, 473, 136535
n10x8192-coef-inner-8192, 53, 274, 147, 1, 0, 475, 136535
n10x8192-coef-inner-8192, 52, 274, 146, 1, 0, 473, 136535
n10x8192-coef-inner-8192, 50, 276, 142, 1, 0, 469, 136535
n10x8192-coef-inner-8192, 57, 276, 144, 1, 0, 478, 136535
n10x8192-coef-inner-8192, 53, 275, 155, 1, 0, 484, 136535
n10x8192-coef-inner-8192, 51, 276, 148, 1, 0, 476, 136535
n10x8192-coef-inner-8192, 50, 274, 147, 1, 0, 472, 136535
n10x8192-coef-inner-8192, 53, 274, 142, 1, 0, 470, 136535
n10x8192-coef-inner-8192, 50, 275, 148, 1, 0, 474, 136535
n10x8192-coef-inner-8192, 51, 273, 154, 1, 0, 479, 136535
n10x8192-coef-inner-8192, 52, 278, 144, 1, 0, 475, 136535
n10x8192-coef-inner-8192, 56, 273, 153, 1, 0, 483, 136535
n10x8192-coef-inner-8192, 52, 275, 147, 1, 0, 475, 136535
n10x8192-coef-inner-8192, 50, 275, 142, 1, 0, 468, 136535
n10x8192-coef-inner-8192, 49, 276, 147, 1, 0, 473, 136535
n10x8192-coef-inner-8192, 52, 274, 142, 1, 0, 469, 136535
n10x8192-coef-inner-8192, 50, 275, 147, 1, 0, 473, 136535
n10x8192-coef-inner-8192, 52, 275, 145, 1, 0, 473, 136535
n10x8192-coef-inner-8192, 50, 276, 149, 1, 0, 476, 136535
n10x8192-coef-inner-8192, 52, 275, 143, 1, 0, 471, 136535
n10x8192-coef-inner-8192, 51, 273, 147, 1, 0, 472, 136535
n10x8192-coef-inner-8192, 50, 274, 144, 1, 0, 469, 136535
n10x8192-coef-inner-8192, 51, 276, 143, 1, 0, 471, 136535
n10x8192-coef-inner-8192, 50, 276, 148, 1, 0, 475, 136535
n10x8192-coef-inner-8192, 50, 274, 147, 1, 0, 472, 136535
n10x8192-coef-inner-8192, 52, 276, 148, 1, 0, 477, 136535
n10x8192-coef-inner-8192, 49, 274, 149, 1, 0, 473, 136535
n10x8192-coef-inner-8192, 52, 276, 143, 1, 0, 472, 136535
n10x8192-coef-inner-8192, 53, 274, 146, 1, 0, 474, 136535
n10x8192-coef-inner-8192, 51, 274, 146, 1, 0, 472, 136535
n10x8192-coef-inner-8192, 52, 273, 149, 1, 0, 475, 136535
n10x8192-coef-inner-8192, 55, 275, 154, 1, 0, 485, 136535
n10x8192-coef-inner-8192, 53, 275, 149, 1, 0, 478, 136535
n10x8192-coef-inner-8192, 50, 280, 144, 1, 0, 475, 136535
n10x8192-coef-inner-8192, 49, 274, 148, 1, 0, 472, 136535
n10x8192-coef-inner-8192, 52, 275, 146, 1, 0, 474, 136535
n10x8192-coef-inner-8192, 53, 277, 155, 1, 0, 486, 136535
n10x8192-coef-inner-8192, 53, 276, 149, 1, 0, 479, 136535
n10x8192-coef-inner-8192, 49, 275, 148, 1, 0, 473, 136535
n10x8192-coef-inner-8192, 54, 275, 147, 1, 0, 477, 136535
n10x8192-coef-inner-8192, 51, 275, 149, 1, 0, 476, 136535
n10x8192-coef-inner-8192, 53, 275, 149, 1, 0, 478, 136535
n25x8192-coef-sum-512, 14, 341, 13, 0, 0, 368, 204801
n25x8192-coef-sum-512, 9, 349, 15, 0, 0, 373, 204801
n25x8192-coef-sum-512, 9, 344, 13, 0, 0, 366, 204801
n25x8192-coef-sum-512, 9, 345, 13, 0, 0, 367, 204801
n25x8192-coef-sum-512, 9, 344, 13, 0, 0, 366, 204801
n25x8192-coef-sum-512, 10, 341, 13, 0, 0, 364, 204801
n25x8192-coef-sum-512, 9, 348, 13, 0, 0, 370, 204801
n25x8192-coef-sum-512, 9, 347, 13, 0, 0, 369, 204801
n25x8192-coef-sum-512, 9, 342, 12, 0, 0, 363, 204801
n25x8192-coef-sum-512, 9, 347, 13, 0, 0, 369, 204801
n25x8192-coef-sum-512, 9, 348, 14, 0, 0, 371, 204801
n25x8192-coef-sum-512, 9, 345, 13, 0, 0, 367, 204801
n25x8192-coef-sum-512, 9, 344, 13, 0, 0, 366, 204801
n25x8192-coef-sum-512, 9, 351, 14, 0, 0, 374, 204801
n25x8192-coef-sum-512, 9, 347, 13, 0, 0, 369, 204801
n25x8192-coef-sum-512, 9, 348, 13, 0, 0, 370, 204801
n25x8192-coef-sum-512, 9, 347, 14, 0, 0, 370, 204801
n25x8192-coef-sum-512, 9, 341, 13, 0, 0, 363, 204801
n25x8192-coef-sum-512, 9, 346, 13, 0, 0, 368, 204801
n25x8192-coef-sum-512, 9, 345, 13, 0, 0, 367, 204801
n25x8192-coef-sum-512, 9, 342, 13, 0, 0, 364, 204801
n25x8192-coef-sum-512, 9, 344, 13, 0, 0, 366, 204801
n25x8192-coef-sum-512, 9, 345, 14, 0, 0, 368, 204801
n25x8192-coef-sum-512, 9, 344, 13, 0, 0, 366, 204801
n25x8192-coef-sum-512, 9, 344, 13, 0, 0, 366, 204801
n25x8192-coef-sum-512, 9, 344, 14, 0, 0, 367, 204801
n25x8192-coef-sum-512, 9, 344, 13, 0, 0, 366, 204801
n25x8192-coef-sum-512, 9, 350, 13, 0, 0, 372, 204801
n25x8192-coef-sum-512, 9, 342, 13, 0, 0, 364, 204801
n25x8192-coef-sum-512, 9, 344, 13, 0, 0, 366, 204801
n25x8192-coef-sum-512, 10, 347, 13, 0, 0, 370, 204801
n25x8192-coef-sum-512, 9, 344, 13, 0, 0, 366, 204801
n25x8192-coef-sum-512, 9, 347, 13, 0, 0, 369, 204801
n25x8192-coef-sum-512, 9, 344, 13, 0, 0, 366, 204801
n25x8192-coef-sum-512, 9, 346, 14, 0, 0, 369, 204801
n25x8192-coef-sum-512, 9, 347, 13, 0, 0, 369, 204801
n25x8192-coef-sum-512, 9, 341, 14, 0, 0, 364, 204801
n25x8192-coef-sum-512, 9, 344, 13, 0, 0, 366, 204801
n25x8192-coef-sum-512, 9, 342, 13, 0, 0, 364, 204801
n25x8192-coef-sum-512, 9, 341, 15, 0, 0, 365, 204801
n25x8192-coef-sum-512, 9, 345, 13, 0, 0, 367, 204801
n25x8192-coef-sum-512, 9, 344, 15, 0, 0, 368, 204801
n25x8192-coef-sum-512, 9, 345, 13, 0, 0, 367, 204801
n25x8192-coef-sum-512, 9, 345, 13, 0, 0, 367, 204801
n25x8192-coef-sum-512, 9, 347, 13, 0, 0, 369, 204801
n25x8192-coef-sum-512, 9, 356, 13, 0, 0, 378, 204801
n25x8192-coef-sum-512, 9, 345, 13, 0, 0, 367, 204801
n25x8192-coef-sum-512, 9, 345, 14, 0, 0, 368, 204801
n25x8192-coef-sum-512, 9, 342, 13, 0, 0, 364, 204801
n25x8192-coef-sum-512, 9, 345, 13, 0, 0, 367, 204801
n25x8192-coef-sum-512, 9, 348, 13, 0, 0, 370, 204801
n25x8192-coef-sum-512, 9, 345, 13, 0, 0, 367, 204801
n25x8192-coef-sum-512, 9, 345, 14, 0, 0, 368, 204801
n25x8192-coef-sum-512, 9, 344, 13, 0, 0, 366, 204801
n25x8192-coef-sum-512, 9, 342, 13, 0, 0, 364, 204801
n25x8192-coef-sum-512, 9, 346, 13, 0, 0, 368, 204801
n25x8192-coef-sum-512, 9, 342, 13, 0, 0, 364, 204801
n25x8192-coef-sum-512, 9, 346, 14, 0, 0, 369, 204801
n25x8192-coef-sum-512, 9, 344, 13, 0, 0, 366, 204801
n25x8192-coef-sum-512, 9, 340, 13, 0, 0, 362, 204801
n25x8192-coef-sum-512, 9, 347, 13, 0, 0, 369, 204801
n25x8192-coef-sum-512, 9, 347, 14, 0, 0, 370, 204801
n25x8192-coef-sum-512, 9, 344, 13, 0, 0, 366, 204801
n25x8192-coef-sum-512, 9, 345, 13, 0, 0, 367, 204801
n25x8192-coef-sum-512, 9, 344, 13, 0, 0, 366, 204801
n25x8192-coef-sum-512, 9, 342, 13, 0, 0, 364, 204801
n25x8192-coef-sum-512, 9, 347, 13, 0, 0, 369, 204801
n25x8192-coef-sum-512, 9, 345, 14, 0, 0, 368, 204801
n25x8192-coef-sum-512, 9, 342, 13, 0, 0, 364, 204801
n25x8192-coef-sum-512, 9, 343, 14, 0, 0, 366, 204801
n25x8192-coef-sum-512, 9, 346, 14, 0, 0, 369, 204801
n25x8192-coef-sum-512, 9, 342, 13, 0, 0, 364, 204801
n25x8192-coef-sum-512, 9, 343, 13, 0, 0, 365, 204801
n25x8192-coef-sum-512, 9, 346, 15, 0, 0, 370, 204801
n25x8192-coef-sum-512, 9, 344, 14, 0, 0, 367, 204801
n25x8192-coef-sum-512, 9, 345, 13, 0, 0, 367, 204801
n25x8192-coef-sum-512, 9, 341, 13, 0, 0, 363, 204801
n25x8192-coef-sum-512, 9, 347, 14, 0, 0, 370, 204801
n25x8192-coef-sum-512, 9, 347, 13, 0, 0, 369, 204801
n25x8192-coef-sum-512, 9, 340, 13, 0, 0, 362, 204801
n25x8192-coef-sum-512, 9, 346, 13, 0, 0, 368, 204801
n25x8192-coef-sum-512, 9, 346, 13, 0, 0, 368, 204801
n25x8192-coef-sum-512, 9, 340, 13, 0, 0, 362, 204801
n25x8192-coef-sum-512, 9, 346, 13, 0, 0, 368, 204801
n25x8192-coef-sum-512, 10, 346, 13, 0, 0, 369, 204801
n25x8192-coef-sum-512, 10, 346, 13, 0, 0, 369, 204801
n25x8192-coef-sum-512, 9, 346, 13, 0, 0, 368, 204801
n25x8192-coef-sum-512, 9, 341, 13, 0, 0, 363, 204801
n25x8192-coef-sum-512, 9, 344, 13, 0, 0, 366, 204801
n25x8192-coef-sum-512, 9, 346, 13, 0, 0, 368, 204801
n25x8192-coef-sum-512, 9, 341, 13, 0, 0, 363, 204801
n25x8192-coef-sum-512, 10, 347, 13, 0, 0, 370, 204801
n25x8192-coef-sum-512, 9, 344, 13, 0, 0, 366, 204801
n25x8192-coef-sum-512, 9, 345, 13, 0, 0, 367, 204801
n25x8192-coef-sum-512, 9, 348, 13, 0, 0, 370, 204801
n25x8192-coef-sum-512, 9, 345, 13, 0, 0, 367, 204801
n25x8192-coef-sum-512, 9, 344, 13, 0, 0, 366, 204801
n25x8192-coef-sum-512, 9, 343, 13, 0, 0, 365, 204801
n25x8192-coef-sum-512, 9, 343, 13, 0, 0, 365, 204801
n25x8192-coef-sum-512, 9, 345, 13, 0, 0, 367, 204801
n25x8192-coef-sum-1024, 16, 333, 11, 0, 0, 360, 204801
n25x8192-coef-sum-1024, 12, 333, 13, 0, 0, 358, 204801
n25x8192-coef-sum-1024, 13, 332, 10, 0, 0, 355, 204801
n25x8192-coef-sum-1024, 13, 333, 11, 0, 0, 357, 204801
n25x8192-coef-sum-1024, 13, 335, 12, 0, 0, 360, 204801
n25x8192-coef-sum-1024, 13, 334, 11, 0, 0, 358, 204801
n25x8192-coef-sum-1024, 13, 336, 10, 0, 0, 359, 204801
n25x8192-coef-sum-1024, 13, 333, 11, 0, 0, 357, 204801
n25x8192-coef-sum-1024, 13, 333, 10, 0, 0, 356, 204801
n25x8192-coef-sum-1024, 15, 335, 10, 0, 0, 360, 204801
n25x8192-coef-sum-1024, 13, 332, 10, 0, 0, 355, 204801
n25x8192-coef-sum-1024, 13, 335, 11, 0, 0, 359, 204801
n25x8192-coef-sum-1024, 13, 342, 12, 0, 0, 367, 204801
n25x8192-coef-sum-1024, 13, 332, 10, 0, 0, 355, 204801
n25x8192-coef-sum-1024, 12, 336, 11, 0, 0, 359, 204801
n25x8192-coef-sum-1024, 13, 333, 11, 0, 0, 357, 204801
n25x8192-coef-sum-1024, 13, 335, 11, 0, 0, 359, 204801
n25x8192-coef-sum-1024, 12, 335, 10, 0, 0, 357, 204801
n25x8192-coef-sum-1024, 13, 332, 10, 0, 0, 355, 204801
n25x8192-coef-sum-1024, 12, 334, 10, 0, 0, 356, 204801
n25x8192-coef-sum-1024, 18, 337, 10, 0, 0, 365, 204801
n25x8192-coef-sum-1024, 13, 331, 10, 0, 0, 354, 204801
n25x8192-coef-sum-1024, 12, 339, 10, 0, 0, 361, 204801
n25x8192-coef-sum-1024, 13, 336, 10, 0, 0, 359, 204801
n25x8192-coef-sum-1024, 13, 333, 10, 0, 0, 356, 204801
n25x8192-coef-sum-1024, 13, 336, 10, 0, 0, 359, 204801
n25x8192-coef-sum-1024, 13, 331, 10, 0, 0, 354, 204801
n25x8192-coef-sum-1024, 12, 334, 10, 0, 0, 356, 204801
n25x8192-coef-sum-1024, 13, 334, 10, 0, 0, 357, 204801
n25x8192-coef-sum-1024, 13, 333, 10, 0, 0, 356, 204801
n25x8192-coef-sum-1024, 13, 336, 10, 0, 0, 359, 204801
n25x8192-coef-sum-1024, 13, 333, 10, 0, 0, 356, 204801
n25x8192-coef-sum-1024, 13, 335, 11, 0, 0, 359, 204801
n25x8192-coef-sum-1024, 13, 335, 11, 0, 0, 359, 204801
n25x8192-coef-sum-1024, 13, 332, 10, 0, 0, 355, 204801
n25x8192-coef-sum-1024, 13, 336, 11, 0, 0, 360, 204801
n25x8192-coef-sum-1024, 12, 332, 10, 0, 0, 354, 204801
n25x8192-coef-sum-1024, 13, 331, 10, 0, 0, 354, 204801
n25x8192-coef-sum-1024, 13, 334, 11, 0, 0, 358, 204801
n25x8192-coef-sum-1024, 13, 334, 10, 0, 0, 357, 204801
n25x8192-coef-sum-1024, 12, 332, 10, 0, 0, 354, 204801
n25x8192-coef-sum-1024, 13, 334, 10, 0, 0, 357, 204801
n25x8192-coef-sum-1024, 13, 333, 10, 0, 0, 356, 204801
n25x8192-coef-sum-1024, 12, 333, 10, 0, 0, 355, 204801
n25x8192-coef-sum-1024, 13, 334, 10, 0, 0, 357, 204801
n25x8192-coef-sum-1024, 18, 331, 10, 0, 0, 359, 204801
n25x8192-coef-sum-1024, 13, 334, 11, 0, 0, 358, 204801
n25x8192-coef-sum-1024, 13, 334, 10, 0, 0, 357, 204801
n25x8192-coef-sum-1024, 13, 332, 10, 0, 0, 355, 204801
n25x8192-coef-sum-1024, 12, 334, 10, 0, 0, 356, 204801
n25x8192-coef-sum-1024, 14, 332, 11, 0, 0, 357, 204801
n25x8192-coef-sum-1024, 12, 332, 10, 0, 0, 354, 204801
n25x8192-coef-sum-1024, 13, 332, 10, 0, 0, 355, 204801
n25x8192-coef-sum-1024, 13, 331, 10, 0, 0, 354, 204801
n25x8192-coef-sum-1024, 13, 334, 10, 0, 0, 357, 204801
n25x8192-coef-sum-1024, 13, 333, 11, 0, 0, 357, 204801
n25x8192-coef-sum-1024, 16, 334, 11, 0, 0, 361, 204801
n25x8192-coef-sum-1024, 13, 335, 10, 0, 0, 358, 204801
n25x8192-coef-sum-1024, 16, 340, 10, 0, 0, 366, 204801
n25x8192-coef-sum-1024, 13, 330, 10, 0, 0, 353, 204801
n25x8192-coef-sum-1024, 13, 331, 10, 0, 0, 354, 204801
n25x8192-coef-sum-1024, 12, 332, 10, 0, 0, 354, 204801
n25x8192-coef-sum-1024, 12, 335, 10, 0, 0, 357, 204801
n25x8192-coef-sum-1024, 12, 331, 10, 0, 0, 353, 204801
n25x8192-coef-sum-1024, 12, 331, 10, 0, 0, 353, 204801
n25x8192-coef-sum-1024, 12, 333, 10, 0, 0, 355, 204801
n25x8192-coef-sum-1024, 14, 332, 10, 0, 0, 356, 204801
n25x8192-coef-sum-1024, 12, 335, 10, 0, 0, 357, 204801
n25x8192-coef-sum-1024, 13, 330, 10, 0, 0, 353, 204801
n25x8192-coef-sum-1024, 12, 332, 10, 0, 0, 354, 204801
n25x8192-coef-sum-1024, 13, 333, 10, 0, 0, 356, 204801
n25x8192-coef-sum-1024, 12, 331, 11, 0, 0, 354, 204801
n25x8192-coef-sum-1024, 13, 333, 10, 0, 0, 356, 204801
n25x8192-coef-sum-1024, 13, 335, 10, 0, 0, 358, 204801
n25x8192-coef-sum-1024, 13, 335, 10, 0, 0, 358, 204801
n25x8192-coef-sum-1024, 13, 335, 10, 0, 0, 358, 204801
n25x8192-coef-sum-1024, 14, 333, 10, 0, 0, 357, 204801
n25x8192-coef-sum-1024, 13, 332, 10, 0, 0, 355, 204801
n25x8192-coef-sum-1024, 12, 333, 10, 0, 0, 355, 204801
n25x8192-coef-sum-1024, 13, 330, 10, 0, 0, 353, 204801
n25x8192-coef-sum-1024, 13, 333, 10, 0, 0, 356, 204801
n25x8192-coef-sum-1024, 13, 333, 10, 0, 0, 356, 204801
n25x8192-coef-sum-1024, 16, 333, 10, 0, 0, 359, 204801
n25x8192-coef-sum-1024, 13, 335, 10, 0, 0, 358, 204801
n25x8192-coef-sum-1024, 12, 333, 10, 0, 0, 355, 204801
n25x8192-coef-sum-1024, 14, 337, 10, 0, 0, 361, 204801
n25x8192-coef-sum-1024, 12, 335, 10, 0, 0, 357, 204801
n25x8192-coef-sum-1024, 13, 333, 10, 0, 0, 356, 204801
n25x8192-coef-sum-1024, 13, 333, 10, 0, 0, 356, 204801
n25x8192-coef-sum-1024, 13, 332, 10, 0, 0, 355, 204801
n25x8192-coef-sum-1024, 12, 332, 10, 0, 0, 354, 204801
n25x8192-coef-sum-1024, 16, 332, 10, 0, 0, 358, 204801
n25x8192-coef-sum-1024, 13, 331, 10, 0, 0, 354, 204801
n25x8192-coef-sum-1024, 12, 332, 10, 0, 0, 354, 204801
n25x8192-coef-sum-1024, 12, 335, 10, 0, 0, 357, 204801
n25x8192-coef-sum-1024, 13, 334, 10, 0, 0, 357, 204801
n25x8192-coef-sum-1024, 13, 331, 11, 0, 0, 355, 204801
n25x8192-coef-sum-1024, 13, 332, 10, 0, 0, 355, 204801
n25x8192-coef-sum-1024, 13, 332, 10, 0, 0, 355, 204801
n25x8192-coef-sum-1024, 13, 333, 10, 0, 0, 356, 204801
n25x8192-coef-sum-2048, 18, 332, 10, 0, 0, 360, 204801
n25x8192-coef-sum-2048, 18, 334, 11, 0, 0, 363, 204801
n25x8192-coef-sum-2048, 17, 341, 10, 0, 0, 368, 204801
n25x8192-coef-sum-2048, 17, 333, 10, 0, 0, 360, 204801
n25x8192-coef-sum-2048, 17, 332, 10, 0, 0, 359, 204801
n25x8192-coef-sum-2048, 17, 331, 9, 0, 0, 357, 204801
n25x8192-coef-sum-2048, 17, 330, 9, 0, 0, 356, 204801
n25x8192-coef-sum-2048, 22, 333, 9, 0, 0, 364, 204801
n25x8192-coef-sum-2048, 20, 333, 10, 0, 0, 363, 204801
n25x8192-coef-sum-2048, 18, 333, 10, 0, 0, 361, 204801
n25x8192-coef-sum-2048, 17, 333, 10, 0, 0, 360, 204801
n25x8192-coef-sum-2048, 28, 334, 10, 0, 0, 372, 204801
n25x8192-coef-sum-2048, 18, 333, 9, 0, 0, 360, 204801
n25x8192-coef-sum-2048, 17, 330, 9, 0, 0, 356, 204801
n25x8192-coef-sum-2048, 18, 331, 9, 0, 0, 358, 204801
n25x8192-coef-sum-2048, 18, 334, 10, 0, 0, 362, 204801
n25x8192-coef-sum-2048, 17, 330, 9, 0, 0, 356, 204801
n25x8192-coef-sum-2048, 17, 331, 10, 0, 0, 358, 204801
n25x8192-coef-sum-2048, 17, 330, 10, 0, 0, 357, 204801
n25x8192-coef-sum-2048, 29, 330, 10, 0, 0, 369, 204801
n25x8192-coef-sum-2048, 19, 335, 10, 0, 0, 364, 204801
n25x8192-coef-sum-2048, 17, 331, 10, 0, 0, 358, 204801
n25x8192-coef-sum-2048, 18, 331, 10, 0, 0, 359, 204801
n25x8192-coef-sum-2048, 17, 332, 9, 0, 0, 358, 204801
n25x8192-coef-sum-2048, 19, 329, 9, 0, 0, 357, 204801
n25x8192-coef-sum-2048, 17, 332, 10, 0, 0, 359, 204801
n25x8192-coef-sum-2048, 18, 332, 10, 0, 0, 360, 204801
n25x8192-coef-sum-2048, 17, 331, 10, 0, 0, 358, 204801
n25x8192-coef-sum-2048, 22, 332, 10, 0, 0, 364, 204801
n25x8192-coef-sum-2048, 17, 332, 10, 0, 0, 359, 204801
n25x8192-coef-sum-2048, 17, 331, 10, 0, 0, 358, 204801
n25x8192-coef-sum-2048, 18, 331, 10, 0, 0, 359, 204801
n25x8192-coef-sum-2048, 17, 331, 10, 0, 0, 358, 204801
n25x8192-coef-sum-2048, 18, 332, 10, 0, 0, 360, 204801
n25x8192-coef-sum-2048, 18, 329, 10, 0, 0, 357, 204801
n25x8192-coef-sum-2048, 18, 331, 10, 0, 0, 359, 204801
n25x8192-coef-sum-2048, 25, 333, 11, 0, 0, 369, 204801
n25x8192-coef-sum-2048, 18, 331, 9, 0, 0, 358, 204801
n25x8192-coef-sum-2048, 17, 330, 10, 0, 0, 357, 204801
n25x8192-coef-sum-2048, 18, 330, 9, 0, 0, 357, 204801
n25x8192-coef-sum-2048, 17, 329, 10, 0, 0, 356, 204801
n25x8192-coef-sum-2048, 21, 332, 9, 0, 0, 362, 204801
n25x8192-coef-sum-2048, 17, 329, 10, 0, 0, 356, 204801
n25x8192-coef-sum-2048, 24, 332, 10, 0, 0, 366, 204801
n25x8192-coef-sum-2048, 17, 331, 10, 0, 0, 358, 204801
n25x8192-coef-sum-2048, 17, 330, 10, 0, 0, 357, 204801
n25x8192-coef-sum-2048, 17, 334, 10, 0, 0, 361, 204801
n25x8192-coef-sum-2048, 17, 331, 10, 0, 0, 358, 204801
n25x8192-coef-sum-2048, 17, 332, 10, 0, 0, 359, 204801
n25x8192-coef-sum-2048, 18, 334, 10, 0, 0, 362, 204801
n25x8192-coef-sum-2048, 18, 331, 10, 0, 0, 359, 204801
n25x8192-coef-sum-2048, 17, 332, 10, 0, 0, 359, 204801
n25x8192-coef-sum-2048, 17, 334, 10, 0, 0, 361, 204801
n25x8192-coef-sum-2048, 18, 336, 9, 0, 0, 363, 204801
n25x8192-coef-sum-2048, 17, 333, 9, 0, 0, 359, 204801
n25x8192-coef-sum-2048, 17, 329, 9, 0, 0, 355, 204801
n25x8192-coef-sum-2048, 17, 331, 9, 0, 0, 357, 204801
n25x8192-coef-sum-2048, 17, 331, 9, 0, 0, 357, 204801
n25x8192-coef-sum-2048, 18, 329, 9, 0, 0, 356, 204801
n25x8192-coef-sum-2048, 17, 332, 10, 0, 0, 359, 204801
n25x8192-coef-sum-2048, 18, 334, 10, 0, 0, 362, 204801
n25x8192-coef-sum-2048, 17, 331, 10, 0, 0, 358, 204801
n25x8192-coef-sum-2048, 18, 332, 10, 0, 0, 360, 204801
n25x8192-coef-sum-2048, 17, 330, 9, 0, 0, 356, 204801
n25x8192-coef-sum-2048, 18, 331, 10, 0, 0, 359, 204801
n25x8192-coef-sum-2048, 18, 333, 10, 0, 0, 361, 204801
n25x8192-coef-sum-2048, 18, 332, 10, 0, 0, 360, 204801
n25x8192-coef-sum-2048, 17, 333, 10, 0, 0, 360, 204801
n25x8192-coef-sum-2048, 20, 331, 10, 0, 0, 361, 204801
n25x8192-coef-sum-2048, 17, 330, 10, 0, 0, 357, 204801
n25x8192-coef-sum-2048, 18, 334, 10, 0, 0, 362, 204801
n25x8192-coef-sum-2048, 17, 330, 9, 0, 0, 356, 204801
n25x8192-coef-sum-2048, 17, 332, 10, 0, 0, 359, 204801
n25x8192-coef-sum-2048, 17, 331, 10, 0, 0, 358, 204801
n25x8192-coef-sum-2048, 18, 330, 10, 0, 0, 358, 204801
n25x8192-coef-sum-2048, 18, 334, 10, 0, 0, 362, 204801
n25x8192-coef-sum-2048, 17, 330, 9, 0, 0, 356, 204801
n25x8192-coef-sum-2048, 18, 330, 9, 0, 0, 357, 204801
n25x8192-coef-sum-2048, 17, 332, 9, 0, 0, 358, 204801
n25x8192-coef-sum-2048, 17, 331, 10, 0, 0, 358, 204801
n25x8192-coef-sum-2048, 19, 333, 9, 0, 0, 361, 204801
n25x8192-coef-sum-2048, 18, 334, 10, 0, 0, 362, 204801
n25x8192-coef-sum-2048, 17, 334, 10, 0, 0, 361, 204801
n25x8192-coef-sum-2048, 18, 333, 10, 0, 0, 361, 204801
n25x8192-coef-sum-2048, 18, 331, 9, 0, 0, 358, 204801
n25x8192-coef-sum-2048, 20, 332, 10, 0, 0, 362, 204801
n25x8192-coef-sum-2048, 21, 333, 10, 0, 0, 364, 204801
n25x8192-coef-sum-2048, 18, 333, 9, 0, 0, 360, 204801
n25x8192-coef-sum-2048, 17, 334, 10, 0, 0, 361, 204801
n25x8192-coef-sum-2048, 18, 331, 10, 0, 0, 359, 204801
n25x8192-coef-sum-2048, 18, 331, 10, 0, 0, 359, 204801
n25x8192-coef-sum-2048, 17, 334, 10, 0, 0, 361, 204801
n25x8192-coef-sum-2048, 21, 333, 9, 0, 0, 363, 204801
n25x8192-coef-sum-2048, 18, 334, 10, 0, 0, 362, 204801
n25x8192-coef-sum-2048, 25, 332, 9, 0, 0, 366, 204801
n25x8192-coef-sum-2048, 18, 330, 9, 0, 0, 357, 204801
n25x8192-coef-sum-2048, 23, 331, 10, 0, 0, 364, 204801
n25x8192-coef-sum-2048, 17, 330, 9, 0, 0, 356, 204801
n25x8192-coef-sum-2048, 17, 331, 10, 0, 0, 358, 204801
n25x8192-coef-sum-2048, 17, 335, 10, 0, 0, 362, 204801
n25x8192-coef-sum-4096, 35, 335, 9, 0, 0, 379, 204801
n25x8192-coef-sum-4096, 31, 337, 9, 0, 0, 377, 204801
n25x8192-coef-sum-4096, 30, 336, 9, 0, 0, 375, 204801
n25x8192-coef-sum-4096, 33, 336, 9, 0, 0, 378, 204801
n25x8192-coef-sum-4096, 30, 338, 9, 0, 0, 377, 204801
n25x8192-coef-sum-4096, 31, 337, 9, 0, 0, 377, 204801
n25x8192-coef-sum-4096, 32, 336, 10, 0, 0, 378, 204801
n25x8192-coef-sum-4096, 33, 335, 9, 0, 0, 377, 204801
n25x8192-coef-sum-4096, 30, 335, 9, 0, 0, 374, 204801
n25x8192-coef-sum-4096, 31, 335, 9, 0, 0, 375, 204801
n25x8192-coef-sum-4096, 30, 336, 9, 0, 0, 375, 204801
n25x8192-coef-sum-4096, 30, 336, 9, 0, 0, 375, 204801
n25x8192-coef-sum-4096, 35, 334, 9, 0, 0, 378, 204801
n25x8192-coef-sum-4096, 31, 336, 9, 0, 0, 376, 204801
n25x8192-coef-sum-4096, 33, 337, 9, 0, 0, 379, 204801
n25x8192-coef-sum-4096, 33, 334, 9, 0, 0, 376, 204801
n25x8192-coef-sum-4096, 32, 337, 9, 0, 0, 378, 204801
n25x8192-coef-sum-4096, 33, 336, 9, 0, 0, 378, 204801
n25x8192-coef-sum-4096, 30, 335, 9, 0, 0, 374, 204801
n25x8192-coef-sum-4096, 30, 335, 9, 0, 0, 374, 204801
n25x8192-coef-sum-4096, 30, 335, 9, 0, 0, 374, 204801
n25x8192-coef-sum-4096, 30, 336, 9, 0, 0, 375, 204801
n25x8192-coef-sum-4096, 34, 335, 9, 0, 0, 378, 204801
n25x8192-coef-sum-4096, 30, 337, 9, 0, 0, 376, 204801
n25x8192-coef-sum-4096, 30, 336, 9, 0, 0, 375, 204801
n25x8192-coef-sum-4096, 33, 334, 8, 0, 0, 375, 204801
n25x8192-coef-sum-4096, 30, 336, 9, 0, 0, 375, 204801
n25x8192-coef-sum-4096, 44, 335, 9, 0, 0, 388, 204801
n25x8192-coef-sum-4096, 30, 335, 10, 0, 0, 375, 204801
n25x8192-coef-sum-4096, 30, 337, 10, 0, 0, 377, 204801
n25x8192-coef-sum-4096, 34, 335, 9, 0, 0, 378, 204801
n25x8192-coef-sum-4096, 34, 337, 9, 0, 0, 380, 204801
n25x8192-coef-sum-4096, 32, 335, 9, 0, 0, 376, 204801
n25x8192-coef-sum-4096, 34, 339, 9, 0, 0, 382, 204801
n25x8192-coef-sum-4096, 37, 334, 9, 0, 0, 380, 204801
n25x8192-coef-sum-4096, 36, 334, 9, 0, 0, 379, 204801
n25x8192-coef-sum-4096, 39, 336, 8, 0, 0, 383, 204801
n25x8192-coef-sum-4096, 34, 335, 8, 0, 0, 377, 204801
n25x8192-coef-sum-4096, 30, 335, 9, 0, 0, 374, 204801
n25x8192-coef-sum-4096, 33, 337, 9, 0, 0, 379, 204801
n25x8192-coef-sum-4096, 33, 335, 8, 0, 0, 376, 204801
n25x8192-coef-sum-4096, 31, 335, 8, 0, 0, 374, 204801
n25x8192-coef-sum-4096, 31, 333, 9, 0, 0, 373, 204801
n25x8192-coef-sum-4096, 32, 335, 10, 0, 0, 377, 204801
n25x8192-coef-sum-4096, 30, 336, 9, 0, 0, 375, 204801
n25x8192-coef-sum-4096, 41, 336, 9, 0, 0, 386, 204801
n25x8192-coef-sum-4096, 38, 334, 9, 0, 0, 381, 204801
n25x8192-coef-sum-4096, 31, 335, 9, 0, 0, 375, 204801
n25x8192-coef-sum-4096, 34, 335, 9, 0, 0, 378, 204801
n25x8192-coef-sum-4096, 34, 337, 9, 0, 0, 380, 204801
n25x8192-coef-sum-4096, 30, 334, 9, 0, 0, 373, 204801
n25x8192-coef-sum-4096, 30, 334, 9, 0, 0, 373, 204801
n25x8192-coef-sum-4096, 32, 333, 9, 0, 0, 374, 204801
n25x8192-coef-sum-4096, 30, 336, 9, 0, 0, 375, 204801
n25x8192-coef-sum-4096, 30, 337, 9, 0, 0, 376, 204801
n25x8192-coef-sum-4096, 31, 337, 9, 0, 0, 377, 204801
n25x8192-coef-sum-4096, 32, 335, 9, 0, 0, 376, 204801
n25x8192-coef-sum-4096, 30, 350, 9, 0, 0, 389, 204801
n25x8192-coef-sum-4096, 30, 334, 8, 0, 0, 372, 204801
n25x8192-coef-sum-4096, 33, 337, 9, 0, 0, 379, 204801
n25x8192-coef-sum-4096, 30, 335, 9, 0, 0, 374, 204801
n25x8192-coef-sum-4096, 40, 337, 9, 0, 0, 386, 204801
n25x8192-coef-sum-4096, 31, 336, 9, 0, 0, 376, 204801
n25x8192-coef-sum-4096, 41, 338, 9, 0, 0, 388, 204801
n25x8192-coef-sum-4096, 31, 334, 9, 0, 0, 374, 204801
n25x8192-coef-sum-4096, 32, 335, 8, 0, 0, 375, 204801
n25x8192-coef-sum-4096, 31, 335, 9, 0, 0, 375, 204801
n25x8192-coef-sum-4096, 31, 335, 9, 0, 0, 375, 204801
n25x8192-coef-sum-4096, 31, 337, 9, 0, 0, 377, 204801
n25x8192-coef-sum-4096, 33, 335, 9, 0, 0, 377, 204801
n25x8192-coef-sum-4096, 31, 335, 9, 0, 0, 375, 204801
n25x8192-coef-sum-4096, 34, 333, 9, 0, 0, 376, 204801
n25x8192-coef-sum-4096, 36, 334, 9, 0, 0, 379, 204801
n25x8192-coef-sum-4096, 34, 337, 9, 0, 0, 380, 204801
n25x8192-coef-sum-4096, 32, 337, 9, 0, 0, 378, 204801
n25x8192-coef-sum-4096, 37, 335, 9, 0, 0, 381, 204801
n25x8192-coef-sum-4096, 31, 334, 9, 0, 0, 374, 204801
n25x8192-coef-sum-4096, 30, 334, 9, 0, 0, 373, 204801
n25x8192-coef-sum-4096, 32, 336, 9, 0, 0, 377, 204801
n25x8192-coef-sum-4096, 34, 336, 9, 0, 0, 379, 204801
n25x8192-coef-sum-4096, 37, 336, 9, 0, 0, 382, 204801
n25x8192-coef-sum-4096, 34, 337, 9, 0, 0, 380, 204801
n25x8192-coef-sum-4096, 30, 335, 9, 0, 0, 374, 204801
n25x8192-coef-sum-4096, 31, 335, 9, 0, 0, 375, 204801
n25x8192-coef-sum-4096, 32, 336, 9, 0, 0, 377, 204801
n25x8192-coef-sum-4096, 34, 334, 8, 0, 0, 376, 204801
n25x8192-coef-sum-4096, 30, 334, 8, 0, 0, 372, 204801
n25x8192-coef-sum-4096, 57, 339, 9, 0, 0, 405, 204801
n25x8192-coef-sum-4096, 31, 335, 9, 0, 0, 375, 204801
n25x8192-coef-sum-4096, 31, 336, 9, 0, 0, 376, 204801
n25x8192-coef-sum-4096, 33, 334, 9, 0, 0, 376, 204801
n25x8192-coef-sum-4096, 35, 336, 9, 0, 0, 380, 204801
n25x8192-coef-sum-4096, 33, 334, 9, 0, 0, 376, 204801
n25x8192-coef-sum-4096, 30, 338, 9, 0, 0, 377, 204801
n25x8192-coef-sum-4096, 41, 337, 8, 0, 0, 386, 204801
n25x8192-coef-sum-4096, 32, 333, 8, 0, 0, 373, 204801
n25x8192-coef-sum-4096, 30, 338, 9, 0, 0, 377, 204801
n25x8192-coef-sum-4096, 33, 337, 9, 0, 0, 379, 204801
n25x8192-coef-sum-4096, 33, 335, 9, 0, 0, 377, 204801
n25x8192-coef-sum-4096, 38, 339, 10, 0, 0, 387, 204801
n25x8192-coef-sum-8192, 59, 341, 8, 1, 0, 409, 204801
n25x8192-coef-sum-8192, 60, 341, 8, 1, 0, 410, 204801
n25x8192-coef-sum-8192, 56, 341, 8, 1, 0, 406, 204801
n25x8192-coef-sum-8192, 56, 343, 8, 1, 0, 408, 204801
n25x8192-coef-sum-8192, 59, 342, 8, 1, 0, 410, 204801
n25x8192-coef-sum-8192, 55, 339, 8, 1, 0, 403, 204801
n25x8192-coef-sum-8192, 59, 343, 8, 1, 0, 411, 204801
n25x8192-coef-sum-8192, 58, 340, 8, 1, 0, 407, 204801
n25x8192-coef-sum-8192, 57, 341, 8, 1, 0, 407, 204801
n25x8192-coef-sum-8192, 65, 340, 8, 1, 0, 414, 204801
n25x8192-coef-sum-8192, 62, 340, 8, 1, 0, 411, 204801
n25x8192-coef-sum-8192, 61, 345, 8, 1, 0, 415, 204801
n25x8192-coef-sum-8192, 57, 342, 8, 1, 0, 408, 204801
n25x8192-coef-sum-8192, 62, 340, 8, 1, 0, 411, 204801
n25x8192-coef-sum-8192, 58, 340, 8, 1, 0, 407, 204801
n25x8192-coef-sum-8192, 57, 342, 8, 1, 0, 408, 204801
n25x8192-coef-sum-8192, 59, 340, 9, 1, 0, 409, 204801
n25x8192-coef-sum-8192, 56, 342, 8, 1, 0, 407, 204801
n25x8192-coef-sum-8192, 59, 341, 8, 1, 0, 409, 204801
n25x8192-coef-sum-8192, 56, 338, 8, 1, 0, 403, 204801
n25x8192-coef-sum-8192, 59, 342, 8, 1, 0, 410, 204801
n25x8192-coef-sum-8192, 56, 342, 8, 1, 0, 407, 204801
n25x8192-coef-sum-8192, 59, 342, 8, 1, 0, 410, 204801
n25x8192-coef-sum-8192, 58, 341, 8, 1, 0, 408, 204801
n25x8192-coef-sum-8192, 60, 339, 8, 1, 0, 408, 204801
n25x8192-coef-sum-8192, 63, 342, 8, 1, 0, 414, 204801
n25x8192-coef-sum-8192, 60, 344, 8, 1, 0, 413, 204801
n25x8192-coef-sum-8192, 57, 340, 8, 1, 0, 406, 204801
n25x8192-coef-sum-8192, 59, 341, 8, 1, 0, 409, 204801
n25x8192-coef-sum-8192, 57, 343, 8, 1, 0, 409, 204801
n25x8192-coef-sum-8192, 59, 341, 8, 1, 0, 409, 204801
n25x8192-coef-sum-8192, 61, 340, 8, 1, 0, 410, 204801
n25x8192-coef-sum-8192, 57, 343, 8, 1, 0, 409, 204801
n25x8192-coef-sum-8192, 58, 345, 8, 1, 0, 412, 204801
n25x8192-coef-sum-8192, 61, 342, 8, 1, 0, 412, 204801
n25x8192-coef-sum-8192, 59, 341, 8, 1, 0, 409, 204801
n25x8192-coef-sum-8192, 61, 342, 10, 1, 0, 414, 204801
n25x8192-coef-sum-8192, 57, 340, 8, 1, 0, 406, 204801
n25x8192-coef-sum-8192, 58, 342, 8, 1, 0, 409, 204801
n25x8192-coef-sum-8192, 56, 340, 8, 1, 0, 405, 204801
n25x8192-coef-sum-8192, 58, 343, 8, 1, 0, 410, 204801
n25x8192-coef-sum-8192, 62, 343, 8, 1, 0, 414, 204801
n25x8192-coef-sum-8192, 59, 339, 8, 1, 0, 407, 204801
n25x8192-coef-sum-8192, 59, 341, 8, 1, 0, 409, 204801
n25x8192-coef-sum-8192, 57, 339, 8, 1, 0, 405, 204801
n25x8192-coef-sum-8192, 59, 340, 8, 1, 0, 408, 204801
n25x8192-coef-sum-8192, 58, 340, 8, 1, 0, 407, 204801
n25x8192-coef-sum-8192, 61, 339, 8, 1, 0, 409, 204801
n25x8192-coef-sum-8192, 59, 340, 8, 1, 0, 408, 204801
n25x8192-coef-sum-8192, 58, 340, 8, 1, 0, 407, 204801
n25x8192-coef-sum-8192, 58, 341, 8, 1, 0, 408, 204801
n25x8192-coef-sum-8192, 56, 339, 8, 1, 0, 404, 204801
n25x8192-coef-sum-8192, 59, 341, 8, 1, 0, 409, 204801
n25x8192-coef-sum-8192, 57, 340, 8, 1, 0, 406, 204801
n25x8192-coef-sum-8192, 63, 344, 8, 1, 0, 416, 204801
n25x8192-coef-sum-8192, 56, 340, 8, 1, 0, 405, 204801
n25x8192-coef-sum-8192, 57, 341, 8, 1, 0, 407, 204801
n25x8192-coef-sum-8192, 57, 340, 8, 1, 0, 406, 204801
n25x8192-coef-sum-8192, 66, 339, 8, 1, 0, 414, 204801
n25x8192-coef-sum-8192, 58, 341, 9, 1, 0, 409, 204801
n25x8192-coef-sum-8192, 56, 338, 8, 1, 0, 403, 204801
n25x8192-coef-sum-8192, 56, 340, 8, 1, 0, 405, 204801
n25x8192-coef-sum-8192, 58, 342, 9, 1, 0, 410, 204801
n25x8192-coef-sum-8192, 58, 339, 8, 1, 0, 406, 204801
n25x8192-coef-sum-8192, 59, 343, 8, 1, 0, 411, 204801
n25x8192-coef-sum-8192, 59, 340, 8, 1, 0, 408, 204801
n25x8192-coef-sum-8192, 62, 342, 8, 1, 0, 413, 204801
n25x8192-coef-sum-8192, 59, 341, 8, 1, 0, 409, 204801
n25x8192-coef-sum-8192, 56, 342, 8, 1, 0, 407, 204801
n25x8192-coef-sum-8192, 59, 341, 8, 1, 0, 409, 204801
n25x8192-coef-sum-8192, 57, 341, 8, 1, 0, 407, 204801
n25x8192-coef-sum-8192, 56, 340, 8, 1, 0, 405, 204801
n25x8192-coef-sum-8192, 61, 338, 7, 1, 0, 407, 204801
n25x8192-coef-sum-8192, 56, 341, 8, 1, 0, 406, 204801
n25x8192-coef-sum-8192, 61, 342, 8, 1, 0, 412, 204801
n25x8192-coef-sum-8192, 56, 345, 8, 1, 0, 410, 204801
n25x8192-coef-sum-8192, 57, 342, 8, 1, 0, 408, 204801
n25x8192-coef-sum-8192, 56, 343, 8, 1, 0, 408, 204801
n25x8192-coef-sum-8192, 59, 341, 8, 1, 0, 409, 204801
n25x8192-coef-sum-8192, 55, 340, 8, 1, 0, 404, 204801
n25x8192-coef-sum-8192, 59, 341, 8, 1, 0, 409, 204801
n25x8192-coef-sum-8192, 57, 344, 8, 1, 0, 410, 204801
n25x8192-coef-sum-8192, 60, 342, 8, 1, 0, 411, 204801
n25x8192-coef-sum-8192, 57, 340, 8, 1, 0, 406, 204801
n25x8192-coef-sum-8192, 62, 340, 8, 1, 0, 411, 204801
n25x8192-coef-sum-8192, 56, 341, 8, 1, 0, 406, 204801
n25x8192-coef-sum-8192, 57, 339, 8, 1, 0, 405, 204801
n25x8192-coef-sum-8192, 56, 342, 8, 1, 0, 407, 204801
n25x8192-coef-sum-8192, 59, 339, 8, 1, 0, 407, 204801
n25x8192-coef-sum-8192, 59, 340, 8, 1, 0, 408, 204801
n25x8192-coef-sum-8192, 56, 342, 8, 1, 0, 407, 204801
n25x8192-coef-sum-8192, 57, 339, 8, 1, 0, 405, 204801
n25x8192-coef-sum-8192, 59, 341, 8, 1, 0, 409, 204801
n25x8192-coef-sum-8192, 59, 339, 8, 1, 0, 407, 204801
n25x8192-coef-sum-8192, 59, 341, 8, 1, 0, 409, 204801
n25x8192-coef-sum-8192, 60, 340, 8, 1, 0, 409, 204801
n25x8192-coef-sum-8192, 61, 340, 8, 1, 0, 410, 204801
n25x8192-coef-sum-8192, 58, 346, 8, 1, 0, 413, 204801
n25x8192-coef-sum-8192, 56, 339, 8, 1, 0, 404, 204801
n25x8192-coef-sum-8192, 56, 350, 8, 1, 0, 415, 204801
n25x8192-slot-sum-512, 18, 193, 15, 0, 0, 226, 204801
n25x8192-slot-sum-512, 18, 194, 14, 0, 0, 226, 204801
n25x8192-slot-sum-512, 18, 195, 17, 0, 0, 230, 204801
n25x8192-slot-sum-512, 18, 193, 15, 0, 0, 226, 204801
n25x8192-slot-sum-512, 18, 192, 15, 0, 0, 225, 204801
n25x8192-slot-sum-512, 17, 193, 15, 0, 0, 225, 204801
n25x8192-slot-sum-512, 18, 193, 15, 0, 0, 226, 204801
n25x8192-slot-sum-512, 18, 192, 14, 0, 0, 224, 204801
n25x8192-slot-sum-512, 18, 194, 15, 0, 0, 227, 204801
n25x8192-slot-sum-512, 18, 192, 15, 0, 0, 225, 204801
n25x8192-slot-sum-512, 18, 196, 15, 0, 0, 229, 204801
n25x8192-slot-sum-512, 18, 194, 16, 0, 0, 228, 204801
n25x8192-slot-sum-512, 18, 192, 14, 0, 0, 224, 204801
n25x8192-slot-sum-512, 18, 192, 15, 0, 0, 225, 204801
n25x8192-slot-sum-512, 18, 194, 15, 0, 0, 227, 204801
n25x8192-slot-sum-512, 17, 193, 15, 0, 0, 225, 204801
n25x8192-slot-sum-512, 18, 195, 17, 0, 0, 230, 204801
n25x8192-slot-sum-512, 18, 193, 15, 0, 0, 226, 204801
n25x8192-slot-sum-512, 18, 196, 15, 0, 0, 229, 204801
n25x8192-slot-sum-512, 18, 194, 15, 0, 0, 227, 204801
n25x8192-slot-sum-512, 18, 191, 15, 0, 0, 224, 204801
n25x8192-slot-sum-512, 18, 192, 15, 0, 0, 225, 204801
n25x8192-slot-sum-512, 18, 192, 15, 0, 0, 225, 204801
n25x8192-slot-sum-512, 18, 191, 15, 0, 0, 224, 204801
n25x8192-slot-sum-512, 18, 193, 15, 0, 0, 226, 204801
n25x8192-slot-sum-512, 18, 193, 15, 0, 0, 226, 204801
n25x8192-slot-sum-512, 18, 192, 15, 0, 0, 225, 204801
n25x8192-slot-sum-512, 18, 193, 15, 0, 0, 226, 204801
n25x8192-slot-sum-512, 18, 193, 15, 0, 0, 226, 204801
n25x8192-slot-sum-512, 17, 191, 15, 0, 0, 223, 204801
n25x8192-slot-sum-512, 18, 193, 15, 0, 0, 226, 204801
n25x8192-slot-sum-512, 18, 192, 15, 0, 0, 225, 204801
n25x8192-slot-sum-512, 18, 192, 15, 0, 0, 225, 204801
n25x8192-slot-sum-512, 18, 192, 15, 0, 0, 225, 204801
n25x8192-slot-sum-512, 18, 192, 15, 0, 0, 225, 204801
n25x8192-slot-sum-512, 18, 195, 16, 0, 0, 229, 204801
n25x8192-slot-sum-512, 18, 192, 15, 0, 0, 225, 204801
n25x8192-slot-sum-512, 18, 192, 15, 0, 0, 225, 204801
n25x8192-slot-sum-512, 18, 192, 15, 0, 0, 225, 204801
n25x8192-slot-sum-512, 18, 193, 15, 0, 0, 226, 204801
n25x8192-slot-sum-512, 18, 193, 15, 0, 0, 226, 204801
n25x8192-slot-sum-512, 18, 193, 14, 0, 0, 225, 204801
n25x8192-slot-sum-512, 18, 193, 15, 0, 0, 226, 204801
n25x8192-slot-sum-512, 17, 192, 15, 0, 0, 224, 204801
n25x8192-slot-sum-512, 18, 192, 14, 0, 0, 224, 204801
n25x8192-slot-sum-512, 18, 192, 15, 0, 0, 225, 204801
n25x8192-slot-sum-512, 18, 192, 15, 0, 0, 225, 204801
n25x8192-slot-sum-512, 18, 194, 16, 0, 0, 228, 204801
n25x8192-slot-sum-512, 18, 193, 15, 0, 0, 226, 204801
n25x8192-slot-sum-512, 18, 192, 15, 0, 0, 225, 204801
n25x8192-slot-sum-512, 18, 192, 15, 0, 0, 225, 204801
n25x8192-slot-sum-512, 18, 193, 15, 0, 0, 226, 204801
n25x8192-slot-sum-512, 18, 193, 15, 0, 0, 226, 204801
n25x8192-slot-sum-512, 18, 191, 15, 0, 0, 224, 204801
n25x8192-slot-sum-512, 18, 192, 15, 0, 0, 225, 204801
n25x8192-slot-sum-512, 18, 195, 15, 0, 0, 228, 204801
n25x8192-slot-sum-512, 17, 191, 15, 0, 0, 223, 204801
n25x8192-slot-sum-512, 18, 192, 15, 0, 0, 225, 204801
n25x8192-slot-sum-512, 18, 192, 15, 0, 0, 225, 204801
n25x8192-slot-sum-512, 18, 194, 17, 0, 0, 229, 204801
n25x8192-slot-sum-512, 18, 195, 17, 0, 0, 230, 204801
n25x8192-slot-sum-512, 18, 191, 15, 0, 0, 224, 204801
n25x8192-slot-sum-512, 18, 193, 15, 0, 0, 226, 204801
n25x8192-slot-sum-512, 18, 193, 15, 0, 0, 226, 204801
n25x8192-slot-sum-512, 18, 194, 16, 0, 0, 228, 204801
n25x8192-slot-sum-512, 18, 193, 15, 0, 0, 226, 204801
n25x8192-slot-sum-512, 18, 191, 15, 0, 0, 224, 204801
n25x8192-slot-sum-512, 18, 193, 15, 0, 0, 226, 204801
n25x8192-slot-sum-512, 18, 192, 15, 0, 0, 225, 204801
n25x8192-slot-sum-512, 18, 191, 15, 0, 0, 224, 204801
n25x8192-slot-sum-512, 18, 191, 15, 0, 0, 224, 204801
n25x8192-slot-sum-512, 18, 193, 16, 0, 0, 227, 204801
n25x8192-slot-sum-512, 18, 193, 15, 0, 0, 226, 204801
n25x8192-slot-sum-512, 17, 192, 15, 0, 0, 224, 204801
n25x8192-slot-sum-512, 18, 192, 15, 0, 0, 225, 204801
n25x8192-slot-sum-512, 18, 195, 15, 0, 0, 228, 204801
n25x8192-slot-sum-512, 18, 194, 15, 0, 0, 227, 204801
n25x8192-slot-sum-512, 18, 192, 15, 0, 0, 225, 204801
n25x8192-slot-sum-512, 17, 192, 15, 0, 0, 224, 204801
n25x8192-slot-sum-512, 18, 193, 15, 0, 0, 226, 204801
n25x8192-slot-sum-512, 18, 193, 15, 0, 0, 226, 204801
n25x8192-slot-sum-512, 18, 193, 15, 0, 0, 226, 204801
n25x8192-slot-sum-512, 18, 195, 15, 0, 0, 228, 204801
n25x8192-slot-sum-512, 18, 193, 15, 0, 0, 226, 204801
n25x8192-slot-sum-512, 18, 194, 14, 0, 0, 226, 204801
n25x8192-slot-sum-512, 18, 192, 15, 0, 0, 225, 204801
n25x8192-slot-sum-512, 18, 192, 15, 0, 0, 225, 204801
n25x8192-slot-sum-512, 18, 193, 15, 0, 0, 226, 204801
n25x8192-slot-sum-512, 18, 192, 15, 0, 0, 225, 204801
n25x8192-slot-sum-512, 18, 192, 15, 0, 0, 225, 204801
n25x8192-slot-sum-512, 18, 191, 15, 0, 0, 224, 204801
n25x8192-slot-sum-512, 18, 194, 15, 0, 0, 227, 204801
n25x8192-slot-sum-512, 18, 193, 15, 0, 0, 226, 204801
n25x8192-slot-sum-512, 18, 192, 15, 0, 0, 225, 204801
n25x8192-slot-sum-512, 18, 191, 14, 0, 0, 223, 204801
n25x8192-slot-sum-512, 18, 192, 15, 0, 0, 225, 204801
n25x8192-slot-sum-512, 18, 194, 15, 0, 0, 227, 204801
n25x8192-slot-sum-512, 18, 191, 15, 0, 0, 224, 204801
n25x8192-slot-sum-512, 17, 193, 15, 0, 0, 225, 204801
n25x8192-slot-sum-512, 18, 194, 16, 0, 0, 228, 204801
n25x8192-slot-sum-1024, 31, 187, 15, 0, 0, 233, 204801
n25x8192-slot-sum-1024, 31, 185, 15, 0, 0, 231, 204801
n25x8192-slot-sum-1024, 31, 185, 14, 0, 0, 230, 204801
n25x8192-slot-sum-1024, 32, 186, 15, 0, 0, 233, 204801
n25x8192-slot-sum-1024, 37, 184, 14, 0, 0, 235, 204801
n25x8192-slot-sum-1024, 31, 184, 15, 0, 0, 230, 204801
n25x8192-slot-sum-1024, 32, 184, 14, 0, 0, 230, 204801
n25x8192-slot-sum-1024, 31, 186, 15, 0, 0, 232, 204801
n25x8192-slot-sum-1024, 38, 185, 15, 0, 0, 238, 204801
n25x8192-slot-sum-1024, 32, 186, 14, 0, 0, 232, 204801
n25x8192-slot-sum-1024, 32, 184, 15, 0, 0, 231, 204801
n25x8192-slot-sum-1024, 31, 187, 15, 0, 0, 233, 204801
n25x8192-slot-sum-1024, 31, 186, 14, 0, 0, 231, 204801
n25x8192-slot-sum-1024, 31, 185, 15, 0, 0, 231, 204801
n25x8192-slot-sum-1024, 32, 185, 15, 0, 0, 232, 204801
n25x8192-slot-sum-1024, 31, 187, 15, 0, 0, 233, 204801
n25x8192-slot-sum-1024, 31, 185, 15, 0, 0, 231, 204801
n25x8192-slot-sum-1024, 32, 189, 15, 0, 0, 236, 204801
n25x8192-slot-sum-1024, 32, 187, 15, 0, 0, 234, 204801
n25x8192-slot-sum-1024, 32, 187, 15, 0, 0, 234, 204801
n25x8192-slot-sum-1024, 31, 184, 15, 0, 0, 230, 204801
n25x8192-slot-sum-1024, 31, 185, 15, 0, 0, 231, 204801
n25x8192-slot-sum-1024, 31, 185, 15, 0, 0, 231, 204801
n25x8192-slot-sum-1024, 32, 186, 15, 0, 0, 233, 204801
n25x8192-slot-sum-1024, 31, 186, 15, 0, 0, 232, 204801
n25x8192-slot-sum-1024, 31, 184, 15, 0, 0, 230, 204801
n25x8192-slot-sum-1024, 31, 184, 15, 0, 0, 230, 204801
n25x8192-slot-sum-1024, 31, 185, 15, 0, 0, 231, 204801
n25x8192-slot-sum-1024, 32, 185, 15, 0, 0, 232, 204801
n25x8192-slot-sum-1024, 32, 186, 15, 0, 0, 233, 204801
n25x8192-slot-sum-1024, 31, 188, 15, 0, 0, 234, 204801
n25x8192-slot-sum-1024, 33, 187, 15, 0, 0, 235, 204801
n25x8192-slot-sum-1024, 30, 186, 15, 0, 0, 231, 204801
n25x8192-slot-sum-1024, 31, 185, 15, 0, 0, 231, 204801
n25x8192-slot-sum-1024, 31, 185, 15, 0, 0, 231, 204801
n25x8192-slot-sum-1024, 32, 186, 15, 0, 0, 233, 204801
n25x8192-slot-sum-1024, 32, 186, 15, 0, 0, 233, 204801
n25x8192-slot-sum-1024, 34, 184, 16, 0, 0, 234, 204801
n25x8192-slot-sum-1024, 34, 186, 16, 0, 0, 236, 204801
n25x8192-slot-sum-1024, 32, 189, 14, 0, 0, 235, 204801
n25x8192-slot-sum-1024, 31, 185, 14, 0, 0, 230, 204801
n25x8192-slot-sum-1024, 35, 185, 14, 0, 0, 234, 204801
n25x8192-slot-sum-1024, 32, 185, 15, 0, 0, 232, 204801
n25x8192-slot-sum-1024, 31, 188, 16, 0, 0, 235, 204801
n25x8192-slot-sum-1024, 31, 186, 15, 0, 0, 232, 204801
n25x8192-slot-sum-1024, 32, 187, 16, 0, 0, 235, 204801
n25x8192-slot-sum-1024, 31, 187, 15, 0, 0, 233, 204801
n25x8192-slot-sum-1024, 31, 186, 15, 0, 0, 232, 204801
n25x8192-slot-sum-1024, 31, 184, 14, 0, 0, 229, 204801
n25x8192-slot-sum-1024, 31, 185, 14, 0, 0, 230, 204801
n25x8192-slot-sum-1024, 31, 185, 15, 0, 0, 231, 204801
n25x8192-slot-sum-1024, 31, 188, 15, 0, 0, 234, 204801
n25x8192-slot-sum-1024, 32, 184, 14, 0, 0, 230, 204801
n25x8192-slot-sum-1024, 31, 185, 15, 0, 0, 231, 204801
n25x8192-slot-sum-1024, 31, 187, 15, 0, 0, 233, 204801
n25x8192-slot-sum-1024, 32, 186, 15, 0, 0, 233, 204801
n25x8192-slot-sum-1024, 32, 185, 15, 0, 0, 232, 204801
n25x8192-slot-sum-1024, 31, 186, 15, 0, 0, 232, 204801
n25x8192-slot-sum-1024, 32, 186, 15, 0, 0, 233, 204801
n25x8192-slot-sum-1024, 32, 188, 15, 0, 0, 235, 204801
n25x8192-slot-sum-1024, 31, 185, 15, 0, 0, 231, 204801
n25x8192-slot-sum-1024, 31, 185, 15, 0, 0, 231, 204801
n25x8192-slot-sum-1024, 31, 186, 14, 0, 0, 231, 204801
n25x8192-slot-sum-1024, 31, 184, 15, 0, 0, 230, 204801
n25x8192-slot-sum-1024, 30, 185, 14, 0, 0, 229, 204801
n25x8192-slot-sum-1024, 32, 185, 15, 0, 0, 232, 204801
n25x8192-slot-sum-1024, 31, 184, 15, 0, 0, 230, 204801
n25x8192-slot-sum-1024, 32, 187, 15, 0, 0, 234, 204801
n25x8192-slot-sum-1024, 32, 187, 16, 0, 0, 235, 204801
n25x8192-slot-sum-1024, 31, 187, 15, 0, 0, 233, 204801
n25x8192-slot-sum-1024, 31, 187, 15, 0, 0, 233, 204801
n25x8192-slot-sum-1024, 32, 188, 16, 0, 0, 236, 204801
n25x8192-slot-sum-1024, 32, 187, 16, 0, 0, 235, 204801
n25x8192-slot-sum-1024, 31, 185, 15, 0, 0, 231, 204801
n25x8192-slot-sum-1024, 31, 186, 15, 0, 0, 232, 204801
n25x8192-slot-sum-1024, 31, 184, 15, 0, 0, 230, 204801
n25x8192-slot-sum-1024, 32, 186, 15, 0, 0, 233, 204801
n25x8192-slot-sum-1024, 31, 186, 15, 0, 0, 232, 204801
n25x8192-slot-sum-1024, 31, 188, 15, 0, 0, 234, 204801
n25x8192-slot-sum-1024, 31, 185, 15, 0, 0, 231, 204801
n25x8192-slot-sum-1024, 31, 186, 14, 0, 0, 231, 204801
n25x8192-slot-sum-1024, 32, 185, 14, 0, 0, 231, 204801
n25x8192-slot-sum-1024, 32, 187, 15, 0, 0, 234, 204801
n25x8192-slot-sum-1024, 35, 186, 14, 0, 0, 235, 204801
n25x8192-slot-sum-1024, 31, 185, 15, 0, 0, 231, 204801
n25x8192-slot-sum-1024, 32, 185, 14, 0, 0, 231, 204801
n25x8192-slot-sum-1024, 31, 187, 15, 0, 0, 233, 204801
n25x8192-slot-sum-1024, 37, 185, 15, 0, 0, 237, 204801
n25x8192-slot-sum-1024, 32, 185, 15, 0, 0, 232, 204801
n25x8192-slot-sum-1024, 31, 185, 15, 0, 0, 231, 204801
n25x8192-slot-sum-1024, 31, 186, 15, 0, 0, 232, 204801
n25x8192-slot-sum-1024, 32, 185, 14, 0, 0, 231, 204801
n25x8192-slot-sum-1024, 31, 185, 15, 0, 0, 231, 204801
n25x8192-slot-sum-1024, 31, 186, 15, 0, 0, 232, 204801
n25x8192-slot-sum-1024, 31, 186, 16, 0, 0, 233, 204801
n25x8192-slot-sum-1024, 32, 185, 15, 0, 0, 232, 204801
n25x8192-slot-sum-1024, 31, 185, 15, 0, 0, 231, 204801
n25x8192-slot-sum-1024, 31, 188, 15, 0, 0, 234, 204801
n25x8192-slot-sum-1024, 41, 186, 15, 0, 0, 242, 204801
n25x8192-slot-sum-1024, 32, 185, 14, 0, 0, 231, 204801
n25x8192-slot-sum-2048, 58, 185, 18, 0, 0, 261, 204801
n25x8192-slot-sum-2048, 64, 188, 18, 0, 0, 270, 204801
n25x8192-slot-sum-2048, 59, 187, 18, 0, 0, 264, 204801
n25x8192-slot-sum-2048, 59, 186, 18, 0, 0, 263, 204801
n25x8192-slot-sum-2048, 59, 188, 19, 0, 0, 266, 204801
n25x8192-slot-sum-2048, 59, 187, 18, 0, 0, 264, 204801
n25x8192-slot-sum-2048, 59, 186, 18, 0, 0, 263, 204801
n25x8192-slot-sum-2048, 58, 185, 18, 0, 0, 261, 204801
n25x8192-slot-sum-2048, 58, 187, 18, 0, 0, 263, 204801
n25x8192-slot-sum-2048, 60, 188, 18, 0, 0, 266, 204801
n25x8192-slot-sum-2048, 58, 185, 18, 0, 0, 261, 204801
n25x8192-slot-sum-2048, 59, 186, 18, 0, 0, 263, 204801
n25x8192-slot-sum-2048, 59, 187, 19, 0, 0, 265, 204801
n25x8192-slot-sum-2048, 60, 186, 18, 0, 0, 264, 204801
n25x8192-slot-sum-2048, 59, 188, 18, 0, 0, 265, 204801
n25x8192-slot-sum-2048, 59, 186, 19, 0, 0, 264, 204801
n25x8192-slot-sum-2048, 59, 187, 18, 0, 0, 264, 204801
n25x8192-slot-sum-2048, 59, 186, 18, 0, 0, 263, 204801
n25x8192-slot-sum-2048, 59, 186, 18, 0, 0, 263, 204801
n25x8192-slot-sum-2048, 59, 187, 19, 0, 0, 265, 204801
n25x8192-slot-sum-2048, 61, 187, 18, 0, 0, 266, 204801
n25x8192-slot-sum-2048, 59, 186, 18, 0, 0, 263, 204801
n25x8192-slot-sum-2048, 59, 187, 18, 0, 0, 264, 204801
n25x8192-slot-sum-2048, 59, 187, 18, 0, 0, 264, 204801
n25x8192-slot-sum-2048, 59, 186, 18, 0, 0, 263, 204801
n25x8192-slot-sum-2048, 59, 187, 18, 0, 0, 264, 204801
n25x8192-slot-sum-2048, 59, 186, 18, 0, 0, 263, 204801
n25x8192-slot-sum-2048, 61, 187, 18, 0, 0, 266, 204801
n25x8192-slot-sum-2048, 58, 185, 18, 0, 0, 261, 204801
n25x8192-slot-sum-2048, 59, 188, 18, 0, 0, 265, 204801
n25x8192-slot-sum-2048, 65, 185, 18, 0, 0, 268, 204801
n25x8192-slot-sum-2048, 58, 186, 18, 0, 0, 262, 204801
n25x8192-slot-sum-2048, 64, 186, 18, 0, 0, 268, 204801
n25x8192-slot-sum-2048, 61, 187, 18, 0, 0, 266, 204801
n25x8192-slot-sum-2048, 59, 198, 18, 0, 0, 275, 204801
n25x8192-slot-sum-2048, 61, 186, 18, 0, 0, 265, 204801
n25x8192-slot-sum-2048, 59, 187, 18, 0, 0, 264, 204801
n25x8192-slot-sum-2048, 58, 186, 18, 0, 0, 262, 204801
n25x8192-slot-sum-2048, 59, 186, 18, 0, 0, 263, 204801
n25x8192-slot-sum-2048, 62, 188, 19, 0, 0, 269, 204801
n25x8192-slot-sum-2048, 59, 188, 18, 0, 0, 265, 204801
n25x8192-slot-sum-2048, 62, 186, 18, 0, 0, 266, 204801
n25x8192-slot-sum-2048, 59, 186, 18, 0, 0, 263, 204801
n25x8192-slot-sum-2048, 59, 188, 18, 0, 0, 265, 204801
n25x8192-slot-sum-2048, 59, 187, 18, 0, 0, 264, 204801
n25x8192-slot-sum-2048, 58, 186, 18, 0, 0, 262, 204801
n25x8192-slot-sum-2048, 59, 188, 18, 0, 0, 265, 204801
n25x8192-slot-sum-2048, 60, 188, 19, 0, 0, 267, 204801
n25x8192-slot-sum-2048, 59, 186, 18, 0, 0, 263, 204801
n25x8192-slot-sum-2048, 59, 187, 18, 0, 0, 264, 204801
n25x8192-slot-sum-2048, 59, 187, 18, 0, 0, 264, 204801
n25x8192-slot-sum-2048, 59, 189, 18, 0, 0, 266, 204801
n25x8192-slot-sum-2048, 60, 188, 18, 0, 0, 266, 204801
n25x8192-slot-sum-2048, 59, 186, 18, 0, 0, 263, 204801
n25x8192-slot-sum-2048, 59, 187, 18, 0, 0, 264, 204801
n25x8192-slot-sum-2048, 59, 186, 18, 0, 0, 263, 204801
n25x8192-slot-sum-2048, 62, 186, 18, 0, 0, 266, 204801
n25x8192-slot-sum-2048, 59, 186, 18, 0, 0, 263, 204801
n25x8192-slot-sum-2048, 58, 187, 18, 0, 0, 263, 204801
n25x8192-slot-sum-2048, 59, 188, 19, 0, 0, 266, 204801
n25x8192-slot-sum-2048, 59, 186, 18, 0, 0, 263, 204801
n25x8192-slot-sum-2048, 60, 186, 18, 0, 0, 264, 204801
n25x8192-slot-sum-2048, 59, 187, 18, 0, 0, 264, 204801
n25x8192-slot-sum-2048, 58, 186, 18, 0, 0, 262, 204801
n25x8192-slot-sum-2048, 59, 188, 18, 0, 0, 265, 204801
n25x8192-slot-sum-2048, 59, 187, 18, 0, 0, 264, 204801
n25x8192-slot-sum-2048, 59, 187, 19, 0, 0, 265, 204801
n25x8192-slot-sum-2048, 58, 187, 18, 0, 0, 263, 204801
n25x8192-slot-sum-2048, 59, 187, 18, 0, 0, 264, 204801
n25x8192-slot-sum-2048, 59, 187, 18, 0, 0, 264, 204801
n25x8192-slot-sum-2048, 63, 188, 19, 0, 0, 270, 204801
n25x8192-slot-sum-2048, 58, 187, 18, 0, 0, 263, 204801
n25x8192-slot-sum-2048, 59, 188, 18, 0, 0, 265, 204801
n25x8192-slot-sum-2048, 59, 189, 18, 0, 0, 266, 204801
n25x8192-slot-sum-2048, 59, 186, 18, 0, 0, 263, 204801
n25x8192-slot-sum-2048, 59, 186, 18, 0, 0, 263, 204801
n25x8192-slot-sum-2048, 59, 186, 18, 0, 0, 263, 204801
n25x8192-slot-sum-2048, 59, 186, 18, 0, 0, 263, 204801
n25x8192-slot-sum-2048, 59, 188, 18, 0, 0, 265, 204801
n25x8192-slot-sum-2048, 59, 189, 18, 0, 0, 266, 204801
n25x8192-slot-sum-2048, 64, 187, 18, 0, 0, 269, 204801
n25x8192-slot-sum-2048, 59, 187, 19, 0, 0, 265, 204801
n25x8192-slot-sum-2048, 59, 186, 18, 0, 0, 263, 204801
n25x8192-slot-sum-2048, 59, 186, 18, 0, 0, 263, 204801
n25x8192-slot-sum-2048, 58, 185, 18, 0, 0, 261, 204801
n25x8192-slot-sum-2048, 63, 188, 19, 0, 0, 270, 204801
n25x8192-slot-sum-2048, 59, 189, 18, 0, 0, 266, 204801
n25x8192-slot-sum-2048, 59, 187, 18, 0, 0, 264, 204801
n25x8192-slot-sum-2048, 59, 187, 18, 0, 0, 264, 204801
n25x8192-slot-sum-2048, 59, 188, 19, 0, 0, 266, 204801
n25x8192-slot-sum-2048, 59, 186, 18, 0, 0, 263, 204801
n25x8192-slot-sum-2048, 59, 185, 18, 0, 0, 262, 204801
n25x8192-slot-sum-2048, 58, 187, 18, 0, 0, 263, 204801
n25x8192-slot-sum-2048, 58, 190, 18, 0, 0, 266, 204801
n25x8192-slot-sum-2048, 59, 186, 18, 0, 0, 263, 204801
n25x8192-slot-sum-2048, 63, 187, 18, 0, 0, 268, 204801
n25x8192-slot-sum-2048, 59, 188, 19, 0, 0, 266, 204801
n25x8192-slot-sum-2048, 62, 186, 18, 0, 0, 266, 204801
n25x8192-slot-sum-2048, 59, 186, 18, 0, 0, 263, 204801
n25x8192-slot-sum-2048, 59, 187, 18, 0, 0, 264, 204801
n25x8192-slot-sum-4096, 125, 192, 27, 0, 0, 344, 204801
n25x8192-slot-sum-4096, 127, 193, 27, 0, 0, 347, 204801
n25x8192-slot-sum-4096, 123, 193, 27, 0, 0, 343, 204801
n25x8192-slot-sum-4096, 123, 191, 26, 0, 0, 340, 204801
n25x8192-slot-sum-4096, 122, 190, 27, 0, 0, 339, 204801
n25x8192-slot-sum-4096, 126, 192, 28, 0, 0, 346, 204801
n25x8192-slot-sum-4096, 127, 193, 28, 0, 0, 348, 204801
n25x8192-slot-sum-4096, 125, 191, 27, 0, 0, 343, 204801
n25x8192-slot-sum-4096, 123, 192, 27, 0, 0, 342, 204801
n25x8192-slot-sum-4096, 124, 192, 27, 0, 0, 343, 204801
n25x8192-slot-sum-4096, 122, 193, 27, 0, 0, 342, 204801
n25x8192-slot-sum-4096, 123, 192, 26, 0, 0, 341, 204801
n25x8192-slot-sum-4096, 123, 192, 26, 0, 0, 341, 204801
n25x8192-slot-sum-4096, 133, 193, 28, 0, 0, 354, 204801
n25x8192-slot-sum-4096, 122, 191, 29, 0, 0, 342, 204801
n25x8192-slot-sum-4096, 126, 191, 28, 0, 0, 345, 204801
n25x8192-slot-sum-4096, 132, 192, 27, 0, 0, 351, 204801
n25x8192-slot-sum-4096, 125, 191, 26, 0, 0, 342, 204801
n25x8192-slot-sum-4096, 122, 194, 27, 0, 0, 343, 204801
n25x8192-slot-sum-4096, 126, 194, 28, 0, 0, 348, 204801
n25x8192-slot-sum-4096, 122, 190, 26, 0, 0, 338, 204801
n25x8192-slot-sum-4096, 123, 191, 27, 0, 0, 341, 204801
n25x8192-slot-sum-4096, 123, 192, 28, 0, 0, 343, 204801
n25x8192-slot-sum-4096, 126, 191, 27, 0, 0, 344, 204801
n25x8192-slot-sum-4096, 122, 191, 27, 0, 0, 340, 204801
n25x8192-slot-sum-4096, 123, 191, 27, 0, 0, 341, 204801
n25x8192-slot-sum-4096, 127, 192, 27, 0, 0, 346, 204801
n25x8192-slot-sum-4096, 124, 192, 27, 0, 0, 343, 204801
n25x8192-slot-sum-4096, 127, 190, 26, 0, 0, 343, 204801
n25x8192-slot-sum-4096, 122, 192, 27, 0, 0, 341, 204801
n25x8192-slot-sum-4096, 123, 191, 27, 0, 0, 341, 204801
n25x8192-slot-sum-4096, 124, 192, 27, 0, 0, 343, 204801
n25x8192-slot-sum-4096, 123, 193, 28, 0, 0, 344, 204801
n25x8192-slot-sum-4096, 124, 192, 27, 0, 0, 343, 204801
n25x8192-slot-sum-4096, 124, 192, 28, 0, 0, 344, 204801
n25x8192-slot-sum-4096, 134, 191, 26, 0, 0, 351, 204801
n25x8192-slot-sum-4096, 122, 191, 26, 0, 0, 339, 204801
n25x8192-slot-sum-4096, 122, 191, 28, 0, 0, 341, 204801
n25x8192-slot-sum-4096, 131, 192, 27, 0, 0, 350, 204801
n25x8192-slot-sum-4096, 128, 190, 27, 0, 0, 345, 204801
n25x8192-slot-sum-4096, 123, 192, 27, 0, 0, 342, 204801
n25x8192-slot-sum-4096, 127, 193, 27, 0, 0, 347, 204801
n25x8192-slot-sum-4096, 132, 191, 27, 0, 0, 350, 204801
n25x8192-slot-sum-4096, 122, 193, 28, 0, 0, 343, 204801
n25x8192-slot-sum-4096, 124, 192, 27, 0, 0, 343, 204801
n25x8192-slot-sum-4096, 130, 191, 27, 0, 0, 348, 204801
n25x8192-slot-sum-4096, 125, 193, 27, 0, 0, 345, 204801
n25x8192-slot-sum-4096, 128, 191, 26, 0, 0, 345, 204801
n25x8192-slot-sum-4096, 131, 191, 27, 0, 0, 349, 204801
n25x8192-slot-sum-4096, 130, 192, 27, 0, 0, 349, 204801
n25x8192-slot-sum-4096, 126, 192, 27, 0, 0, 345, 204801
n25x8192-slot-sum-4096, 123, 191, 27, 0, 0, 341, 204801
n25x8192-slot-sum-4096, 122, 192, 27, 0, 0, 341, 204801
n25x8192-slot-sum-4096, 125, 191, 27, 0, 0, 343, 204801
n25x8192-slot-sum-4096, 124, 192, 26, 0, 0, 342, 204801
n25x8192-slot-sum-4096, 128, 191, 27, 0, 0, 346, 204801
n25x8192-slot-sum-4096, 124, 191, 27, 0, 0, 342, 204801
n25x8192-slot-sum-4096, 123, 192, 26, 0, 0, 341, 204801
n25x8192-slot-sum-4096, 126, 191, 27, 0, 0, 344, 204801
n25x8192-slot-sum-4096, 126, 192, 28, 0, 0, 346, 204801
n25x8192-slot-sum-4096, 129, 190, 27, 0, 0, 346, 204801
n25x8192-slot-sum-4096, 126, 190, 27, 0, 0, 343, 204801
n25x8192-slot-sum-4096, 124, 191, 27, 0, 0, 342, 204801
n25x8192-slot-sum-4096, 125, 191, 28, 0, 0, 344, 204801
n25x8192-slot-sum-4096, 122, 191, 27, 0, 0, 340, 204801
n25x8192-slot-sum-4096, 126, 191, 27, 0, 0, 344, 204801
n25x8192-slot-sum-4096, 123, 191, 27, 0, 0, 341, 204801
n25x8192-slot-sum-4096, 122, 190, 26, 0, 0, 338, 204801
n25x8192-slot-sum-4096, 125, 192, 27, 0, 0, 344, 204801
n25x8192-slot-sum-4096, 123, 190, 27, 0, 0, 340, 204801
n25x8192-slot-sum-4096, 126, 193, 27, 0, 0, 346, 204801
n25x8192-slot-sum-4096, 129, 190, 27, 0, 0, 346, 204801
n25x8192-slot-sum-4096, 126, 192, 28, 0, 0, 346, 204801
n25x8192-slot-sum-4096, 125, 191, 26, 0, 0, 342, 204801
n25x8192-slot-sum-4096, 127, 191, 27, 0, 0, 345, 204801
n25x8192-slot-sum-4096, 129, 191, 27, 0, 0, 347, 204801
n25x8192-slot-sum-4096, 124, 193, 27, 0, 0, 344, 204801
n25x8192-slot-sum-4096, 123, 191, 27, 0, 0, 341, 204801
n25x8192-slot-sum-4096, 124, 194, 28, 0, 0, 346, 204801
n25x8192-slot-sum-4096, 126, 193, 27, 0, 0, 346, 204801
n25x8192-slot-sum-4096, 128, 192, 27, 0, 0, 347, 204801
n25x8192-slot-sum-4096, 122, 193, 26, 0, 0, 341, 204801
n25x8192-slot-sum-4096, 125, 191, 27, 0, 0, 343, 204801
n25x8192-slot-sum-4096, 122, 196, 27, 0, 0, 345, 204801
n25x8192-slot-sum-4096, 124, 192, 28, 0, 0, 344, 204801
n25x8192-slot-sum-4096, 123, 191, 27, 0, 0, 341, 204801
n25x8192-slot-sum-4096, 127, 191, 28, 0, 0, 346, 204801
n25x8192-slot-sum-4096, 123, 190, 26, 0, 0, 339, 204801
n25x8192-slot-sum-4096, 127, 192, 27, 0, 0, 346, 204801
n25x8192-slot-sum-4096, 130, 190, 26, 0, 0, 346, 204801
n25x8192-slot-sum-4096, 123, 192, 27, 0, 0, 342, 204801
n25x8192-slot-sum-4096, 126, 191, 27, 0, 0, 344, 204801
n25x8192-slot-sum-4096, 124, 194, 27, 0, 0, 345, 204801
n25x8192-slot-sum-4096, 123, 191, 27, 0, 0, 341, 204801
n25x8192-slot-sum-4096, 126, 191, 27, 0, 0, 344, 204801
n25x8192-slot-sum-4096, 121, 191, 27, 0, 0, 339, 204801
n25x8192-slot-sum-4096, 123, 192, 27, 0, 0, 342, 204801
n25x8192-slot-sum-4096, 123, 191, 27, 0, 0, 341, 204801
n25x8192-slot-sum-4096, 125, 192, 28, 0, 0, 345, 204801
n25x8192-slot-sum-4096, 125, 191, 27, 0, 0, 343, 204801
n25x8192-slot-sum-8192, 262, 200, 69, 1, 0, 532, 204801
n25x8192-slot-sum-8192, 263, 200, 69, 1, 0, 533, 204801
n25x8192-slot-sum-8192, 264, 201, 73, 1, 0, 539, 204801
n25x8192-slot-sum-8192, 262, 199, 68, 1, 0, 530, 204801
n25x8192-slot-sum-8192, 272, 203, 73, 1, 0, 549, 204801
n25x8192-slot-sum-8192, 267, 201, 71, 1, 0, 540, 204801
n25x8192-slot-sum-8192, 263, 199, 69, 1, 0, 532, 204801
n25x8192-slot-sum-8192, 267, 201, 70, 1, 0, 539, 204801
n25x8192-slot-sum-8192, 272, 199, 71, 1, 0, 543, 204801
n25x8192-slot-sum-8192, 263, 200, 69, 1, 0, 533, 204801
n25x8192-slot-sum-8192, 266, 200, 69, 1, 0, 536, 204801
n25x8192-slot-sum-8192, 265, 200, 70, 1, 0, 536, 204801
n25x8192-slot-sum-8192, 267, 200, 69, 1, 0, 537, 204801
n25x8192-slot-sum-8192, 263, 202, 75, 1, 0, 541, 204801
n25x8192-slot-sum-8192, 262, 201, 70, 1, 0, 534, 204801
n25x8192-slot-sum-8192, 276, 200, 69, 1, 0, 546, 204801
n25x8192-slot-sum-8192, 266, 202, 70, 1, 0, 539, 204801
n25x8192-slot-sum-8192, 263, 199, 68, 1, 0, 531, 204801
n25x8192-slot-sum-8192, 263, 201, 69, 1, 0, 534, 204801
n25x8192-slot-sum-8192, 262, 199, 68, 1, 0, 530, 204801
n25x8192-slot-sum-8192, 264, 201, 70, 1, 0, 536, 204801
n25x8192-slot-sum-8192, 262, 199, 69, 1, 0, 531, 204801
n25x8192-slot-sum-8192, 266, 199, 68, 1, 0, 534, 204801
n25x8192-slot-sum-8192, 266, 200, 68, 1, 0, 535, 204801
n25x8192-slot-sum-8192, 263, 199, 69, 1, 0, 532, 204801
n25x8192-slot-sum-8192, 264, 201, 69, 1, 0, 535, 204801
n25x8192-slot-sum-8192, 272, 199, 69, 1, 0, 541, 204801
n25x8192-slot-sum-8192, 265, 202, 69, 1, 0, 537, 204801
n25x8192-slot-sum-8192, 267, 200, 70, 1, 0, 538, 204801
n25x8192-slot-sum-8192, 262, 200, 69, 1, 0, 532, 204801
n25x8192-slot-sum-8192, 267, 199, 71, 1, 0, 538, 204801
n25x8192-slot-sum-8192, 264, 201, 69, 1, 0, 535, 204801
n25x8192-slot-sum-8192, 264, 198, 69, 1, 0, 532, 204801
n25x8192-slot-sum-8192, 264, 198, 69, 1, 0, 532, 204801
n25x8192-slot-sum-8192, 263, 201, 69, 1, 0, 534, 204801
n25x8192-slot-sum-8192, 263, 200, 70, 1, 0, 534, 204801
n25x8192-slot-sum-8192, 264, 199, 68, 1, 0, 532, 204801
n25x8192-slot-sum-8192, 262, 199, 69, 1, 0, 531, 204801
n25x8192-slot-sum-8192, 266, 201, 69, 1, 0, 537, 204801
n25x8192-slot-sum-8192, 269, 201, 69, 1, 0, 540, 204801
n25x8192-slot-sum-8192, 260, 200, 68, 1, 0, 529, 204801
n25x8192-slot-sum-8192, 265, 201, 68, 1, 0, 535, 204801
n25x8192-slot-sum-8192, 265, 198, 69, 1, 0, 533, 204801
n25x8192-slot-sum-8192, 267, 200, 69, 1, 0, 537, 204801
n25x8192-slot-sum-8192, 265, 200, 69, 1, 0, 535, 204801
n25x8192-slot-sum-8192, 264, 201, 70, 1, 0, 536, 204801
n25x8192-slot-sum-8192, 269, 199, 69, 1, 0, 538, 204801
n25x8192-slot-sum-8192, 264, 200, 70, 1, 0, 535, 204801
n25x8192-slot-sum-8192, 263, 200, 70, 1, 0, 534, 204801
n25x8192-slot-sum-8192, 263, 201, 71, 1, 0, 536, 204801
n25x8192-slot-sum-8192, 263, 198, 69, 1, 0, 531, 204801
n25x8192-slot-sum-8192, 266, 200, 68, 1, 0, 535, 204801
n25x8192-slot-sum-8192, 271, 200, 69, 1, 0, 541, 204801
n25x8192-slot-sum-8192, 266, 201, 70, 1, 0, 538, 204801
n25x8192-slot-sum-8192, 270, 200, 69, 1, 0, 540, 204801
n25x8192-slot-sum-8192, 263, 199, 73, 1, 0, 536, 204801
n25x8192-slot-sum-8192, 263, 200, 68, 1, 0, 532, 204801
n25x8192-slot-sum-8192, 263, 200, 72, 1, 0, 536, 204801
n25x8192-slot-sum-8192, 263, 200, 69, 1, 0, 533, 204801
n25x8192-slot-sum-8192, 263, 201, 69, 1, 0, 534, 204801
n25x8192-slot-sum-8192, 262, 201, 69, 1, 0, 533, 204801
n25x8192-slot-sum-8192, 264, 200, 68, 1, 0, 533, 204801
n25x8192-slot-sum-8192, 263, 201, 71, 1, 0, 536, 204801
n25x8192-slot-sum-8192, 264, 198, 70, 1, 0, 533, 204801
n25x8192-slot-sum-8192, 264, 199, 69, 1, 0, 533, 204801
n25x8192-slot-sum-8192, 268, 200, 70, 1, 0, 539, 204801
n25x8192-slot-sum-8192, 264, 200, 70, 1, 0, 535, 204801
n25x8192-slot-sum-8192, 264, 201, 69, 1, 0, 535, 204801
n25x8192-slot-sum-8192, 266, 201, 69, 1, 0, 537, 204801
n25x8192-slot-sum-8192, 264, 201, 70, 1, 0, 536, 204801
n25x8192-slot-sum-8192, 270, 202, 68, 1, 0, 541, 204801
n25x8192-slot-sum-8192, 261, 198, 68, 1, 0, 528, 204801
n25x8192-slot-sum-8192, 268, 200, 69, 1, 0, 538, 204801
n25x8192-slot-sum-8192, 267, 199, 70, 1, 0, 537, 204801
n25x8192-slot-sum-8192, 264, 200, 69, 1, 0, 534, 204801
n25x8192-slot-sum-8192, 269, 200, 68, 1, 0, 538, 204801
n25x8192-slot-sum-8192, 265, 199, 69, 1, 0, 534, 204801
n25x8192-slot-sum-8192, 263, 200, 69, 1, 0, 533, 204801
n25x8192-slot-sum-8192, 268, 199, 70, 1, 0, 538, 204801
n25x8192-slot-sum-8192, 265, 200, 69, 1, 0, 535, 204801
n25x8192-slot-sum-8192, 267, 200, 68, 1, 0, 536, 204801
n25x8192-slot-sum-8192, 266, 199, 68, 1, 0, 534, 204801
n25x8192-slot-sum-8192, 264, 201, 69, 1, 0, 535, 204801
n25x8192-slot-sum-8192, 266, 201, 68, 1, 0, 536, 204801
n25x8192-slot-sum-8192, 264, 200, 69, 1, 0, 534, 204801
n25x8192-slot-sum-8192, 266, 199, 68, 1, 0, 534, 204801
n25x8192-slot-sum-8192, 265, 202, 70, 1, 0, 538, 204801
n25x8192-slot-sum-8192, 267, 200, 73, 1, 0, 541, 204801
n25x8192-slot-sum-8192, 264, 201, 68, 1, 0, 534, 204801
n25x8192-slot-sum-8192, 263, 200, 70, 1, 0, 534, 204801
n25x8192-slot-sum-8192, 261, 200, 68, 1, 0, 530, 204801
n25x8192-slot-sum-8192, 262, 199, 70, 1, 0, 532, 204801
n25x8192-slot-sum-8192, 269, 199, 70, 1, 0, 539, 204801
n25x8192-slot-sum-8192, 262, 199, 68, 1, 0, 530, 204801
n25x8192-slot-sum-8192, 264, 201, 72, 1, 0, 538, 204801
n25x8192-slot-sum-8192, 269, 200, 71, 1, 0, 541, 204801
n25x8192-slot-sum-8192, 263, 200, 72, 1, 0, 536, 204801
n25x8192-slot-sum-8192, 266, 201, 69, 1, 0, 537, 204801
n25x8192-slot-sum-8192, 260, 200, 68, 1, 0, 529, 204801
n25x8192-slot-sum-8192, 267, 198, 69, 1, 0, 535, 204801
n25x8192-slot-inner-512, 18, 191, 360, 0, 0, 569, 341335
n25x8192-slot-inner-512, 19, 196, 366, 0, 0, 581, 341335
n25x8192-slot-inner-512, 19, 191, 363, 0, 0, 573, 341335
n25x8192-slot-inner-512, 19, 192, 360, 0, 0, 571, 341335
n25x8192-slot-inner-512, 19, 197, 365, 0, 0, 581, 341335
n25x8192-slot-inner-512, 19, 194, 364, 0, 0, 577, 341335
n25x8192-slot-inner-512, 19, 193, 361, 0, 0, 573, 341335
n25x8192-slot-inner-512, 19, 192, 364, 0, 0, 575, 341335
n25x8192-slot-inner-512, 19, 193, 363, 0, 0, 575, 341335
n25x8192-slot-inner-512, 19, 193, 368, 0, 0, 580, 341335
n25x8192-slot-inner-512, 19, 195, 369, 0, 0, 583, 341335
n25x8192-slot-inner-512, 19, 192, 362, 0, 0, 573, 341335
n25x8192-slot-inner-512, 19, 192, 366, 0, 0, 577, 341335
n25x8192-slot-inner-512, 19, 194, 366, 0, 0, 579, 341335
n25x8192-slot-inner-512, 19, 197, 380, 0, 0, 596, 341335
n25x8192-slot-inner-512, 19, 192, 361, 0, 0, 572, 341335
n25x8192-slot-inner-512, 19, 194, 363, 0, 0, 576, 341335
n25x8192-slot-inner-512, 19, 195, 366, 0, 0, 580, 341335
n25x8192-slot-inner-512, 19, 192, 361, 0, 0, 572, 341335
n25x8192-slot-inner-512, 19, 193, 364, 0, 0, 576, 341335
n25x8192-slot-inner-512, 19, 193, 365, 0, 0, 577, 341335
n25x8192-slot-inner-512, 19, 194, 361, 0, 0, 574, 341335
n25x8192-slot-inner-512, 19, 193, 365, 0, 0, 577, 341335
n25x8192-slot-inner-512, 19, 193, 361, 0, 0, 573, 341335
n25x8192-slot-inner-512, 19, 193, 365, 0, 0, 577, 341335
n25x8192-slot-inner-512, 19, 194, 366, 0, 0, 579, 341335
n25x8192-slot-inner-512, 19, 193, 364, 0, 0, 576, 341335
n25x8192-slot-inner-512, 19, 193, 368, 0, 0, 580, 341335
n25x8192-slot-inner-512, 19, 192, 360, 0, 0, 571, 341335
n25x8192-slot-inner-512, 19, 193, 364, 0, 0, 576, 341335
n25x8192-slot-inner-512, 19, 191, 367, 0, 0, 577, 341335
n25x8192-slot-inner-512, 19, 193, 361, 0, 0, 573, 341335
n25x8192-slot-inner-512, 19, 194, 364, 0, 0, 577, 341335
n25x8192-slot-inner-512, 19, 194, 361, 0, 0, 574, 341335
n25x8192-slot-inner-512, 19, 193, 364, 0, 0, 576, 341335
n25x8192-slot-inner-512, 19, 195, 366, 0, 0, 580, 341335
n25x8192-slot-inner-512, 19, 193, 363, 0, 0, 575, 341335
n25x8192-slot-inner-512, 19, 195, 369, 0, 0, 583, 341335
n25x8192-slot-inner-512, 19, 193, 360, 0, 0, 572, 341335
n25x8192-slot-inner-512, 19, 195, 365, 0, 0, 579, 341335
n25x8192-slot-inner-512, 19, 191, 362, 0, 0, 572, 341335
n25x8192-slot-inner-512, 19, 192, 364, 0, 0, 575, 341335
n25x8192-slot-inner-512, 19, 192, 366, 0, 0, 577, 341335
n25x8192-slot-inner-512, 19, 193, 365, 0, 0, 577, 341335
n25x8192-slot-inner-512, 19, 194, 367, 0, 0, 580, 341335
n25x8192-slot-inner-512, 19, 195, 364, 0, 0, 578, 341335
n25x8192-slot-inner-512, 19, 193, 362, 0, 0, 574, 341335
n25x8192-slot-inner-512, 18, 195, 368, 0, 0, 581, 341335
n25x8192-slot-inner-512, 19, 191, 361, 0, 0, 571, 341335
n25x8192-slot-inner-512, 19, 191, 367, 0, 0, 577, 341335
n25x8192-slot-inner-512, 19, 192, 365, 0, 0, 576, 341335
n25x8192-slot-inner-512, 19, 195, 363, 0, 0, 577, 341335
n25x8192-slot-inner-512, 19, 193, 364, 0, 0, 576, 341335
n25x8192-slot-inner-512, 19, 192, 360, 0, 0, 571, 341335
n25x8192-slot-inner-512, 19, 194, 366, 0, 0, 579, 341335
n25x8192-slot-inner-512, 19, 192, 364, 0, 0, 575, 341335
n25x8192-slot-inner-512, 19, 194, 361, 0, 0, 574, 341335
n25x8192-slot-inner-512, 19, 191, 364, 0, 0, 574, 341335
n25x8192-slot-inner-512, 19, 204, 366, 0, 0, 589, 341335
n25x8192-slot-inner-512, 19, 193, 364, 0, 0, 576, 341335
n25x8192-slot-inner-512, 19, 191, 361, 0, 0, 571, 341335
n25x8192-slot-inner-512, 19, 192, 362, 0, 0, 573, 341335
n25x8192-slot-inner-512, 19, 192, 364, 0, 0, 575, 341335
n25x8192-slot-inner-512, 19, 192, 362, 0, 0, 573, 341335
n25x8192-slot-inner-512, 19, 195, 366, 0, 0, 580, 341335
n25x8192-slot-inner-512, 19, 192, 362, 0, 0, 573, 341335
n25x8192-slot-inner-512, 19, 194, 364, 0, 0, 577, 341335
n25x8192-slot-inner-512, 19, 191, 365, 0, 0, 575, 341335
n25x8192-slot-inner-512, 19, 192, 367, 0, 0, 578, 341335
n25x8192-slot-inner-512, 19, 192, 366, 0, 0, 577, 341335
n25x8192-slot-inner-512, 19, 193, 365, 0, 0, 577, 341335
n25x8192-slot-inner-512, 19, 196, 365, 0, 0, 580, 341335
n25x8192-slot-inner-512, 19, 193, 368, 0, 0, 580, 341335
n25x8192-slot-inner-512, 20, 196, 367, 0, 0, 583, 341335
n25x8192-slot-inner-512, 19, 194, 363, 0, 0, 576, 341335
n25x8192-slot-inner-512, 19, 191, 360, 0, 0, 570, 341335
n25x8192-slot-inner-512, 19, 192, 364, 0, 0, 575, 341335
n25x8192-slot-inner-512, 19, 193, 365, 0, 0, 577, 341335
n25x8192-slot-inner-512, 19, 192, 361, 0, 0, 572, 341335
n25x8192-slot-inner-512, 19, 193, 366, 0, 0, 578, 341335
n25x8192-slot-inner-512, 19, 198, 364, 0, 0, 581, 341335
n25x8192-slot-inner-512, 19, 193, 367, 0, 0, 579, 341335
n25x8192-slot-inner-512, 19, 193, 362, 0, 0, 574, 341335
n25x8192-slot-inner-512, 19, 195, 362, 0, 0, 576, 341335
n25x8192-slot-inner-512, 19, 192, 364, 0, 0, 575, 341335
n25x8192-slot-inner-512, 19, 192, 361, 0, 0, 572, 341335
n25x8192-slot-inner-512, 19, 193, 365, 0, 0, 577, 341335
n25x8192-slot-inner-512, 19, 191, 365, 0, 0, 575, 341335
n25x8192-slot-inner-512, 19, 195, 364, 0, 0, 578, 341335
n25x8192-slot-inner-512, 19, 196, 365, 0, 0, 580, 341335
n25x8192-slot-inner-512, 18, 191, 360, 0, 0, 569, 341335
n25x8192-slot-inner-512, 19, 193, 364, 0, 0, 576, 341335
n25x8192-slot-inner-512, 19, 193, 368, 0, 0, 580, 341335
n25x8192-slot-inner-512, 19, 197, 366, 0, 0, 582, 341335
n25x8192-slot-inner-512, 19, 193, 367, 0, 0, 579, 341335
n25x8192-slot-inner-512, 19, 192, 362, 0, 0, 573, 341335
n25x8192-slot-inner-512, 19, 195, 364, 0, 0, 578, 341335
n25x8192-slot-inner-512, 19, 195, 369, 0, 0, 583, 341335
n25x8192-slot-inner-512, 19, 196, 366, 0, 0, 581, 341335
n25x8192-slot-inner-512, 19, 194, 365, 0, 0, 578, 341335
n25x8192-slot-inner-1024, 33, 184, 328, 0, 0, 545, 341335
n25x8192-slot-inner-1024, 33, 185, 333, 0, 0, 551, 341335
n25x8192-slot-inner-1024, 34, 184, 328, 0, 0, 546, 341335
n25x8192-slot-inner-1024, 34, 186, 330, 0, 0, 550, 341335
n25x8192-slot-inner-1024, 33, 186, 332, 0, 0, 551, 341335
n25x8192-slot-inner-1024, 33, 185, 330, 0, 0, 548, 341335
n25x8192-slot-inner-1024, 33, 184, 333, 0, 0, 550, 341335
n25x8192-slot-inner-1024, 34, 185, 340, 0, 0, 559, 341335
n25x8192-slot-inner-1024, 33, 184, 332, 0, 0, 549, 341335
n25x8192-slot-inner-1024, 33, 184, 331, 0, 0, 548, 341335
n25x8192-slot-inner-1024, 33, 186, 330, 0, 0, 549, 341335
n25x8192-slot-inner-1024, 34, 186, 334, 0, 0, 554, 341335
n25x8192-slot-inner-1024, 35, 185, 331, 0, 0, 551, 341335
n25x8192-slot-inner-1024, 33, 185, 335, 0, 0, 553, 341335
n25x8192-slot-inner-1024, 36, 184, 342, 0, 0, 562, 341335
n25x8192-slot-inner-1024, 33, 187, 354, 0, 0, 574, 341335
n25x8192-slot-inner-1024, 34, 186, 332, 0, 0, 552, 341335
n25x8192-slot-inner-1024, 33, 186, 330, 0, 0, 549, 341335
n25x8192-slot-inner-1024, 35, 184, 346, 0, 0, 565, 341335
n25x8192-slot-inner-1024, 34, 187, 333, 0, 0, 554, 341335
n25x8192-slot-inner-1024, 33, 186, 334, 0, 0, 553, 341335
n25x8192-slot-inner-1024, 34, 185, 332, 0, 0, 551, 341335
n25x8192-slot-inner-1024, 33, 187, 331, 0, 0, 551, 341335
n25x8192-slot-inner-1024, 33, 186, 333, 0, 0, 552, 341335
n25x8192-slot-inner-1024, 34, 186, 332, 0, 0, 552, 341335
n25x8192-slot-inner-1024, 34, 185, 332, 0, 0, 551, 341335
n25x8192-slot-inner-1024, 34, 184, 329, 0, 0, 547, 341335
n25x8192-slot-inner-1024, 34, 185, 333, 0, 0, 552, 341335
n25x8192-slot-inner-1024, 33, 187, 333, 0, 0, 553, 341335
n25x8192-slot-inner-1024, 33, 186, 329, 0, 0, 548, 341335
n25x8192-slot-inner-1024, 34, 185, 330, 0, 0, 549, 341335
n25x8192-slot-inner-1024, 34, 186, 331, 0, 0, 551, 341335
n25x8192-slot-inner-1024, 34, 186, 332, 0, 0, 552, 341335
n25x8192-slot-inner-1024, 34, 187, 337, 0, 0, 558, 341335
n25x8192-slot-inner-1024, 34, 186, 333, 0, 0, 553, 341335
n25x8192-slot-inner-1024, 33, 185, 331, 0, 0, 549, 341335
n25x8192-slot-inner-1024, 33, 186, 333, 0, 0, 552, 341335
n25x8192-slot-inner-1024, 33, 184, 330, 0, 0, 547, 341335
n25x8192-slot-inner-1024, 34, 186, 329, 0, 0, 549, 341335
n25x8192-slot-inner-1024, 33, 185, 331, 0, 0, 549, 341335
n25x8192-slot-inner-1024, 34, 185, 331, 0, 0, 550, 341335
n25x8192-slot-inner-1024, 34, 187, 333, 0, 0, 554, 341335
n25x8192-slot-inner-1024, 34, 185, 333, 0, 0, 552, 341335
n25x8192-slot-inner-1024, 34, 186, 332, 0, 0, 552, 341335
n25x8192-slot-inner-1024, 34, 185, 333, 0, 0, 552, 341335
n25x8192-slot-inner-1024, 38, 185, 344, 0, 0, 567, 341335
n25x8192-slot-inner-1024, 33, 186, 333, 0, 0, 552, 341335
n25x8192-slot-inner-1024, 33, 186, 329, 0, 0, 548, 341335
n25x8192-slot-inner-1024, 35, 186, 332, 0, 0, 553, 341335
n25x8192-slot-inner-1024, 34, 186, 336, 0, 0, 556, 341335
n25x8192-slot-inner-1024, 41, 187, 345, 0, 0, 573, 341335
n25x8192-slot-inner-1024, 35, 186, 333, 0, 0, 554, 341335
n25x8192-slot-inner-1024, 34, 187, 332, 0, 0, 553, 341335
n25x8192-slot-inner-1024, 33, 186, 333, 0, 0, 552, 341335
n25x8192-slot-inner-1024, 35, 185, 330, 0, 0, 550, 341335
n25x8192-slot-inner-1024, 33, 186, 331, 0, 0, 550, 341335
n25x8192-slot-inner-1024, 33, 185, 332, 0, 0, 550, 341335
n25x8192-slot-inner-1024, 33, 187, 332, 0, 0, 552, 341335
n25x8192-slot-inner-1024, 33, 185, 334, 0, 0, 552, 341335
n25x8192-slot-inner-1024, 34, 189, 331, 0, 0, 554, 341335
n25x8192-slot-inner-1024, 33, 185, 335, 0, 0, 553, 341335
n25x8192-slot-inner-1024, 33, 185, 331, 0, 0, 549, 341335
n25x8192-slot-inner-1024, 33, 186, 332, 0, 0, 551, 341335
n25x8192-slot-inner-1024, 33, 185, 331, 0, 0, 549, 341335
n25x8192-slot-inner-1024, 33, 187, 331, 0, 0, 551, 341335
n25x8192-slot-inner-1024, 34, 186, 335, 0, 0, 555, 341335
n25x8192-slot-inner-1024, 34, 184, 345, 0, 0, 563, 341335
n25x8192-slot-inner-1024, 40, 186, 343, 0, 0, 569, 341335
n25x8192-slot-inner-1024, 34, 185, 334, 0, 0, 553, 341335
n25x8192-slot-inner-1024, 32, 186, 332, 0, 0, 550, 341335
n25x8192-slot-inner-1024, 33, 188, 333, 0, 0, 554, 341335
n25x8192-slot-inner-1024, 35, 187, 346, 0, 0, 568, 341335
n25x8192-slot-inner-1024, 33, 186, 333, 0, 0, 552, 341335
n25x8192-slot-inner-1024, 34, 185, 329, 0, 0, 548, 341335
n25x8192-slot-inner-1024, 34, 189, 333, 0, 0, 556, 341335
n25x8192-slot-inner-1024, 33, 185, 332, 0, 0, 550, 341335
n25x8192-slot-inner-1024, 33, 187, 330, 0, 0, 550, 341335
n25x8192-slot-inner-1024, 33, 186, 332, 0, 0, 551, 341335
n25x8192-slot-inner-1024, 36, 185, 343, 0, 0, 564, 341335
n25x8192-slot-inner-1024, 33, 185, 330, 0, 0, 548, 341335
n25x8192-slot-inner-1024, 33, 187, 334, 0, 0, 554, 341335
n25x8192-slot-inner-1024, 33, 186, 331, 0, 0, 550, 341335
n25x8192-slot-inner-1024, 34, 187, 332, 0, 0, 553, 341335
n25x8192-slot-inner-1024, 33, 186, 333, 0, 0, 552, 341335
n25x8192-slot-inner-1024, 33, 185, 335, 0, 0, 553, 341335
n25x8192-slot-inner-1024, 34, 185, 333, 0, 0, 552, 341335
n25x8192-slot-inner-1024, 34, 184, 333, 0, 0, 551, 341335
n25x8192-slot-inner-1024, 35, 184, 342, 0, 0, 561, 341335
n25x8192-slot-inner-1024, 33, 186, 336, 0, 0, 555, 341335
n25x8192-slot-inner-1024, 34, 185, 328, 0, 0, 547, 341335
n25x8192-slot-inner-1024, 33, 186, 331, 0, 0, 550, 341335
n25x8192-slot-inner-1024, 33, 185, 333, 0, 0, 551, 341335
n25x8192-slot-inner-1024, 33, 185, 331, 0, 0, 549, 341335
n25x8192-slot-inner-1024, 35, 185, 347, 0, 0, 567, 341335
n25x8192-slot-inner-1024, 33, 184, 330, 0, 0, 547, 341335
n25x8192-slot-inner-1024, 33, 185, 332, 0, 0, 550, 341335
n25x8192-slot-inner-1024, 33, 185, 333, 0, 0, 551, 341335
n25x8192-slot-inner-1024, 33, 185, 330, 0, 0, 548, 341335
n25x8192-slot-inner-1024, 34, 185, 334, 0, 0, 553, 341335
n25x8192-slot-inner-1024, 34, 186, 333, 0, 0, 553, 341335
n25x8192-slot-inner-2048, 63, 186, 327, 0, 0, 576, 341335
n25x8192-slot-inner-2048, 63, 186, 328, 0, 0, 577, 341335
n25x8192-slot-inner-2048, 63, 187, 327, 0, 0, 577, 341335
n25x8192-slot-inner-2048, 72, 186, 326, 0, 0, 584, 341335
n25x8192-slot-inner-2048, 63, 186, 325, 0, 0, 574, 341335
n25x8192-slot-inner-2048, 63, 187, 327, 0, 0, 577, 341335
n25x8192-slot-inner-2048, 62, 186, 327, 0, 0, 575, 341335
n25x8192-slot-inner-2048, 67, 187, 340, 0, 0, 594, 341335
n25x8192-slot-inner-2048, 62, 185, 326, 0, 0, 573, 341335
n25x8192-slot-inner-2048, 63, 185, 325, 0, 0, 573, 341335
n25x8192-slot-inner-2048, 63, 186, 331, 0, 0, 580, 341335
n25x8192-slot-inner-2048, 64, 187, 327, 0, 0, 578, 341335
n25x8192-slot-inner-2048, 74, 186, 339, 0, 0, 599, 341335
n25x8192-slot-inner-2048, 63, 186, 329, 0, 0, 578, 341335
n25x8192-slot-inner-2048, 63, 186, 326, 0, 0, 575, 341335
n25x8192-slot-inner-2048, 63, 186, 329, 0, 0, 578, 341335
n25x8192-slot-inner-2048, 64, 188, 328, 0, 0, 580, 341335
n25x8192-slot-inner-2048, 63, 188, 330, 0, 0, 581, 341335
n25x8192-slot-inner-2048, 63, 185, 329, 0, 0, 577, 341335
n25x8192-slot-inner-2048, 79, 187, 330, 0, 0, 596, 341335
n25x8192-slot-inner-2048, 63, 187, 332, 0, 0, 582, 341335
n25x8192-slot-inner-2048, 65, 187, 326, 0, 0, 578, 341335
n25x8192-slot-inner-2048, 63, 187, 329, 0, 0, 579, 341335
n25x8192-slot-inner-2048, 63, 186, 330, 0, 0, 579, 341335
n25x8192-slot-inner-2048, 63, 186, 326, 0, 0, 575, 341335
n25x8192-slot-inner-2048, 67, 188, 331, 0, 0, 586, 341335
n25x8192-slot-inner-2048, 63, 186, 329, 0, 0, 578, 341335
n25x8192-slot-inner-2048, 64, 188, 328, 0, 0, 580, 341335
n25x8192-slot-inner-2048, 63, 186, 329, 0, 0, 578, 341335
n25x8192-slot-inner-2048, 63, 185, 327, 0, 0, 575, 341335
n25x8192-slot-inner-2048, 63, 187, 330, 0, 0, 580, 341335
n25x8192-slot-inner-2048, 63, 187, 328, 0, 0, 578, 341335
n25x8192-slot-inner-2048, 63, 188, 326, 0, 0, 577, 341335
n25x8192-slot-inner-2048, 63, 185, 329, 0, 0, 577, 341335
n25x8192-slot-inner-2048, 63, 187, 328, 0, 0, 578, 341335
n25x8192-slot-inner-2048, 63, 187, 330, 0, 0, 580, 341335
n25x8192-slot-inner-2048, 63, 186, 328, 0, 0, 577, 341335
n25x8192-slot-inner-2048, 63, 188, 326, 0, 0, 577, 341335
n25x8192-slot-inner-2048, 63, 185, 331, 0, 0, 579, 341335
n25x8192-slot-inner-2048, 63, 186, 327, 0, 0, 576, 341335
n25x8192-slot-inner-2048, 68, 187, 329, 0, 0, 584, 341335
n25x8192-slot-inner-2048, 73, 186, 339, 0, 0, 598, 341335
n25x8192-slot-inner-2048, 63, 187, 326, 0, 0, 576, 341335
n25x8192-slot-inner-2048, 70, 186, 343, 0, 0, 599, 341335
n25x8192-slot-inner-2048, 63, 186, 326, 0, 0, 575, 341335
n25x8192-slot-inner-2048, 64, 186, 325, 0, 0, 575, 341335
n25x8192-slot-inner-2048, 63, 186, 330, 0, 0, 579, 341335
n25x8192-slot-inner-2048, 63, 187, 329, 0, 0, 579, 341335
n25x8192-slot-inner-2048, 63, 188, 328, 0, 0, 579, 341335
n25x8192-slot-inner-2048, 64, 188, 330, 0, 0, 582, 341335
n25x8192-slot-inner-2048, 64, 188, 332, 0, 0, 584, 341335
n25x8192-slot-inner-2048, 63, 186, 329, 0, 0, 578, 341335
n25x8192-slot-inner-2048, 75, 187, 328, 0, 0, 590, 341335
n25x8192-slot-inner-2048, 63, 188, 325, 0, 0, 576, 341335
n25x8192-slot-inner-2048, 63, 186, 326, 0, 0, 575, 341335
n25x8192-slot-inner-2048, 66, 186, 328, 0, 0, 580, 341335
n25x8192-slot-inner-2048, 63, 186, 327, 0, 0, 576, 341335
n25x8192-slot-inner-2048, 63, 186, 325, 0, 0, 574, 341335
n25x8192-slot-inner-2048, 63, 187, 329, 0, 0, 579, 341335
n25x8192-slot-inner-2048, 63, 185, 325, 0, 0, 573, 341335
n25x8192-slot-inner-2048, 64, 187, 330, 0, 0, 581, 341335
n25x8192-slot-inner-2048, 64, 187, 331, 0, 0, 582, 341335
n25x8192-slot-inner-2048, 66, 195, 326, 0, 0, 587, 341335
n25x8192-slot-inner-2048, 63, 187, 329, 0, 0, 579, 341335
n25x8192-slot-inner-2048, 63, 186, 325, 0, 0, 574, 341335
n25x8192-slot-inner-2048, 63, 187, 325, 0, 0, 575, 341335
n25x8192-slot-inner-2048, 63, 186, 329, 0, 0, 578, 341335
n25x8192-slot-inner-2048, 64, 186, 326, 0, 0, 576, 341335
n25x8192-slot-inner-2048, 63, 187, 331, 0, 0, 581, 341335
n25x8192-slot-inner-2048, 62, 186, 328, 0, 0, 576, 341335
n25x8192-slot-inner-2048, 63, 187, 330, 0, 0, 580, 341335
n25x8192-slot-inner-2048, 63, 186, 328, 0, 0, 577, 341335
n25x8192-slot-inner-2048, 64, 188, 329, 0, 0, 581, 341335
n25x8192-slot-inner-2048, 64, 188, 328, 0, 0, 580, 341335
n25x8192-slot-inner-2048, 63, 186, 324, 0, 0, 573, 341335
n25x8192-slot-inner-2048, 63, 187, 329, 0, 0, 579, 341335
n25x8192-slot-inner-2048, 74, 187, 331, 0, 0, 592, 341335
n25x8192-slot-inner-2048, 65, 189, 329, 0, 0, 583, 341335
n25x8192-slot-inner-2048, 63, 188, 329, 0, 0, 580, 341335
n25x8192-slot-inner-2048, 63, 186, 327, 0, 0, 576, 341335
n25x8192-slot-inner-2048, 63, 186, 329, 0, 0, 578, 341335
n25x8192-slot-inner-2048, 64, 188, 328, 0, 0, 580, 341335
n25x8192-slot-inner-2048, 63, 187, 326, 0, 0, 576, 341335
n25x8192-slot-inner-2048, 63, 187, 328, 0, 0, 578, 341335
n25x8192-slot-inner-2048, 63, 186, 327, 0, 0, 576, 341335
n25x8192-slot-inner-2048, 64, 188, 328, 0, 0, 580, 341335
n25x8192-slot-inner-2048, 64, 189, 328, 0, 0, 581, 341335
n25x8192-slot-inner-2048, 67, 188, 328, 0, 0, 583, 341335
n25x8192-slot-inner-2048, 63, 189, 328, 0, 0, 580, 341335
n25x8192-slot-inner-2048, 63, 186, 325, 0, 0, 574, 341335
n25x8192-slot-inner-2048, 64, 188, 326, 0, 0, 578, 341335
n25x8192-slot-inner-2048, 63, 186, 326, 0, 0, 575, 341335
n25x8192-slot-inner-2048, 64, 186, 325, 0, 0, 575, 341335
n25x8192-slot-inner-2048, 63, 188, 328, 0, 0, 579, 341335
n25x8192-slot-inner-2048, 63, 186, 328, 0, 0, 577, 341335
n25x8192-slot-inner-2048, 63, 185, 326, 0, 0, 574, 341335
n25x8192-slot-inner-2048, 63, 186, 329, 0, 0, 578, 341335
n25x8192-slot-inner-2048, 64, 187, 330, 0, 0, 581, 341335
n25x8192-slot-inner-2048, 63, 188, 330, 0, 0, 581, 341335
n25x8192-slot-inner-2048, 63, 186, 327, 0, 0, 576, 341335
n25x8192-slot-inner-8192, 291, 205, 398, 1, 0, 895, 341335
n25x8192-slot-inner-8192, 283, 200, 397, 1, 0, 881, 341335
n25x8192-slot-inner-8192, 283, 200, 399, 1, 0, 883, 341335
n25x8192-slot-inner-8192, 285, 202, 394, 1, 0, 882, 341335
n25x8192-slot-inner-8192, 282, 201, 397, 1, 0, 881, 341335
n25x8192-slot-inner-8192, 278, 201, 392, 1, 0, 872, 341335
n25x8192-slot-inner-8192, 287, 200, 397, 1, 0, 885, 341335
n25x8192-slot-inner-8192, 282, 204, 397, 1, 0, 884, 341335
n25x8192-slot-inner-8192, 280, 200, 399, 1, 0, 880, 341335
n25x8192-slot-inner-8192, 285, 202, 398, 1, 0, 886, 341335
n25x8192-slot-inner-8192, 283, 199, 399, 1, 0, 882, 341335
n25x8192-slot-inner-8192, 284, 202, 397, 1, 0, 884, 341335
n25x8192-slot-inner-8192, 280, 200, 396, 1, 0, 877, 341335
n25x8192-slot-inner-8192, 293, 200, 399, 1, 0, 893, 341335
n25x8192-slot-inner-8192, 282, 202, 403, 1, 0, 888, 341335
n25x8192-slot-inner-8192, 284, 202, 399, 1, 0, 886, 341335
n25x8192-slot-inner-8192, 283, 202, 400, 1, 0, 886, 341335
n25x8192-slot-inner-8192, 281, 202, 395, 1, 0, 879, 341335
n25x8192-slot-inner-8192, 283, 201, 398, 1, 0, 883, 341335
n25x8192-slot-inner-8192, 283, 201, 396, 1, 0, 881, 341335
n25x8192-slot-inner-8192, 283, 199, 414, 1, 0, 897, 341335
n25x8192-slot-inner-8192, 286, 203, 396, 1, 0, 886, 341335
n25x8192-slot-inner-8192, 280, 200, 400, 1, 0, 881, 341335
n25x8192-slot-inner-8192, 280, 201, 398, 1, 0, 880, 341335
n25x8192-slot-inner-8192, 286, 201, 412, 1, 0, 900, 341335
n25x8192-slot-inner-8192, 288, 201, 396, 1, 0, 886, 341335
n25x8192-slot-inner-8192, 282, 200, 396, 1, 0, 879, 341335
n25x8192-slot-inner-8192, 282, 201, 403, 1, 0, 887, 341335
n25x8192-slot-inner-8192, 286, 199, 398, 1, 0, 884, 341335
n25x8192-slot-inner-8192, 291, 203, 396, 1, 0, 891, 341335
n25x8192-slot-inner-8192, 283, 200, 411, 1, 0, 895, 341335
n25x8192-slot-inner-8192, 286, 200, 414, 1, 0, 901, 341335
n25x8192-slot-inner-8192, 280, 199, 402, 1, 0, 882, 341335
n25x8192-slot-inner-8192, 284, 202, 401, 1, 0, 888, 341335
n25x8192-slot-inner-8192, 285, 200, 404, 1, 0, 890, 341335
n25x8192-slot-inner-8192, 283, 199, 399, 1, 0, 882, 341335
n25x8192-slot-inner-8192, 287, 200, 395, 1, 0, 883, 341335
n25x8192-slot-inner-8192, 283, 201, 398, 1, 0, 883, 341335
n25x8192-slot-inner-8192, 284, 201, 400, 1, 0, 886, 341335
n25x8192-slot-inner-8192, 279, 201, 399, 1, 0, 880, 341335
n25x8192-slot-inner-8192, 283, 201, 396, 1, 0, 881, 341335
n25x8192-slot-inner-8192, 284, 201, 398, 1, 0, 884, 341335
n25x8192-slot-inner-8192, 279, 199, 398, 1, 0, 877, 341335
n25x8192-slot-inner-8192, 282, 202, 396, 1, 0, 881, 341335
n25x8192-slot-inner-8192, 280, 199, 397, 1, 0, 877, 341335
n25x8192-slot-inner-8192, 287, 200, 397, 1, 0, 885, 341335
n25x8192-slot-inner-8192, 284, 199, 397, 1, 0, 881, 341335
n25x8192-slot-inner-8192, 285, 201, 395, 1, 0, 882, 341335
n25x8192-slot-inner-8192, 287, 202, 396, 1, 0, 886, 341335
n25x8192-slot-inner-8192, 281, 200, 402, 1, 0, 884, 341335
n25x8192-slot-inner-8192, 280, 200, 409, 1, 0, 890, 341335
n25x8192-slot-inner-8192, 288, 200, 414, 1, 0, 903, 341335
n25x8192-slot-inner-8192, 283, 199, 396, 1, 0, 879, 341335
n25x8192-slot-inner-8192, 283, 199, 395, 1, 0, 878, 341335
n25x8192-slot-inner-8192, 282, 199, 395, 1, 0, 877, 341335
n25x8192-slot-inner-8192, 282, 198, 398, 1, 0, 879, 341335
n25x8192-slot-inner-8192, 282, 201, 396, 1, 0, 880, 341335
n25x8192-slot-inner-8192, 282, 199, 390, 1, 0, 872, 341335
n25x8192-slot-inner-8192, 279, 202, 396, 1, 0, 878, 341335
n25x8192-slot-inner-8192, 287, 200, 395, 1, 0, 883, 341335
n25x8192-slot-inner-8192, 280, 200, 398, 1, 0, 879, 341335
n25x8192-slot-inner-8192, 278, 200, 399, 1, 0, 878, 341335
n25x8192-slot-inner-8192, 283, 201, 411, 1, 0, 896, 341335
n25x8192-slot-inner-8192, 284, 201, 400, 1, 0, 886, 341335
n25x8192-slot-inner-8192, 281, 201, 401, 1, 0, 884, 341335
n25x8192-slot-inner-8192, 282, 200, 396, 1, 0, 879, 341335
n25x8192-slot-inner-8192, 296, 199, 412, 1, 0, 908, 341335
n25x8192-slot-inner-8192, 286, 202, 399, 1, 0, 888, 341335
n25x8192-slot-inner-8192, 288, 201, 399, 1, 0, 889, 341335
n25x8192-slot-inner-8192, 280, 199, 392, 1, 0, 872, 341335
n25x8192-slot-inner-8192, 282, 201, 397, 1, 0, 881, 341335
n25x8192-slot-inner-8192, 284, 200, 396, 1, 0, 881, 341335
n25x8192-slot-inner-8192, 286, 200, 395, 1, 0, 882, 341335
n25x8192-slot-inner-8192, 286, 201, 400, 1, 0, 888, 341335
n25x8192-slot-inner-8192, 286, 200, 394, 1, 0, 881, 341335
n25x8192-slot-inner-8192, 279, 200, 399, 1, 0, 879, 341335
n25x8192-slot-inner-8192, 285, 201, 395, 1, 0, 882, 341335
n25x8192-slot-inner-8192, 280, 199, 400, 1, 0, 880, 341335
n25x8192-slot-inner-8192, 284, 200, 396, 1, 0, 881, 341335
n25x8192-slot-inner-8192, 283, 200, 399, 1, 0, 883, 341335
n25x8192-slot-inner-8192, 283, 200, 398, 1, 0, 882, 341335
n25x8192-slot-inner-8192, 289, 202, 411, 1, 0, 903, 341335
n25x8192-slot-inner-8192, 283, 201, 402, 1, 0, 887, 341335
n25x8192-slot-inner-8192, 282, 200, 413, 1, 0, 896, 341335
n25x8192-slot-inner-8192, 281, 199, 413, 1, 0, 894, 341335
n25x8192-slot-inner-8192, 279, 200, 398, 1, 0, 878, 341335
n25x8192-slot-inner-8192, 284, 200, 414, 1, 0, 899, 341335
n25x8192-slot-inner-8192, 279, 198, 391, 1, 0, 869, 341335
n25x8192-slot-inner-8192, 283, 202, 400, 1, 0, 886, 341335
n25x8192-slot-inner-8192, 281, 199, 394, 1, 0, 875, 341335
n25x8192-slot-inner-8192, 280, 201, 396, 1, 0, 878, 341335
n25x8192-slot-inner-8192, 282, 201, 401, 1, 0, 885, 341335
n25x8192-slot-inner-8192, 279, 201, 396, 1, 0, 877, 341335
n25x8192-slot-inner-8192, 281, 201, 393, 1, 0, 876, 341335
n25x8192-slot-inner-8192, 280, 198, 398, 1, 0, 877, 341335
n25x8192-slot-inner-8192, 281, 199, 399, 1, 0, 880, 341335
n25x8192-slot-inner-8192, 278, 199, 394, 1, 0, 872, 341335
n25x8192-slot-inner-8192, 280, 202, 395, 1, 0, 878, 341335
n25x8192-slot-inner-8192, 285, 200, 396, 1, 0, 882, 341335
n25x8192-slot-inner-8192, 283, 201, 404, 1, 0, 889, 341335
n25x8192-coef-inner-512, 9, 690, 371, 0, 0, 1070, 341335
n25x8192-coef-inner-512, 9, 687, 363, 0, 0, 1059, 341335
n25x8192-coef-inner-512, 9, 682, 364, 0, 0, 1055, 341335
n25x8192-coef-inner-512, 9, 682, 367, 0, 0, 1058, 341335
n25x8192-coef-inner-512, 9, 684, 366, 0, 0, 1059, 341335
n25x8192-coef-inner-512, 9, 682, 366, 0, 0, 1057, 341335
n25x8192-coef-inner-512, 9, 686, 362, 0, 0, 1057, 341335
n25x8192-coef-inner-512, 9, 685, 366, 0, 0, 1060, 341335
n25x8192-coef-inner-512, 8, 681, 361, 0, 0, 1050, 341335
n25x8192-coef-inner-512, 9, 682, 359, 0, 0, 1050, 341335
n25x8192-coef-inner-512, 9, 687, 365, 0, 0, 1061, 341335
n25x8192-coef-inner-512, 9, 686, 362, 0, 0, 1057, 341335
n25x8192-coef-inner-512, 9, 685, 365, 0, 0, 1059, 341335
n25x8192-coef-inner-512, 9, 690, 366, 0, 0, 1065, 341335
n25x8192-coef-inner-512, 9, 689, 365, 0, 0, 1063, 341335
n25x8192-coef-inner-512, 9, 686, 362, 0, 0, 1057, 341335
n25x8192-coef-inner-512, 9, 677, 366, 0, 0, 1052, 341335
n25x8192-coef-inner-512, 9, 678, 364, 0, 0, 1051, 341335
n25x8192-coef-inner-512, 9, 682, 364, 0, 0, 1055, 341335
n25x8192-coef-inner-512, 9, 683, 364, 0, 0, 1056, 341335
n25x8192-coef-inner-512, 9, 688, 363, 0, 0, 1060, 341335
n25x8192-coef-inner-512, 9, 686, 363, 0, 0, 1058, 341335
n25x8192-coef-inner-512, 9, 684, 364, 0, 0, 1057, 341335
n25x8192-coef-inner-512, 9, 688, 371, 0, 0, 1068, 341335
n25x8192-coef-inner-512, 9, 697, 379, 0, 0, 1085, 341335
n25x8192-coef-inner-512, 9, 688, 365, 0, 0, 1062, 341335
n25x8192-coef-inner-512, 9, 690, 364, 0, 0, 1063, 341335
n25x8192-coef-inner-512, 9, 687, 365, 0, 0, 1061, 341335
n25x8192-coef-inner-512, 9, 683, 368, 0, 0, 1060, 341335
n25x8192-coef-inner-512, 9, 687, 369, 0, 0, 1065, 341335
n25x8192-coef-inner-512, 9, 681, 366, 0, 0, 1056, 341335
n25x8192-coef-inner-512, 9, 683, 363, 0, 0, 1055, 341335
n25x8192-coef-inner-512, 9, 687, 362, 0, 0, 1058, 341335
n25x8192-coef-inner-512, 9, 683, 362, 0, 0, 1054, 341335
n25x8192-coef-inner-512, 9, 685, 360, 0, 0, 1054, 341335
n25x8192-coef-inner-512, 9, 689, 364, 0, 0, 1062, 341335
n25x8192-coef-inner-512, 9, 684, 364, 0, 0, 1057, 341335
n25x8192-coef-inner-512, 9, 684, 378, 0, 0, 1071, 341335
n25x8192-coef-inner-512, 9, 689, 367, 0, 0, 1065, 341335
n25x8192-coef-inner-512, 9, 685, 366, 0, 0, 1060, 341335
n25x8192-coef-inner-512, 9, 683, 362, 0, 0, 1054, 341335
n25x8192-coef-inner-512, 9, 682, 365, 0, 0, 1056, 341335
n25x8192-coef-inner-512, 9, 682, 367, 0, 0, 1058, 341335
n25x8192-coef-inner-512, 9, 683, 363, 0, 0, 1055, 341335
n25x8192-coef-inner-512, 9, 684, 369, 0, 0, 1062, 341335
n25x8192-coef-inner-512, 9, 687, 361, 0, 0, 1057, 341335
n25x8192-coef-inner-512, 9, 686, 362, 0, 0, 1057, 341335
n25x8192-coef-inner-512, 9, 687, 367, 0, 0, 1063, 341335
n25x8192-coef-inner-512, 9, 686, 361, 0, 0, 1056, 341335
n25x8192-coef-inner-512, 9, 682, 365, 0, 0, 1056, 341335
n25x8192-coef-inner-512, 9, 681, 366, 0, 0, 1056, 341335
n25x8192-coef-inner-512, 9, 684, 367, 0, 0, 1060, 341335
n25x8192-coef-inner-512, 9, 685, 369, 0, 0, 1063, 341335
n25x8192-coef-inner-512, 9, 688, 367, 0, 0, 1064, 341335
n25x8192-coef-inner-512, 9, 683, 365, 0, 0, 1057, 341335
n25x8192-coef-inner-512, 9, 686, 362, 0, 0, 1057, 341335
n25x8192-coef-inner-512, 9, 687, 361, 0, 0, 1057, 341335
n25x8192-coef-inner-512, 9, 684, 361, 0, 0, 1054, 341335
n25x8192-coef-inner-512, 9, 684, 361, 0, 0, 1054, 341335
n25x8192-coef-inner-512, 9, 688, 366, 0, 0, 1063, 341335
n25x8192-coef-inner-512, 9, 687, 366, 0, 0, 1062, 341335
n25x8192-coef-inner-512, 9, 683, 360, 0, 0, 1052, 341335
n25x8192-coef-inner-512, 9, 685, 364, 0, 0, 1058, 341335
n25x8192-coef-inner-512, 9, 679, 364, 0, 0, 1052, 341335
n25x8192-coef-inner-512, 9, 684, 362, 0, 0, 1055, 341335
n25x8192-coef-inner-512, 9, 689, 364, 0, 0, 1062, 341335
n25x8192-coef-inner-512, 9, 684, 368, 0, 0, 1061, 341335
n25x8192-coef-inner-512, 9, 686, 364, 0, 0, 1059, 341335
n25x8192-coef-inner-512, 9, 686, 364, 0, 0, 1059, 341335
n25x8192-coef-inner-512, 9, 685, 365, 0, 0, 1059, 341335
n25x8192-coef-inner-512, 9, 688, 365, 0, 0, 1062, 341335
n25x8192-coef-inner-512, 9, 680, 361, 0, 0, 1050, 341335
n25x8192-coef-inner-512, 9, 685, 365, 0, 0, 1059, 341335
n25x8192-coef-inner-512, 9, 682, 363, 0, 0, 1054, 341335
n25x8192-coef-inner-512, 9, 687, 364, 0, 0, 1060, 341335
n25x8192-coef-inner-512, 9, 684, 364, 0, 0, 1057, 341335
n25x8192-coef-inner-512, 9, 682, 364, 0, 0, 1055, 341335
n25x8192-coef-inner-512, 9, 688, 364, 0, 0, 1061, 341335
n25x8192-coef-inner-512, 9, 683, 363, 0, 0, 1055, 341335
n25x8192-coef-inner-512, 9, 683, 375, 0, 0, 1067, 341335
n25x8192-coef-inner-512, 9, 692, 364, 0, 0, 1065, 341335
n25x8192-coef-inner-512, 9, 687, 370, 0, 0, 1066, 341335
n25x8192-coef-inner-512, 9, 685, 362, 0, 0, 1056, 341335
n25x8192-coef-inner-512, 9, 682, 363, 0, 0, 1054, 341335
n25x8192-coef-inner-512, 9, 681, 361, 0, 0, 1051, 341335
n25x8192-coef-inner-512, 9, 682, 364, 0, 0, 1055, 341335
n25x8192-coef-inner-512, 9, 685, 366, 0, 0, 1060, 341335
n25x8192-coef-inner-512, 9, 684, 369, 0, 0, 1062, 341335
n25x8192-coef-inner-512, 9, 681, 365, 0, 0, 1055, 341335
n25x8192-coef-inner-512, 9, 683, 368, 0, 0, 1060, 341335
n25x8192-coef-inner-512, 9, 686, 365, 0, 0, 1060, 341335
n25x8192-coef-inner-512, 9, 687, 361, 0, 0, 1057, 341335
n25x8192-coef-inner-512, 9, 687, 364, 0, 0, 1060, 341335
n25x8192-coef-inner-512, 9, 686, 361, 0, 0, 1056, 341335
n25x8192-coef-inner-512, 10, 683, 363, 0, 0, 1056, 341335
n25x8192-coef-inner-512, 9, 685, 362, 0, 0, 1056, 341335
n25x8192-coef-inner-512, 9, 688, 366, 0, 0, 1063, 341335
n25x8192-coef-inner-512, 9, 685, 363, 0, 0, 1057, 341335
n25x8192-coef-inner-512, 9, 681, 363, 0, 0, 1053, 341335
n25x8192-coef-inner-512, 9, 684, 365, 0, 0, 1058, 341335
n25x8192-coef-inner-1024, 12, 665, 329, 0, 0, 1006, 341335
n25x8192-coef-inner-1024, 12, 661, 331, 0, 0, 1004, 341335
n25x8192-coef-inner-1024, 11, 667, 329, 0, 0, 1007, 341335
n25x8192-coef-inner-1024, 13, 667, 336, 0, 0, 1016, 341335
n25x8192-coef-inner-1024, 16, 662, 339, 0, 0, 1017, 341335
n25x8192-coef-inner-1024, 12, 668, 329, 0, 0, 1009, 341335
n25x8192-coef-inner-1024, 11, 666, 328, 0, 0, 1005, 341335
n25x8192-coef-inner-1024, 11, 664, 334, 0, 0, 1009, 341335
n25x8192-coef-inner-1024, 12, 667, 329, 0, 0, 1008, 341335
n25x8192-coef-inner-1024, 11, 667, 329, 0, 0, 1007, 341335
n25x8192-coef-inner-1024, 12, 667, 329, 0, 0, 1008, 341335
n25x8192-coef-inner-1024, 12, 666, 329, 0, 0, 1007, 341335
n25x8192-coef-inner-1024, 12, 671, 329, 0, 0, 1012, 341335
n25x8192-coef-inner-1024, 12, 669, 329, 0, 0, 1010, 341335
n25x8192-coef-inner-1024, 12, 668, 326, 0, 0, 1006, 341335
n25x8192-coef-inner-1024, 11, 666, 328, 0, 0, 1005, 341335
n25x8192-coef-inner-1024, 12, 668, 331, 0, 0, 1011, 341335
n25x8192-coef-inner-1024, 12, 668, 327, 0, 0, 1007, 341335
n25x8192-coef-inner-1024, 12, 664, 326, 0, 0, 1002, 341335
n25x8192-coef-inner-1024, 13, 666, 326, 0, 0, 1005, 341335
n25x8192-coef-inner-1024, 16, 667, 343, 0, 0, 1026, 341335
n25x8192-coef-inner-1024, 12, 663, 327, 0, 0, 1002, 341335
n25x8192-coef-inner-1024, 13, 667, 328, 0, 0, 1008, 341335
n25x8192-coef-inner-1024, 11, 668, 328, 0, 0, 1007, 341335
n25x8192-coef-inner-1024, 12, 671, 331, 0, 0, 1014, 341335
n25x8192-coef-inner-1024, 12, 665, 328, 0, 0, 1005, 341335
n25x8192-coef-inner-1024, 12, 669, 331, 0, 0, 1012, 341335
n25x8192-coef-inner-1024, 12, 669, 329, 0, 0, 1010, 341335
n25x8192-coef-inner-1024, 12, 670, 331, 0, 0, 1013, 341335
n25x8192-coef-inner-1024, 12, 665, 330, 0, 0, 1007, 341335
n25x8192-coef-inner-1024, 13, 660, 328, 0, 0, 1001, 341335
n25x8192-coef-inner-1024, 13, 668, 331, 0, 0, 1012, 341335
n25x8192-coef-inner-1024, 12, 667, 328, 0, 0, 1007, 341335
n25x8192-coef-inner-1024, 11, 662, 329, 0, 0, 1002, 341335
n25x8192-coef-inner-1024, 11, 662, 328, 0, 0, 1001, 341335
n25x8192-coef-inner-1024, 11, 664, 327, 0, 0, 1002, 341335
n25x8192-coef-inner-1024, 12, 664, 344, 0, 0, 1020, 341335
n25x8192-coef-inner-1024, 12, 669, 334, 0, 0, 1015, 341335
n25x8192-coef-inner-1024, 13, 667, 330, 0, 0, 1010, 341335
n25x8192-coef-inner-1024, 12, 663, 330, 0, 0, 1005, 341335
n25x8192-coef-inner-1024, 13, 665, 341, 0, 0, 1019, 341335
n25x8192-coef-inner-1024, 12, 668, 329, 0, 0, 1009, 341335
n25x8192-coef-inner-1024, 12, 664, 328, 0, 0, 1004, 341335
n25x8192-coef-inner-1024, 12, 667, 328, 0, 0, 1007, 341335
n25x8192-coef-inner-1024, 12, 669, 326, 0, 0, 1007, 341335
n25x8192-coef-inner-1024, 12, 666, 327, 0, 0, 1005, 341335
n25x8192-coef-inner-1024, 12, 667, 329, 0, 0, 1008, 341335
n25x8192-coef-inner-1024, 14, 666, 339, 0, 0, 1019, 341335
n25x8192-coef-inner-1024, 13, 666, 328, 0, 0, 1007, 341335
n25x8192-coef-inner-1024, 11, 666, 325, 0, 0, 1002, 341335
n25x8192-coef-inner-1024, 12, 668, 329, 0, 0, 1009, 341335
n25x8192-coef-inner-1024, 12, 671, 333, 0, 0, 1016, 341335
n25x8192-coef-inner-1024, 11, 666, 326, 0, 0, 1003, 341335
n25x8192-coef-inner-1024, 12, 670, 331, 0, 0, 1013, 341335
n25x8192-coef-inner-1024, 11, 667, 329, 0, 0, 1007, 341335
n25x8192-coef-inner-1024, 12, 670, 331, 0, 0, 1013, 341335
n25x8192-coef-inner-1024, 11, 671, 331, 0, 0, 1013, 341335
n25x8192-coef-inner-1024, 13, 662, 329, 0, 0, 1004, 341335
n25x8192-coef-inner-1024, 12, 665, 328, 0, 0, 1005, 341335
n25x8192-coef-inner-1024, 11, 662, 328, 0, 0, 1001, 341335
n25x8192-coef-inner-1024, 15, 664, 342, 0, 0, 1021, 341335
n25x8192-coef-inner-1024, 12, 667, 329, 0, 0, 1008, 341335
n25x8192-coef-inner-1024, 13, 670, 330, 0, 0, 1013, 341335
n25x8192-coef-inner-1024, 11, 664, 328, 0, 0, 1003, 341335
n25x8192-coef-inner-1024, 13, 669, 330, 0, 0, 1012, 341335
n25x8192-coef-inner-1024, 12, 668, 330, 0, 0, 1010, 341335
n25x8192-coef-inner-1024, 12, 671, 331, 0, 0, 1014, 341335
n25x8192-coef-inner-1024, 12, 664, 327, 0, 0, 1003, 341335
n25x8192-coef-inner-1024, 12, 663, 332, 0, 0, 1007, 341335
n25x8192-coef-inner-1024, 11, 669, 329, 0, 0, 1009, 341335
n25x8192-coef-inner-1024, 12, 667, 329, 0, 0, 1008, 341335
n25x8192-coef-inner-1024, 11, 666, 328, 0, 0, 1005, 341335
n25x8192-coef-inner-1024, 12, 670, 330, 0, 0, 1012, 341335
n25x8192-coef-inner-1024, 12, 666, 328, 0, 0, 1006, 341335
n25x8192-coef-inner-1024, 19, 665, 338, 0, 0, 1022, 341335
n25x8192-coef-inner-1024, 12, 668, 330, 0, 0, 1010, 341335
n25x8192-coef-inner-1024, 12, 664, 326, 0, 0, 1002, 341335
n25x8192-coef-inner-1024, 12, 661, 330, 0, 0, 1003, 341335
n25x8192-coef-inner-1024, 12, 665, 326, 0, 0, 1003, 341335
n25x8192-coef-inner-1024, 11, 662, 327, 0, 0, 1000, 341335
n25x8192-coef-inner-1024, 19, 671, 331, 0, 0, 1021, 341335
n25x8192-coef-inner-1024, 13, 669, 331, 0, 0, 1013, 341335
n25x8192-coef-inner-1024, 13, 669, 328, 0, 0, 1010, 341335
n25x8192-coef-inner-1024, 12, 665, 328, 0, 0, 1005, 341335
n25x8192-coef-inner-1024, 12, 667, 331, 0, 0, 1010, 341335
n25x8192-coef-inner-1024, 12, 670, 332, 0, 0, 1014, 341335
n25x8192-coef-inner-1024, 12, 668, 327, 0, 0, 1007, 341335
n25x8192-coef-inner-1024, 12, 665, 330, 0, 0, 1007, 341335
n25x8192-coef-inner-1024, 12, 665, 325, 0, 0, 1002, 341335
n25x8192-coef-inner-1024, 11, 669, 330, 0, 0, 1010, 341335
n25x8192-coef-inner-1024, 12, 667, 328, 0, 0, 1007, 341335
n25x8192-coef-inner-1024, 12, 666, 327, 0, 0, 1005, 341335
n25x8192-coef-inner-1024, 16, 661, 342, 0, 0, 1019, 341335
n25x8192-coef-inner-1024, 12, 665, 329, 0, 0, 1006, 341335
n25x8192-coef-inner-1024, 12, 666, 332, 0, 0, 1010, 341335
n25x8192-coef-inner-1024, 18, 666, 341, 0, 0, 1025, 341335
n25x8192-coef-inner-1024, 12, 669, 330, 0, 0, 1011, 341335
n25x8192-coef-inner-1024, 12, 670, 332, 0, 0, 1014, 341335
n25x8192-coef-inner-1024, 12, 668, 329, 0, 0, 1009, 341335
n25x8192-coef-inner-1024, 11, 667, 329, 0, 0, 1007, 341335
n25x8192-coef-inner-2048, 16, 661, 320, 0, 0, 997, 341335
n25x8192-coef-inner-2048, 16, 661, 321, 0, 0, 998, 341335
n25x8192-coef-inner-2048, 16, 665, 317, 0, 0, 998, 341335
n25x8192-coef-inner-2048, 16, 666, 321, 0, 0, 1003, 341335
n25x8192-coef-inner-2048, 16, 666, 319, 0, 0, 1001, 341335
n25x8192-coef-inner-2048, 16, 665, 323, 0, 0, 1004, 341335
n25x8192-coef-inner-2048, 16, 661, 316, 0, 0, 993, 341335
n25x8192-coef-inner-2048, 16, 661, 316, 0, 0, 993, 341335
n25x8192-coef-inner-2048, 16, 663, 317, 0, 0, 996, 341335
n25x8192-coef-inner-2048, 16, 663, 317, 0, 0, 996, 341335
n25x8192-coef-inner-2048, 16, 663, 316, 0, 0, 995, 341335
n25x8192-coef-inner-2048, 16, 665, 318, 0, 0, 999, 341335
n25x8192-coef-inner-2048, 16, 664, 319, 0, 0, 999, 341335
n25x8192-coef-inner-2048, 16, 666, 319, 0, 0, 1001, 341335
n25x8192-coef-inner-2048, 16, 663, 316, 0, 0, 995, 341335
n25x8192-coef-inner-2048, 16, 665, 317, 0, 0, 998, 341335
n25x8192-coef-inner-2048, 16, 663, 318, 0, 0, 997, 341335
n25x8192-coef-inner-2048, 19, 664, 316, 0, 0, 999, 341335
n25x8192-coef-inner-2048, 22, 665, 334, 0, 0, 1021, 341335
n25x8192-coef-inner-2048, 16, 663, 321, 0, 0, 1000, 341335
n25x8192-coef-inner-2048, 16, 665, 320, 0, 0, 1001, 341335
n25x8192-coef-inner-2048, 16, 663, 317, 0, 0, 996, 341335
n25x8192-coef-inner-2048, 16, 664, 319, 0, 0, 999, 341335
n25x8192-coef-inner-2048, 16, 664, 319, 0, 0, 999, 341335
n25x8192-coef-inner-2048, 16, 665, 319, 0, 0, 1000, 341335
n25x8192-coef-inner-2048, 16, 660, 320, 0, 0, 996, 341335
n25x8192-coef-inner-2048, 16, 659, 317, 0, 0, 992, 341335
n25x8192-coef-inner-2048, 16, 667, 320, 0, 0, 1003, 341335
n25x8192-coef-inner-2048, 16, 659, 320, 0, 0, 995, 341335
n25x8192-coef-inner-2048, 16, 663, 320, 0, 0, 999, 341335
n25x8192-coef-inner-2048, 16, 658, 320, 0, 0, 994, 341335
n25x8192-coef-inner-2048, 27, 662, 321, 0, 0, 1010, 341335
n25x8192-coef-inner-2048, 16, 665, 319, 0, 0, 1000, 341335
n25x8192-coef-inner-2048, 19, 662, 334, 0, 0, 1015, 341335
n25x8192-coef-inner-2048, 16, 661, 319, 0, 0, 996, 341335
n25x8192-coef-inner-2048, 18, 664, 322, 0, 0, 1004, 341335
n25x8192-coef-inner-2048, 16, 665, 321, 0, 0, 1002, 341335
n25x8192-coef-inner-2048, 27, 662, 330, 0, 0, 1019, 341335
n25x8192-coef-inner-2048, 16, 663, 317, 0, 0, 996, 341335
n25x8192-coef-inner-2048, 16, 661, 319, 0, 0, 996, 341335
n25x8192-coef-inner-2048, 16, 664, 317, 0, 0, 997, 341335
n25x8192-coef-inner-2048, 16, 662, 319, 0, 0, 997, 341335
n25x8192-coef-inner-2048, 18, 659, 319, 0, 0, 996, 341335
n25x8192-coef-inner-2048, 19, 669, 319, 0, 0, 1007, 341335
n25x8192-coef-inner-2048, 16, 663, 318, 0, 0, 997, 341335
n25x8192-coef-inner-2048, 16, 661, 318, 0, 0, 995, 341335
n25x8192-coef-inner-2048, 19, 665, 316, 0, 0, 1000, 341335
n25x8192-coef-inner-2048, 16, 663, 318, 0, 0, 997, 341335
n25x8192-coef-inner-2048, 17, 662, 317, 0, 0, 996, 341335
n25x8192-coef-inner-2048, 16, 664, 317, 0, 0, 997, 341335
n25x8192-coef-inner-2048, 16, 661, 318, 0, 0, 995, 341335
n25x8192-coef-inner-2048, 28, 661, 329, 0, 0, 1018, 341335
n25x8192-coef-inner-2048, 27, 663, 331, 0, 0, 1021, 341335
n25x8192-coef-inner-2048, 16, 675, 319, 0, 0, 1010, 341335
n25x8192-coef-inner-2048, 19, 665, 322, 0, 0, 1006, 341335
n25x8192-coef-inner-2048, 16, 665, 318, 0, 0, 999, 341335
n25x8192-coef-inner-2048, 16, 664, 319, 0, 0, 999, 341335
n25x8192-coef-inner-2048, 16, 668, 317, 0, 0, 1001, 341335
n25x8192-coef-inner-2048, 16, 664, 318, 0, 0, 998, 341335
n25x8192-coef-inner-2048, 16, 659, 317, 0, 0, 992, 341335
n25x8192-coef-inner-2048, 16, 663, 321, 0, 0, 1000, 341335
n25x8192-coef-inner-2048, 16, 665, 323, 0, 0, 1004, 341335
n25x8192-coef-inner-2048, 19, 670, 323, 0, 0, 1012, 341335
n25x8192-coef-inner-2048, 16, 664, 318, 0, 0, 998, 341335
n25x8192-coef-inner-2048, 19, 662, 334, 0, 0, 1015, 341335
n25x8192-coef-inner-2048, 16, 662, 318, 0, 0, 996, 341335
n25x8192-coef-inner-2048, 16, 665, 319, 0, 0, 1000, 341335
n25x8192-coef-inner-2048, 16, 665, 322, 0, 0, 1003, 341335
n25x8192-coef-inner-2048, 20, 661, 319, 0, 0, 1000, 341335
n25x8192-coef-inner-2048, 16, 661, 320, 0, 0, 997, 341335
n25x8192-coef-inner-2048, 16, 662, 319, 0, 0, 997, 341335
n25x8192-coef-inner-2048, 16, 665, 325, 0, 0, 1006, 341335
n25x8192-coef-inner-2048, 16, 666, 321, 0, 0, 1003, 341335
n25x8192-coef-inner-2048, 16, 663, 318, 0, 0, 997, 341335
n25x8192-coef-inner-2048, 16, 667, 319, 0, 0, 1002, 341335
n25x8192-coef-inner-2048, 16, 660, 319, 0, 0, 995, 341335
n25x8192-coef-inner-2048, 16, 660, 323, 0, 0, 999, 341335
n25x8192-coef-inner-2048, 16, 660, 317, 0, 0, 993, 341335
n25x8192-coef-inner-2048, 16, 664, 319, 0, 0, 999, 341335
n25x8192-coef-inner-2048, 16, 661, 319, 0, 0, 996, 341335
n25x8192-coef-inner-2048, 16, 664, 319, 0, 0, 999, 341335
n25x8192-coef-inner-2048, 16, 660, 318, 0, 0, 994, 341335
n25x8192-coef-inner-2048, 16, 667, 318, 0, 0, 1001, 341335
n25x8192-coef-inner-2048, 16, 664, 318, 0, 0, 998, 341335
n25x8192-coef-inner-2048, 16, 667, 318, 0, 0, 1001, 341335
n25x8192-coef-inner-2048, 16, 662, 317, 0, 0, 995, 341335
n25x8192-coef-inner-2048, 16, 662, 322, 0, 0, 1000, 341335
n25x8192-coef-inner-2048, 16, 664, 318, 0, 0, 998, 341335
n25x8192-coef-inner-2048, 16, 662, 321, 0, 0, 999, 341335
n25x8192-coef-inner-2048, 16, 663, 317, 0, 0, 996, 341335
n25x8192-coef-inner-2048, 16, 663, 317, 0, 0, 996, 341335
n25x8192-coef-inner-2048, 16, 660, 315, 0, 0, 991, 341335
n25x8192-coef-inner-2048, 16, 665, 317, 0, 0, 998, 341335
n25x8192-coef-inner-2048, 16, 661, 318, 0, 0, 995, 341335
n25x8192-coef-inner-2048, 20, 664, 318, 0, 0, 1002, 341335
n25x8192-coef-inner-2048, 16, 660, 318, 0, 0, 994, 341335
n25x8192-coef-inner-2048, 16, 666, 317, 0, 0, 999, 341335
n25x8192-coef-inner-2048, 16, 666, 320, 0, 0, 1002, 341335
n25x8192-coef-inner-2048, 16, 665, 316, 0, 0, 997, 341335
n25x8192-coef-inner-2048, 20, 665, 330, 0, 0, 1015, 341335
n25x8192-coef-inner-4096, 27, 674, 321, 0, 0, 1022, 341335
n25x8192-coef-inner-4096, 32, 670, 327, 0, 0, 1029, 341335
n25x8192-coef-inner-4096, 32, 670, 336, 0, 0, 1038, 341335
n25x8192-coef-inner-4096, 27, 671, 323, 0, 0, 1021, 341335
n25x8192-coef-inner-4096, 28, 672, 322, 0, 0, 1022, 341335
n25x8192-coef-inner-4096, 27, 666, 323, 0, 0, 1016, 341335
n25x8192-coef-inner-4096, 27, 667, 328, 0, 0, 1022, 341335
n25x8192-coef-inner-4096, 27, 666, 323, 0, 0, 1016, 341335
n25x8192-coef-inner-4096, 35, 669, 342, 0, 0, 1046, 341335
n25x8192-coef-inner-4096, 30, 671, 325, 0, 0, 1026, 341335
n25x8192-coef-inner-4096, 28, 669, 339, 0, 0, 1036, 341335
n25x8192-coef-inner-4096, 27, 675, 339, 0, 0, 1041, 341335
n25x8192-coef-inner-4096, 29, 672, 327, 0, 0, 1028, 341335
n25x8192-coef-inner-4096, 30, 673, 325, 0, 0, 1028, 341335
n25x8192-coef-inner-4096, 27, 668, 324, 0, 0, 1019, 341335
n25x8192-coef-inner-4096, 33, 673, 336, 0, 0, 1042, 341335
n25x8192-coef-inner-4096, 28, 672, 323, 0, 0, 1023, 341335
n25x8192-coef-inner-4096, 27, 671, 323, 0, 0, 1021, 341335
n25x8192-coef-inner-4096, 30, 673, 326, 0, 0, 1029, 341335
n25x8192-coef-inner-4096, 30, 671, 325, 0, 0, 1026, 341335
n25x8192-coef-inner-4096, 29, 669, 327, 0, 0, 1025, 341335
n25x8192-coef-inner-4096, 29, 674, 326, 0, 0, 1029, 341335
n25x8192-coef-inner-4096, 29, 674, 322, 0, 0, 1025, 341335
n25x8192-coef-inner-4096, 29, 672, 324, 0, 0, 1025, 341335
n25x8192-coef-inner-4096, 30, 670, 323, 0, 0, 1023, 341335
n25x8192-coef-inner-4096, 32, 669, 328, 0, 0, 1029, 341335
n25x8192-coef-inner-4096, 27, 674, 325, 0, 0, 1026, 341335
n25x8192-coef-inner-4096, 28, 671, 326, 0, 0, 1025, 341335
n25x8192-coef-inner-4096, 28, 673, 327, 0, 0, 1028, 341335
n25x8192-coef-inner-4096, 29, 676, 329, 0, 0, 1034, 341335
n25x8192-coef-inner-4096, 27, 672, 326, 0, 0, 1025, 341335
n25x8192-coef-inner-4096, 27, 673, 325, 0, 0, 1025, 341335
n25x8192-coef-inner-4096, 27, 669, 325, 0, 0, 1021, 341335
n25x8192-coef-inner-4096, 34, 671, 338, 0, 0, 1043, 341335
n25x8192-coef-inner-4096, 29, 668, 324, 0, 0, 1021, 341335
n25x8192-coef-inner-4096, 28, 670, 325, 0, 0, 1023, 341335
n25x8192-coef-inner-4096, 34, 678, 341, 0, 0, 1053, 341335
n25x8192-coef-inner-4096, 31, 671, 328, 0, 0, 1030, 341335
n25x8192-coef-inner-4096, 27, 667, 321, 0, 0, 1015, 341335
n25x8192-coef-inner-4096, 30, 667, 322, 0, 0, 1019, 341335
n25x8192-coef-inner-4096, 27, 673, 323, 0, 0, 1023, 341335
n25x8192-coef-inner-4096, 27, 670, 324, 0, 0, 1021, 341335
n25x8192-coef-inner-4096, 34, 672, 323, 0, 0, 1029, 341335
n25x8192-coef-inner-4096, 30, 669, 324, 0, 0, 1023, 341335
n25x8192-coef-inner-4096, 28, 671, 327, 0, 0, 1026, 341335
n25x8192-coef-inner-4096, 30, 669, 321, 0, 0, 1020, 341335
n25x8192-coef-inner-4096, 27, 669, 324, 0, 0, 1020, 341335
n25x8192-coef-inner-4096, 32, 668, 322, 0, 0, 1022, 341335
n25x8192-coef-inner-4096, 32, 672, 331, 0, 0, 1035, 341335
n25x8192-coef-inner-4096, 27, 672, 326, 0, 0, 1025, 341335
n25x8192-coef-inner-4096, 27, 675, 325, 0, 0, 1027, 341335
n25x8192-coef-inner-4096, 27, 667, 324, 0, 0, 1018, 341335
n25x8192-coef-inner-4096, 27, 669, 324, 0, 0, 1020, 341335
n25x8192-coef-inner-4096, 30, 670, 326, 0, 0, 1026, 341335
n25x8192-coef-inner-4096, 27, 669, 323, 0, 0, 1019, 341335
n25x8192-coef-inner-4096, 30, 672, 327, 0, 0, 1029, 341335
n25x8192-coef-inner-4096, 30, 671, 323, 0, 0, 1024, 341335
n25x8192-coef-inner-4096, 35, 667, 324, 0, 0, 1026, 341335
n25x8192-coef-inner-4096, 31, 670, 324, 0, 0, 1025, 341335
n25x8192-coef-inner-4096, 27, 677, 326, 0, 0, 1030, 341335
n25x8192-coef-inner-4096, 28, 671, 323, 0, 0, 1022, 341335
n25x8192-coef-inner-4096, 27, 668, 325, 0, 0, 1020, 341335
n25x8192-coef-inner-4096, 27, 671, 321, 0, 0, 1019, 341335
n25x8192-coef-inner-4096, 29, 667, 323, 0, 0, 1019, 341335
n25x8192-coef-inner-4096, 32, 670, 335, 0, 0, 1037, 341335
n25x8192-coef-inner-4096, 31, 672, 322, 0, 0, 1025, 341335
n25x8192-coef-inner-4096, 31, 673, 324, 0, 0, 1028, 341335
n25x8192-coef-inner-4096, 32, 671, 328, 0, 0, 1031, 341335
n25x8192-coef-inner-4096, 34, 671, 337, 0, 0, 1042, 341335
n25x8192-coef-inner-4096, 29, 679, 329, 0, 0, 1037, 341335
n25x8192-coef-inner-4096, 27, 670, 325, 0, 0, 1022, 341335
n25x8192-coef-inner-4096, 28, 670, 325, 0, 0, 1023, 341335
n25x8192-coef-inner-4096, 34, 666, 338, 0, 0, 1038, 341335
n25x8192-coef-inner-4096, 29, 673, 324, 0, 0, 1026, 341335
n25x8192-coef-inner-4096, 37, 666, 337, 0, 0, 1040, 341335
n25x8192-coef-inner-4096, 29, 671, 323, 0, 0, 1023, 341335
n25x8192-coef-inner-4096, 27, 671, 322, 0, 0, 1020, 341335
n25x8192-coef-inner-4096, 32, 670, 338, 0, 0, 1040, 341335
n25x8192-coef-inner-4096, 34, 671, 340, 0, 0, 1045, 341335
n25x8192-coef-inner-4096, 30, 673, 327, 0, 0, 1030, 341335
n25x8192-coef-inner-4096, 28, 670, 323, 0, 0, 1021, 341335
n25x8192-coef-inner-4096, 27, 669, 321, 0, 0, 1017, 341335
n25x8192-coef-inner-4096, 27, 668, 322, 0, 0, 1017, 341335
n25x8192-coef-inner-4096, 36, 672, 326, 0, 0, 1034, 341335
n25x8192-coef-inner-4096, 30, 671, 339, 0, 0, 1040, 341335
n25x8192-coef-inner-4096, 31, 672, 323, 0, 0, 1026, 341335
n25x8192-coef-inner-4096, 38, 669, 340, 0, 0, 1047, 341335
n25x8192-coef-inner-4096, 32, 669, 324, 0, 0, 1025, 341335
n25x8192-coef-inner-4096, 28, 672, 327, 0, 0, 1027, 341335
n25x8192-coef-inner-4096, 30, 669, 327, 0, 0, 1026, 341335
n25x8192-coef-inner-4096, 27, 674, 322, 0, 0, 1023, 341335
n25x8192-coef-inner-4096, 30, 668, 324, 0, 0, 1022, 341335
n25x8192-coef-inner-4096, 29, 673, 342, 0, 0, 1044, 341335
n25x8192-coef-inner-4096, 30, 671, 322, 0, 0, 1023, 341335
n25x8192-coef-inner-4096, 32, 672, 326, 0, 0, 1030, 341335
n25x8192-coef-inner-4096, 35, 667, 324, 0, 0, 1026, 341335
n25x8192-coef-inner-4096, 29, 673, 326, 0, 0, 1028, 341335
n25x8192-coef-inner-4096, 30, 674, 325, 0, 0, 1029, 341335
n25x8192-coef-inner-4096, 30, 674, 325, 0, 0, 1029, 341335
n25x8192-coef-inner-4096, 27, 670, 325, 0, 0, 1022, 341335
n25x8192-coef-inner-8192, 50, 684, 336, 1, 0, 1071, 341335
n25x8192-coef-inner-8192, 56, 679, 345, 1, 0, 1081, 341335
n25x8192-coef-inner-8192, 52, 680, 360, 1, 0, 1093, 341335
n25x8192-coef-inner-8192, 53, 676, 344, 1, 0, 1074, 341335
n25x8192-coef-inner-8192, 54, 681, 344, 1, 0, 1080, 341335
n25x8192-coef-inner-8192, 51, 677, 343, 1, 0, 1072, 341335
n25x8192-coef-inner-8192, 53, 678, 363, 1, 0, 1095, 341335
n25x8192-coef-inner-8192, 52, 680, 363, 1, 0, 1096, 341335
n25x8192-coef-inner-8192, 49, 680, 342, 1, 0, 1072, 341335
n25x8192-coef-inner-8192, 52, 682, 334, 1, 0, 1069, 341335
n25x8192-coef-inner-8192, 53, 679, 337, 1, 0, 1070, 341335
n25x8192-coef-inner-8192, 52, 682, 335, 1, 0, 1070, 341335
n25x8192-coef-inner-8192, 60, 679, 363, 1, 0, 1103, 341335
n25x8192-coef-inner-8192, 51, 676, 344, 1, 0, 1072, 341335
n25x8192-coef-inner-8192, 56, 682, 345, 1, 0, 1084, 341335
n25x8192-coef-inner-8192, 62, 679, 364, 1, 0, 1106, 341335
n25x8192-coef-inner-8192, 50, 678, 344, 1, 0, 1073, 341335
n25x8192-coef-inner-8192, 51, 682, 343, 1, 0, 1077, 341335
n25x8192-coef-inner-8192, 52, 682, 334, 1, 0, 1069, 341335
n25x8192-coef-inner-8192, 53, 681, 336, 1, 0, 1071, 341335
n25x8192-coef-inner-8192, 52, 679, 361, 1, 0, 1093, 341335
n25x8192-coef-inner-8192, 51, 678, 334, 1, 0, 1064, 341335
n25x8192-coef-inner-8192, 52, 682, 336, 1, 0, 1071, 341335
n25x8192-coef-inner-8192, 52, 682, 339, 1, 0, 1074, 341335
n25x8192-coef-inner-8192, 51, 676, 356, 1, 0, 1084, 341335
n25x8192-coef-inner-8192, 53, 684, 339, 1, 0, 1077, 341335
n25x8192-coef-inner-8192, 50, 678, 346, 1, 0, 1075, 341335
n25x8192-coef-inner-8192, 52, 682, 336, 1, 0, 1071, 341335
n25x8192-coef-inner-8192, 55, 684, 335, 1, 0, 1075, 341335
n25x8192-coef-inner-8192, 53, 679, 342, 1, 0, 1075, 341335
n25x8192-coef-inner-8192, 51, 683, 336, 1, 0, 1071, 341335
n25x8192-coef-inner-8192, 50, 679, 342, 1, 0, 1072, 341335
n25x8192-coef-inner-8192, 51, 683, 337, 1, 0, 1072, 341335
n25x8192-coef-inner-8192, 52, 683, 344, 1, 0, 1080, 341335
n25x8192-coef-inner-8192, 54, 677, 343, 1, 0, 1075, 341335
n25x8192-coef-inner-8192, 52, 677, 342, 1, 0, 1072, 341335
n25x8192-coef-inner-8192, 49, 678, 344, 1, 0, 1072, 341335
n25x8192-coef-inner-8192, 51, 680, 342, 1, 0, 1074, 341335
n25x8192-coef-inner-8192, 51, 680, 345, 1, 0, 1077, 341335
n25x8192-coef-inner-8192, 51, 678, 343, 1, 0, 1073, 341335
n25x8192-coef-inner-8192, 51, 683, 334, 1, 0, 1069, 341335
n25x8192-coef-inner-8192, 54, 684, 337, 1, 0, 1076, 341335
n25x8192-coef-inner-8192, 50, 678, 343, 1, 0, 1072, 341335
n25x8192-coef-inner-8192, 50, 681, 366, 1, 0, 1098, 341335
n25x8192-coef-inner-8192, 50, 678, 344, 1, 0, 1073, 341335
n25x8192-coef-inner-8192, 50, 680, 344, 1, 0, 1075, 341335
n25x8192-coef-inner-8192, 53, 679, 334, 1, 0, 1067, 341335
n25x8192-coef-inner-8192, 51, 682, 335, 1, 0, 1069, 341335
n25x8192-coef-inner-8192, 56, 681, 367, 1, 0, 1105, 341335
n25x8192-coef-inner-8192, 52, 678, 361, 1, 0, 1092, 341335
n25x8192-coef-inner-8192, 50, 682, 344, 1, 0, 1077, 341335
n25x8192-coef-inner-8192, 54, 678, 360, 1, 0, 1093, 341335
n25x8192-coef-inner-8192, 53, 683, 337, 1, 0, 1074, 341335
n25x8192-coef-inner-8192, 54, 680, 364, 1, 0, 1099, 341335
n25x8192-coef-inner-8192, 53, 682, 337, 1, 0, 1073, 341335
n25x8192-coef-inner-8192, 49, 678, 349, 1, 0, 1077, 341335
n25x8192-coef-inner-8192, 53, 682, 336, 1, 0, 1072, 341335
n25x8192-coef-inner-8192, 51, 685, 336, 1, 0, 1073, 341335
n25x8192-coef-inner-8192, 50, 680, 344, 1, 0, 1075, 341335
n25x8192-coef-inner-8192, 51, 677, 342, 1, 0, 1071, 341335
n25x8192-coef-inner-8192, 50, 680, 337, 1, 0, 1068, 341335
n25x8192-coef-inner-8192, 51, 679, 361, 1, 0, 1092, 341335
n25x8192-coef-inner-8192, 51, 678, 361, 1, 0, 1091, 341335
n25x8192-coef-inner-8192, 50, 680, 342, 1, 0, 1073, 341335
n25x8192-coef-inner-8192, 50, 682, 333, 1, 0, 1066, 341335
n25x8192-coef-inner-8192, 49, 681, 335, 1, 0, 1066, 341335
n25x8192-coef-inner-8192, 52, 677, 345, 1, 0, 1075, 341335
n25x8192-coef-inner-8192, 51, 683, 346, 1, 0, 1081, 341335
n25x8192-coef-inner-8192, 52, 682, 334, 1, 0, 1069, 341335
n25x8192-coef-inner-8192, 53, 681, 339, 1, 0, 1074, 341335
n25x8192-coef-inner-8192, 50, 684, 343, 1, 0, 1078, 341335
n25x8192-coef-inner-8192, 53, 677, 344, 1, 0, 1075, 341335
n25x8192-coef-inner-8192, 50, 678, 345, 1, 0, 1074, 341335
n25x8192-coef-inner-8192, 54, 682, 335, 1, 0, 1072, 341335
n25x8192-coef-inner-8192, 52, 682, 337, 1, 0, 1072, 341335
n25x8192-coef-inner-8192, 54, 681, 337, 1, 0, 1073, 341335
n25x8192-coef-inner-8192, 51, 681, 362, 1, 0, 1095, 341335
n25x8192-coef-inner-8192, 50, 678, 344, 1, 0, 1073, 341335
n25x8192-coef-inner-8192, 55, 677, 359, 1, 0, 1092, 341335
n25x8192-coef-inner-8192, 50, 687, 345, 1, 0, 1083, 341335
n25x8192-coef-inner-8192, 52, 682, 348, 1, 0, 1083, 341335
n25x8192-coef-inner-8192, 51, 678, 345, 1, 0, 1075, 341335
n25x8192-coef-inner-8192, 56, 681, 362, 1, 0, 1100, 341335
n25x8192-coef-inner-8192, 58, 685, 346, 1, 0, 1090, 341335
n25x8192-coef-inner-8192, 58, 677, 359, 1, 0, 1095, 341335
n25x8192-coef-inner-8192, 49, 681, 345, 1, 0, 1076, 341335
n25x8192-coef-inner-8192, 58, 680, 335, 1, 0, 1074, 341335
n25x8192-coef-inner-8192, 50, 678, 342, 1, 0, 1071, 341335
n25x8192-coef-inner-8192, 53, 683, 337, 1, 0, 1074, 341335
n25x8192-coef-inner-8192, 49, 680, 341, 1, 0, 1071, 341335
n25x8192-coef-inner-8192, 55, 678, 343, 1, 0, 1077, 341335
n25x8192-coef-inner-8192, 56, 679, 358, 1, 0, 1094, 341335
n25x8192-coef-inner-8192, 58, 677, 365, 1, 0, 1101, 341335
n25x8192-coef-inner-8192, 51, 687, 336, 1, 0, 1075, 341335
n25x8192-coef-inner-8192, 49, 678, 348, 1, 0, 1076, 341335
n25x8192-coef-inner-8192, 51, 680, 347, 1, 0, 1079, 341335
n25x8192-coef-inner-8192, 50, 687, 341, 1, 0, 1079, 341335
n25x8192-coef-inner-8192, 50, 679, 345, 1, 0, 1075, 341335
n25x8192-coef-inner-8192, 52, 680, 365, 1, 0, 1098, 341335
n25x8192-coef-inner-8192, 52, 679, 360, 1, 0, 1092, 341335
n10x8192-slot-inner-4096, 180, 92, 209, 0, 0, 481, 136535
n10x8192-slot-inner-4096, 158, 86, 174, 0, 0, 418, 136535
n10x8192-slot-inner-4096, 136, 86, 172, 0, 0, 394, 136535
n10x8192-slot-inner-4096, 136, 80, 166, 0, 0, 382, 136535
n10x8192-slot-inner-4096, 136, 80, 167, 0, 0, 383, 136535
n10x8192-slot-inner-4096, 133, 81, 167, 0, 0, 381, 136535
n10x8192-slot-inner-4096, 137, 79, 163, 0, 0, 379, 136535
n10x8192-slot-inner-4096, 144, 81, 168, 0, 0, 393, 136535
n10x8192-slot-inner-4096, 142, 85, 173, 0, 0, 400, 136535
n10x8192-slot-inner-4096, 148, 85, 199, 0, 0, 432, 136535
n10x8192-slot-inner-4096, 143, 84, 188, 0, 0, 415, 136535
n10x8192-slot-inner-4096, 149, 84, 164, 0, 0, 397, 136535
n10x8192-slot-inner-4096, 134, 79, 173, 0, 0, 386, 136535
n10x8192-slot-inner-4096, 136, 80, 171, 0, 0, 387, 136535
n10x8192-slot-inner-4096, 142, 80, 174, 0, 0, 396, 136535
n10x8192-slot-inner-4096, 135, 81, 181, 0, 0, 397, 136535
n10x8192-slot-inner-4096, 150, 87, 193, 0, 0, 430, 136535
n10x8192-slot-inner-4096, 156, 89, 192, 0, 0, 437, 136535
n10x8192-slot-inner-4096, 140, 84, 197, 0, 0, 421, 136535
n10x8192-slot-inner-4096, 145, 92, 220, 0, 0, 457, 136535
n10x8192-slot-inner-4096, 160, 96, 196, 0, 0, 452, 136535
n10x8192-slot-inner-4096, 141, 79, 164, 0, 0, 384, 136535
n10x8192-slot-inner-4096, 133, 80, 175, 0, 0, 388, 136535
n10x8192-slot-inner-4096, 137, 82, 171, 0, 0, 390, 136535
n10x8192-slot-inner-4096, 146, 84, 173, 0, 0, 403, 136535
n10x8192-slot-inner-4096, 133, 89, 169, 0, 0, 391, 136535
n10x8192-slot-inner-4096, 133, 79, 167, 0, 0, 379, 136535
n10x8192-slot-inner-4096, 135, 81, 167, 0, 0, 383, 136535
n10x8192-slot-inner-4096, 134, 82, 169, 0, 0, 385, 136535
n10x8192-slot-inner-4096, 136, 81, 169, 0, 0, 386, 136535
n10x8192-slot-inner-4096, 148, 84, 173, 0, 0, 405, 136535
n10x8192-slot-inner-4096, 144, 88, 190, 0, 0, 422, 136535
n10x8192-slot-inner-4096, 136, 84, 193, 0, 0, 413, 136535
n10x8192-slot-inner-4096, 140, 82, 168, 0, 0, 390, 136535
n10x8192-slot-inner-4096, 152, 83, 167, 0, 0, 402, 136535
n10x8192-slot-inner-4096, 141, 83, 169, 0, 0, 393, 136535
n10x8192-slot-inner-4096, 147, 85, 176, 0, 0, 408, 136535
n10x8192-slot-inner-4096, 139, 79, 165, 0, 0, 383, 136535
n10x8192-slot-inner-4096, 135, 80, 174, 0, 0, 389, 136535
n10x8192-slot-inner-4096, 131, 80, 166, 0, 0, 377, 136535
n10x8192-slot-inner-4096, 141, 80, 170, 0, 0, 391, 136535
n10x8192-slot-inner-4096, 138, 81, 171, 0, 0, 390, 136535
n10x8192-slot-inner-4096, 134, 80, 167, 0, 0, 381, 136535
n10x8192-slot-inner-4096, 151, 86, 185, 0, 0, 422, 136535
n10x8192-slot-inner-4096, 134, 78, 169, 0, 0, 381, 136535
n10x8192-slot-inner-4096, 131, 78, 165, 0, 0, 374, 136535
n10x8192-slot-inner-4096, 141, 78, 163, 0, 0, 382, 136535
n10x8192-slot-inner-4096, 145, 84, 179, 0, 0, 408, 136535
n10x8192-slot-inner-4096, 134, 79, 164, 0, 0, 377, 136535
n10x8192-slot-inner-4096, 140, 82, 167, 0, 0, 389, 136535
n10x8192-slot-inner-4096, 136, 81, 178, 0, 0, 395, 136535
n10x8192-slot-inner-4096, 142, 83, 171, 0, 0, 396, 136535
n10x8192-slot-inner-4096, 144, 78, 167, 1, 0, 390, 136535
n10x8192-slot-inner-4096, 139, 85, 207, 0, 0, 431, 136535
n10x8192-slot-inner-4096, 135, 78, 166, 0, 0, 379, 136535
n10x8192-slot-inner-4096, 135, 79, 165, 0, 0, 379, 136535
n10x8192-slot-inner-4096, 138, 82, 173, 0, 0, 393, 136535
n10x8192-slot-inner-4096, 137, 81, 167, 1, 0, 386, 136535
n10x8192-slot-inner-4096, 144, 82, 167, 0, 0, 393, 136535
n10x8192-slot-inner-4096, 134, 82, 191, 0, 0, 407, 136535
n10x8192-slot-inner-4096, 158, 93, 195, 0, 0, 446, 136535
n10x8192-slot-inner-4096, 154, 84, 191, 0, 0, 429, 136535
n10x8192-slot-inner-4096, 155, 94, 224, 0, 0, 473, 136535
n10x8192-slot-inner-4096, 159, 113, 190, 0, 0, 462, 136535
n10x8192-slot-inner-4096, 151, 91, 193, 0, 0, 435, 136535
n10x8192-slot-inner-4096, 175, 89, 195, 0, 0, 459, 136535
n10x8192-slot-inner-4096, 199, 89, 180, 0, 0, 468, 136535
n10x8192-slot-inner-4096, 145, 79, 163, 0, 0, 387, 136535
n10x8192-slot-inner-4096, 136, 81, 175, 0, 0, 392, 136535
n10x8192-slot-inner-4096, 134, 83, 189, 0, 0, 406, 136535
n10x8192-slot-inner-4096, 143, 85, 170, 0, 0, 398, 136535
n10x8192-slot-inner-4096, 144, 81, 178, 0, 0, 403, 136535
n10x8192-slot-inner-4096, 138, 80, 164, 0, 0, 382, 136535
n10x8192-slot-inner-4096, 139, 80, 170, 0, 0, 389, 136535
n10x8192-slot-inner-4096, 131, 78, 172, 0, 0, 381, 136535
n10x8192-slot-inner-4096, 135, 79, 167, 0, 0, 381, 136535
n10x8192-slot-inner-4096, 140, 79, 167, 0, 0, 386, 136535
n10x8192-slot-inner-4096, 132, 78, 173, 0, 0, 383, 136535
n10x8192-slot-inner-4096, 142, 84, 171, 0, 0, 397, 136535
n10x8192-slot-inner-4096, 142, 80, 170, 0, 0, 392, 136535
n10x8192-slot-inner-4096, 135, 80, 181, 0, 0, 396, 136535
n10x8192-slot-inner-4096, 142, 84, 169, 0, 0, 395, 136535
n10x8192-slot-inner-4096, 151, 95, 191, 0, 0, 437, 136535
n10x8192-slot-inner-4096, 142, 93, 168, 0, 0, 403, 136535
n10x8192-slot-inner-4096, 142, 85, 178, 0, 0, 405, 136535
n10x8192-slot-inner-4096, 135, 80, 170, 0, 0, 385, 136535
n10x8192-slot-inner-4096, 133, 86, 182, 0, 0, 401, 136535
n10x8192-slot-inner-4096, 137, 80, 174, 0, 0, 391, 136535
n10x8192-slot-inner-4096, 135, 81, 165, 0, 0, 381, 136535
n10x8192-slot-inner-4096, 134, 83, 171, 0, 0, 388, 136535
n10x8192-slot-inner-4096, 133, 79, 175, 0, 0, 387, 136535
n10x8192-slot-inner-4096, 133, 81, 165, 0, 0, 379, 136535
n10x8192-slot-inner-4096, 144, 85, 174, 0, 0, 403, 136535
n10x8192-slot-inner-4096, 133, 79, 176, 0, 0, 388, 136535
n10x8192-slot-inner-4096, 134, 79, 165, 0, 0, 378, 136535
n10x8192-slot-inner-4096, 139, 89, 191, 0, 0, 419, 136535
n10x8192-slot-inner-4096, 143, 89, 185, 0, 0, 417, 136535
n10x8192-slot-inner-4096, 133, 79, 166, 0, 0, 378, 136535
n10x8192-slot-inner-4096, 152, 85, 167, 0, 0, 404, 136535
n10x8192-slot-inner-4096, 132, 79, 173, 0, 0, 384, 136535
n25x8192-slot-inner-4096, 158, 247, 375, 0, 0, 780, 341335
n25x8192-slot-inner-4096, 142, 205, 373, 0, 0, 720, 341335
n25x8192-slot-inner-4096, 143, 206, 377, 0, 0, 726, 341335
n25x8192-slot-inner-4096, 132, 193, 375, 0, 0, 700, 341335
n25x8192-slot-inner-4096, 147, 221, 383, 0, 0, 751, 341335
n25x8192-slot-inner-4096, 135, 201, 380, 0, 0, 716, 341335
n25x8192-slot-inner-4096, 143, 198, 376, 0, 0, 717, 341335
n25x8192-slot-inner-4096, 132, 196, 374, 0, 0, 702, 341335
n25x8192-slot-inner-4096, 137, 198, 373, 0, 0, 708, 341335
n25x8192-slot-inner-4096, 137, 203, 372, 0, 0, 712, 341335
n25x8192-slot-inner-4096, 146, 205, 378, 0, 0, 729, 341335
n25x8192-slot-inner-4096, 144, 211, 410, 0, 0, 765, 341335
n25x8192-slot-inner-4096, 133, 198, 366, 0, 0, 697, 341335
n25x8192-slot-inner-4096, 134, 198, 371, 0, 0, 703, 341335
n25x8192-slot-inner-4096, 139, 204, 369, 0, 0, 712, 341335
n25x8192-slot-inner-4096, 143, 196, 364, 0, 0, 703, 341335
n25x8192-slot-inner-4096, 135, 200, 371, 0, 0, 706, 341335
n25x8192-slot-inner-4096, 136, 202, 389, 0, 0, 727, 341335
n25x8192-slot-inner-4096, 132, 197, 364, 0, 0, 693, 341335
n25x8192-slot-inner-4096, 149, 220, 420, 0, 0, 789, 341335
n25x8192-slot-inner-4096, 140, 205, 372, 0, 0, 717, 341335
n25x8192-slot-inner-4096, 142, 204, 377, 0, 0, 723, 341335
n25x8192-slot-inner-4096, 143, 202, 379, 0, 0, 724, 341335
n25x8192-slot-inner-4096, 144, 205, 370, 0, 0, 719, 341335
n25x8192-slot-inner-4096, 135, 194, 361, 0, 0, 690, 341335
n25x8192-slot-inner-4096, 135, 202, 392, 0, 0, 729, 341335
n25x8192-slot-inner-4096, 136, 207, 368, 0, 0, 711, 341335
n25x8192-slot-inner-4096, 134, 197, 369, 0, 0, 700, 341335
n25x8192-slot-inner-4096, 139, 197, 369, 0, 0, 705, 341335
n25x8192-slot-inner-4096, 142, 207, 372, 0, 0, 721, 341335
n25x8192-slot-inner-4096, 142, 207, 408, 0, 0, 757, 341335
n25x8192-slot-inner-4096, 136, 200, 370, 0, 0, 706, 341335
n25x8192-slot-inner-4096, 144, 211, 377, 0, 0, 732, 341335
n25x8192-slot-inner-4096, 135, 208, 397, 0, 0, 740, 341335
n25x8192-slot-inner-4096, 136, 196, 370, 0, 0, 702, 341335
n25x8192-slot-inner-4096, 137, 195, 367, 0, 0, 699, 341335
n25x8192-slot-inner-4096, 136, 198, 372, 0, 0, 706, 341335
n25x8192-slot-inner-4096, 133, 193, 364, 0, 0, 690, 341335
n25x8192-slot-inner-4096, 135, 195, 371, 0, 0, 701, 341335
n25x8192-slot-inner-4096, 138, 198, 368, 0, 0, 704, 341335
n25x8192-slot-inner-4096, 134, 193, 390, 0, 0, 717, 341335
n25x8192-slot-inner-4096, 138, 203, 374, 0, 0, 715, 341335
n25x8192-slot-inner-4096, 131, 193, 358, 0, 0, 682, 341335
n25x8192-slot-inner-4096, 131, 194, 359, 0, 0, 684, 341335
n25x8192-slot-inner-4096, 131, 194, 366, 0, 0, 691, 341335
n25x8192-slot-inner-4096, 134, 198, 367, 0, 0, 699, 341335
n25x8192-slot-inner-4096, 138, 200, 374, 0, 0, 712, 341335
n25x8192-slot-inner-4096, 140, 207, 374, 0, 0, 721, 341335
n25x8192-slot-inner-4096, 132, 198, 408, 0, 0, 738, 341335
n25x8192-slot-inner-4096, 137, 197, 370, 0, 0, 704, 341335
n25x8192-slot-inner-4096, 142, 206, 377, 0, 0, 725, 341335
n25x8192-slot-inner-4096, 144, 208, 374, 0, 0, 726, 341335
n25x8192-slot-inner-4096, 135, 194, 376, 0, 0, 705, 341335
n25x8192-slot-inner-4096, 152, 226, 385, 0, 0, 763, 341335
n25x8192-slot-inner-4096, 131, 194, 366, 0, 0, 691, 341335
n25x8192-slot-inner-4096, 131, 198, 364, 0, 0, 693, 341335
n25x8192-slot-inner-4096, 137, 202, 370, 0, 0, 709, 341335
n25x8192-slot-inner-4096, 134, 200, 364, 0, 0, 698, 341335
n25x8192-slot-inner-4096, 145, 212, 373, 0, 0, 730, 341335
n25x8192-slot-inner-4096, 132, 202, 380, 0, 0, 714, 341335
n25x8192-slot-inner-4096, 135, 203, 362, 0, 0, 700, 341335
n25x8192-slot-inner-4096, 132, 195, 362, 0, 0, 689, 341335
n25x8192-slot-inner-4096, 137, 193, 363, 0, 0, 693, 341335
n25x8192-slot-inner-4096, 137, 197, 366, 0, 0, 700, 341335
n25x8192-slot-inner-4096, 135, 198, 363, 0, 0, 696, 341335
n25x8192-slot-inner-4096, 141, 209, 414, 0, 0, 764, 341335
n25x8192-slot-inner-4096, 150, 198, 373, 0, 0, 721, 341335
n25x8192-slot-inner-4096, 140, 201, 373, 0, 0, 714, 341335
n25x8192-slot-inner-4096, 137, 199, 370, 0, 0, 706, 341335
n25x8192-slot-inner-4096, 143, 207, 378, 0, 0, 728, 341335
n25x8192-slot-inner-4096, 133, 198, 368, 0, 0, 699, 341335
n25x8192-slot-inner-4096, 138, 211, 397, 0, 0, 746, 341335
n25x8192-slot-inner-4096, 137, 197, 370, 0, 0, 704, 341335
n25x8192-slot-inner-4096, 145, 210, 384, 0, 0, 739, 341335
n25x8192-slot-inner-4096, 134, 198, 377, 0, 0, 709, 341335
n25x8192-slot-inner-4096, 146, 214, 387, 0, 0, 747, 341335
n25x8192-slot-inner-4096, 135, 198, 369, 0, 0, 702, 341335
n25x8192-slot-inner-4096, 143, 209, 377, 0, 0, 729, 341335
n25x8192-slot-inner-4096, 138, 214, 412, 0, 0, 764, 341335
n25x8192-slot-inner-4096, 133, 194, 376, 0, 0, 703, 341335
n25x8192-slot-inner-4096, 135, 199, 375, 0, 0, 709, 341335
n25x8192-slot-inner-4096, 145, 198, 363, 0, 0, 706, 341335
n25x8192-slot-inner-4096, 146, 209, 372, 0, 0, 727, 341335
n25x8192-slot-inner-4096, 137, 196, 370, 0, 0, 703, 341335
n25x8192-slot-inner-4096, 139, 206, 406, 0, 0, 751, 341335
n25x8192-slot-inner-4096, 144, 211, 378, 0, 0, 733, 341335
n25x8192-slot-inner-4096, 132, 198, 373, 0, 0, 703, 341335
n25x8192-slot-inner-4096, 135, 197, 373, 0, 0, 705, 341335
n25x8192-slot-inner-4096, 133, 195, 361, 0, 0, 689, 341335
n25x8192-slot-inner-4096, 136, 204, 366, 0, 0, 706, 341335
n25x8192-slot-inner-4096, 138, 198, 369, 0, 0, 705, 341335
n25x8192-slot-inner-4096, 134, 199, 374, 0, 0, 707, 341335
n25x8192-slot-inner-4096, 139, 194, 362, 0, 0, 695, 341335
n25x8192-slot-inner-4096, 136, 194, 381, 0, 0, 711, 341335
n25x8192-slot-inner-4096, 135, 200, 380, 0, 0, 715, 341335
n25x8192-slot-inner-4096, 135, 194, 364, 0, 0, 693, 341335
n25x8192-slot-inner-4096, 133, 196, 362, 0, 0, 691, 341335
n25x8192-slot-inner-4096, 138, 204, 412, 0, 0, 754, 341335
n25x8192-slot-inner-4096, 148, 210, 379, 0, 0, 737, 341335
n25x8192-slot-inner-4096, 135, 195, 362, 0, 0, 692, 341335
