type, setup, encryption, homomorphic, decryption, plaintext, total, value

simple-slot, 65, 77715, 6463, 1, 0, 84244, 2
simple-slot, 54, 75480, 3371, 1, 0, 78906, 2
simple-slot, 55, 75476, 3304, 1, 0, 78836, 2
simple-slot, 54, 75325, 3279, 2, 0, 78660, 2
simple-slot, 56, 74805, 3333, 1, 0, 78195, 2
simple-coef, 55, 124027, 3864, 1, 0, 127947, 2
simple-coef, 57, 124430, 3411, 3, 0, 127901, 2
simple-coef, 53, 124365, 3405, 1, 0, 127824, 2
simple-coef, 52, 124538, 3402, 1, 0, 127993, 2
simple-coef, 51, 124374, 3387, 1, 0, 127813, 2
rot-slot, 73, 12, 49865, 1, 0, 49951, 2.00024
rot-slot, 78, 13, 49209, 1, 0, 49301, 2.00024
rot-slot, 73, 13, 50065, 1, 0, 50152, 2.00024
rot-slot, 72, 11, 49707, 1, 0, 49791, 2.00024
rot-slot, 76, 11, 49063, 1, 0, 49151, 2.00024
rot-slot, 70, 12, 49695, 1, 0, 49778, 2.00024
rot-slot, 72, 12, 49223, 1, 0, 49308, 2.00024
rot-slot, 71, 11, 49447, 1, 0, 49530, 2.00024
rot-slot, 77, 12, 49465, 1, 0, 49555, 2.00024
rot-slot, 82, 12, 50813, 1, 0, 50908, 2.00024
opt-rot-slot, 280, 12, 72, 1, 0, 365, 2
opt-rot-slot, 283, 12, 70, 1, 0, 366, 2
opt-rot-slot, 284, 11, 74, 1, 0, 370, 2
opt-rot-slot, 287, 12, 84, 1, 0, 384, 2
opt-rot-slot, 281, 12, 73, 1, 0, 367, 2
opt-rot-slot, 304, 11, 71, 1, 0, 387, 2
opt-rot-slot, 278, 12, 71, 1, 0, 362, 2
opt-rot-slot, 285, 12, 72, 1, 0, 370, 2
opt-rot-slot, 299, 11, 71, 1, 0, 382, 2
opt-rot-slot, 290, 11, 71, 1, 0, 373, 2
opt-rot-slot, 306, 11, 72, 1, 0, 390, 2
opt-rot-slot, 275, 16, 71, 1, 0, 363, 2
opt-rot-slot, 285, 11, 73, 1, 0, 370, 2
opt-rot-slot, 284, 11, 72, 1, 0, 368, 2
opt-rot-slot, 291, 12, 81, 1, 0, 385, 2
opt-rot-slot, 278, 12, 71, 1, 0, 362, 2
opt-rot-slot, 287, 12, 72, 1, 0, 372, 2
opt-rot-slot, 275, 12, 70, 1, 0, 358, 2
opt-rot-slot, 287, 11, 71, 1, 0, 370, 2
opt-rot-slot, 280, 12, 73, 1, 0, 366, 2
opt-rot-slot, 280, 12, 72, 1, 0, 365, 2
opt-rot-slot, 293, 13, 80, 1, 0, 387, 2
opt-rot-slot, 278, 12, 90, 1, 0, 381, 2
opt-rot-slot, 274, 11, 69, 1, 0, 355, 2
opt-rot-slot, 292, 11, 85, 1, 0, 389, 2
opt-rot-slot, 310, 12, 83, 1, 0, 406, 2
opt-rot-slot, 277, 11, 69, 1, 0, 358, 2
opt-rot-slot, 280, 12, 71, 1, 0, 364, 2
opt-rot-slot, 285, 15, 70, 1, 0, 371, 2
opt-rot-slot, 282, 12, 72, 1, 0, 367, 2
opt-rot-slot, 278, 11, 74, 1, 0, 364, 2
opt-rot-slot, 279, 11, 70, 1, 0, 361, 2
opt-rot-slot, 281, 12, 73, 1, 0, 367, 2
opt-rot-slot, 285, 12, 78, 1, 0, 376, 2
opt-rot-slot, 276, 11, 70, 1, 0, 358, 2
opt-rot-slot, 288, 12, 70, 1, 0, 371, 2
opt-rot-slot, 280, 11, 72, 1, 0, 364, 2
opt-rot-slot, 281, 12, 72, 1, 0, 366, 2
opt-rot-slot, 278, 14, 70, 1, 0, 363, 2
opt-rot-slot, 287, 11, 72, 1, 0, 371, 2
opt-rot-slot, 285, 11, 76, 1, 0, 373, 2
opt-rot-slot, 285, 15, 82, 1, 0, 383, 2
opt-rot-slot, 280, 11, 74, 1, 0, 366, 2
opt-rot-slot, 296, 11, 72, 1, 0, 380, 2
opt-rot-slot, 273, 11, 75, 1, 0, 360, 2
opt-rot-slot, 280, 11, 71, 1, 0, 363, 2
opt-rot-slot, 295, 13, 71, 1, 0, 380, 2
opt-rot-slot, 279, 12, 71, 1, 0, 363, 2
opt-rot-slot, 289, 12, 71, 1, 0, 373, 2
opt-rot-slot, 280, 12, 89, 1, 0, 382, 2
opt-rot-slot, 282, 11, 73, 1, 0, 367, 2
opt-rot-slot, 288, 12, 74, 1, 0, 375, 2
opt-rot-slot, 276, 11, 81, 1, 0, 369, 2
opt-rot-slot, 287, 12, 71, 1, 0, 371, 2
opt-rot-slot, 282, 11, 68, 1, 0, 362, 2
opt-rot-slot, 288, 12, 72, 1, 0, 373, 2
opt-rot-slot, 281, 12, 72, 1, 0, 366, 2
opt-rot-slot, 286, 11, 70, 1, 0, 368, 2
opt-rot-slot, 280, 12, 70, 1, 0, 363, 2
opt-rot-slot, 285, 12, 72, 1, 0, 370, 2
opt-rot-slot, 284, 11, 77, 1, 0, 373, 2
opt-rot-slot, 281, 11, 75, 1, 0, 368, 2
opt-rot-slot, 296, 11, 85, 1, 0, 393, 2
opt-rot-slot, 280, 11, 76, 1, 0, 368, 2
opt-rot-slot, 282, 12, 74, 1, 0, 369, 2
opt-rot-slot, 281, 12, 71, 1, 0, 365, 2
opt-rot-slot, 277, 11, 72, 1, 0, 361, 2
opt-rot-slot, 282, 12, 74, 1, 0, 369, 2
opt-rot-slot, 277, 12, 77, 1, 0, 367, 2
opt-rot-slot, 292, 12, 72, 1, 0, 377, 2
opt-rot-slot, 283, 11, 72, 1, 0, 367, 2
opt-rot-slot, 280, 12, 78, 1, 0, 371, 2
opt-rot-slot, 282, 12, 71, 1, 0, 366, 2
opt-rot-slot, 279, 12, 72, 1, 0, 364, 2
opt-rot-slot, 285, 11, 72, 1, 0, 369, 2
opt-rot-slot, 288, 11, 72, 1, 0, 372, 2
opt-rot-slot, 291, 14, 72, 1, 0, 378, 2
opt-rot-slot, 288, 12, 72, 1, 0, 373, 2
opt-rot-slot, 294, 12, 73, 1, 0, 380, 2
opt-rot-slot, 284, 12, 80, 1, 0, 377, 2
opt-rot-slot, 292, 12, 71, 1, 0, 376, 2
opt-rot-slot, 290, 12, 72, 1, 0, 375, 2
opt-rot-slot, 276, 12, 72, 1, 0, 361, 2
opt-rot-slot, 281, 12, 74, 1, 0, 368, 2
opt-rot-slot, 293, 12, 72, 1, 0, 378, 2
opt-rot-slot, 281, 12, 72, 1, 0, 366, 2
opt-rot-slot, 290, 12, 74, 1, 0, 377, 2
opt-rot-slot, 282, 11, 69, 1, 0, 363, 2
opt-rot-slot, 279, 12, 72, 1, 0, 364, 2
opt-rot-slot, 284, 11, 71, 1, 0, 367, 2
opt-rot-slot, 278, 11, 76, 1, 0, 366, 2
opt-rot-slot, 274, 11, 71, 1, 0, 357, 2
opt-rot-slot, 279, 11, 71, 1, 0, 362, 2
opt-rot-slot, 277, 11, 70, 1, 0, 359, 2
opt-rot-slot, 293, 12, 73, 1, 0, 379, 2
opt-rot-slot, 289, 12, 73, 1, 0, 375, 2
opt-rot-slot, 284, 11, 71, 1, 0, 367, 2
opt-rot-slot, 294, 12, 72, 1, 0, 379, 2
opt-rot-slot, 280, 13, 71, 1, 0, 365, 2
opt-rot-slot, 285, 12, 75, 1, 0, 373, 2
opt-rot-slot, 280, 12, 74, 1, 0, 367, 2
opt-rot-slot, 284, 12, 74, 1, 0, 371, 2
opt-rot-slot, 304, 11, 72, 1, 0, 388, 2
opt-rot-slot, 278, 11, 69, 1, 0, 359, 2
opt-rot-slot, 285, 11, 72, 1, 0, 369, 2
opt-rot-slot, 278, 11, 71, 1, 0, 361, 2
opt-rot-slot, 288, 12, 74, 1, 0, 375, 2
opt-rot-slot, 280, 12, 76, 1, 0, 369, 2
opt-rot-slot, 278, 11, 73, 1, 0, 363, 2
opt-rot-slot, 276, 12, 73, 1, 0, 362, 2
opt-rot-slot, 291, 12, 72, 1, 0, 376, 2
opt-rot-slot, 285, 11, 73, 1, 0, 370, 2
opt-rot-slot, 282, 12, 71, 1, 0, 366, 2
opt-rot-slot, 286, 11, 72, 1, 0, 370, 2
opt-rot-slot, 291, 12, 73, 1, 0, 377, 2
opt-rot-slot, 291, 12, 73, 1, 0, 377, 2
opt-rot-slot, 279, 12, 71, 1, 0, 363, 2
opt-rot-slot, 286, 12, 72, 1, 0, 371, 2
opt-rot-slot, 312, 12, 70, 1, 0, 395, 2
opt-rot-slot, 278, 11, 69, 1, 0, 359, 2
opt-rot-slot, 278, 12, 71, 1, 0, 362, 2
opt-rot-slot, 281, 12, 74, 1, 0, 368, 2
opt-rot-slot, 280, 12, 72, 1, 0, 365, 2
opt-rot-slot, 292, 11, 75, 1, 0, 379, 2
opt-rot-slot, 288, 12, 71, 1, 0, 372, 2
opt-rot-slot, 284, 12, 72, 1, 0, 369, 2
opt-rot-slot, 275, 11, 71, 1, 0, 358, 2
opt-rot-slot, 278, 11, 70, 1, 0, 360, 2
opt-rot-slot, 279, 11, 72, 1, 0, 363, 2
opt-rot-slot, 297, 11, 70, 1, 0, 379, 2
opt-rot-slot, 281, 12, 72, 1, 0, 366, 2
opt-rot-slot, 277, 12, 75, 1, 0, 365, 2
opt-rot-slot, 277, 12, 71, 1, 0, 361, 2
opt-rot-slot, 280, 12, 72, 1, 0, 365, 2
opt-rot-slot, 280, 11, 72, 1, 0, 364, 2
opt-rot-slot, 285, 11, 71, 1, 0, 368, 2
opt-rot-slot, 279, 11, 71, 1, 0, 362, 2
opt-rot-slot, 282, 11, 71, 1, 0, 365, 2
opt-rot-slot, 278, 11, 73, 1, 0, 363, 2
opt-rot-slot, 288, 11, 78, 1, 0, 378, 2
opt-rot-slot, 282, 12, 75, 1, 0, 370, 2
opt-rot-slot, 283, 11, 70, 1, 0, 365, 2
opt-rot-slot, 279, 11, 72, 1, 0, 363, 2
opt-rot-slot, 284, 11, 74, 1, 0, 370, 2
opt-rot-slot, 279, 11, 72, 1, 0, 363, 2
opt-rot-slot, 296, 11, 70, 1, 0, 378, 2
opt-rot-slot, 277, 12, 70, 1, 0, 360, 2
opt-rot-slot, 290, 11, 73, 1, 0, 375, 2
opt-rot-slot, 280, 12, 72, 1, 0, 365, 2
opt-rot-slot, 278, 12, 75, 1, 0, 366, 2
opt-rot-slot, 282, 12, 72, 1, 0, 367, 2
opt-rot-slot, 274, 11, 70, 1, 0, 356, 2
opt-rot-slot, 285, 12, 73, 1, 0, 371, 2
opt-rot-slot, 277, 12, 72, 1, 0, 362, 2
opt-rot-slot, 297, 12, 73, 1, 0, 383, 2
opt-rot-slot, 280, 11, 93, 1, 0, 385, 2
opt-rot-slot, 277, 11, 71, 1, 0, 360, 2
opt-rot-slot, 280, 12, 73, 1, 0, 366, 2
opt-rot-slot, 288, 12, 70, 1, 0, 371, 2
opt-rot-slot, 285, 12, 72, 1, 0, 370, 2
opt-rot-slot, 283, 12, 72, 1, 0, 368, 2
opt-rot-slot, 289, 11, 72, 1, 0, 373, 2
opt-rot-slot, 273, 12, 70, 1, 0, 356, 2
opt-rot-slot, 283, 12, 74, 1, 0, 370, 2
opt-rot-slot, 279, 11, 71, 1, 0, 362, 2
opt-rot-slot, 289, 12, 74, 1, 0, 376, 2
opt-rot-slot, 286, 12, 73, 1, 0, 372, 2
opt-rot-slot, 279, 17, 72, 1, 0, 369, 2
opt-rot-slot, 282, 11, 71, 1, 0, 365, 2
opt-rot-slot, 279, 11, 73, 1, 0, 364, 2
opt-rot-slot, 291, 12, 72, 1, 0, 376, 2
opt-rot-slot, 274, 11, 101, 1, 0, 387, 2
opt-rot-slot, 277, 12, 72, 1, 0, 362, 2
opt-rot-slot, 277, 12, 72, 1, 0, 362, 2
opt-rot-slot, 280, 11, 70, 1, 0, 362, 2
opt-rot-slot, 282, 11, 72, 1, 0, 366, 2
opt-rot-slot, 297, 11, 71, 1, 0, 380, 2
opt-rot-slot, 282, 12, 73, 1, 0, 368, 2
opt-rot-slot, 277, 12, 73, 1, 0, 363, 2
opt-rot-slot, 280, 12, 72, 1, 0, 365, 2
opt-rot-slot, 284, 11, 75, 1, 0, 371, 2
opt-rot-slot, 288, 12, 72, 1, 0, 373, 2
opt-rot-slot, 300, 11, 70, 1, 0, 382, 2
opt-rot-slot, 285, 12, 71, 1, 0, 369, 2
opt-rot-slot, 284, 11, 75, 1, 0, 371, 2
opt-rot-slot, 281, 12, 76, 1, 0, 370, 2
opt-rot-slot, 279, 12, 73, 1, 0, 365, 2
opt-rot-slot, 288, 12, 76, 1, 0, 377, 2
opt-rot-slot, 279, 12, 71, 1, 0, 363, 2
opt-rot-slot, 280, 11, 71, 1, 0, 363, 2
opt-rot-slot, 275, 11, 70, 1, 0, 357, 2
opt-rot-slot, 273, 12, 72, 1, 0, 358, 2
opt-rot-slot, 277, 11, 69, 1, 0, 358, 2
opt-rot-slot, 299, 12, 74, 1, 0, 386, 2
opt-rot-slot, 286, 12, 73, 1, 0, 372, 2
opt-rot-slot, 287, 11, 72, 1, 0, 371, 2
opt-rot-slot, 282, 11, 71, 1, 0, 365, 2
opt-rot-slot, 282, 11, 74, 1, 0, 368, 2
opt-rot-slot, 279, 12, 74, 1, 0, 366, 2
opt-rot-slot, 303, 12, 72, 1, 0, 388, 2
opt-rot-slot, 281, 11, 72, 1, 0, 365, 2
opt-rot-slot, 286, 12, 74, 1, 0, 373, 2
opt-rot-slot, 286, 12, 73, 1, 0, 372, 2
opt-rot-slot, 283, 12, 74, 1, 0, 370, 2
opt-rot-slot, 293, 12, 72, 1, 0, 378, 2
opt-rot-slot, 283, 11, 70, 1, 0, 365, 2
opt-rot-slot, 277, 12, 71, 1, 0, 361, 2
opt-rot-slot, 283, 12, 73, 1, 0, 369, 2
opt-rot-slot, 283, 12, 73, 1, 0, 369, 2
opt-rot-slot, 299, 12, 74, 1, 0, 386, 2
opt-rot-slot, 281, 12, 73, 1, 0, 367, 2
opt-rot-slot, 281, 12, 70, 1, 0, 364, 2
opt-rot-slot, 287, 12, 71, 1, 0, 371, 2
opt-rot-slot, 282, 12, 74, 1, 0, 369, 2
opt-rot-slot, 287, 11, 76, 1, 0, 375, 2
opt-rot-slot, 288, 11, 71, 1, 0, 371, 2
opt-rot-slot, 280, 11, 72, 1, 0, 364, 2
opt-rot-slot, 277, 11, 72, 1, 0, 361, 2
opt-rot-slot, 283, 12, 73, 1, 0, 369, 2
opt-rot-slot, 285, 12, 73, 1, 0, 371, 2
opt-rot-slot, 291, 11, 71, 1, 0, 374, 2
opt-rot-slot, 289, 12, 77, 1, 0, 379, 2
opt-rot-slot, 282, 11, 75, 1, 0, 369, 2
opt-rot-slot, 283, 14, 75, 1, 0, 373, 2
opt-rot-slot, 285, 12, 80, 1, 0, 378, 2
opt-rot-slot, 295, 11, 71, 1, 0, 378, 2
opt-rot-slot, 275, 12, 73, 1, 0, 361, 2
opt-rot-slot, 283, 12, 78, 1, 0, 374, 2
opt-rot-slot, 289, 12, 73, 1, 0, 375, 2
opt-rot-slot, 280, 12, 70, 1, 0, 363, 2
opt-rot-slot, 280, 11, 74, 1, 0, 366, 2
opt-rot-slot, 275, 12, 70, 1, 0, 358, 2
opt-rot-slot, 273, 11, 70, 1, 0, 355, 2
opt-rot-slot, 278, 11, 72, 1, 0, 362, 2
opt-rot-slot, 282, 12, 72, 1, 0, 367, 2
opt-rot-slot, 289, 12, 73, 1, 0, 375, 2
opt-rot-slot, 291, 11, 72, 1, 0, 375, 2
opt-rot-slot, 276, 11, 71, 1, 0, 359, 2
opt-rot-slot, 282, 12, 73, 1, 0, 368, 2
opt-rot-slot, 286, 12, 75, 1, 0, 374, 2
opt-rot-slot, 274, 11, 70, 1, 0, 356, 2
opt-rot-slot, 288, 11, 70, 1, 0, 370, 2
opt-rot-slot, 289, 12, 71, 1, 0, 373, 2
opt-rot-slot, 290, 12, 72, 1, 0, 375, 2
opt-rot-slot, 276, 11, 71, 1, 0, 359, 2
opt-rot-slot, 281, 12, 71, 1, 0, 365, 2
opt-rot-slot, 279, 11, 88, 1, 0, 379, 2
opt-rot-slot, 281, 12, 72, 1, 0, 366, 2
opt-rot-slot, 281, 12, 74, 1, 0, 368, 2
opt-rot-slot, 290, 12, 72, 1, 0, 375, 2
opt-rot-slot, 279, 11, 71, 1, 0, 362, 2
opt-rot-slot, 278, 12, 72, 1, 0, 363, 2
opt-rot-slot, 301, 12, 71, 1, 0, 385, 2
opt-rot-slot, 277, 11, 74, 1, 0, 363, 2
opt-rot-slot, 281, 12, 74, 1, 0, 368, 2
opt-rot-slot, 290, 12, 71, 1, 0, 374, 2
opt-rot-slot, 278, 12, 71, 1, 0, 362, 2
opt-rot-slot, 299, 12, 76, 1, 0, 388, 2
opt-rot-slot, 293, 12, 73, 1, 0, 379, 2
opt-rot-slot, 285, 11, 72, 1, 0, 369, 2
opt-rot-slot, 289, 11, 76, 1, 0, 377, 2
opt-rot-slot, 276, 11, 71, 1, 0, 359, 2
opt-rot-slot, 278, 11, 91, 1, 0, 381, 2
opt-rot-slot, 279, 11, 72, 1, 0, 363, 2
opt-rot-slot, 279, 11, 72, 1, 0, 363, 2
opt-rot-slot, 283, 12, 73, 1, 0, 369, 2
opt-rot-slot, 293, 12, 73, 1, 0, 379, 2
opt-rot-slot, 279, 12, 71, 1, 0, 363, 2
opt-rot-slot, 285, 12, 73, 1, 0, 371, 2
opt-rot-slot, 280, 11, 71, 1, 0, 363, 2
opt-rot-slot, 278, 12, 70, 1, 0, 361, 2
opt-rot-slot, 282, 12, 72, 1, 0, 367, 2
opt-rot-slot, 284, 12, 72, 1, 0, 369, 2
opt-rot-slot, 293, 15, 74, 1, 0, 383, 2
opt-rot-slot, 277, 12, 73, 1, 0, 363, 2
opt-rot-slot, 275, 16, 71, 1, 0, 363, 2
opt-rot-slot, 279, 11, 70, 1, 0, 361, 2
opt-rot-slot, 281, 12, 72, 1, 0, 366, 2
opt-rot-slot, 280, 11, 75, 1, 0, 367, 2
opt-rot-slot, 277, 11, 71, 1, 0, 360, 2
opt-rot-slot, 275, 16, 72, 1, 0, 364, 2
opt-rot-slot, 271, 12, 73, 1, 0, 357, 2
opt-rot-slot, 289, 12, 72, 1, 0, 374, 2
opt-rot-slot, 279, 12, 73, 1, 0, 365, 2
opt-rot-slot, 279, 12, 70, 1, 0, 362, 2
opt-rot-slot, 895, 31, 208, 3, 0, 1137, 2
opt-rot-slot, 688, 28, 220, 4, 0, 940, 2
opt-rot-slot, 656, 27, 200, 2, 0, 885, 2
opt-rot-slot, 700, 33, 273, 6, 0, 1012, 2
opt-rot-slot, 637, 29, 196, 3, 0, 865, 2
opt-rot-slot, 645, 31, 311, 4, 0, 991, 2
opt-rot-slot, 633, 29, 227, 4, 0, 893, 2
opt-rot-slot, 649, 38, 253, 5, 0, 945, 2
opt-rot-slot, 665, 30, 230, 4, 0, 929, 2
opt-rot-slot, 710, 37, 249, 8, 0, 1004, 2
opt-rot-slot, 759, 37, 219, 4, 0, 1019, 2
opt-rot-slot, 671, 36, 273, 4, 0, 984, 2
opt-rot-slot, 693, 34, 187, 4, 0, 918, 2
opt-rot-slot, 694, 28, 199, 4, 0, 925, 2
opt-rot-slot, 722, 40, 221, 3, 0, 986, 2
opt-rot-slot, 726, 34, 214, 3, 0, 977, 2
opt-rot-slot, 672, 29, 236, 4, 0, 941, 2
opt-rot-slot, 812, 40, 287, 5, 0, 1144, 2
opt-rot-slot, 668, 33, 283, 6, 0, 990, 2
opt-rot-slot, 769, 35, 252, 5, 0, 1061, 2
opt-rot-slot, 795, 36, 218, 6, 0, 1055, 2
opt-rot-slot, 686, 31, 240, 3, 0, 960, 2
opt-rot-slot, 704, 43, 244, 7, 0, 998, 2
opt-rot-slot, 614, 34, 269, 8, 0, 925, 2
opt-rot-slot, 607, 32, 263, 7, 0, 909, 2
opt-rot-slot, 604, 49, 289, 7, 0, 949, 2
opt-rot-slot, 750, 36, 284, 8, 0, 1078, 2
opt-rot-slot, 688, 30, 201, 4, 0, 923, 2
opt-rot-slot, 733, 38, 280, 4, 0, 1055, 2
opt-rot-slot, 553, 26, 239, 5, 0, 823, 2
opt-rot-slot, 567, 37, 257, 4, 0, 865, 2
opt-rot-slot, 543, 26, 210, 4, 0, 783, 2
opt-rot-slot, 761, 35, 241, 7, 0, 1044, 2
opt-rot-slot, 577, 32, 239, 5, 0, 853, 2
opt-rot-slot, 733, 34, 234, 7, 0, 1008, 2
opt-rot-slot, 559, 35, 239, 4, 0, 837, 2
opt-rot-slot, 926, 43, 215, 5, 0, 1189, 2
opt-rot-slot, 669, 26, 216, 4, 0, 915, 2
opt-rot-slot, 646, 35, 286, 4, 0, 971, 2
opt-rot-slot, 688, 35, 229, 4, 0, 956, 2
opt-rot-slot, 634, 32, 265, 4, 0, 935, 2
opt-rot-slot, 692, 26, 173, 1, 0, 892, 2
opt-rot-slot, 661, 31, 194, 3, 0, 889, 2
opt-rot-slot, 555, 26, 103, 1, 0, 685, 2
opt-rot-slot, 312, 12, 76, 1, 0, 401, 2
opt-rot-slot, 294, 13, 96, 1, 0, 404, 2
opt-rot-slot, 277, 11, 74, 1, 0, 363, 2
opt-rot-slot, 295, 12, 73, 1, 0, 381, 2
opt-rot-slot, 282, 11, 74, 1, 0, 368, 2
opt-rot-slot, 279, 11, 74, 1, 0, 365, 2
opt-rot-slot, 280, 11, 72, 1, 0, 364, 2
opt-rot-slot, 282, 12, 72, 1, 0, 367, 2
opt-rot-slot, 281, 11, 71, 1, 0, 364, 2
opt-rot-slot, 280, 12, 72, 1, 0, 365, 2
opt-rot-slot, 285, 11, 75, 1, 0, 372, 2
opt-rot-slot, 296, 11, 73, 1, 0, 381, 2
opt-rot-slot, 301, 12, 71, 1, 0, 385, 2
opt-rot-slot, 275, 12, 74, 1, 0, 362, 2
opt-rot-slot, 279, 12, 71, 1, 0, 363, 2
opt-rot-slot, 282, 12, 71, 1, 0, 366, 2
opt-rot-slot, 275, 12, 72, 1, 0, 360, 2
opt-rot-slot, 277, 12, 78, 1, 0, 368, 2
opt-rot-slot, 289, 14, 76, 1, 0, 380, 2
opt-rot-slot, 278, 12, 72, 1, 0, 363, 2
opt-rot-slot, 284, 12, 73, 1, 0, 370, 2
opt-rot-slot, 277, 11, 74, 1, 0, 363, 2
opt-rot-slot, 272, 11, 72, 1, 0, 356, 2
opt-rot-slot, 288, 12, 74, 1, 0, 375, 2
opt-rot-slot, 283, 12, 74, 1, 0, 370, 2
opt-rot-slot, 281, 12, 71, 1, 0, 365, 2
opt-rot-slot, 289, 11, 73, 1, 0, 374, 2
opt-rot-slot, 288, 12, 71, 1, 0, 372, 2
opt-rot-slot, 289, 11, 71, 1, 0, 372, 2
opt-rot-slot, 279, 12, 72, 1, 0, 364, 2
opt-rot-slot, 283, 11, 68, 1, 0, 363, 2
opt-rot-slot, 276, 12, 74, 1, 0, 363, 2
opt-rot-slot, 283, 13, 73, 1, 0, 370, 2
opt-rot-slot, 290, 12, 75, 1, 0, 378, 2
opt-rot-slot, 286, 12, 72, 1, 0, 371, 2
opt-rot-slot, 279, 11, 69, 1, 0, 360, 2
opt-rot-slot, 279, 11, 71, 1, 0, 362, 2
opt-rot-slot, 283, 12, 72, 1, 0, 368, 2
opt-rot-slot, 285, 12, 73, 1, 0, 371, 2
opt-rot-slot, 301, 13, 76, 1, 0, 391, 2
opt-rot-slot, 283, 12, 72, 1, 0, 368, 2
opt-rot-slot, 282, 13, 73, 1, 0, 369, 2
opt-rot-slot, 281, 11, 73, 1, 0, 366, 2
opt-rot-slot, 287, 11, 72, 1, 0, 371, 2
opt-rot-slot, 278, 12, 74, 1, 0, 365, 2
opt-rot-slot, 280, 12, 70, 1, 0, 363, 2
opt-rot-slot, 281, 12, 69, 1, 0, 363, 2
opt-rot-slot, 287, 12, 72, 1, 0, 372, 2
opt-rot-slot, 282, 11, 72, 1, 0, 366, 2
opt-rot-slot, 276, 12, 97, 1, 0, 386, 2
opt-rot-slot, 282, 11, 71, 1, 0, 365, 2
opt-rot-slot, 284, 11, 70, 1, 0, 366, 2
opt-rot-slot, 283, 12, 73, 1, 0, 369, 2
opt-rot-slot, 294, 11, 82, 1, 0, 388, 2
opt-rot-slot, 277, 12, 72, 1, 0, 362, 2
opt-rot-slot, 279, 12, 72, 1, 0, 364, 2
opt-rot-slot, 281, 12, 71, 1, 0, 365, 2
opt-rot-slot, 275, 12, 75, 1, 0, 363, 2
opt-rot-slot, 278, 11, 73, 1, 0, 363, 2
opt-rot-slot, 281, 12, 72, 1, 0, 366, 2
opt-rot-slot, 292, 12, 75, 1, 0, 380, 2
opt-rot-slot, 277, 11, 75, 1, 0, 364, 2
opt-rot-slot, 286, 11, 74, 1, 0, 372, 2
opt-rot-slot, 289, 11, 73, 1, 0, 374, 2
opt-rot-slot, 283, 11, 74, 1, 0, 369, 2
opt-rot-slot, 283, 11, 96, 1, 0, 391, 2
opt-rot-slot, 286, 11, 73, 1, 0, 371, 2
opt-rot-slot, 279, 11, 71, 1, 0, 362, 2
opt-rot-slot, 276, 13, 78, 1, 0, 368, 2
opt-rot-slot, 278, 13, 75, 1, 0, 367, 2
opt-rot-slot, 276, 11, 74, 1, 0, 362, 2
opt-rot-slot, 277, 12, 72, 1, 0, 362, 2
opt-rot-slot, 288, 14, 76, 1, 0, 379, 2
opt-rot-slot, 277, 11, 74, 1, 0, 363, 2
opt-rot-slot, 283, 12, 72, 1, 0, 368, 2
opt-rot-slot, 283, 12, 73, 1, 0, 369, 2
opt-rot-slot, 295, 12, 70, 1, 0, 378, 2
opt-rot-slot, 280, 11, 71, 1, 0, 363, 2
opt-rot-slot, 283, 11, 69, 1, 0, 364, 2
opt-rot-slot, 288, 12, 73, 1, 0, 374, 2
opt-rot-slot, 281, 12, 71, 1, 0, 365, 2
opt-rot-slot, 289, 14, 74, 1, 0, 378, 2
opt-rot-slot, 281, 12, 70, 1, 0, 364, 2
opt-rot-slot, 280, 13, 70, 1, 0, 364, 2
opt-rot-slot, 286, 14, 74, 1, 0, 375, 2
opt-rot-slot, 285, 11, 70, 1, 0, 367, 2
opt-rot-slot, 276, 11, 74, 1, 0, 362, 2
opt-rot-slot, 289, 11, 71, 1, 0, 372, 2
opt-rot-slot, 282, 11, 71, 1, 0, 365, 2
opt-rot-slot, 286, 12, 72, 1, 0, 371, 2
opt-rot-slot, 283, 12, 73, 1, 0, 369, 2
opt-rot-slot, 281, 12, 73, 1, 0, 367, 2
opt-rot-slot, 290, 11, 71, 1, 0, 373, 2
opt-rot-slot, 289, 12, 72, 1, 0, 374, 2
opt-rot-slot, 290, 12, 72, 1, 0, 375, 2
opt-rot-slot, 291, 11, 73, 1, 0, 376, 2
opt-rot-slot, 279, 14, 72, 1, 0, 366, 2
opt-rot-slot, 292, 12, 74, 1, 0, 379, 2
opt-rot-slot, 275, 11, 69, 1, 0, 356, 2
opt-rot-slot, 289, 12, 73, 1, 0, 375, 2
opt-rot-slot, 279, 12, 70, 1, 0, 362, 2
opt-rot-slot, 277, 11, 69, 1, 0, 358, 2
opt-rot-slot, 284, 12, 71, 1, 0, 368, 2
opt-rot-slot, 292, 11, 70, 1, 0, 374, 2
opt-rot-slot, 274, 11, 71, 1, 0, 357, 2
opt-rot-slot, 285, 12, 71, 1, 0, 369, 2
opt-rot-slot, 279, 11, 72, 1, 0, 363, 2
opt-rot-slot, 286, 11, 72, 1, 0, 370, 2
opt-rot-slot, 284, 11, 70, 1, 0, 366, 2
opt-rot-slot, 276, 12, 71, 1, 0, 360, 2
opt-rot-slot, 279, 12, 71, 1, 0, 363, 2
opt-rot-slot, 282, 12, 74, 1, 0, 369, 2
opt-rot-slot, 289, 11, 72, 1, 0, 373, 2
opt-rot-slot, 287, 12, 72, 1, 0, 372, 2
opt-rot-slot, 275, 11, 69, 1, 0, 356, 2
opt-rot-slot, 290, 11, 74, 1, 0, 376, 2
opt-rot-slot, 284, 12, 72, 1, 0, 369, 2
opt-rot-slot, 280, 11, 74, 1, 0, 366, 2
opt-rot-slot, 279, 16, 73, 1, 0, 369, 2
opt-rot-slot, 279, 12, 73, 1, 0, 365, 2
opt-rot-slot, 287, 11, 72, 1, 0, 371, 2
opt-rot-slot, 281, 12, 73, 1, 0, 367, 2
opt-rot-slot, 279, 11, 70, 1, 0, 361, 2
opt-rot-slot, 282, 12, 72, 1, 0, 367, 2
opt-rot-slot, 275, 11, 71, 1, 0, 358, 2
opt-rot-slot, 277, 14, 72, 1, 0, 364, 2
opt-rot-slot, 288, 12, 73, 1, 0, 374, 2
opt-rot-slot, 290, 11, 71, 1, 0, 373, 2
opt-rot-slot, 284, 11, 71, 1, 0, 367, 2
opt-rot-slot, 285, 12, 74, 1, 0, 372, 2
opt-rot-slot, 274, 12, 72, 1, 0, 359, 2
opt-rot-slot, 279, 11, 69, 1, 0, 360, 2
opt-rot-slot, 273, 11, 69, 1, 0, 354, 2
opt-rot-slot, 277, 12, 72, 1, 0, 362, 2
opt-rot-slot, 280, 12, 71, 1, 0, 364, 2
opt-rot-slot, 282, 11, 71, 1, 0, 365, 2
opt-rot-slot, 275, 11, 70, 1, 0, 357, 2
opt-rot-slot, 287, 11, 75, 1, 0, 374, 2
opt-rot-slot, 295, 12, 74, 1, 0, 382, 2
opt-rot-slot, 283, 12, 75, 1, 0, 371, 2
opt-rot-slot, 298, 11, 74, 1, 0, 384, 2
opt-rot-slot, 273, 12, 72, 1, 0, 358, 2
opt-rot-slot, 292, 12, 71, 1, 0, 376, 2
opt-rot-slot, 281, 12, 72, 1, 0, 366, 2
opt-rot-slot, 280, 12, 93, 1, 0, 386, 2
opt-rot-slot, 282, 11, 73, 1, 0, 367, 2
opt-rot-slot, 279, 11, 72, 1, 0, 363, 2
opt-rot-slot, 287, 11, 70, 1, 0, 369, 2
opt-rot-slot, 286, 15, 73, 1, 0, 375, 2
opt-rot-slot, 281, 12, 72, 1, 0, 366, 2
opt-rot-slot, 298, 11, 71, 1, 0, 381, 2
opt-rot-slot, 274, 11, 72, 1, 0, 358, 2
opt-rot-slot, 281, 11, 70, 1, 0, 363, 2
opt-rot-slot, 279, 12, 73, 1, 0, 365, 2
opt-rot-slot, 290, 11, 74, 1, 0, 376, 2
opt-rot-slot, 281, 12, 71, 1, 0, 365, 2
opt-rot-slot, 283, 12, 71, 1, 0, 367, 2
opt-rot-slot, 276, 11, 71, 1, 0, 359, 2
opt-rot-slot, 289, 13, 75, 1, 0, 378, 2
opt-rot-slot, 286, 11, 74, 1, 0, 372, 2
opt-rot-slot, 283, 12, 91, 1, 0, 387, 2
opt-rot-slot, 282, 11, 75, 1, 0, 369, 2
opt-rot-slot, 283, 12, 73, 1, 0, 369, 2
opt-rot-slot, 272, 11, 70, 1, 0, 354, 2
opt-rot-slot, 277, 12, 72, 1, 0, 362, 2
opt-rot-slot, 284, 14, 76, 1, 0, 375, 2
opt-rot-slot, 282, 12, 75, 1, 0, 370, 2
opt-rot-slot, 278, 12, 69, 1, 0, 360, 2
opt-rot-slot, 284, 12, 72, 1, 0, 369, 2
opt-rot-slot, 277, 11, 71, 1, 0, 360, 2
opt-rot-slot, 283, 12, 71, 1, 0, 367, 2
opt-rot-slot, 284, 12, 75, 1, 0, 372, 2
opt-rot-slot, 292, 11, 74, 1, 0, 378, 2
opt-rot-slot, 290, 12, 71, 1, 0, 374, 2
opt-rot-slot, 275, 11, 74, 1, 0, 361, 2
opt-rot-slot, 279, 12, 72, 1, 0, 364, 2
opt-rot-slot, 284, 11, 103, 1, 0, 399, 2
opt-rot-slot, 290, 11, 74, 1, 0, 376, 2
opt-rot-slot, 283, 11, 74, 1, 0, 369, 2
opt-rot-slot, 283, 11, 74, 1, 0, 369, 2
opt-rot-slot, 275, 12, 71, 1, 0, 359, 2
opt-rot-slot, 287, 11, 74, 1, 0, 373, 2
opt-rot-slot, 292, 11, 73, 1, 0, 377, 2
opt-rot-slot, 277, 12, 73, 1, 0, 363, 2
opt-rot-slot, 284, 12, 74, 1, 0, 371, 2
opt-rot-slot, 284, 11, 75, 1, 0, 371, 2
opt-rot-slot, 284, 12, 71, 1, 0, 368, 2
opt-rot-slot, 301, 11, 73, 1, 0, 386, 2
opt-rot-slot, 278, 11, 69, 1, 0, 359, 2
opt-rot-slot, 277, 11, 70, 1, 0, 359, 2
opt-rot-slot, 282, 12, 74, 1, 0, 369, 2
opt-rot-slot, 285, 12, 72, 1, 0, 370, 2
opt-rot-slot, 273, 12, 74, 1, 0, 360, 2
opt-rot-slot, 295, 13, 74, 1, 0, 383, 2
opt-rot-slot, 276, 12, 74, 1, 0, 363, 2
opt-rot-slot, 278, 11, 72, 1, 0, 362, 2
opt-rot-slot, 280, 12, 72, 1, 0, 365, 2
opt-rot-slot, 287, 12, 72, 1, 0, 372, 2
opt-rot-slot, 290, 11, 70, 1, 0, 372, 2
opt-rot-slot, 279, 11, 71, 1, 0, 362, 2
opt-rot-slot, 279, 11, 70, 1, 0, 361, 2
opt-rot-slot, 280, 11, 73, 1, 0, 365, 2
opt-rot-slot, 293, 12, 73, 1, 0, 379, 2
opt-rot-slot, 285, 12, 71, 1, 0, 369, 2
opt-rot-slot, 276, 12, 69, 1, 0, 358, 2
opt-rot-slot, 283, 12, 70, 1, 0, 366, 2
opt-rot-slot, 277, 12, 72, 1, 0, 362, 2
opt-rot-slot, 277, 11, 72, 1, 0, 361, 2
opt-rot-slot, 279, 12, 71, 1, 0, 363, 2
opt-rot-slot, 285, 13, 75, 1, 0, 374, 2
opt-rot-slot, 274, 11, 72, 1, 0, 358, 2
opt-rot-slot, 273, 11, 72, 1, 0, 357, 2
opt-rot-slot, 291, 12, 71, 1, 0, 375, 2
opt-rot-slot, 273, 11, 71, 1, 0, 356, 2
opt-rot-slot, 303, 11, 72, 1, 0, 387, 2
opt-rot-slot, 283, 12, 72, 1, 0, 368, 2
opt-rot-slot, 279, 12, 73, 1, 0, 365, 2
opt-rot-slot, 282, 11, 74, 1, 0, 368, 2
opt-rot-slot, 285, 12, 74, 1, 0, 372, 2
opt-rot-slot, 294, 12, 72, 1, 0, 379, 2
opt-rot-slot, 280, 12, 73, 1, 0, 366, 2
opt-rot-slot, 287, 12, 72, 1, 0, 372, 2
opt-rot-slot, 286, 11, 71, 1, 0, 369, 2
opt-rot-slot, 281, 11, 72, 1, 0, 365, 2
opt-rot-slot, 278, 11, 72, 1, 0, 362, 2
opt-rot-slot, 297, 11, 71, 1, 0, 380, 2
opt-rot-slot, 282, 11, 71, 1, 0, 365, 2
opt-rot-slot, 281, 12, 73, 1, 0, 367, 2
opt-rot-slot, 279, 12, 71, 1, 0, 363, 2
opt-rot-slot, 278, 12, 72, 1, 0, 363, 2
opt-rot-slot, 285, 12, 73, 1, 0, 371, 2
opt-rot-slot, 291, 12, 73, 1, 0, 377, 2
opt-rot-slot, 272, 11, 70, 1, 0, 354, 2
opt-rot-slot, 281, 12, 78, 1, 0, 372, 2
opt-rot-slot, 286, 11, 74, 1, 0, 372, 2
opt-rot-slot, 281, 16, 72, 1, 0, 370, 2
opt-rot-slot, 278, 11, 69, 1, 0, 359, 2
opt-rot-slot, 273, 11, 71, 1, 0, 356, 2
opt-rot-slot, 281, 12, 72, 1, 0, 366, 2
opt-rot-slot, 274, 11, 70, 1, 0, 356, 2
opt-rot-slot, 291, 12, 71, 1, 0, 375, 2
opt-rot-slot, 289, 12, 72, 1, 0, 374, 2
opt-rot-slot, 280, 12, 70, 1, 0, 363, 2
opt-rot-slot, 294, 11, 76, 1, 0, 382, 2
opt-rot-slot, 284, 12, 71, 1, 0, 368, 2
opt-rot-slot, 279, 12, 74, 1, 0, 366, 2
opt-rot-slot, 279, 12, 73, 1, 0, 365, 2
opt-rot-slot, 279, 11, 70, 1, 0, 361, 2
opt-rot-slot, 283, 11, 71, 1, 0, 366, 2
opt-rot-slot, 279, 12, 74, 1, 0, 366, 2
opt-rot-slot, 284, 11, 71, 1, 0, 367, 2
opt-rot-slot, 282, 12, 95, 1, 0, 390, 2
opt-rot-slot, 278, 11, 72, 1, 0, 362, 2
opt-rot-slot, 276, 12, 72, 1, 0, 361, 2
opt-rot-slot, 284, 12, 73, 1, 0, 370, 2
opt-rot-slot, 277, 12, 74, 1, 0, 364, 2
opt-rot-slot, 283, 12, 79, 1, 0, 375, 2
opt-rot-slot, 289, 15, 72, 1, 0, 377, 2
opt-rot-slot, 292, 11, 75, 1, 0, 379, 2
opt-rot-slot, 280, 12, 72, 1, 0, 365, 2
opt-rot-slot, 288, 11, 72, 1, 0, 372, 2
opt-rot-slot, 284, 12, 71, 1, 0, 368, 2
opt-rot-slot, 291, 16, 79, 1, 0, 387, 2
opt-rot-slot, 299, 13, 72, 1, 0, 385, 2
opt-rot-slot, 279, 11, 71, 1, 0, 362, 2
opt-rot-slot, 285, 12, 70, 1, 0, 368, 2
opt-rot-slot, 282, 12, 73, 1, 0, 368, 2
opt-rot-slot, 286, 11, 72, 1, 0, 370, 2
opt-rot-slot, 276, 11, 72, 1, 0, 360, 2
opt-rot-slot, 299, 11, 70, 1, 0, 381, 2
opt-rot-slot, 282, 11, 71, 1, 0, 365, 2
opt-rot-slot, 289, 12, 72, 1, 0, 374, 2
opt-rot-slot, 282, 12, 72, 1, 0, 367, 2
opt-rot-slot, 283, 12, 72, 1, 0, 368, 2
opt-rot-slot, 278, 11, 72, 1, 0, 362, 2
opt-rot-slot, 284, 12, 74, 1, 0, 371, 2
opt-rot-slot, 280, 11, 76, 1, 0, 368, 2
opt-rot-slot, 279, 11, 73, 1, 0, 364, 2
opt-rot-slot, 287, 11, 72, 1, 0, 371, 2
opt-rot-slot, 286, 11, 75, 1, 0, 373, 2
opt-rot-slot, 283, 12, 72, 1, 0, 368, 2
opt-rot-slot, 275, 11, 70, 1, 0, 357, 2
opt-rot-slot, 291, 12, 71, 1, 0, 375, 2
opt-rot-slot, 285, 12, 71, 1, 0, 369, 2
opt-rot-slot, 278, 11, 71, 1, 0, 361, 2
opt-rot-slot, 276, 12, 71, 1, 0, 360, 2
opt-rot-slot, 287, 11, 71, 1, 0, 370, 2
opt-rot-slot, 279, 12, 71, 1, 0, 363, 2
opt-rot-slot, 276, 12, 72, 1, 0, 361, 2
opt-rot-slot, 280, 12, 73, 1, 0, 366, 2
opt-rot-slot, 286, 14, 73, 1, 0, 374, 2
opt-rot-slot, 281, 12, 72, 1, 0, 366, 2
opt-rot-slot, 280, 12, 72, 1, 0, 365, 2
opt-rot-slot, 284, 11, 70, 1, 0, 366, 2
opt-rot-slot, 280, 12, 73, 1, 0, 366, 2
opt-rot-slot, 281, 12, 71, 1, 0, 365, 2
opt-rot-slot, 284, 12, 74, 1, 0, 371, 2
opt-rot-slot, 278, 11, 70, 1, 0, 360, 2
opt-rot-slot, 281, 12, 74, 1, 0, 368, 2
opt-rot-slot, 293, 12, 74, 1, 0, 380, 2
opt-rot-slot, 286, 11, 73, 1, 0, 371, 2
opt-rot-slot, 278, 11, 74, 1, 0, 364, 2
opt-rot-slot, 277, 12, 74, 1, 0, 364, 2
opt-rot-slot, 281, 12, 72, 1, 0, 366, 2
opt-rot-slot, 279, 12, 74, 1, 0, 366, 2
opt-rot-slot, 286, 12, 73, 1, 0, 372, 2
opt-rot-slot, 280, 11, 73, 1, 0, 365, 2
opt-rot-slot, 283, 12, 71, 1, 0, 367, 2
opt-rot-slot, 281, 12, 70, 1, 0, 364, 2
opt-rot-slot, 300, 12, 71, 1, 0, 384, 2
opt-rot-slot, 277, 12, 74, 1, 0, 364, 2
opt-rot-slot, 279, 12, 70, 1, 0, 362, 2
opt-rot-slot, 286, 12, 71, 1, 0, 370, 2
opt-rot-slot, 282, 12, 71, 1, 0, 366, 2
opt-rot-slot, 280, 12, 73, 1, 0, 366, 2
opt-rot-slot, 288, 11, 73, 1, 0, 373, 2
opt-rot-slot, 279, 12, 72, 1, 0, 364, 2
opt-rot-slot, 286, 12, 76, 1, 0, 375, 2
opt-rot-slot, 287, 12, 74, 1, 0, 374, 2
opt-rot-slot, 283, 11, 71, 1, 0, 366, 2
opt-rot-slot, 278, 12, 74, 1, 0, 365, 2
opt-rot-slot, 289, 12, 71, 1, 0, 373, 2
opt-rot-slot, 274, 11, 70, 1, 0, 356, 2
opt-rot-slot, 275, 12, 71, 1, 0, 359, 2
opt-rot-slot, 282, 12, 75, 1, 0, 370, 2
opt-rot-slot, 297, 12, 71, 1, 0, 381, 2
opt-rot-slot, 283, 12, 73, 1, 0, 369, 2
opt-rot-slot, 295, 12, 73, 1, 0, 381, 2
opt-rot-slot, 280, 11, 72, 1, 0, 364, 2
opt-rot-slot, 276, 12, 71, 1, 0, 360, 2
opt-rot-slot, 284, 11, 72, 1, 0, 368, 2
opt-rot-slot, 279, 12, 71, 1, 0, 363, 2
opt-rot-slot, 283, 11, 71, 1, 0, 366, 2
opt-rot-slot, 279, 12, 70, 1, 0, 362, 2
opt-rot-slot, 281, 11, 72, 1, 0, 365, 2
opt-rot-slot, 285, 18, 87, 1, 0, 391, 2
opt-rot-slot, 282, 12, 74, 1, 0, 369, 2
opt-rot-slot, 282, 12, 77, 1, 0, 372, 2
opt-rot-slot, 283, 11, 74, 1, 0, 369, 2
opt-rot-slot, 276, 12, 73, 1, 0, 362, 2
opt-rot-slot, 279, 11, 69, 1, 0, 360, 2
opt-rot-slot, 300, 11, 72, 1, 0, 384, 2
opt-rot-slot, 291, 12, 72, 1, 0, 376, 2
opt-rot-slot, 285, 11, 73, 1, 0, 370, 2
opt-rot-slot, 281, 11, 74, 1, 0, 367, 2
opt-rot-slot, 282, 12, 70, 1, 0, 365, 2
opt-rot-slot, 292, 12, 74, 1, 0, 379, 2
opt-rot-slot, 277, 11, 72, 1, 0, 361, 2
opt-rot-slot, 278, 15, 72, 1, 0, 366, 2
opt-rot-slot, 281, 12, 72, 1, 0, 366, 2
opt-rot-slot, 288, 12, 73, 1, 0, 374, 2
opt-rot-slot, 289, 11, 78, 1, 0, 379, 2
opt-rot-slot, 279, 11, 71, 1, 0, 362, 2
opt-rot-slot, 276, 11, 70, 1, 0, 358, 2
opt-rot-slot, 278, 12, 72, 1, 0, 363, 2
opt-rot-slot, 285, 12, 73, 1, 0, 371, 2
opt-rot-slot, 273, 12, 71, 1, 0, 357, 2
opt-rot-slot, 283, 12, 73, 1, 0, 369, 2
opt-rot-slot, 275, 12, 72, 1, 0, 360, 2
opt-rot-slot, 276, 11, 73, 1, 0, 361, 2
opt-rot-slot, 279, 11, 71, 1, 0, 362, 2
opt-rot-slot, 283, 11, 70, 1, 0, 365, 2
opt-rot-slot, 306, 11, 70, 1, 0, 388, 2
opt-rot-slot, 281, 12, 70, 1, 0, 364, 2
opt-rot-slot, 291, 12, 73, 1, 0, 377, 2
opt-rot-slot, 291, 12, 74, 1, 0, 378, 2
opt-rot-slot, 274, 12, 72, 1, 0, 359, 2
opt-rot-slot, 280, 11, 78, 1, 0, 370, 2
opt-rot-slot, 292, 12, 72, 1, 0, 377, 2
opt-rot-slot, 281, 12, 73, 1, 0, 367, 2
opt-rot-slot, 280, 11, 71, 1, 0, 363, 2
opt-rot-slot, 282, 12, 71, 1, 0, 366, 2
opt-rot-slot, 274, 11, 70, 1, 0, 356, 2
opt-rot-slot, 301, 12, 74, 1, 0, 388, 2
opt-rot-slot, 274, 11, 73, 1, 0, 359, 2
opt-rot-slot, 277, 12, 76, 1, 0, 366, 2
opt-rot-slot, 277, 11, 73, 1, 0, 362, 2
opt-rot-slot, 284, 12, 74, 1, 0, 371, 2
opt-rot-slot, 326, 12, 74, 1, 0, 413, 2
opt-rot-slot, 288, 11, 72, 1, 0, 372, 2
opt-rot-slot, 286, 12, 73, 1, 0, 372, 2
opt-rot-slot, 287, 12, 73, 1, 0, 373, 2
opt-rot-slot, 288, 12, 72, 1, 0, 373, 2
opt-rot-slot, 281, 12, 72, 1, 0, 366, 2
opt-rot-slot, 278, 12, 75, 1, 0, 366, 2
opt-rot-slot, 280, 11, 70, 1, 0, 362, 2
opt-rot-slot, 287, 12, 73, 1, 0, 373, 2
opt-rot-slot, 281, 12, 76, 1, 0, 370, 2
opt-rot-slot, 282, 11, 74, 1, 0, 368, 2
opt-rot-slot, 292, 11, 71, 1, 0, 375, 2
opt-rot-slot, 279, 12, 78, 1, 0, 370, 2
opt-rot-slot, 283, 12, 72, 1, 0, 368, 2
opt-rot-slot, 282, 12, 73, 1, 0, 368, 2
opt-rot-slot, 274, 11, 72, 1, 0, 358, 2
opt-rot-slot, 285, 11, 72, 1, 0, 369, 2
opt-rot-slot, 280, 12, 72, 1, 0, 365, 2
opt-rot-slot, 279, 12, 71, 1, 0, 363, 2
opt-rot-slot, 282, 12, 71, 1, 0, 366, 2
opt-rot-slot, 281, 12, 70, 1, 0, 364, 2
opt-rot-slot, 298, 15, 74, 1, 0, 388, 2
opt-rot-slot, 284, 12, 73, 1, 0, 370, 2
opt-rot-slot, 281, 12, 73, 1, 0, 367, 2
opt-rot-slot, 277, 12, 71, 1, 0, 361, 2
opt-rot-slot, 282, 11, 71, 1, 0, 365, 2
opt-rot-slot, 276, 12, 73, 1, 0, 362, 2
opt-rot-slot, 278, 12, 76, 1, 0, 367, 2
opt-rot-slot, 279, 11, 71, 1, 0, 362, 2
opt-rot-slot, 288, 11, 72, 1, 0, 372, 2
opt-rot-slot, 280, 12, 71, 1, 0, 364, 2
opt-rot-slot, 281, 11, 71, 1, 0, 364, 2
opt-rot-slot, 281, 12, 72, 1, 0, 366, 2
opt-rot-slot, 278, 11, 72, 1, 0, 362, 2
opt-rot-slot, 279, 11, 70, 1, 0, 361, 2
opt-rot-slot, 284, 12, 72, 1, 0, 369, 2
opt-rot-slot, 278, 12, 71, 1, 0, 362, 2
opt-rot-slot, 285, 12, 96, 1, 0, 394, 2
opt-rot-slot, 294, 12, 71, 1, 0, 378, 2
opt-rot-slot, 291, 12, 74, 1, 0, 378, 2
opt-rot-slot, 293, 12, 74, 1, 0, 380, 2
opt-rot-slot, 287, 11, 74, 1, 0, 373, 2
opt-rot-slot, 286, 12, 75, 1, 0, 374, 2
opt-rot-slot, 278, 12, 73, 1, 0, 364, 2
opt-rot-slot, 286, 12, 73, 1, 0, 372, 2
opt-rot-slot, 278, 12, 73, 1, 0, 364, 2
opt-rot-slot, 284, 12, 74, 1, 0, 371, 2
opt-rot-slot, 274, 12, 73, 1, 0, 360, 2
opt-rot-slot, 301, 11, 74, 1, 0, 387, 2
opt-rot-slot, 277, 11, 71, 1, 0, 360, 2
opt-rot-slot, 280, 12, 73, 1, 0, 366, 2
opt-rot-slot, 285, 11, 73, 1, 0, 370, 2
opt-rot-slot, 291, 12, 72, 1, 0, 376, 2
opt-rot-slot, 289, 12, 75, 1, 0, 377, 2
opt-rot-slot, 281, 11, 73, 1, 0, 366, 2
opt-rot-slot, 281, 12, 73, 1, 0, 367, 2
opt-rot-slot, 291, 12, 74, 1, 0, 378, 2
opt-rot-slot, 292, 12, 74, 1, 0, 379, 2
opt-rot-slot, 280, 12, 75, 1, 0, 368, 2
opt-rot-slot, 285, 12, 73, 1, 0, 371, 2
opt-rot-slot, 276, 11, 73, 1, 0, 361, 2
opt-rot-slot, 282, 12, 72, 1, 0, 367, 2
opt-rot-slot, 278, 12, 71, 1, 0, 362, 2
opt-rot-slot, 280, 11, 72, 1, 0, 364, 2
opt-rot-slot, 281, 12, 73, 1, 0, 367, 2
opt-rot-slot, 283, 12, 72, 1, 0, 368, 2
opt-rot-slot, 280, 13, 73, 1, 0, 367, 2
opt-rot-slot, 282, 11, 72, 1, 0, 366, 2
opt-rot-slot, 284, 12, 73, 1, 0, 370, 2
opt-rot-slot, 279, 12, 70, 1, 0, 362, 2
opt-rot-slot, 277, 11, 72, 1, 0, 361, 2
opt-rot-slot, 288, 12, 73, 1, 0, 374, 2
opt-rot-slot, 281, 12, 71, 1, 0, 365, 2
opt-rot-slot, 283, 12, 74, 1, 0, 370, 2
opt-rot-slot, 282, 12, 72, 1, 0, 367, 2
opt-rot-slot, 281, 15, 74, 1, 0, 371, 2
opt-rot-slot, 278, 11, 71, 1, 0, 361, 2
opt-rot-slot, 283, 11, 70, 1, 0, 365, 2
opt-rot-slot, 279, 12, 74, 1, 0, 366, 2
opt-rot-slot, 289, 11, 72, 1, 0, 373, 2
opt-rot-slot, 293, 12, 74, 1, 0, 380, 2
opt-rot-slot, 280, 11, 72, 1, 0, 364, 2
opt-rot-slot, 282, 12, 73, 1, 0, 368, 2
opt-rot-slot, 289, 12, 72, 1, 0, 374, 2
opt-rot-slot, 281, 12, 71, 1, 0, 365, 2
opt-rot-slot, 284, 12, 72, 1, 0, 369, 2
opt-rot-slot, 283, 12, 74, 1, 0, 370, 2
opt-rot-slot, 279, 12, 73, 1, 0, 365, 2
opt-rot-slot, 277, 11, 72, 1, 0, 361, 2
opt-rot-slot, 284, 15, 70, 1, 0, 370, 2
opt-rot-slot, 280, 11, 72, 1, 0, 364, 2
opt-rot-slot, 282, 12, 71, 1, 0, 366, 2
opt-rot-slot, 283, 11, 74, 1, 0, 369, 2
opt-rot-slot, 283, 12, 76, 1, 0, 372, 2
opt-rot-slot, 274, 11, 71, 1, 0, 357, 2
opt-rot-slot, 282, 11, 73, 1, 0, 367, 2
opt-rot-slot, 278, 12, 72, 1, 0, 363, 2
opt-rot-slot, 280, 11, 73, 1, 0, 365, 2
opt-rot-slot, 286, 12, 75, 1, 0, 374, 2
opt-rot-slot, 277, 11, 72, 1, 0, 361, 2
opt-rot-slot, 279, 11, 71, 1, 0, 362, 2
opt-rot-slot, 289, 12, 72, 1, 0, 374, 2
opt-rot-slot, 280, 12, 72, 1, 0, 365, 2
opt-rot-slot, 279, 12, 74, 1, 0, 366, 2
opt-rot-slot, 287, 12, 71, 1, 0, 371, 2
opt-rot-slot, 293, 12, 71, 1, 0, 377, 2
opt-rot-slot, 275, 12, 71, 1, 0, 359, 2
opt-rot-slot, 286, 11, 73, 1, 0, 371, 2
opt-rot-slot, 279, 11, 70, 1, 0, 361, 2
opt-rot-slot, 279, 13, 72, 1, 0, 365, 2
opt-rot-slot, 290, 11, 72, 1, 0, 374, 2
opt-rot-slot, 283, 11, 72, 1, 0, 367, 2
opt-rot-slot, 279, 12, 79, 1, 0, 371, 2
opt-rot-slot, 281, 11, 72, 1, 0, 365, 2
opt-rot-slot, 281, 11, 71, 1, 0, 364, 2
opt-rot-slot, 281, 11, 71, 1, 0, 364, 2
opt-rot-slot, 299, 11, 72, 1, 0, 383, 2
opt-rot-slot, 287, 12, 77, 1, 0, 377, 2
opt-rot-slot, 284, 13, 71, 1, 0, 369, 2
opt-rot-slot, 289, 11, 74, 1, 0, 375, 2
opt-rot-slot, 285, 12, 71, 1, 0, 369, 2
opt-rot-slot, 284, 12, 73, 1, 0, 370, 2
opt-rot-slot, 281, 12, 72, 1, 0, 366, 2
opt-rot-slot, 278, 11, 71, 1, 0, 361, 2
opt-rot-slot, 282, 11, 71, 1, 0, 365, 2
opt-rot-slot, 287, 12, 73, 1, 0, 373, 2
opt-rot-slot, 278, 11, 70, 1, 0, 360, 2
opt-rot-slot, 286, 12, 74, 1, 0, 373, 2
opt-rot-slot, 284, 11, 70, 1, 0, 366, 2
opt-rot-slot, 274, 11, 71, 1, 0, 357, 2
opt-rot-slot, 279, 12, 72, 1, 0, 364, 2
opt-rot-slot, 279, 13, 80, 1, 0, 373, 2
opt-rot-slot, 308, 12, 70, 1, 0, 391, 2
opt-rot-slot, 280, 11, 72, 1, 0, 364, 2
opt-rot-slot, 281, 11, 72, 1, 0, 365, 2
opt-rot-slot, 280, 12, 72, 1, 0, 365, 2
opt-rot-slot, 276, 12, 71, 1, 0, 360, 2
opt-rot-slot, 291, 12, 75, 1, 0, 379, 2
opt-rot-slot, 275, 12, 72, 1, 0, 360, 2
opt-rot-slot, 272, 11, 73, 1, 0, 357, 2
opt-rot-slot, 285, 12, 72, 1, 0, 370, 2
opt-rot-slot, 285, 12, 72, 1, 0, 370, 2
opt-rot-slot, 277, 11, 70, 1, 0, 359, 2
opt-rot-slot, 300, 12, 71, 1, 0, 384, 2
opt-rot-slot, 274, 11, 71, 1, 0, 357, 2
opt-rot-slot, 284, 12, 72, 1, 0, 369, 2
opt-rot-slot, 290, 13, 71, 1, 0, 375, 2
opt-rot-slot, 281, 11, 72, 1, 0, 365, 2
opt-rot-slot, 290, 12, 72, 1, 0, 375, 2
opt-rot-slot, 283, 12, 72, 1, 0, 368, 2
opt-rot-slot, 275, 11, 72, 1, 0, 359, 2
opt-rot-slot, 278, 11, 71, 1, 0, 361, 2
opt-rot-slot, 278, 11, 69, 1, 0, 359, 2
opt-rot-slot, 283, 12, 72, 1, 0, 368, 2
opt-rot-slot, 281, 11, 73, 1, 0, 366, 2
opt-rot-slot, 280, 12, 72, 1, 0, 365, 2
opt-rot-slot, 278, 12, 75, 1, 0, 366, 2
opt-rot-slot, 283, 12, 71, 1, 0, 367, 2
opt-rot-slot, 284, 12, 72, 1, 0, 369, 2
opt-rot-slot, 287, 11, 73, 1, 0, 372, 2
opt-rot-slot, 283, 11, 72, 1, 0, 367, 2
opt-rot-slot, 283, 12, 75, 1, 0, 371, 2
opt-rot-slot, 291, 12, 71, 1, 0, 375, 2
opt-rot-slot, 280, 12, 73, 1, 0, 366, 2
opt-rot-slot, 281, 13, 71, 1, 0, 366, 2
opt-rot-slot, 277, 12, 73, 1, 0, 363, 2
opt-rot-slot, 281, 12, 73, 1, 0, 367, 2
opt-rot-slot, 285, 11, 82, 1, 0, 379, 2
opt-rot-slot, 279, 11, 72, 1, 0, 363, 2
opt-rot-slot, 289, 12, 71, 1, 0, 373, 2
opt-rot-slot, 285, 12, 73, 1, 0, 371, 2
opt-rot-slot, 279, 12, 71, 1, 0, 363, 2
opt-rot-slot, 288, 11, 72, 1, 0, 372, 2
opt-rot-slot, 277, 11, 72, 1, 0, 361, 2
opt-rot-slot, 282, 11, 71, 1, 0, 365, 2
opt-rot-slot, 292, 12, 71, 1, 0, 376, 2
opt-rot-slot, 288, 11, 70, 1, 0, 370, 2
opt-rot-slot, 280, 15, 72, 1, 0, 368, 2
opt-rot-slot, 297, 13, 72, 1, 0, 383, 2
opt-rot-slot, 286, 15, 73, 1, 0, 375, 2
opt-rot-slot, 277, 31, 74, 1, 0, 383, 2
opt-rot-slot, 277, 11, 68, 1, 0, 357, 2
opt-rot-slot, 282, 11, 74, 1, 0, 368, 2
opt-rot-slot, 280, 11, 74, 1, 0, 366, 2
opt-rot-slot, 282, 11, 71, 1, 0, 365, 2
opt-rot-slot, 277, 11, 71, 1, 0, 360, 2
opt-rot-slot, 278, 11, 73, 1, 0, 363, 2
opt-rot-slot, 281, 11, 73, 1, 0, 366, 2
opt-rot-slot, 276, 12, 73, 1, 0, 362, 2
opt-rot-slot, 291, 12, 72, 1, 0, 376, 2
opt-rot-slot, 274, 11, 71, 1, 0, 357, 2
opt-rot-slot, 282, 13, 70, 1, 0, 366, 2
opt-rot-slot, 280, 11, 70, 1, 0, 362, 2
opt-rot-slot, 279, 11, 73, 1, 0, 364, 2
opt-rot-slot, 282, 12, 73, 1, 0, 368, 2
opt-rot-slot, 277, 12, 73, 1, 0, 363, 2
opt-rot-slot, 280, 11, 90, 1, 0, 382, 2
opt-rot-slot, 283, 12, 70, 1, 0, 366, 2
opt-rot-slot, 288, 13, 74, 1, 0, 376, 2
opt-rot-slot, 281, 12, 72, 1, 0, 366, 2
opt-rot-slot, 281, 11, 71, 1, 0, 364, 2
opt-rot-slot, 279, 11, 73, 1, 0, 364, 2
opt-rot-slot, 283, 11, 72, 1, 0, 367, 2
opt-rot-slot, 276, 11, 71, 1, 0, 359, 2
opt-rot-slot, 283, 12, 70, 1, 0, 366, 2
opt-rot-slot, 280, 12, 73, 1, 0, 366, 2
opt-rot-slot, 287, 12, 71, 1, 0, 371, 2
opt-rot-slot, 305, 12, 74, 1, 0, 392, 2
opt-rot-slot, 280, 11, 72, 1, 0, 364, 2
opt-rot-slot, 291, 12, 72, 1, 0, 376, 2
opt-rot-slot, 276, 11, 71, 1, 0, 359, 2
opt-rot-slot, 299, 12, 73, 1, 0, 385, 2
opt-rot-slot, 280, 12, 73, 1, 0, 366, 2
opt-rot-slot, 297, 12, 71, 1, 0, 381, 2
opt-rot-slot, 291, 11, 73, 1, 0, 376, 2
opt-rot-slot, 287, 12, 78, 1, 0, 378, 2
opt-rot-slot, 281, 17, 74, 1, 0, 373, 2
opt-rot-slot, 277, 11, 73, 1, 0, 362, 2
opt-rot-slot, 280, 11, 73, 1, 0, 365, 2
opt-rot-slot, 283, 11, 72, 1, 0, 367, 2
opt-rot-slot, 277, 12, 74, 1, 0, 364, 2
opt-rot-slot, 283, 12, 71, 1, 0, 367, 2
opt-rot-slot, 297, 11, 70, 1, 0, 379, 2
opt-rot-slot, 276, 12, 76, 1, 0, 365, 2
opt-rot-slot, 281, 12, 70, 1, 0, 364, 2
opt-rot-slot, 279, 11, 71, 1, 0, 362, 2
opt-rot-slot, 283, 11, 68, 1, 0, 363, 2
opt-rot-slot, 281, 11, 73, 1, 0, 366, 2
opt-rot-slot, 275, 12, 72, 1, 0, 360, 2
opt-rot-slot, 279, 11, 70, 1, 0, 361, 2
opt-rot-slot, 283, 12, 73, 1, 0, 369, 2
opt-rot-slot, 277, 11, 73, 1, 0, 362, 2
opt-rot-slot, 273, 12, 76, 1, 0, 362, 2
opt-rot-slot, 286, 12, 74, 1, 0, 373, 2
opt-rot-slot, 283, 11, 71, 1, 0, 366, 2
opt-rot-slot, 278, 12, 72, 1, 0, 363, 2
opt-rot-slot, 288, 11, 73, 1, 0, 373, 2
opt-rot-slot, 282, 11, 70, 1, 0, 364, 2
opt-rot-slot, 303, 12, 70, 1, 0, 386, 2
opt-rot-slot, 297, 12, 75, 1, 0, 385, 2
opt-rot-slot, 280, 12, 74, 1, 0, 367, 2
opt-rot-slot, 282, 12, 73, 1, 0, 368, 2
opt-rot-slot, 283, 12, 71, 1, 0, 367, 2
opt-rot-slot, 283, 12, 74, 1, 0, 370, 2
opt-rot-slot, 277, 12, 76, 1, 0, 366, 2
opt-rot-slot, 282, 11, 71, 1, 0, 365, 2
opt-rot-slot, 275, 12, 71, 1, 0, 359, 2
opt-rot-slot, 287, 12, 74, 1, 0, 374, 2
opt-rot-slot, 274, 11, 90, 1, 0, 376, 2
opt-rot-slot, 277, 11, 71, 1, 0, 360, 2
opt-rot-slot, 282, 12, 71, 1, 0, 366, 2
opt-rot-slot, 276, 12, 72, 1, 0, 361, 2
opt-rot-slot, 287, 11, 72, 1, 0, 371, 2
opt-rot-slot, 285, 12, 71, 1, 0, 369, 2
opt-rot-slot, 283, 11, 72, 1, 0, 367, 2
opt-rot-slot, 281, 12, 71, 1, 0, 365, 2
opt-rot-slot, 284, 12, 70, 1, 0, 367, 2
opt-rot-slot, 277, 12, 71, 1, 0, 361, 2
opt-rot-slot, 278, 12, 69, 1, 0, 360, 2
opt-rot-slot, 281, 11, 71, 1, 0, 364, 2
opt-rot-slot, 280, 12, 72, 1, 0, 365, 2
opt-rot-slot, 292, 12, 71, 1, 0, 376, 2
opt-rot-slot, 278, 11, 72, 1, 0, 362, 2
opt-rot-slot, 281, 11, 71, 1, 0, 364, 2
opt-rot-slot, 280, 11, 89, 1, 0, 381, 2
opt-rot-slot, 278, 12, 70, 1, 0, 361, 2
opt-rot-slot, 288, 11, 70, 1, 0, 370, 2
opt-rot-slot, 279, 12, 71, 1, 0, 363, 2
opt-rot-slot, 277, 11, 73, 1, 0, 362, 2
opt-rot-slot, 285, 12, 71, 1, 0, 369, 2
opt-rot-slot, 279, 12, 71, 1, 0, 363, 2
opt-rot-slot, 294, 11, 74, 1, 0, 380, 2
opt-rot-slot, 282, 12, 70, 1, 0, 365, 2
opt-rot-slot, 282, 12, 71, 1, 0, 366, 2
opt-rot-slot, 285, 11, 71, 1, 0, 368, 2
opt-rot-slot, 299, 12, 71, 1, 0, 383, 2
opt-rot-slot, 281, 12, 73, 1, 0, 367, 2
opt-rot-slot, 281, 12, 74, 1, 0, 368, 2
opt-rot-slot, 285, 12, 73, 1, 0, 371, 2
opt-rot-slot, 280, 12, 71, 1, 0, 364, 2
opt-rot-slot, 286, 12, 76, 1, 0, 375, 2
opt-rot-slot, 287, 12, 72, 1, 0, 372, 2
opt-rot-slot, 288, 11, 74, 1, 0, 374, 2
opt-rot-slot, 280, 12, 73, 1, 0, 366, 2
opt-rot-slot, 291, 12, 75, 1, 0, 379, 2
opt-rot-slot, 286, 11, 71, 1, 0, 369, 2
opt-rot-slot, 277, 11, 72, 1, 0, 361, 2
opt-rot-slot, 289, 11, 74, 1, 0, 375, 2
opt-rot-slot, 279, 11, 71, 1, 0, 362, 2
opt-rot-slot, 289, 11, 74, 1, 0, 375, 2
opt-rot-slot, 281, 12, 75, 1, 0, 369, 2
opt-rot-slot, 297, 11, 71, 1, 0, 380, 2
opt-rot-slot, 276, 12, 73, 1, 0, 362, 2
opt-coef-rot, 131, 15, 13, 1, 0, 160, 1.99976
opt-coef-rot, 147, 15, 14, 1, 0, 177, 1.99976
opt-coef-rot, 129, 16, 13, 1, 0, 159, 1.99976
opt-coef-rot, 127, 15, 13, 1, 0, 156, 1.99976
opt-coef-rot, 131, 15, 13, 1, 0, 160, 1.99976
opt-coef-rot, 133, 16, 13, 1, 0, 163, 1.99976
opt-coef-rot, 132, 16, 13, 1, 0, 162, 1.99976
opt-coef-rot, 133, 15, 13, 1, 0, 162, 1.99976
opt-coef-rot, 141, 15, 14, 1, 0, 171, 1.99976
opt-coef-rot, 135, 16, 13, 1, 0, 165, 1.99976
opt-coef-rot, 128, 15, 13, 1, 0, 157, 1.99976
opt-coef-rot, 128, 15, 13, 1, 0, 157, 1.99976
opt-coef-rot, 135, 15, 13, 1, 0, 164, 1.99976
opt-coef-rot, 147, 15, 13, 1, 0, 176, 1.99976
opt-coef-rot, 131, 15, 13, 1, 0, 160, 1.99976
opt-coef-rot, 133, 15, 13, 1, 0, 162, 1.99976
opt-coef-rot, 132, 16, 13, 1, 0, 162, 1.99976
opt-coef-rot, 131, 16, 13, 1, 0, 161, 1.99976
opt-coef-rot, 129, 16, 13, 1, 0, 159, 1.99976
opt-coef-rot, 127, 15, 13, 1, 0, 156, 1.99976
opt-coef-rot, 128, 15, 13, 1, 0, 157, 1.99976
opt-coef-rot, 131, 15, 13, 1, 0, 160, 1.99976
opt-coef-rot, 130, 15, 13, 1, 0, 159, 1.99976
opt-coef-rot, 131, 15, 13, 1, 0, 160, 1.99976
opt-coef-rot, 141, 15, 17, 1, 0, 174, 1.99976
opt-coef-rot, 129, 15, 13, 1, 0, 158, 1.99976
opt-coef-rot, 132, 16, 13, 1, 0, 162, 1.99976
opt-coef-rot, 132, 15, 13, 1, 0, 161, 1.99976
opt-coef-rot, 134, 15, 13, 1, 0, 163, 1.99976
opt-coef-rot, 130, 16, 13, 1, 0, 160, 1.99976
opt-coef-rot, 131, 15, 13, 1, 0, 160, 1.99976
opt-coef-rot, 130, 15, 13, 1, 0, 159, 1.99976
opt-coef-rot, 134, 15, 13, 1, 0, 163, 1.99976
opt-coef-rot, 133, 15, 14, 1, 0, 163, 1.99976
opt-coef-rot, 140, 15, 14, 1, 0, 170, 1.99976
opt-coef-rot, 136, 15, 13, 1, 0, 165, 1.99976
opt-coef-rot, 136, 15, 13, 1, 0, 165, 1.99976
opt-coef-rot, 135, 15, 14, 1, 0, 165, 1.99976
opt-coef-rot, 140, 16, 13, 1, 0, 170, 1.99976
opt-coef-rot, 134, 15, 13, 1, 0, 163, 1.99976
opt-coef-rot, 130, 15, 13, 1, 0, 159, 1.99976
opt-coef-rot, 131, 15, 13, 1, 0, 160, 1.99976
opt-coef-rot, 133, 16, 14, 1, 0, 164, 1.99976
opt-coef-rot, 133, 15, 13, 1, 0, 162, 1.99976
opt-coef-rot, 131, 15, 13, 1, 0, 160, 1.99976
opt-coef-rot, 129, 15, 13, 1, 0, 158, 1.99976
opt-coef-rot, 139, 16, 13, 1, 0, 169, 1.99976
opt-coef-rot, 130, 22, 25, 1, 0, 178, 1.99976
opt-coef-rot, 129, 17, 13, 1, 0, 160, 1.99976
opt-coef-rot, 136, 15, 13, 1, 0, 165, 1.99976
opt-coef-rot, 131, 16, 13, 1, 0, 161, 1.99976
opt-coef-rot, 136, 15, 13, 1, 0, 165, 1.99976
opt-coef-rot, 131, 16, 13, 1, 0, 161, 1.99976
opt-coef-rot, 128, 15, 13, 1, 0, 157, 1.99976
opt-coef-rot, 130, 16, 13, 1, 0, 160, 1.99976
opt-coef-rot, 133, 16, 14, 1, 0, 164, 1.99976
opt-coef-rot, 131, 18, 13, 1, 0, 163, 1.99976
opt-coef-rot, 130, 16, 13, 1, 0, 160, 1.99976
opt-coef-rot, 127, 16, 13, 1, 0, 157, 1.99976
opt-coef-rot, 132, 15, 13, 1, 0, 161, 1.99976
opt-coef-rot, 129, 16, 13, 1, 0, 159, 1.99976
opt-coef-rot, 128, 15, 13, 1, 0, 157, 1.99976
opt-coef-rot, 137, 15, 13, 1, 0, 166, 1.99976
opt-coef-rot, 134, 15, 13, 1, 0, 163, 1.99976
opt-coef-rot, 130, 16, 13, 1, 0, 160, 1.99976
opt-coef-rot, 131, 19, 13, 1, 0, 164, 1.99976
opt-coef-rot, 132, 16, 13, 1, 0, 162, 1.99976
opt-coef-rot, 137, 15, 13, 1, 0, 166, 1.99976
opt-coef-rot, 133, 15, 12, 1, 0, 161, 1.99976
opt-coef-rot, 137, 15, 13, 1, 0, 166, 1.99976
opt-coef-rot, 132, 25, 28, 1, 0, 186, 1.99976
opt-coef-rot, 132, 15, 13, 1, 0, 161, 1.99976
opt-coef-rot, 130, 15, 13, 1, 0, 159, 1.99976
opt-coef-rot, 132, 16, 13, 1, 0, 162, 1.99976
opt-coef-rot, 133, 18, 13, 1, 0, 165, 1.99976
opt-coef-rot, 133, 15, 13, 1, 0, 162, 1.99976
opt-coef-rot, 130, 15, 13, 1, 0, 159, 1.99976
opt-coef-rot, 133, 16, 13, 1, 0, 163, 1.99976
opt-coef-rot, 136, 15, 13, 1, 0, 165, 1.99976
opt-coef-rot, 131, 16, 13, 1, 0, 161, 1.99976
opt-coef-rot, 135, 16, 13, 1, 0, 165, 1.99976
opt-coef-rot, 130, 16, 14, 1, 0, 161, 1.99976
opt-coef-rot, 135, 16, 13, 1, 0, 165, 1.99976
opt-coef-rot, 132, 16, 13, 1, 0, 162, 1.99976
opt-coef-rot, 137, 17, 13, 1, 0, 168, 1.99976
opt-coef-rot, 132, 15, 13, 1, 0, 161, 1.99976
opt-coef-rot, 131, 15, 13, 1, 0, 160, 1.99976
opt-coef-rot, 132, 15, 12, 1, 0, 160, 1.99976
opt-coef-rot, 136, 16, 12, 1, 0, 165, 1.99976
opt-coef-rot, 138, 16, 13, 1, 0, 168, 1.99976
opt-coef-rot, 132, 16, 13, 1, 0, 162, 1.99976
opt-coef-rot, 131, 15, 13, 1, 0, 160, 1.99976
opt-coef-rot, 131, 15, 13, 1, 0, 160, 1.99976
opt-coef-rot, 134, 20, 13, 1, 0, 168, 1.99976
opt-coef-rot, 136, 16, 13, 1, 0, 166, 1.99976
opt-coef-rot, 130, 16, 13, 1, 0, 160, 1.99976
opt-coef-rot, 132, 15, 13, 1, 0, 161, 1.99976
opt-coef-rot, 130, 15, 13, 1, 0, 159, 1.99976
opt-coef-rot, 132, 15, 13, 1, 0, 161, 1.99976
opt-coef-rot, 132, 15, 13, 1, 0, 161, 1.99976
opt-coef-rot, 136, 19, 13, 1, 0, 169, 1.99976
opt-coef-rot, 132, 15, 13, 1, 0, 161, 1.99976
opt-coef-rot, 130, 16, 13, 1, 0, 160, 1.99976
opt-coef-rot, 135, 15, 12, 1, 0, 163, 1.99976
opt-coef-rot, 132, 15, 13, 1, 0, 161, 1.99976
opt-coef-rot, 150, 15, 13, 1, 0, 179, 1.99976
opt-coef-rot, 133, 15, 13, 1, 0, 162, 1.99976
opt-coef-rot, 127, 15, 13, 1, 0, 156, 1.99976
opt-coef-rot, 134, 17, 12, 1, 0, 164, 1.99976
opt-coef-rot, 134, 15, 13, 1, 0, 163, 1.99976
opt-coef-rot, 132, 17, 13, 1, 0, 163, 1.99976
opt-coef-rot, 129, 15, 13, 1, 0, 158, 1.99976
opt-coef-rot, 131, 15, 13, 1, 0, 160, 1.99976
opt-coef-rot, 131, 15, 13, 1, 0, 160, 1.99976
opt-coef-rot, 133, 15, 13, 1, 0, 162, 1.99976
opt-coef-rot, 140, 17, 14, 1, 0, 172, 1.99976
opt-coef-rot, 136, 15, 13, 1, 0, 165, 1.99976
opt-coef-rot, 139, 16, 13, 1, 0, 169, 1.99976
opt-coef-rot, 132, 15, 13, 1, 0, 161, 1.99976
opt-coef-rot, 131, 16, 14, 1, 0, 162, 1.99976
opt-coef-rot, 135, 16, 13, 1, 0, 165, 1.99976
opt-coef-rot, 131, 15, 13, 1, 0, 160, 1.99976
opt-coef-rot, 129, 15, 13, 1, 0, 158, 1.99976
opt-coef-rot, 133, 15, 13, 1, 0, 162, 1.99976
opt-coef-rot, 134, 16, 13, 1, 0, 164, 1.99976
opt-coef-rot, 132, 15, 13, 1, 0, 161, 1.99976
opt-coef-rot, 132, 16, 13, 1, 0, 162, 1.99976
opt-coef-rot, 139, 16, 13, 1, 0, 169, 1.99976
opt-coef-rot, 148, 16, 14, 1, 0, 179, 1.99976
opt-coef-rot, 129, 15, 13, 1, 0, 158, 1.99976
opt-coef-rot, 129, 15, 13, 1, 0, 158, 1.99976
opt-coef-rot, 134, 21, 13, 1, 0, 169, 1.99976
opt-coef-rot, 132, 16, 13, 1, 0, 162, 1.99976
opt-coef-rot, 139, 20, 14, 1, 0, 174, 1.99976
opt-coef-rot, 135, 16, 13, 1, 0, 165, 1.99976
opt-coef-rot, 135, 16, 14, 1, 0, 166, 1.99976
opt-coef-rot, 128, 15, 12, 1, 0, 156, 1.99976
opt-coef-rot, 132, 16, 12, 1, 0, 161, 1.99976
opt-coef-rot, 135, 15, 13, 1, 0, 164, 1.99976
opt-coef-rot, 131, 16, 14, 1, 0, 162, 1.99976
opt-coef-rot, 130, 16, 13, 1, 0, 160, 1.99976
opt-coef-rot, 134, 15, 13, 1, 0, 163, 1.99976
opt-coef-rot, 136, 15, 13, 1, 0, 165, 1.99976
opt-coef-rot, 132, 17, 13, 1, 0, 163, 1.99976
opt-coef-rot, 130, 15, 13, 1, 0, 159, 1.99976
opt-coef-rot, 134, 15, 13, 1, 0, 163, 1.99976
opt-coef-rot, 136, 15, 12, 1, 0, 164, 1.99976
opt-coef-rot, 133, 16, 13, 1, 0, 163, 1.99976
opt-coef-rot, 130, 16, 13, 1, 0, 160, 1.99976
opt-coef-rot, 138, 15, 13, 1, 0, 167, 1.99976
opt-coef-rot, 141, 16, 13, 1, 0, 171, 1.99976
opt-coef-rot, 139, 16, 12, 1, 0, 168, 1.99976
opt-coef-rot, 127, 15, 13, 1, 0, 156, 1.99976
opt-coef-rot, 132, 15, 12, 1, 0, 160, 1.99976
opt-coef-rot, 129, 15, 13, 1, 0, 158, 1.99976
opt-coef-rot, 132, 15, 13, 1, 0, 161, 1.99976
opt-coef-rot, 130, 16, 13, 1, 0, 160, 1.99976
opt-coef-rot, 132, 16, 13, 1, 0, 162, 1.99976
opt-coef-rot, 135, 15, 13, 1, 0, 164, 1.99976
opt-coef-rot, 131, 15, 13, 1, 0, 160, 1.99976
opt-coef-rot, 142, 15, 14, 1, 0, 172, 1.99976
opt-coef-rot, 132, 15, 13, 1, 0, 161, 1.99976
opt-coef-rot, 130, 15, 13, 1, 0, 159, 1.99976
opt-coef-rot, 137, 15, 13, 1, 0, 166, 1.99976
opt-coef-rot, 129, 15, 13, 1, 0, 158, 1.99976
opt-coef-rot, 127, 16, 12, 1, 0, 156, 1.99976
opt-coef-rot, 139, 16, 13, 1, 0, 169, 1.99976
opt-coef-rot, 128, 16, 13, 1, 0, 158, 1.99976
opt-coef-rot, 130, 15, 13, 1, 0, 159, 1.99976
opt-coef-rot, 128, 15, 13, 1, 0, 157, 1.99976
opt-coef-rot, 132, 16, 13, 1, 0, 162, 1.99976
opt-coef-rot, 129, 17, 13, 1, 0, 160, 1.99976
opt-coef-rot, 143, 15, 13, 1, 0, 172, 1.99976
opt-coef-rot, 136, 14, 13, 1, 0, 164, 1.99976
opt-coef-rot, 137, 16, 13, 1, 0, 167, 1.99976
opt-coef-rot, 133, 16, 13, 1, 0, 163, 1.99976
opt-coef-rot, 135, 16, 13, 1, 0, 165, 1.99976
opt-coef-rot, 135, 15, 13, 1, 0, 164, 1.99976
opt-coef-rot, 129, 17, 13, 1, 0, 160, 1.99976
opt-coef-rot, 134, 15, 13, 1, 0, 163, 1.99976
opt-coef-rot, 132, 16, 13, 1, 0, 162, 1.99976
opt-coef-rot, 134, 16, 13, 1, 0, 164, 1.99976
opt-coef-rot, 131, 16, 13, 1, 0, 161, 1.99976
opt-coef-rot, 147, 15, 13, 1, 0, 176, 1.99976
opt-coef-rot, 130, 15, 13, 1, 0, 159, 1.99976
opt-coef-rot, 135, 16, 13, 1, 0, 165, 1.99976
opt-coef-rot, 132, 15, 13, 1, 0, 161, 1.99976
opt-coef-rot, 140, 15, 13, 1, 0, 169, 1.99976
opt-coef-rot, 135, 15, 13, 1, 0, 164, 1.99976
opt-coef-rot, 133, 15, 13, 1, 0, 162, 1.99976
opt-coef-rot, 132, 15, 13, 1, 0, 161, 1.99976
opt-coef-rot, 133, 15, 13, 1, 0, 162, 1.99976
opt-coef-rot, 132, 16, 13, 1, 0, 162, 1.99976
opt-coef-rot, 136, 16, 14, 1, 0, 167, 1.99976
opt-coef-rot, 131, 16, 13, 1, 0, 161, 1.99976
opt-coef-rot, 131, 15, 13, 1, 0, 160, 1.99976
opt-coef-rot, 135, 15, 14, 1, 0, 165, 1.99976
opt-coef-rot, 134, 15, 13, 1, 0, 163, 1.99976
opt-coef-rot, 138, 18, 13, 1, 0, 170, 1.99976
opt-coef-rot, 134, 15, 13, 1, 0, 163, 1.99976
opt-coef-rot, 130, 15, 12, 1, 0, 158, 1.99976
opt-coef-rot, 137, 15, 13, 1, 0, 166, 1.99976
opt-coef-rot, 135, 16, 13, 1, 0, 165, 1.99976
opt-coef-rot, 133, 15, 13, 1, 0, 162, 1.99976
opt-coef-rot, 130, 15, 13, 1, 0, 159, 1.99976
opt-coef-rot, 135, 16, 13, 1, 0, 165, 1.99976
opt-coef-rot, 137, 16, 13, 1, 0, 167, 1.99976
opt-coef-rot, 131, 15, 13, 1, 0, 160, 1.99976
opt-coef-rot, 132, 15, 13, 1, 0, 161, 1.99976
opt-coef-rot, 137, 17, 13, 1, 0, 168, 1.99976
opt-coef-rot, 131, 15, 13, 1, 0, 160, 1.99976
opt-coef-rot, 129, 16, 13, 1, 0, 159, 1.99976
opt-coef-rot, 129, 16, 13, 1, 0, 159, 1.99976
opt-coef-rot, 131, 16, 13, 2, 0, 162, 1.99976
opt-coef-rot, 129, 15, 13, 1, 0, 158, 1.99976
opt-coef-rot, 140, 15, 14, 1, 0, 170, 1.99976
opt-coef-rot, 129, 15, 13, 1, 0, 158, 1.99976
opt-coef-rot, 131, 16, 13, 1, 0, 161, 1.99976
opt-coef-rot, 144, 15, 13, 1, 0, 173, 1.99976
opt-coef-rot, 132, 16, 13, 1, 0, 162, 1.99976
opt-coef-rot, 146, 16, 13, 1, 0, 176, 1.99976
opt-coef-rot, 134, 15, 13, 1, 0, 163, 1.99976
opt-coef-rot, 134, 16, 14, 1, 0, 165, 1.99976
opt-coef-rot, 130, 15, 13, 1, 0, 159, 1.99976
opt-coef-rot, 130, 15, 13, 1, 0, 159, 1.99976
opt-coef-rot, 143, 15, 13, 1, 0, 172, 1.99976
opt-coef-rot, 131, 16, 13, 1, 0, 161, 1.99976
opt-coef-rot, 130, 16, 13, 1, 0, 160, 1.99976
opt-coef-rot, 139, 16, 13, 1, 0, 169, 1.99976
opt-coef-rot, 141, 15, 14, 1, 0, 171, 1.99976
opt-coef-rot, 130, 15, 13, 1, 0, 159, 1.99976
opt-coef-rot, 131, 16, 14, 1, 0, 162, 1.99976
opt-coef-rot, 134, 15, 12, 1, 0, 162, 1.99976
opt-coef-rot, 130, 16, 13, 1, 0, 160, 1.99976
opt-coef-rot, 137, 15, 13, 1, 0, 166, 1.99976
opt-coef-rot, 134, 15, 13, 1, 0, 163, 1.99976
opt-coef-rot, 130, 16, 13, 1, 0, 160, 1.99976
opt-coef-rot, 132, 15, 13, 1, 0, 161, 1.99976
opt-coef-rot, 132, 15, 13, 1, 0, 161, 1.99976
opt-coef-rot, 129, 15, 13, 1, 0, 158, 1.99976
opt-coef-rot, 132, 15, 12, 1, 0, 160, 1.99976
opt-coef-rot, 134, 15, 13, 1, 0, 163, 1.99976
opt-coef-rot, 131, 15, 13, 1, 0, 160, 1.99976
opt-coef-rot, 129, 16, 13, 1, 0, 159, 1.99976
opt-coef-rot, 141, 15, 13, 1, 0, 170, 1.99976
opt-coef-rot, 128, 16, 13, 1, 0, 158, 1.99976
opt-coef-rot, 131, 15, 13, 1, 0, 160, 1.99976
opt-coef-rot, 127, 15, 13, 1, 0, 156, 1.99976
opt-coef-rot, 129, 15, 13, 1, 0, 158, 1.99976
opt-coef-rot, 134, 15, 13, 1, 0, 163, 1.99976
opt-coef-rot, 134, 15, 12, 1, 0, 162, 1.99976
opt-coef-rot, 136, 15, 13, 1, 0, 165, 1.99976
opt-coef-rot, 139, 15, 13, 1, 0, 168, 1.99976
opt-coef-rot, 132, 15, 13, 1, 0, 161, 1.99976
opt-coef-rot, 132, 15, 13, 1, 0, 161, 1.99976
opt-coef-rot, 131, 16, 13, 1, 0, 161, 1.99976
opt-coef-rot, 134, 16, 13, 1, 0, 164, 1.99976
opt-coef-rot, 132, 15, 13, 1, 0, 161, 1.99976
opt-coef-rot, 130, 15, 13, 1, 0, 159, 1.99976
opt-coef-rot, 129, 15, 13, 1, 0, 158, 1.99976
opt-coef-rot, 138, 15, 13, 1, 0, 167, 1.99976
opt-coef-rot, 128, 15, 13, 1, 0, 157, 1.99976
opt-coef-rot, 128, 16, 13, 1, 0, 158, 1.99976
opt-coef-rot, 127, 15, 12, 1, 0, 155, 1.99976
opt-coef-rot, 129, 15, 13, 1, 0, 158, 1.99976
opt-coef-rot, 134, 15, 13, 1, 0, 163, 1.99976
opt-coef-rot, 133, 15, 13, 1, 0, 162, 1.99976
opt-coef-rot, 132, 16, 13, 1, 0, 162, 1.99976
opt-coef-rot, 134, 19, 13, 1, 0, 167, 1.99976
opt-coef-rot, 135, 18, 14, 1, 0, 168, 1.99976
opt-coef-rot, 135, 16, 13, 1, 0, 165, 1.99976
opt-coef-rot, 128, 15, 13, 1, 0, 157, 1.99976
opt-coef-rot, 130, 15, 13, 1, 0, 159, 1.99976
opt-coef-rot, 129, 16, 14, 1, 0, 160, 1.99976
opt-coef-rot, 136, 16, 13, 1, 0, 166, 1.99976
opt-coef-rot, 142, 17, 13, 1, 0, 173, 1.99976
opt-coef-rot, 133, 15, 13, 1, 0, 162, 1.99976
opt-coef-rot, 136, 15, 13, 1, 0, 165, 1.99976
opt-coef-rot, 134, 15, 13, 1, 0, 163, 1.99976
opt-coef-rot, 130, 17, 12, 1, 0, 160, 1.99976
opt-coef-rot, 129, 15, 13, 1, 0, 158, 1.99976
opt-coef-rot, 132, 15, 13, 1, 0, 161, 1.99976
opt-coef-rot, 136, 15, 13, 1, 0, 165, 1.99976
opt-coef-rot, 130, 15, 13, 1, 0, 159, 1.99976
opt-coef-rot, 139, 15, 13, 1, 0, 168, 1.99976
opt-coef-rot, 128, 16, 13, 1, 0, 158, 1.99976
opt-coef-rot, 130, 16, 13, 1, 0, 160, 1.99976
opt-coef-rot, 146, 16, 13, 1, 0, 176, 1.99976
opt-coef-rot, 141, 15, 13, 1, 0, 170, 1.99976
opt-coef-rot, 134, 16, 13, 1, 0, 164, 1.99976
opt-coef-rot, 130, 19, 13, 1, 0, 163, 1.99976
opt-coef-rot, 136, 15, 13, 1, 0, 165, 1.99976
opt-coef-rot, 131, 15, 13, 1, 0, 160, 1.99976
opt-coef-rot, 133, 15, 13, 1, 0, 162, 1.99976
opt-coef-rot, 136, 15, 13, 1, 0, 165, 1.99976
opt-coef-rot, 131, 15, 13, 1, 0, 160, 1.99976
opt-coef-rot, 131, 15, 13, 1, 0, 160, 1.99976
opt-coef-rot, 133, 15, 13, 1, 0, 162, 1.99976
opt-coef-rot, 148, 15, 13, 1, 0, 177, 1.99976
opt-coef-rot, 134, 16, 13, 1, 0, 164, 1.99976
opt-coef-rot, 129, 15, 12, 1, 0, 157, 1.99976
opt-coef-rot, 130, 15, 13, 1, 0, 159, 1.99976
opt-coef-rot, 130, 15, 14, 1, 0, 160, 1.99976
opt-coef-rot, 134, 16, 13, 1, 0, 164, 1.99976
opt-coef-rot, 135, 15, 13, 1, 0, 164, 1.99976
opt-coef-rot, 129, 16, 13, 1, 0, 159, 1.99976
opt-coef-rot, 132, 16, 13, 1, 0, 162, 1.99976
opt-coef-rot, 130, 15, 12, 1, 0, 158, 1.99976
opt-coef-rot, 134, 16, 13, 1, 0, 164, 1.99976
opt-coef-rot, 135, 16, 13, 1, 0, 165, 1.99976
opt-coef-rot, 139, 15, 13, 1, 0, 168, 1.99976
opt-coef-rot, 143, 15, 13, 1, 0, 172, 1.99976
opt-coef-rot, 137, 16, 12, 1, 0, 166, 1.99976
opt-coef-rot, 133, 15, 13, 1, 0, 162, 1.99976
opt-coef-rot, 139, 15, 12, 1, 0, 167, 1.99976
opt-coef-rot, 139, 16, 13, 1, 0, 169, 1.99976
opt-coef-rot, 136, 16, 13, 1, 0, 166, 1.99976
opt-coef-rot, 137, 15, 13, 1, 0, 166, 1.99976
opt-coef-rot, 131, 16, 13, 1, 0, 161, 1.99976
opt-coef-rot, 133, 16, 13, 1, 0, 163, 1.99976
opt-coef-rot, 131, 16, 13, 1, 0, 161, 1.99976
opt-coef-rot, 129, 15, 13, 1, 0, 158, 1.99976
opt-coef-rot, 131, 16, 13, 1, 0, 161, 1.99976
opt-coef-rot, 131, 15, 13, 1, 0, 160, 1.99976
opt-coef-rot, 129, 15, 12, 1, 0, 157, 1.99976
opt-coef-rot, 133, 15, 13, 1, 0, 162, 1.99976
opt-coef-rot, 128, 15, 13, 1, 0, 157, 1.99976
opt-coef-rot, 133, 16, 13, 1, 0, 163, 1.99976
opt-coef-rot, 132, 15, 12, 1, 0, 160, 1.99976
opt-coef-rot, 135, 15, 13, 1, 0, 164, 1.99976
opt-coef-rot, 131, 15, 13, 1, 0, 160, 1.99976
opt-coef-rot, 132, 16, 13, 1, 0, 162, 1.99976
opt-coef-rot, 135, 16, 13, 1, 0, 165, 1.99976
opt-coef-rot, 135, 16, 13, 1, 0, 165, 1.99976
opt-coef-rot, 135, 16, 13, 1, 0, 165, 1.99976
opt-coef-rot, 131, 15, 13, 1, 0, 160, 1.99976
opt-coef-rot, 134, 15, 14, 1, 0, 164, 1.99976
opt-coef-rot, 137, 15, 13, 1, 0, 166, 1.99976
opt-coef-rot, 141, 15, 13, 1, 0, 170, 1.99976
opt-coef-rot, 132, 15, 13, 1, 0, 161, 1.99976
opt-coef-rot, 136, 15, 13, 1, 0, 165, 1.99976
opt-coef-rot, 135, 16, 12, 1, 0, 164, 1.99976
opt-coef-rot, 131, 19, 13, 1, 0, 164, 1.99976
opt-coef-rot, 127, 15, 13, 1, 0, 156, 1.99976
opt-coef-rot, 137, 16, 13, 1, 0, 167, 1.99976
opt-coef-rot, 132, 16, 13, 1, 0, 162, 1.99976
opt-coef-rot, 130, 16, 13, 1, 0, 160, 1.99976
opt-coef-rot, 133, 15, 13, 1, 0, 162, 1.99976
opt-coef-rot, 129, 15, 13, 1, 0, 158, 1.99976
opt-coef-rot, 136, 15, 13, 1, 0, 165, 1.99976
opt-coef-rot, 131, 15, 13, 1, 0, 160, 1.99976
opt-coef-rot, 132, 15, 13, 1, 0, 161, 1.99976
opt-coef-rot, 129, 15, 13, 1, 0, 158, 1.99976
opt-coef-rot, 132, 18, 13, 1, 0, 164, 1.99976
opt-coef-rot, 134, 16, 13, 1, 0, 164, 1.99976
opt-coef-rot, 132, 15, 13, 1, 0, 161, 1.99976
opt-coef-rot, 150, 16, 13, 1, 0, 180, 1.99976
opt-coef-rot, 141, 15, 13, 1, 0, 170, 1.99976
opt-coef-rot, 130, 15, 13, 1, 0, 159, 1.99976
opt-coef-rot, 135, 15, 13, 1, 0, 164, 1.99976
opt-coef-rot, 130, 15, 13, 1, 0, 159, 1.99976
opt-coef-rot, 133, 15, 13, 1, 0, 162, 1.99976
opt-coef-rot, 132, 16, 13, 1, 0, 162, 1.99976
opt-coef-rot, 130, 15, 13, 1, 0, 159, 1.99976
opt-coef-rot, 132, 15, 13, 1, 0, 161, 1.99976
opt-coef-rot, 131, 16, 13, 1, 0, 161, 1.99976
opt-coef-rot, 132, 15, 13, 1, 0, 161, 1.99976
opt-coef-rot, 141, 16, 13, 1, 0, 171, 1.99976
opt-coef-rot, 128, 16, 13, 1, 0, 158, 1.99976
opt-coef-rot, 134, 15, 13, 1, 0, 163, 1.99976
opt-coef-rot, 133, 16, 13, 1, 0, 163, 1.99976
opt-coef-rot, 133, 15, 13, 1, 0, 162, 1.99976
opt-coef-rot, 129, 15, 13, 1, 0, 158, 1.99976
opt-coef-rot, 131, 15, 13, 1, 0, 160, 1.99976
opt-coef-rot, 132, 16, 13, 1, 0, 162, 1.99976
opt-coef-rot, 130, 15, 13, 1, 0, 159, 1.99976
opt-coef-rot, 134, 15, 13, 1, 0, 163, 1.99976
opt-coef-rot, 133, 15, 13, 1, 0, 162, 1.99976
opt-coef-rot, 130, 15, 13, 1, 0, 159, 1.99976
opt-coef-rot, 132, 16, 13, 1, 0, 162, 1.99976
opt-coef-rot, 135, 15, 13, 1, 0, 164, 1.99976
opt-coef-rot, 141, 16, 13, 1, 0, 171, 1.99976
opt-coef-rot, 128, 15, 12, 1, 0, 156, 1.99976
opt-coef-rot, 128, 15, 12, 1, 0, 156, 1.99976
opt-coef-rot, 136, 16, 13, 1, 0, 166, 1.99976
opt-coef-rot, 131, 15, 13, 1, 0, 160, 1.99976
opt-coef-rot, 134, 15, 13, 1, 0, 163, 1.99976
opt-coef-rot, 131, 15, 12, 1, 0, 159, 1.99976
opt-coef-rot, 131, 16, 13, 1, 0, 161, 1.99976
opt-coef-rot, 139, 16, 13, 1, 0, 169, 1.99976
opt-coef-rot, 138, 20, 14, 1, 0, 173, 1.99976
opt-coef-rot, 131, 15, 13, 1, 0, 160, 1.99976
opt-coef-rot, 139, 15, 13, 1, 0, 168, 1.99976
opt-coef-rot, 137, 15, 13, 1, 0, 166, 1.99976
opt-coef-rot, 130, 16, 13, 1, 0, 160, 1.99976
opt-coef-rot, 138, 16, 13, 1, 0, 168, 1.99976
opt-coef-rot, 138, 15, 13, 1, 0, 167, 1.99976
opt-coef-rot, 137, 15, 13, 1, 0, 166, 1.99976
opt-coef-rot, 133, 18, 13, 1, 0, 165, 1.99976
opt-coef-rot, 127, 15, 12, 1, 0, 155, 1.99976
opt-coef-rot, 132, 16, 13, 1, 0, 162, 1.99976
opt-coef-rot, 132, 16, 13, 1, 0, 162, 1.99976
opt-coef-rot, 144, 15, 13, 1, 0, 173, 1.99976
opt-coef-rot, 132, 16, 13, 1, 0, 162, 1.99976
opt-coef-rot, 136, 15, 13, 1, 0, 165, 1.99976
opt-coef-rot, 132, 16, 13, 1, 0, 162, 1.99976
opt-coef-rot, 130, 15, 13, 1, 0, 159, 1.99976
opt-coef-rot, 131, 16, 13, 1, 0, 161, 1.99976
opt-coef-rot, 133, 16, 13, 1, 0, 163, 1.99976
opt-coef-rot, 129, 15, 13, 1, 0, 158, 1.99976
opt-coef-rot, 131, 15, 14, 1, 0, 161, 1.99976
opt-coef-rot, 140, 16, 13, 1, 0, 170, 1.99976
opt-coef-rot, 133, 17, 13, 1, 0, 164, 1.99976
opt-coef-rot, 130, 15, 38, 1, 0, 184, 1.99976
opt-coef-rot, 130, 15, 13, 1, 0, 159, 1.99976
opt-coef-rot, 129, 15, 13, 1, 0, 158, 1.99976
opt-coef-rot, 130, 16, 13, 1, 0, 160, 1.99976
opt-coef-rot, 133, 15, 13, 1, 0, 162, 1.99976
opt-coef-rot, 131, 15, 13, 1, 0, 160, 1.99976
opt-coef-rot, 141, 15, 13, 1, 0, 170, 1.99976
opt-coef-rot, 141, 16, 13, 1, 0, 171, 1.99976
opt-coef-rot, 132, 16, 13, 1, 0, 162, 1.99976
opt-coef-rot, 130, 16, 13, 1, 0, 160, 1.99976
opt-coef-rot, 130, 16, 12, 1, 0, 159, 1.99976
opt-coef-rot, 127, 15, 13, 1, 0, 156, 1.99976
opt-coef-rot, 133, 15, 13, 1, 0, 162, 1.99976
opt-coef-rot, 133, 15, 13, 1, 0, 162, 1.99976
opt-coef-rot, 131, 16, 13, 1, 0, 161, 1.99976
opt-coef-rot, 143, 16, 13, 1, 0, 173, 1.99976
opt-coef-rot, 134, 15, 13, 1, 0, 163, 1.99976
opt-coef-rot, 136, 16, 14, 1, 0, 167, 1.99976
opt-coef-rot, 130, 15, 13, 1, 0, 159, 1.99976
opt-coef-rot, 130, 15, 13, 1, 0, 159, 1.99976
opt-coef-rot, 129, 15, 13, 1, 0, 158, 1.99976
opt-coef-rot, 134, 16, 13, 1, 0, 164, 1.99976
opt-coef-rot, 129, 16, 13, 1, 0, 159, 1.99976
opt-coef-rot, 130, 15, 35, 1, 0, 181, 1.99976
opt-coef-rot, 136, 15, 13, 1, 0, 165, 1.99976
opt-coef-rot, 130, 16, 13, 1, 0, 160, 1.99976
opt-coef-rot, 131, 15, 13, 1, 0, 160, 1.99976
opt-coef-rot, 128, 15, 13, 1, 0, 157, 1.99976
opt-coef-rot, 134, 15, 13, 1, 0, 163, 1.99976
opt-coef-rot, 131, 16, 15, 1, 0, 163, 1.99976
opt-coef-rot, 132, 16, 13, 1, 0, 162, 1.99976
opt-coef-rot, 132, 15, 13, 1, 0, 161, 1.99976
opt-coef-rot, 133, 15, 14, 1, 0, 163, 1.99976
opt-coef-rot, 133, 16, 13, 1, 0, 163, 1.99976
opt-coef-rot, 132, 15, 13, 1, 0, 161, 1.99976
opt-coef-rot, 136, 16, 13, 1, 0, 166, 1.99976
opt-coef-rot, 132, 20, 13, 1, 0, 166, 1.99976
opt-coef-rot, 131, 15, 13, 1, 0, 160, 1.99976
opt-coef-rot, 128, 15, 13, 1, 0, 157, 1.99976
opt-coef-rot, 133, 15, 13, 1, 0, 162, 1.99976
opt-coef-rot, 129, 16, 13, 1, 0, 159, 1.99976
opt-coef-rot, 134, 16, 13, 1, 0, 164, 1.99976
opt-coef-rot, 146, 15, 13, 1, 0, 175, 1.99976
opt-coef-rot, 133, 15, 13, 1, 0, 162, 1.99976
opt-coef-rot, 134, 15, 14, 1, 0, 164, 1.99976
opt-coef-rot, 127, 15, 12, 1, 0, 155, 1.99976
opt-coef-rot, 131, 20, 13, 1, 0, 165, 1.99976
opt-coef-rot, 131, 16, 13, 1, 0, 161, 1.99976
opt-coef-rot, 131, 16, 14, 1, 0, 162, 1.99976
opt-coef-rot, 137, 15, 13, 1, 0, 166, 1.99976
opt-coef-rot, 131, 15, 13, 1, 0, 160, 1.99976
opt-coef-rot, 133, 15, 13, 1, 0, 162, 1.99976
opt-coef-rot, 132, 15, 13, 1, 0, 161, 1.99976
opt-coef-rot, 141, 16, 13, 1, 0, 171, 1.99976
opt-coef-rot, 132, 17, 13, 1, 0, 163, 1.99976
opt-coef-rot, 130, 16, 13, 1, 0, 160, 1.99976
opt-coef-rot, 135, 16, 13, 1, 0, 165, 1.99976
opt-coef-rot, 135, 17, 14, 1, 0, 167, 1.99976
opt-coef-rot, 239, 16, 13, 1, 0, 269, 1.99976
opt-coef-rot, 137, 16, 14, 1, 0, 168, 1.99976
opt-coef-rot, 130, 16, 13, 1, 0, 160, 1.99976
opt-coef-rot, 133, 16, 13, 1, 0, 163, 1.99976
opt-coef-rot, 131, 23, 13, 1, 0, 168, 1.99976
opt-coef-rot, 131, 16, 14, 1, 0, 162, 1.99976
opt-coef-rot, 134, 15, 13, 1, 0, 163, 1.99976
opt-coef-rot, 129, 15, 13, 1, 0, 158, 1.99976
opt-coef-rot, 132, 15, 13, 1, 0, 161, 1.99976
opt-coef-rot, 140, 16, 13, 1, 0, 170, 1.99976
opt-coef-rot, 128, 15, 13, 1, 0, 157, 1.99976
opt-coef-rot, 134, 16, 13, 1, 0, 164, 1.99976
opt-coef-rot, 131, 16, 13, 1, 0, 161, 1.99976
opt-coef-rot, 130, 16, 13, 1, 0, 160, 1.99976
opt-coef-rot, 134, 16, 13, 1, 0, 164, 1.99976
opt-coef-rot, 142, 15, 13, 1, 0, 171, 1.99976
opt-coef-rot, 131, 16, 14, 1, 0, 162, 1.99976
opt-coef-rot, 138, 15, 13, 1, 0, 167, 1.99976
opt-coef-rot, 130, 16, 13, 1, 0, 160, 1.99976
opt-coef-rot, 128, 15, 13, 1, 0, 157, 1.99976
opt-coef-rot, 133, 15, 13, 1, 0, 162, 1.99976
opt-coef-rot, 138, 15, 14, 1, 0, 168, 1.99976
opt-coef-rot, 153, 16, 13, 1, 0, 183, 1.99976
opt-coef-rot, 130, 15, 13, 1, 0, 159, 1.99976
opt-coef-rot, 135, 16, 14, 1, 0, 166, 1.99976
opt-coef-rot, 127, 15, 13, 1, 0, 156, 1.99976
opt-coef-rot, 128, 15, 13, 1, 0, 157, 1.99976
opt-coef-rot, 132, 15, 13, 1, 0, 161, 1.99976
opt-coef-rot, 129, 17, 13, 1, 0, 160, 1.99976
opt-coef-rot, 135, 16, 13, 1, 0, 165, 1.99976
opt-coef-rot, 131, 19, 13, 1, 0, 164, 1.99976
opt-coef-rot, 132, 15, 13, 1, 0, 161, 1.99976
opt-coef-rot, 131, 16, 13, 1, 0, 161, 1.99976
opt-coef-rot, 134, 15, 13, 1, 0, 163, 1.99976
opt-coef-rot, 147, 16, 14, 1, 0, 178, 1.99976
opt-coef-rot, 132, 15, 13, 1, 0, 161, 1.99976
opt-coef-rot, 134, 15, 13, 1, 0, 163, 1.99976
opt-coef-rot, 137, 16, 13, 1, 0, 167, 1.99976
opt-coef-rot, 129, 16, 14, 1, 0, 160, 1.99976
opt-coef-rot, 134, 16, 13, 1, 0, 164, 1.99976
opt-coef-rot, 131, 15, 13, 1, 0, 160, 1.99976
opt-coef-rot, 133, 16, 13, 1, 0, 163, 1.99976
opt-coef-rot, 137, 16, 14, 1, 0, 168, 1.99976
opt-coef-rot, 130, 16, 13, 1, 0, 160, 1.99976
opt-coef-rot, 136, 18, 13, 2, 0, 169, 1.99976
opt-coef-rot, 134, 16, 13, 1, 0, 164, 1.99976
opt-coef-rot, 131, 16, 14, 1, 0, 162, 1.99976
opt-coef-rot, 131, 15, 13, 1, 0, 160, 1.99976
opt-coef-rot, 142, 15, 13, 1, 0, 171, 1.99976
opt-coef-rot, 136, 16, 14, 1, 0, 167, 1.99976
opt-coef-rot, 139, 15, 14, 1, 0, 169, 1.99976
opt-coef-rot, 133, 15, 13, 1, 0, 162, 1.99976
opt-coef-rot, 135, 15, 13, 1, 0, 164, 1.99976
opt-coef-rot, 141, 24, 23, 1, 0, 189, 1.99976
opt-coef-rot, 133, 16, 13, 1, 0, 163, 1.99976
opt-coef-rot, 130, 16, 13, 1, 0, 160, 1.99976
opt-coef-rot, 131, 16, 13, 1, 0, 161, 1.99976
opt-coef-rot, 132, 16, 13, 1, 0, 162, 1.99976
opt-coef-rot, 131, 16, 14, 1, 0, 162, 1.99976
opt-coef-rot, 131, 15, 13, 1, 0, 160, 1.99976
opt-coef-rot, 135, 15, 13, 1, 0, 164, 1.99976
opt-coef-rot, 132, 15, 14, 1, 0, 162, 1.99976
opt-coef-rot, 141, 16, 13, 1, 0, 171, 1.99976
opt-coef-rot, 143, 16, 13, 1, 0, 173, 1.99976
opt-coef-rot, 130, 16, 14, 1, 0, 161, 1.99976
opt-coef-rot, 132, 15, 13, 1, 0, 161, 1.99976
opt-coef-rot, 132, 15, 13, 1, 0, 161, 1.99976
opt-coef-rot, 132, 16, 14, 1, 0, 163, 1.99976
opt-coef-rot, 135, 16, 14, 1, 0, 166, 1.99976
opt-coef-rot, 132, 15, 13, 1, 0, 161, 1.99976
opt-coef-rot, 133, 15, 13, 1, 0, 162, 1.99976
opt-coef-rot, 129, 16, 17, 1, 0, 163, 1.99976
opt-coef-rot, 137, 15, 13, 1, 0, 166, 1.99976
opt-coef-rot, 132, 15, 13, 1, 0, 161, 1.99976
opt-coef-rot, 131, 15, 13, 1, 0, 160, 1.99976
opt-coef-rot, 129, 15, 13, 1, 0, 158, 1.99976
opt-coef-rot, 138, 16, 13, 1, 0, 168, 1.99976
opt-coef-rot, 132, 15, 13, 1, 0, 161, 1.99976
opt-coef-rot, 138, 15, 13, 1, 0, 167, 1.99976
opt-coef-rot, 136, 17, 13, 1, 0, 167, 1.99976
opt-coef-rot, 135, 15, 13, 1, 0, 164, 1.99976
opt-coef-rot, 129, 15, 13, 1, 0, 158, 1.99976
opt-coef-rot, 130, 15, 14, 1, 0, 160, 1.99976
opt-coef-rot, 130, 15, 14, 1, 0, 160, 1.99976
opt-coef-rot, 134, 15, 13, 1, 0, 163, 1.99976
opt-coef-rot, 131, 16, 13, 1, 0, 161, 1.99976
opt-coef-rot, 132, 15, 13, 1, 0, 161, 1.99976
opt-coef-rot, 130, 15, 13, 1, 0, 159, 1.99976
opt-coef-rot, 153, 16, 13, 1, 0, 183, 1.99976
opt-coef-rot, 132, 15, 13, 1, 0, 161, 1.99976
opt-coef-rot, 136, 15, 13, 1, 0, 165, 1.99976
opt-coef-rot, 133, 15, 13, 1, 0, 162, 1.99976
opt-coef-rot, 139, 16, 13, 1, 0, 169, 1.99976
opt-coef-rot, 133, 16, 13, 1, 0, 163, 1.99976
opt-coef-rot, 136, 16, 14, 1, 0, 167, 1.99976
opt-coef-rot, 134, 15, 13, 1, 0, 163, 1.99976
opt-coef-rot, 149, 20, 13, 1, 0, 183, 1.99976
opt-coef-rot, 131, 15, 13, 1, 0, 160, 1.99976
opt-coef-rot, 138, 15, 13, 1, 0, 167, 1.99976
opt-coef-rot, 138, 16, 13, 1, 0, 168, 1.99976
opt-coef-rot, 136, 15, 13, 1, 0, 165, 1.99976
opt-coef-rot, 134, 16, 13, 1, 0, 164, 1.99976
opt-coef-rot, 132, 15, 13, 1, 0, 161, 1.99976
opt-coef-rot, 133, 15, 14, 1, 0, 163, 1.99976
opt-coef-rot, 127, 15, 13, 1, 0, 156, 1.99976
opt-coef-rot, 129, 15, 13, 1, 0, 158, 1.99976
opt-coef-rot, 133, 16, 13, 1, 0, 163, 1.99976
opt-coef-rot, 141, 15, 13, 1, 0, 170, 1.99976
opt-coef-rot, 130, 15, 13, 1, 0, 159, 1.99976
opt-coef-rot, 131, 15, 13, 1, 0, 160, 1.99976
opt-coef-rot, 130, 15, 13, 1, 0, 159, 1.99976
opt-coef-rot, 132, 16, 13, 1, 0, 162, 1.99976
opt-coef-rot, 128, 16, 13, 1, 0, 158, 1.99976
opt-coef-rot, 139, 15, 13, 1, 0, 168, 1.99976
opt-coef-rot, 129, 16, 13, 1, 0, 159, 1.99976
opt-coef-rot, 129, 16, 14, 1, 0, 160, 1.99976
opt-coef-rot, 135, 16, 14, 1, 0, 166, 1.99976
opt-coef-rot, 128, 15, 12, 1, 0, 156, 1.99976
opt-coef-rot, 136, 15, 13, 1, 0, 165, 1.99976
opt-coef-rot, 135, 16, 13, 1, 0, 165, 1.99976
opt-coef-rot, 134, 15, 13, 1, 0, 163, 1.99976
opt-coef-rot, 130, 16, 13, 1, 0, 160, 1.99976
opt-coef-rot, 131, 16, 13, 1, 0, 161, 1.99976
opt-coef-rot, 131, 15, 13, 1, 0, 160, 1.99976
opt-coef-rot, 132, 15, 12, 1, 0, 160, 1.99976
opt-coef-rot, 132, 16, 13, 1, 0, 162, 1.99976
opt-coef-rot, 132, 19, 13, 1, 0, 165, 1.99976
opt-coef-rot, 131, 15, 13, 1, 0, 160, 1.99976
opt-coef-rot, 129, 15, 13, 1, 0, 158, 1.99976
opt-coef-rot, 138, 16, 13, 1, 0, 168, 1.99976
opt-coef-rot, 141, 16, 13, 1, 0, 171, 1.99976
opt-coef-rot, 137, 16, 13, 1, 0, 167, 1.99976
opt-coef-rot, 130, 15, 13, 1, 0, 159, 1.99976
opt-coef-rot, 133, 15, 13, 1, 0, 162, 1.99976
opt-coef-rot, 133, 15, 13, 1, 0, 162, 1.99976
opt-coef-rot, 134, 16, 13, 1, 0, 164, 1.99976
opt-coef-rot, 128, 15, 13, 1, 0, 157, 1.99976
opt-coef-rot, 135, 15, 13, 1, 0, 164, 1.99976
opt-coef-rot, 134, 15, 13, 1, 0, 163, 1.99976
opt-coef-rot, 131, 15, 13, 1, 0, 160, 1.99976
opt-coef-rot, 135, 15, 13, 1, 0, 164, 1.99976
opt-coef-rot, 136, 15, 13, 1, 0, 165, 1.99976
opt-coef-rot, 131, 16, 13, 1, 0, 161, 1.99976
opt-coef-rot, 126, 15, 12, 1, 0, 154, 1.99976
opt-coef-rot, 132, 15, 13, 1, 0, 161, 1.99976
opt-coef-rot, 143, 16, 13, 1, 0, 173, 1.99976
opt-coef-rot, 132, 16, 12, 1, 0, 161, 1.99976
opt-coef-rot, 131, 15, 13, 1, 0, 160, 1.99976
opt-coef-rot, 131, 16, 13, 1, 0, 161, 1.99976
opt-coef-rot, 127, 15, 13, 1, 0, 156, 1.99976
opt-coef-rot, 138, 16, 13, 1, 0, 168, 1.99976
opt-coef-rot, 134, 15, 13, 1, 0, 163, 1.99976
opt-coef-rot, 129, 15, 13, 1, 0, 158, 1.99976
opt-coef-rot, 131, 15, 13, 1, 0, 160, 1.99976
opt-coef-rot, 131, 19, 14, 1, 0, 165, 1.99976
opt-coef-rot, 129, 15, 13, 1, 0, 158, 1.99976
opt-coef-rot, 136, 15, 14, 1, 0, 166, 1.99976
opt-coef-rot, 135, 15, 13, 1, 0, 164, 1.99976
opt-coef-rot, 135, 15, 14, 1, 0, 165, 1.99976
opt-coef-rot, 136, 16, 15, 1, 0, 168, 1.99976
opt-coef-rot, 141, 16, 14, 1, 0, 172, 1.99976
opt-coef-rot, 140, 15, 13, 1, 0, 169, 1.99976
opt-coef-rot, 129, 17, 14, 1, 0, 161, 1.99976
opt-coef-rot, 135, 16, 13, 1, 0, 165, 1.99976
opt-coef-rot, 134, 16, 13, 1, 0, 164, 1.99976
opt-coef-rot, 135, 16, 13, 1, 0, 165, 1.99976
opt-coef-rot, 135, 16, 14, 1, 0, 166, 1.99976
opt-coef-rot, 140, 15, 13, 1, 0, 169, 1.99976
opt-coef-rot, 146, 15, 14, 1, 0, 176, 1.99976
opt-coef-rot, 138, 16, 14, 1, 0, 169, 1.99976
opt-coef-rot, 138, 16, 14, 1, 0, 169, 1.99976
opt-coef-rot, 133, 16, 14, 1, 0, 164, 1.99976
opt-coef-rot, 140, 16, 13, 1, 0, 170, 1.99976
opt-coef-rot, 131, 17, 13, 1, 0, 162, 1.99976
opt-coef-rot, 135, 16, 13, 1, 0, 165, 1.99976
opt-coef-rot, 138, 16, 13, 1, 0, 168, 1.99976
opt-coef-rot, 138, 15, 13, 1, 0, 167, 1.99976
opt-coef-rot, 130, 16, 14, 1, 0, 161, 1.99976
opt-coef-rot, 134, 16, 13, 1, 0, 164, 1.99976
opt-coef-rot, 135, 16, 13, 1, 0, 165, 1.99976
opt-coef-rot, 139, 16, 13, 1, 0, 169, 1.99976
opt-coef-rot, 131, 15, 13, 1, 0, 160, 1.99976
opt-coef-rot, 132, 15, 13, 1, 0, 161, 1.99976
opt-coef-rot, 136, 17, 14, 1, 0, 168, 1.99976
opt-coef-rot, 136, 15, 13, 1, 0, 165, 1.99976
opt-coef-rot, 139, 16, 13, 1, 0, 169, 1.99976
opt-coef-rot, 132, 15, 13, 1, 0, 161, 1.99976
opt-coef-rot, 133, 15, 13, 1, 0, 162, 1.99976
opt-coef-rot, 135, 15, 13, 1, 0, 164, 1.99976
opt-coef-rot, 128, 15, 13, 1, 0, 157, 1.99976
opt-coef-rot, 136, 16, 14, 1, 0, 167, 1.99976
opt-coef-rot, 141, 19, 13, 1, 0, 174, 1.99976
opt-coef-rot, 135, 17, 14, 1, 0, 167, 1.99976
opt-coef-rot, 137, 15, 13, 1, 0, 166, 1.99976
opt-coef-rot, 128, 16, 13, 1, 0, 158, 1.99976
opt-coef-rot, 133, 16, 13, 1, 0, 163, 1.99976
opt-coef-rot, 130, 16, 13, 1, 0, 160, 1.99976
opt-coef-rot, 132, 16, 13, 1, 0, 162, 1.99976
opt-coef-rot, 130, 15, 13, 1, 0, 159, 1.99976
opt-coef-rot, 134, 15, 13, 1, 0, 163, 1.99976
opt-coef-rot, 127, 15, 13, 1, 0, 156, 1.99976
opt-coef-rot, 132, 15, 13, 1, 0, 161, 1.99976
opt-coef-rot, 141, 18, 15, 1, 0, 175, 1.99976
opt-coef-rot, 130, 15, 13, 1, 0, 159, 1.99976
opt-coef-rot, 128, 15, 12, 1, 0, 156, 1.99976
opt-coef-rot, 131, 15, 13, 1, 0, 160, 1.99976
opt-coef-rot, 128, 15, 13, 1, 0, 157, 1.99976
opt-coef-rot, 127, 15, 13, 1, 0, 156, 1.99976
opt-coef-rot, 129, 16, 13, 1, 0, 159, 1.99976
opt-coef-rot, 130, 16, 13, 1, 0, 160, 1.99976
opt-coef-rot, 129, 15, 13, 1, 0, 158, 1.99976
opt-coef-rot, 133, 16, 13, 1, 0, 163, 1.99976
opt-coef-rot, 132, 15, 13, 1, 0, 161, 1.99976
opt-coef-rot, 132, 15, 13, 1, 0, 161, 1.99976
opt-coef-rot, 141, 15, 13, 1, 0, 170, 1.99976
opt-coef-rot, 131, 15, 13, 1, 0, 160, 1.99976
opt-coef-rot, 131, 15, 14, 1, 0, 161, 1.99976
opt-coef-rot, 132, 16, 13, 1, 0, 162, 1.99976
opt-coef-rot, 134, 15, 13, 1, 0, 163, 1.99976
opt-coef-rot, 129, 15, 13, 1, 0, 158, 1.99976
opt-coef-rot, 132, 15, 13, 1, 0, 161, 1.99976
opt-coef-rot, 129, 16, 13, 1, 0, 159, 1.99976
opt-coef-rot, 132, 19, 13, 1, 0, 165, 1.99976
opt-coef-rot, 130, 16, 13, 1, 0, 160, 1.99976
opt-coef-rot, 130, 15, 13, 1, 0, 159, 1.99976
opt-coef-rot, 133, 16, 13, 1, 0, 163, 1.99976
opt-coef-rot, 134, 15, 13, 1, 0, 163, 1.99976
opt-coef-rot, 128, 15, 13, 1, 0, 157, 1.99976
opt-coef-rot, 133, 16, 14, 1, 0, 164, 1.99976
opt-coef-rot, 134, 16, 13, 1, 0, 164, 1.99976
opt-coef-rot, 138, 15, 13, 1, 0, 167, 1.99976
opt-coef-rot, 133, 15, 13, 1, 0, 162, 1.99976
opt-coef-rot, 131, 18, 13, 1, 0, 163, 1.99976
opt-coef-rot, 130, 16, 13, 1, 0, 160, 1.99976
opt-coef-rot, 137, 16, 13, 1, 0, 167, 1.99976
opt-coef-rot, 135, 16, 13, 1, 0, 165, 1.99976
opt-coef-rot, 133, 16, 13, 1, 0, 163, 1.99976
opt-coef-rot, 131, 15, 13, 1, 0, 160, 1.99976
opt-coef-rot, 134, 15, 13, 1, 0, 163, 1.99976
opt-coef-rot, 130, 15, 13, 1, 0, 159, 1.99976
opt-coef-rot, 132, 15, 13, 1, 0, 161, 1.99976
opt-coef-rot, 134, 15, 13, 1, 0, 163, 1.99976
opt-coef-rot, 135, 15, 14, 1, 0, 165, 1.99976
opt-coef-rot, 129, 15, 13, 1, 0, 158, 1.99976
opt-coef-rot, 129, 16, 13, 1, 0, 159, 1.99976
opt-coef-rot, 133, 18, 13, 1, 0, 165, 1.99976
opt-coef-rot, 130, 15, 13, 1, 0, 159, 1.99976
opt-coef-rot, 133, 15, 12, 1, 0, 161, 1.99976
opt-coef-rot, 130, 15, 14, 1, 0, 160, 1.99976
opt-coef-rot, 144, 15, 13, 1, 0, 173, 1.99976
opt-coef-rot, 134, 16, 13, 1, 0, 164, 1.99976
opt-coef-rot, 133, 16, 14, 1, 0, 164, 1.99976
opt-coef-rot, 133, 15, 13, 1, 0, 162, 1.99976
opt-coef-rot, 132, 16, 13, 1, 0, 162, 1.99976
opt-coef-rot, 132, 16, 14, 1, 0, 163, 1.99976
opt-coef-rot, 134, 16, 14, 1, 0, 165, 1.99976
opt-coef-rot, 136, 16, 13, 1, 0, 166, 1.99976
opt-coef-rot, 146, 16, 13, 1, 0, 176, 1.99976
opt-coef-rot, 136, 15, 13, 1, 0, 165, 1.99976
opt-coef-rot, 134, 16, 13, 1, 0, 164, 1.99976
opt-coef-rot, 151, 15, 14, 1, 0, 181, 1.99976
opt-coef-rot, 135, 15, 13, 1, 0, 164, 1.99976
opt-coef-rot, 131, 16, 13, 1, 0, 161, 1.99976
opt-coef-rot, 134, 16, 13, 1, 0, 164, 1.99976
opt-coef-rot, 129, 15, 13, 1, 0, 158, 1.99976
opt-coef-rot, 131, 16, 13, 1, 0, 161, 1.99976
opt-coef-rot, 132, 16, 13, 1, 0, 162, 1.99976
opt-coef-rot, 137, 15, 12, 1, 0, 165, 1.99976
opt-coef-rot, 131, 15, 13, 1, 0, 160, 1.99976
opt-coef-rot, 131, 15, 13, 1, 0, 160, 1.99976
opt-coef-rot, 134, 15, 13, 1, 0, 163, 1.99976
opt-coef-rot, 136, 16, 13, 1, 0, 166, 1.99976
opt-coef-rot, 133, 16, 13, 1, 0, 163, 1.99976
opt-coef-rot, 133, 16, 13, 1, 0, 163, 1.99976
opt-coef-rot, 130, 16, 13, 1, 0, 160, 1.99976
opt-coef-rot, 128, 15, 13, 1, 0, 157, 1.99976
opt-coef-rot, 131, 16, 13, 1, 0, 161, 1.99976
opt-coef-rot, 132, 16, 13, 1, 0, 162, 1.99976
opt-coef-rot, 129, 15, 13, 1, 0, 158, 1.99976
opt-coef-rot, 132, 15, 13, 1, 0, 161, 1.99976
opt-coef-rot, 133, 15, 13, 1, 0, 162, 1.99976
opt-coef-rot, 134, 15, 13, 1, 0, 163, 1.99976
opt-coef-rot, 131, 15, 13, 1, 0, 160, 1.99976
opt-coef-rot, 130, 28, 13, 1, 0, 172, 1.99976
opt-coef-rot, 135, 15, 13, 1, 0, 164, 1.99976
opt-coef-rot, 130, 15, 12, 1, 0, 158, 1.99976
opt-coef-rot, 134, 16, 14, 1, 0, 165, 1.99976
opt-coef-rot, 130, 15, 13, 1, 0, 159, 1.99976
opt-coef-rot, 131, 16, 13, 1, 0, 161, 1.99976
opt-coef-rot, 138, 16, 13, 1, 0, 168, 1.99976
opt-coef-rot, 137, 16, 13, 1, 0, 167, 1.99976
opt-coef-rot, 138, 15, 13, 1, 0, 167, 1.99976
opt-coef-rot, 135, 15, 13, 1, 0, 164, 1.99976
opt-coef-rot, 128, 18, 13, 1, 0, 160, 1.99976
opt-coef-rot, 131, 16, 14, 1, 0, 162, 1.99976
opt-coef-rot, 135, 16, 13, 1, 0, 165, 1.99976
opt-coef-rot, 135, 15, 13, 1, 0, 164, 1.99976
opt-coef-rot, 131, 15, 13, 1, 0, 160, 1.99976
opt-coef-rot, 135, 15, 13, 1, 0, 164, 1.99976
opt-coef-rot, 134, 15, 13, 1, 0, 163, 1.99976
opt-coef-rot, 131, 16, 13, 1, 0, 161, 1.99976
opt-coef-rot, 129, 15, 13, 1, 0, 158, 1.99976
opt-coef-rot, 133, 16, 13, 1, 0, 163, 1.99976
opt-coef-rot, 132, 15, 13, 1, 0, 161, 1.99976
opt-coef-rot, 130, 15, 13, 1, 0, 159, 1.99976
opt-coef-rot, 135, 15, 14, 1, 0, 165, 1.99976
opt-coef-rot, 137, 23, 13, 1, 0, 174, 1.99976
opt-coef-rot, 129, 15, 13, 1, 0, 158, 1.99976
opt-coef-rot, 131, 15, 14, 1, 0, 161, 1.99976
opt-coef-rot, 132, 16, 13, 1, 0, 162, 1.99976
opt-coef-rot, 134, 15, 13, 1, 0, 163, 1.99976
opt-coef-rot, 129, 16, 13, 1, 0, 159, 1.99976
opt-coef-rot, 131, 16, 13, 1, 0, 161, 1.99976
opt-coef-rot, 132, 15, 14, 1, 0, 162, 1.99976
opt-coef-rot, 130, 15, 13, 1, 0, 159, 1.99976
opt-coef-rot, 132, 15, 13, 1, 0, 161, 1.99976
opt-coef-rot, 128, 15, 13, 1, 0, 157, 1.99976
opt-coef-rot, 132, 16, 13, 1, 0, 162, 1.99976
opt-coef-rot, 132, 15, 13, 1, 0, 161, 1.99976
opt-coef-rot, 132, 15, 14, 2, 0, 163, 1.99976
opt-coef-rot, 129, 15, 13, 1, 0, 158, 1.99976
opt-coef-rot, 132, 15, 13, 1, 0, 161, 1.99976
opt-coef-rot, 133, 15, 14, 1, 0, 163, 1.99976
opt-coef-rot, 133, 17, 13, 1, 0, 164, 1.99976
opt-coef-rot, 134, 15, 13, 1, 0, 163, 1.99976
opt-coef-rot, 134, 15, 14, 1, 0, 164, 1.99976
opt-coef-rot, 131, 15, 13, 1, 0, 160, 1.99976
opt-coef-rot, 131, 16, 13, 1, 0, 161, 1.99976
opt-coef-rot, 130, 15, 12, 1, 0, 158, 1.99976
opt-coef-rot, 135, 17, 12, 1, 0, 165, 1.99976
opt-coef-rot, 132, 16, 13, 1, 0, 162, 1.99976
opt-coef-rot, 131, 15, 14, 1, 0, 161, 1.99976
opt-coef-rot, 133, 15, 13, 1, 0, 162, 1.99976
opt-coef-rot, 129, 15, 13, 1, 0, 158, 1.99976
opt-coef-rot, 133, 16, 13, 1, 0, 163, 1.99976
opt-coef-rot, 141, 15, 13, 1, 0, 170, 1.99976
opt-coef-rot, 131, 16, 13, 1, 0, 161, 1.99976
opt-coef-rot, 138, 17, 13, 1, 0, 169, 1.99976
opt-coef-rot, 130, 15, 13, 1, 0, 159, 1.99976
opt-coef-rot, 130, 16, 14, 1, 0, 161, 1.99976
opt-coef-rot, 135, 16, 13, 1, 0, 165, 1.99976
opt-coef-rot, 141, 16, 13, 1, 0, 171, 1.99976
opt-coef-rot, 133, 15, 13, 1, 0, 162, 1.99976
opt-coef-rot, 135, 16, 14, 1, 0, 166, 1.99976
opt-coef-rot, 132, 15, 14, 1, 0, 162, 1.99976
opt-coef-rot, 130, 15, 13, 1, 0, 159, 1.99976
opt-coef-rot, 130, 16, 13, 1, 0, 160, 1.99976
opt-coef-rot, 140, 16, 13, 1, 0, 170, 1.99976
opt-coef-rot, 131, 15, 13, 1, 0, 160, 1.99976
opt-coef-rot, 129, 15, 12, 1, 0, 157, 1.99976
opt-coef-rot, 134, 15, 13, 1, 0, 163, 1.99976
opt-coef-rot, 133, 16, 13, 1, 0, 163, 1.99976
opt-coef-rot, 140, 15, 13, 1, 0, 169, 1.99976
opt-coef-rot, 137, 16, 13, 1, 0, 167, 1.99976
opt-coef-rot, 132, 16, 13, 1, 0, 162, 1.99976
opt-coef-rot, 133, 15, 13, 1, 0, 162, 1.99976
opt-coef-rot, 131, 15, 13, 1, 0, 160, 1.99976
opt-coef-rot, 130, 16, 13, 1, 0, 160, 1.99976
opt-coef-rot, 129, 15, 13, 1, 0, 158, 1.99976
opt-coef-rot, 132, 15, 13, 1, 0, 161, 1.99976
opt-coef-rot, 134, 15, 13, 1, 0, 163, 1.99976
opt-coef-rot, 141, 15, 13, 1, 0, 170, 1.99976
opt-coef-rot, 134, 16, 13, 1, 0, 164, 1.99976
opt-coef-rot, 131, 16, 13, 1, 0, 161, 1.99976
opt-coef-rot, 148, 15, 13, 1, 0, 177, 1.99976
opt-coef-rot, 135, 15, 13, 1, 0, 164, 1.99976
opt-coef-rot, 134, 17, 13, 1, 0, 165, 1.99976
opt-coef-rot, 130, 16, 13, 1, 0, 160, 1.99976
opt-coef-rot, 130, 16, 13, 1, 0, 160, 1.99976
opt-coef-rot, 134, 16, 14, 1, 0, 165, 1.99976
opt-coef-rot, 131, 15, 13, 1, 0, 160, 1.99976
opt-coef-rot, 135, 15, 13, 1, 0, 164, 1.99976
opt-coef-rot, 133, 15, 13, 1, 0, 162, 1.99976
opt-coef-rot, 138, 16, 14, 1, 0, 169, 1.99976
opt-coef-rot, 133, 15, 13, 1, 0, 162, 1.99976
opt-coef-rot, 139, 16, 13, 1, 0, 169, 1.99976
opt-coef-rot, 136, 15, 13, 1, 0, 165, 1.99976
opt-coef-rot, 131, 16, 13, 1, 0, 161, 1.99976
opt-coef-rot, 138, 15, 13, 1, 0, 167, 1.99976
opt-coef-rot, 136, 15, 12, 1, 0, 164, 1.99976
opt-coef-rot, 136, 15, 14, 1, 0, 166, 1.99976
opt-coef-rot, 134, 15, 13, 1, 0, 163, 1.99976
opt-coef-rot, 133, 15, 14, 1, 0, 163, 1.99976
opt-coef-rot, 141, 21, 13, 1, 0, 176, 1.99976
opt-coef-rot, 138, 15, 13, 1, 0, 167, 1.99976
opt-coef-rot, 145, 16, 14, 1, 0, 176, 1.99976
opt-coef-rot, 131, 15, 13, 1, 0, 160, 1.99976
opt-coef-rot, 132, 16, 13, 1, 0, 162, 1.99976
opt-coef-rot, 134, 15, 13, 1, 0, 163, 1.99976
opt-coef-rot, 135, 18, 13, 1, 0, 167, 1.99976
opt-coef-rot, 133, 16, 13, 1, 0, 163, 1.99976
opt-coef-rot, 129, 15, 13, 1, 0, 158, 1.99976
opt-coef-rot, 131, 16, 13, 1, 0, 161, 1.99976
opt-coef-rot, 137, 18, 13, 1, 0, 169, 1.99976
opt-coef-rot, 132, 15, 13, 1, 0, 161, 1.99976
opt-coef-rot, 150, 16, 13, 1, 0, 180, 1.99976
opt-coef-rot, 134, 16, 13, 1, 0, 164, 1.99976
opt-coef-rot, 136, 15, 13, 1, 0, 165, 1.99976
opt-coef-rot, 131, 15, 13, 1, 0, 160, 1.99976
opt-coef-rot, 130, 17, 13, 1, 0, 161, 1.99976
opt-coef-rot, 138, 16, 13, 1, 0, 168, 1.99976
opt-coef-rot, 133, 16, 14, 1, 0, 164, 1.99976
opt-coef-rot, 136, 15, 13, 1, 0, 165, 1.99976
opt-coef-rot, 138, 16, 13, 1, 0, 168, 1.99976
opt-coef-rot, 131, 15, 13, 1, 0, 160, 1.99976
opt-coef-rot, 130, 16, 13, 1, 0, 160, 1.99976
opt-coef-rot, 132, 15, 13, 1, 0, 161, 1.99976
opt-coef-rot, 132, 15, 13, 1, 0, 161, 1.99976
opt-coef-rot, 131, 16, 13, 1, 0, 161, 1.99976
opt-coef-rot, 141, 15, 13, 1, 0, 170, 1.99976
opt-coef-rot, 130, 16, 13, 1, 0, 160, 1.99976
opt-coef-rot, 139, 15, 13, 1, 0, 168, 1.99976
opt-coef-rot, 135, 19, 13, 1, 0, 168, 1.99976
opt-coef-rot, 136, 15, 13, 1, 0, 165, 1.99976
opt-coef-rot, 131, 15, 13, 1, 0, 160, 1.99976
opt-coef-rot, 129, 15, 13, 1, 0, 158, 1.99976
opt-coef-rot, 131, 15, 13, 1, 0, 160, 1.99976
opt-coef-rot, 135, 16, 13, 1, 0, 165, 1.99976
opt-coef-rot, 134, 15, 13, 1, 0, 163, 1.99976
opt-coef-rot, 134, 16, 12, 1, 0, 163, 1.99976
opt-coef-rot, 132, 16, 13, 1, 0, 162, 1.99976
opt-coef-rot, 132, 16, 13, 1, 0, 162, 1.99976
opt-coef-rot, 136, 16, 13, 1, 0, 166, 1.99976
opt-coef-rot, 131, 15, 13, 1, 0, 160, 1.99976
opt-coef-rot, 127, 15, 12, 1, 0, 155, 1.99976
opt-coef-rot, 137, 16, 13, 1, 0, 167, 1.99976
opt-coef-rot, 134, 15, 13, 1, 0, 163, 1.99976
opt-coef-rot, 136, 16, 13, 1, 0, 166, 1.99976
opt-coef-rot, 128, 19, 13, 1, 0, 161, 1.99976
opt-coef-rot, 139, 15, 15, 1, 0, 170, 1.99976
opt-coef-rot, 137, 15, 13, 1, 0, 166, 1.99976
opt-coef-rot, 131, 15, 13, 1, 0, 160, 1.99976
opt-coef-rot, 141, 16, 13, 1, 0, 171, 1.99976
opt-coef-rot, 136, 16, 14, 1, 0, 167, 1.99976
opt-coef-rot, 137, 16, 13, 1, 0, 167, 1.99976
opt-coef-rot, 130, 16, 13, 1, 0, 160, 1.99976
opt-coef-rot, 136, 16, 13, 1, 0, 166, 1.99976
opt-coef-rot, 139, 16, 13, 1, 0, 169, 1.99976
opt-coef-rot, 133, 16, 14, 1, 0, 164, 1.99976
opt-coef-rot, 132, 15, 13, 1, 0, 161, 1.99976
opt-coef-rot, 129, 16, 13, 1, 0, 159, 1.99976
opt-coef-rot, 132, 15, 13, 1, 0, 161, 1.99976
opt-coef-rot, 131, 16, 14, 1, 0, 162, 1.99976
opt-coef-rot, 137, 16, 13, 1, 0, 167, 1.99976
opt-coef-rot, 136, 15, 14, 1, 0, 166, 1.99976
opt-coef-rot, 134, 16, 13, 1, 0, 164, 1.99976
opt-coef-rot, 135, 16, 13, 1, 0, 165, 1.99976
opt-coef-rot, 134, 15, 13, 1, 0, 163, 1.99976
opt-coef-rot, 132, 15, 13, 1, 0, 161, 1.99976
opt-coef-rot, 129, 15, 13, 1, 0, 158, 1.99976
opt-coef-rot, 132, 15, 13, 1, 0, 161, 1.99976
opt-coef-rot, 128, 15, 13, 1, 0, 157, 1.99976
opt-coef-rot, 146, 16, 14, 1, 0, 177, 1.99976
opt-coef-rot, 135, 15, 13, 1, 0, 164, 1.99976
opt-coef-rot, 130, 15, 13, 1, 0, 159, 1.99976
opt-coef-rot, 129, 15, 13, 1, 0, 158, 1.99976
opt-coef-rot, 131, 16, 14, 1, 0, 162, 1.99976
opt-coef-rot, 136, 16, 13, 1, 0, 166, 1.99976
opt-coef-rot, 132, 15, 13, 1, 0, 161, 1.99976
opt-coef-rot, 137, 15, 13, 1, 0, 166, 1.99976
opt-coef-rot, 131, 15, 13, 1, 0, 160, 1.99976
opt-coef-rot, 130, 16, 13, 1, 0, 160, 1.99976
opt-coef-rot, 131, 16, 13, 1, 0, 161, 1.99976
opt-coef-rot, 133, 15, 18, 1, 0, 167, 1.99976
opt-coef-rot, 134, 16, 13, 1, 0, 164, 1.99976
opt-coef-rot, 129, 15, 13, 1, 0, 158, 1.99976
opt-coef-rot, 133, 16, 13, 1, 0, 163, 1.99976
opt-coef-rot, 136, 16, 13, 1, 0, 166, 1.99976
opt-coef-rot, 133, 15, 13, 1, 0, 162, 1.99976
opt-coef-rot, 134, 16, 13, 1, 0, 164, 1.99976
opt-coef-rot, 130, 15, 13, 1, 0, 159, 1.99976
opt-coef-rot, 141, 16, 13, 1, 0, 171, 1.99976
opt-coef-rot, 133, 15, 13, 1, 0, 162, 1.99976
opt-coef-rot, 132, 15, 13, 1, 0, 161, 1.99976
opt-coef-rot, 133, 16, 13, 1, 0, 163, 1.99976
opt-coef-rot, 128, 15, 13, 1, 0, 157, 1.99976
opt-coef-rot, 135, 16, 13, 1, 0, 165, 1.99976
opt-coef-rot, 132, 15, 14, 1, 0, 162, 1.99976
opt-coef-rot, 130, 15, 13, 1, 0, 159, 1.99976
opt-coef-rot, 131, 16, 13, 1, 0, 161, 1.99976
opt-coef-rot, 130, 15, 14, 1, 0, 160, 1.99976
opt-coef-rot, 129, 15, 13, 1, 0, 158, 1.99976
opt-coef-rot, 133, 15, 13, 1, 0, 162, 1.99976
opt-coef-rot, 137, 16, 13, 1, 0, 167, 1.99976
opt-coef-rot, 128, 18, 13, 1, 0, 160, 1.99976
opt-coef-rot, 133, 16, 13, 1, 0, 163, 1.99976
opt-coef-rot, 130, 36, 14, 1, 0, 181, 1.99976
opt-coef-rot, 132, 15, 13, 1, 0, 161, 1.99976
opt-coef-rot, 135, 15, 13, 1, 0, 164, 1.99976
opt-coef-rot, 130, 15, 13, 1, 0, 159, 1.99976
opt-coef-rot, 131, 16, 13, 1, 0, 161, 1.99976
opt-coef-rot, 133, 19, 13, 1, 0, 166, 1.99976
opt-coef-rot, 131, 15, 13, 1, 0, 160, 1.99976
opt-coef-rot, 132, 16, 14, 1, 0, 163, 1.99976
opt-coef-rot, 130, 15, 13, 1, 0, 159, 1.99976
opt-coef-rot, 135, 16, 13, 1, 0, 165, 1.99976
opt-coef-rot, 142, 15, 14, 1, 0, 172, 1.99976
opt-coef-rot, 130, 15, 13, 1, 0, 159, 1.99976
opt-coef-rot, 138, 15, 13, 1, 0, 167, 1.99976
opt-coef-rot, 129, 15, 13, 1, 0, 158, 1.99976
opt-coef-rot, 129, 15, 13, 1, 0, 158, 1.99976
opt-coef-rot, 129, 15, 13, 1, 0, 158, 1.99976
opt-coef-rot, 135, 16, 13, 1, 0, 165, 1.99976
opt-coef-rot, 131, 15, 13, 1, 0, 160, 1.99976
opt-coef-rot, 130, 15, 12, 1, 0, 158, 1.99976
opt-coef-rot, 128, 15, 13, 1, 0, 157, 1.99976
opt-coef-rot, 131, 16, 12, 1, 0, 160, 1.99976
opt-coef-rot, 131, 16, 13, 1, 0, 161, 1.99976
opt-coef-rot, 133, 15, 13, 1, 0, 162, 1.99976
opt-coef-rot, 131, 32, 17, 1, 0, 181, 1.99976
opt-coef-rot, 132, 16, 13, 1, 0, 162, 1.99976
opt-coef-rot, 130, 16, 13, 1, 0, 160, 1.99976
opt-coef-rot, 134, 16, 13, 1, 0, 164, 1.99976
opt-coef-rot, 133, 16, 13, 1, 0, 163, 1.99976
opt-coef-rot, 135, 16, 15, 1, 0, 167, 1.99976
opt-coef-rot, 133, 16, 14, 1, 0, 164, 1.99976
opt-coef-rot, 139, 16, 13, 1, 0, 169, 1.99976
opt-coef-rot, 137, 17, 14, 1, 0, 169, 1.99976
opt-coef-rot, 132, 16, 13, 1, 0, 162, 1.99976
opt-coef-rot, 140, 16, 13, 1, 0, 170, 1.99976
opt-coef-rot, 128, 16, 13, 1, 0, 158, 1.99976
opt-coef-rot, 134, 15, 13, 1, 0, 163, 1.99976
opt-coef-rot, 138, 15, 14, 1, 0, 168, 1.99976
opt-coef-rot, 130, 15, 14, 1, 0, 160, 1.99976
opt-coef-rot, 130, 15, 13, 1, 0, 159, 1.99976
opt-coef-rot, 132, 15, 13, 1, 0, 161, 1.99976
opt-coef-rot, 139, 16, 13, 1, 0, 169, 1.99976
opt-coef-rot, 133, 15, 13, 1, 0, 162, 1.99976
opt-coef-rot, 136, 15, 13, 1, 0, 165, 1.99976
pre-proc-coef, 65, 20, 1, 1, 0, 87, 2
pre-proc-coef, 65, 16, 0, 1, 0, 82, 2
pre-proc-coef, 65, 20, 0, 1, 0, 86, 2
pre-proc-coef, 70, 22, 0, 1, 0, 93, 2
pre-proc-coef, 65, 16, 0, 1, 0, 82, 2
pre-proc-coef, 59, 18, 0, 1, 0, 78, 2
pre-proc-coef, 71, 16, 5, 1, 0, 93, 2
pre-proc-coef, 63, 15, 0, 1, 0, 79, 2
pre-proc-coef, 61, 20, 0, 1, 0, 82, 2
pre-proc-coef, 66, 15, 0, 1, 0, 82, 2
pre-proc-coef, 66, 20, 0, 1, 0, 87, 2
pre-proc-coef, 63, 15, 0, 1, 0, 79, 2
pre-proc-coef, 92, 18, 0, 1, 0, 111, 2
pre-proc-coef, 64, 15, 0, 1, 0, 80, 2
pre-proc-coef, 60, 16, 0, 1, 0, 77, 2
pre-proc-coef, 60, 16, 0, 1, 0, 77, 2
pre-proc-coef, 61, 16, 0, 1, 0, 78, 2
pre-proc-coef, 58, 17, 0, 1, 0, 76, 2
pre-proc-coef, 67, 15, 0, 1, 0, 83, 2
pre-proc-coef, 60, 16, 0, 1, 0, 77, 2
pre-proc-coef, 65, 16, 0, 1, 0, 82, 2
pre-proc-coef, 67, 16, 0, 1, 0, 84, 2
pre-proc-coef, 59, 16, 0, 1, 0, 76, 2
pre-proc-coef, 58, 16, 0, 1, 0, 75, 2
pre-proc-coef, 60, 21, 0, 1, 0, 82, 2
pre-proc-coef, 60, 15, 0, 1, 0, 76, 2
pre-proc-coef, 59, 16, 0, 1, 0, 76, 2
pre-proc-coef, 58, 16, 0, 1, 0, 75, 2
pre-proc-coef, 59, 16, 0, 1, 0, 76, 2
pre-proc-coef, 61, 17, 0, 1, 0, 79, 2
pre-proc-coef, 58, 15, 0, 1, 0, 74, 2
pre-proc-coef, 61, 25, 0, 1, 0, 87, 2
pre-proc-coef, 59, 16, 0, 1, 0, 76, 2
pre-proc-coef, 60, 16, 0, 1, 0, 77, 2
pre-proc-coef, 73, 14, 0, 1, 0, 88, 2
pre-proc-coef, 60, 16, 0, 1, 0, 77, 2
pre-proc-coef, 63, 15, 0, 1, 0, 79, 2
pre-proc-coef, 59, 16, 0, 1, 0, 76, 2
pre-proc-coef, 62, 23, 0, 1, 0, 86, 2
pre-proc-coef, 64, 16, 0, 1, 0, 81, 2
pre-proc-coef, 62, 16, 0, 1, 0, 79, 2
pre-proc-coef, 58, 16, 0, 1, 0, 75, 2
pre-proc-coef, 60, 16, 0, 1, 0, 77, 2
pre-proc-coef, 58, 16, 0, 1, 0, 75, 2
pre-proc-coef, 58, 16, 0, 1, 0, 75, 2
pre-proc-coef, 59, 25, 0, 1, 0, 85, 2
pre-proc-coef, 62, 16, 0, 1, 0, 79, 2
pre-proc-coef, 58, 16, 0, 1, 0, 75, 2
pre-proc-coef, 58, 16, 0, 1, 0, 75, 2
pre-proc-coef, 59, 15, 0, 1, 0, 75, 2
pre-proc-coef, 60, 16, 0, 1, 0, 77, 2
pre-proc-coef, 59, 16, 0, 1, 0, 76, 2
pre-proc-coef, 66, 16, 0, 1, 0, 83, 2
pre-proc-coef, 59, 16, 0, 1, 0, 76, 2
pre-proc-coef, 62, 15, 0, 1, 0, 78, 2
pre-proc-coef, 61, 15, 0, 1, 0, 77, 2
pre-proc-coef, 58, 16, 0, 1, 0, 75, 2
pre-proc-coef, 61, 16, 0, 1, 0, 78, 2
pre-proc-coef, 68, 16, 0, 1, 0, 85, 2
pre-proc-coef, 63, 15, 0, 1, 0, 79, 2
pre-proc-coef, 60, 15, 0, 1, 0, 76, 2
pre-proc-coef, 57, 16, 0, 1, 0, 74, 2
pre-proc-coef, 59, 15, 0, 1, 0, 75, 2
pre-proc-coef, 59, 16, 0, 1, 0, 76, 2
pre-proc-coef, 58, 16, 0, 1, 0, 75, 2
pre-proc-coef, 59, 15, 0, 1, 0, 75, 2
pre-proc-coef, 65, 16, 0, 1, 0, 82, 2
pre-proc-coef, 59, 16, 0, 1, 0, 76, 2
pre-proc-coef, 61, 15, 0, 1, 0, 77, 2
pre-proc-coef, 60, 16, 0, 1, 0, 77, 2
pre-proc-coef, 66, 16, 0, 1, 0, 83, 2
pre-proc-coef, 63, 16, 0, 1, 0, 80, 2
pre-proc-coef, 60, 20, 0, 1, 0, 81, 2
pre-proc-coef, 62, 16, 0, 1, 0, 79, 2
pre-proc-coef, 58, 15, 0, 1, 0, 74, 2
pre-proc-coef, 59, 16, 0, 1, 0, 76, 2
pre-proc-coef, 62, 16, 0, 1, 0, 79, 2
pre-proc-coef, 60, 16, 0, 1, 0, 77, 2
pre-proc-coef, 59, 16, 0, 1, 0, 76, 2
pre-proc-coef, 61, 15, 0, 1, 0, 77, 2
pre-proc-coef, 62, 15, 1, 1, 0, 79, 2
pre-proc-coef, 60, 16, 0, 1, 0, 77, 2
pre-proc-coef, 58, 16, 0, 1, 0, 75, 2
pre-proc-coef, 58, 17, 0, 1, 0, 76, 2
pre-proc-coef, 61, 16, 0, 1, 0, 78, 2
pre-proc-coef, 59, 16, 0, 1, 0, 76, 2
pre-proc-coef, 63, 15, 0, 1, 0, 79, 2
pre-proc-coef, 64, 16, 0, 1, 0, 81, 2
pre-proc-coef, 61, 16, 0, 1, 0, 78, 2
pre-proc-coef, 64, 15, 0, 1, 0, 80, 2
pre-proc-coef, 59, 16, 0, 1, 0, 76, 2
pre-proc-coef, 59, 16, 0, 1, 0, 76, 2
pre-proc-coef, 71, 16, 0, 1, 0, 88, 2
pre-proc-coef, 61, 15, 0, 1, 0, 77, 2
pre-proc-coef, 63, 16, 0, 1, 0, 80, 2
pre-proc-coef, 59, 16, 0, 1, 0, 76, 2
pre-proc-coef, 59, 16, 0, 1, 0, 76, 2
pre-proc-coef, 62, 16, 1, 1, 0, 80, 2
pre-proc-coef, 58, 16, 0, 1, 0, 75, 2
pre-proc-coef, 67, 20, 0, 1, 0, 88, 2
pre-proc-coef, 62, 17, 0, 1, 0, 80, 2
pre-proc-coef, 63, 24, 0, 1, 0, 88, 2
pre-proc-coef, 69, 18, 0, 1, 0, 88, 2
pre-proc-coef, 67, 16, 0, 1, 0, 84, 2
pre-proc-coef, 70, 16, 0, 1, 0, 87, 2
pre-proc-coef, 63, 21, 0, 1, 0, 85, 2
pre-proc-coef, 71, 16, 0, 1, 0, 88, 2
pre-proc-coef, 74, 15, 0, 1, 0, 90, 2
pre-proc-coef, 64, 18, 0, 1, 0, 83, 2
pre-proc-coef, 61, 16, 0, 1, 0, 78, 2
pre-proc-coef, 62, 16, 0, 1, 0, 79, 2
pre-proc-coef, 57, 15, 0, 1, 0, 73, 2
pre-proc-coef, 59, 16, 0, 1, 0, 76, 2
pre-proc-coef, 66, 16, 0, 1, 0, 83, 2
pre-proc-coef, 62, 16, 0, 1, 0, 79, 2
pre-proc-coef, 60, 16, 0, 1, 0, 77, 2
pre-proc-coef, 59, 16, 0, 1, 0, 76, 2
pre-proc-coef, 59, 15, 0, 1, 0, 75, 2
pre-proc-coef, 59, 16, 0, 1, 0, 76, 2
pre-proc-coef, 58, 15, 0, 1, 0, 74, 2
pre-proc-coef, 63, 15, 1, 1, 0, 80, 2
pre-proc-coef, 64, 16, 0, 1, 0, 81, 2
pre-proc-coef, 62, 15, 0, 1, 0, 78, 2
pre-proc-coef, 63, 16, 0, 1, 0, 80, 2
pre-proc-coef, 59, 16, 0, 1, 0, 76, 2
pre-proc-coef, 62, 16, 1, 1, 0, 80, 2
pre-proc-coef, 62, 15, 0, 1, 0, 78, 2
pre-proc-coef, 62, 18, 0, 1, 0, 81, 2
pre-proc-coef, 65, 15, 0, 1, 0, 81, 2
pre-proc-coef, 59, 16, 0, 1, 0, 76, 2
pre-proc-coef, 59, 16, 0, 1, 0, 76, 2
pre-proc-coef, 62, 16, 0, 1, 0, 79, 2
pre-proc-coef, 61, 16, 1, 1, 0, 79, 2
pre-proc-coef, 58, 16, 0, 1, 0, 75, 2
pre-proc-coef, 65, 16, 0, 1, 0, 82, 2
pre-proc-coef, 58, 16, 0, 1, 0, 75, 2
pre-proc-coef, 60, 16, 0, 1, 0, 77, 2
pre-proc-coef, 58, 16, 0, 1, 0, 75, 2
pre-proc-coef, 60, 16, 0, 1, 0, 77, 2
pre-proc-coef, 61, 16, 0, 1, 0, 78, 2
pre-proc-coef, 62, 16, 0, 1, 0, 79, 2
pre-proc-coef, 66, 21, 0, 1, 0, 88, 2
pre-proc-coef, 59, 16, 0, 1, 0, 76, 2
pre-proc-coef, 58, 15, 0, 1, 0, 74, 2
pre-proc-coef, 66, 16, 0, 1, 0, 83, 2
pre-proc-coef, 61, 16, 0, 1, 0, 78, 2
pre-proc-coef, 58, 19, 0, 1, 0, 78, 2
pre-proc-coef, 60, 16, 0, 1, 0, 77, 2
pre-proc-coef, 62, 19, 0, 1, 0, 82, 2
pre-proc-coef, 59, 16, 0, 1, 0, 76, 2
pre-proc-coef, 63, 16, 0, 1, 0, 80, 2
pre-proc-coef, 60, 16, 0, 1, 0, 77, 2
pre-proc-coef, 58, 16, 0, 1, 0, 75, 2
pre-proc-coef, 59, 15, 0, 1, 0, 75, 2
pre-proc-coef, 64, 20, 0, 1, 0, 85, 2
pre-proc-coef, 62, 21, 0, 1, 0, 84, 2
pre-proc-coef, 62, 16, 0, 1, 0, 79, 2
pre-proc-coef, 61, 16, 0, 1, 0, 78, 2
pre-proc-coef, 60, 16, 0, 1, 0, 77, 2
pre-proc-coef, 69, 16, 0, 1, 0, 86, 2
pre-proc-coef, 63, 18, 0, 1, 0, 82, 2
pre-proc-coef, 64, 16, 0, 1, 0, 81, 2
pre-proc-coef, 62, 15, 1, 1, 0, 79, 2
pre-proc-coef, 61, 16, 0, 1, 0, 78, 2
pre-proc-coef, 65, 15, 0, 1, 0, 81, 2
pre-proc-coef, 58, 16, 0, 1, 0, 75, 2
pre-proc-coef, 62, 15, 0, 1, 0, 78, 2
pre-proc-coef, 60, 16, 1, 1, 0, 78, 2
pre-proc-coef, 58, 16, 0, 1, 0, 75, 2
pre-proc-coef, 62, 16, 0, 1, 0, 79, 2
pre-proc-coef, 60, 16, 0, 1, 0, 77, 2
pre-proc-coef, 59, 16, 0, 1, 0, 76, 2
pre-proc-coef, 59, 16, 0, 1, 0, 76, 2
pre-proc-coef, 60, 16, 0, 1, 0, 77, 2
pre-proc-coef, 62, 16, 0, 1, 0, 79, 2
pre-proc-coef, 60, 15, 0, 1, 0, 76, 2
pre-proc-coef, 60, 15, 0, 1, 0, 76, 2
pre-proc-coef, 59, 16, 0, 1, 0, 76, 2
pre-proc-coef, 59, 16, 0, 1, 0, 76, 2
pre-proc-coef, 62, 16, 0, 1, 0, 79, 2
pre-proc-coef, 57, 15, 0, 1, 0, 73, 2
pre-proc-coef, 60, 21, 1, 1, 0, 83, 2
pre-proc-coef, 60, 16, 0, 1, 0, 77, 2
pre-proc-coef, 64, 15, 0, 1, 0, 80, 2
pre-proc-coef, 63, 15, 0, 1, 0, 79, 2
pre-proc-coef, 63, 16, 0, 1, 0, 80, 2
pre-proc-coef, 59, 16, 0, 1, 0, 76, 2
pre-proc-coef, 58, 16, 0, 1, 0, 75, 2
pre-proc-coef, 58, 16, 0, 1, 0, 75, 2
pre-proc-coef, 59, 15, 0, 1, 0, 75, 2
pre-proc-coef, 60, 16, 0, 1, 0, 77, 2
pre-proc-coef, 60, 16, 0, 1, 0, 77, 2
pre-proc-coef, 60, 16, 0, 1, 0, 77, 2
pre-proc-coef, 59, 15, 0, 1, 0, 75, 2
pre-proc-coef, 60, 16, 0, 1, 0, 77, 2
pre-proc-coef, 63, 17, 0, 1, 0, 81, 2
pre-proc-coef, 61, 15, 0, 1, 0, 77, 2
pre-proc-coef, 65, 16, 0, 1, 0, 82, 2
pre-proc-coef, 60, 16, 1, 1, 0, 78, 2
pre-proc-coef, 62, 15, 0, 1, 0, 78, 2
pre-proc-coef, 63, 16, 0, 1, 0, 80, 2
pre-proc-coef, 61, 16, 0, 1, 0, 78, 2
pre-proc-coef, 60, 16, 0, 1, 0, 77, 2
pre-proc-coef, 58, 16, 0, 1, 0, 75, 2
pre-proc-coef, 69, 16, 0, 1, 0, 86, 2
pre-proc-coef, 60, 16, 0, 1, 0, 77, 2
pre-proc-coef, 66, 16, 0, 1, 0, 83, 2
pre-proc-coef, 61, 15, 0, 1, 0, 77, 2
pre-proc-coef, 62, 16, 0, 1, 0, 79, 2
pre-proc-coef, 62, 16, 1, 1, 0, 80, 2
pre-proc-coef, 58, 15, 0, 1, 0, 74, 2
pre-proc-coef, 65, 16, 0, 1, 0, 82, 2
pre-proc-coef, 66, 15, 0, 1, 0, 82, 2
pre-proc-coef, 68, 16, 0, 1, 0, 85, 2
pre-proc-coef, 60, 15, 0, 1, 0, 76, 2
pre-proc-coef, 62, 15, 0, 1, 0, 78, 2
pre-proc-coef, 59, 16, 0, 1, 0, 76, 2
pre-proc-coef, 59, 19, 0, 1, 0, 79, 2
pre-proc-coef, 59, 29, 0, 1, 0, 89, 2
pre-proc-coef, 61, 16, 0, 1, 0, 78, 2
pre-proc-coef, 66, 16, 0, 1, 0, 83, 2
pre-proc-coef, 60, 16, 0, 1, 0, 77, 2
pre-proc-coef, 62, 16, 0, 1, 0, 79, 2
pre-proc-coef, 61, 16, 0, 1, 0, 78, 2
pre-proc-coef, 66, 16, 7, 4, 0, 93, 2
pre-proc-coef, 65, 16, 1, 1, 0, 83, 2
pre-proc-coef, 59, 16, 0, 1, 0, 76, 2
pre-proc-coef, 61, 16, 0, 1, 0, 78, 2
pre-proc-coef, 59, 16, 0, 1, 0, 76, 2
pre-proc-coef, 58, 15, 0, 1, 0, 74, 2
pre-proc-coef, 60, 15, 0, 1, 0, 76, 2
pre-proc-coef, 58, 18, 0, 1, 0, 77, 2
pre-proc-coef, 61, 16, 0, 1, 0, 78, 2
pre-proc-coef, 58, 15, 0, 1, 0, 74, 2
pre-proc-coef, 60, 16, 0, 1, 0, 77, 2
pre-proc-coef, 61, 16, 0, 1, 0, 78, 2
pre-proc-coef, 63, 15, 0, 1, 0, 79, 2
pre-proc-coef, 61, 16, 0, 1, 0, 78, 2
pre-proc-coef, 70, 16, 0, 1, 0, 87, 2
pre-proc-coef, 61, 16, 0, 1, 0, 78, 2
pre-proc-coef, 58, 16, 0, 1, 0, 75, 2
pre-proc-coef, 60, 16, 0, 1, 0, 77, 2
pre-proc-coef, 58, 18, 0, 1, 0, 77, 2
pre-proc-coef, 64, 16, 0, 1, 0, 81, 2
pre-proc-coef, 59, 16, 0, 1, 0, 76, 2
pre-proc-coef, 64, 16, 0, 1, 0, 81, 2
pre-proc-coef, 59, 16, 0, 1, 0, 76, 2
pre-proc-coef, 61, 16, 0, 1, 0, 78, 2
pre-proc-coef, 59, 16, 0, 1, 0, 76, 2
pre-proc-coef, 59, 15, 0, 1, 0, 75, 2
pre-proc-coef, 59, 19, 0, 1, 0, 79, 2
pre-proc-coef, 60, 15, 0, 1, 0, 76, 2
pre-proc-coef, 62, 15, 0, 1, 0, 78, 2
pre-proc-coef, 59, 17, 0, 1, 0, 77, 2
pre-proc-coef, 61, 15, 0, 1, 0, 77, 2
pre-proc-coef, 61, 15, 0, 1, 0, 77, 2
pre-proc-coef, 59, 16, 0, 1, 0, 76, 2
pre-proc-coef, 59, 16, 0, 1, 0, 76, 2
pre-proc-coef, 62, 16, 0, 1, 0, 79, 2
pre-proc-coef, 79, 16, 0, 1, 0, 96, 2
pre-proc-coef, 59, 16, 0, 1, 0, 76, 2
pre-proc-coef, 60, 16, 0, 1, 0, 77, 2
pre-proc-coef, 59, 16, 0, 1, 0, 76, 2
pre-proc-coef, 60, 16, 0, 1, 0, 77, 2
pre-proc-coef, 61, 16, 0, 1, 0, 78, 2
pre-proc-coef, 58, 16, 0, 1, 0, 75, 2
pre-proc-coef, 60, 16, 0, 1, 0, 77, 2
pre-proc-coef, 58, 15, 0, 1, 0, 74, 2
pre-proc-coef, 59, 16, 0, 1, 0, 76, 2
pre-proc-coef, 59, 16, 0, 1, 0, 76, 2
pre-proc-coef, 59, 19, 0, 1, 0, 79, 2
pre-proc-coef, 60, 16, 0, 1, 0, 77, 2
pre-proc-coef, 66, 15, 0, 1, 0, 82, 2
pre-proc-coef, 59, 15, 0, 1, 0, 75, 2
pre-proc-coef, 58, 16, 1, 1, 0, 76, 2
pre-proc-coef, 60, 16, 0, 1, 0, 77, 2
pre-proc-coef, 60, 17, 0, 1, 0, 78, 2
pre-proc-coef, 60, 16, 0, 1, 0, 77, 2
pre-proc-coef, 58, 15, 0, 1, 0, 74, 2
pre-proc-coef, 59, 16, 0, 1, 0, 76, 2
pre-proc-coef, 62, 15, 0, 1, 0, 78, 2
pre-proc-coef, 58, 16, 0, 1, 0, 75, 2
pre-proc-coef, 59, 15, 0, 1, 0, 75, 2
pre-proc-coef, 81, 16, 0, 1, 0, 98, 2
pre-proc-coef, 58, 16, 0, 1, 0, 75, 2
pre-proc-coef, 61, 16, 1, 1, 0, 79, 2
pre-proc-coef, 58, 17, 0, 1, 0, 76, 2
pre-proc-coef, 61, 16, 0, 1, 0, 78, 2
pre-proc-coef, 59, 15, 0, 1, 0, 75, 2
pre-proc-coef, 59, 16, 0, 1, 0, 76, 2
pre-proc-coef, 58, 15, 0, 1, 0, 74, 2
pre-proc-coef, 59, 16, 0, 1, 0, 76, 2
pre-proc-coef, 67, 16, 0, 1, 0, 84, 2
pre-proc-coef, 60, 16, 0, 1, 0, 77, 2
pre-proc-coef, 58, 15, 0, 1, 0, 74, 2
pre-proc-coef, 61, 16, 0, 1, 0, 78, 2
pre-proc-coef, 68, 16, 1, 1, 0, 86, 2
pre-proc-coef, 60, 16, 0, 1, 0, 77, 2
pre-proc-coef, 61, 16, 0, 1, 0, 78, 2
pre-proc-coef, 58, 16, 0, 1, 0, 75, 2
pre-proc-coef, 58, 16, 0, 1, 0, 75, 2
pre-proc-coef, 58, 16, 0, 1, 0, 75, 2
pre-proc-coef, 59, 16, 0, 1, 0, 76, 2
pre-proc-coef, 60, 16, 0, 1, 0, 77, 2
pre-proc-coef, 62, 16, 0, 1, 0, 79, 2
pre-proc-coef, 59, 16, 0, 1, 0, 76, 2
pre-proc-coef, 66, 16, 0, 1, 0, 83, 2
pre-proc-coef, 58, 16, 0, 1, 0, 75, 2
pre-proc-coef, 59, 19, 0, 1, 0, 79, 2
pre-proc-coef, 61, 16, 0, 1, 0, 78, 2
pre-proc-coef, 57, 15, 0, 1, 0, 73, 2
pre-proc-coef, 60, 16, 0, 1, 0, 77, 2
pre-proc-coef, 61, 16, 0, 1, 0, 78, 2
pre-proc-coef, 62, 15, 0, 1, 0, 78, 2
pre-proc-coef, 59, 15, 0, 1, 0, 75, 2
pre-proc-coef, 59, 16, 0, 1, 0, 76, 2
pre-proc-coef, 59, 16, 0, 1, 0, 76, 2
pre-proc-coef, 59, 16, 0, 1, 0, 76, 2
pre-proc-coef, 58, 16, 0, 1, 0, 75, 2
pre-proc-coef, 64, 16, 0, 1, 0, 81, 2
pre-proc-coef, 61, 15, 0, 1, 0, 77, 2
pre-proc-coef, 63, 15, 0, 1, 0, 79, 2
pre-proc-coef, 60, 15, 0, 1, 0, 76, 2
pre-proc-coef, 59, 16, 0, 1, 0, 76, 2
pre-proc-coef, 58, 16, 0, 1, 0, 75, 2
pre-proc-coef, 58, 15, 0, 1, 0, 74, 2
pre-proc-coef, 62, 16, 0, 1, 0, 79, 2
pre-proc-coef, 59, 16, 0, 1, 0, 76, 2
pre-proc-coef, 59, 16, 0, 1, 0, 76, 2
pre-proc-coef, 60, 16, 0, 1, 0, 77, 2
pre-proc-coef, 58, 16, 1, 1, 0, 76, 2
pre-proc-coef, 62, 15, 0, 1, 0, 78, 2
pre-proc-coef, 62, 15, 0, 1, 0, 78, 2
pre-proc-coef, 59, 15, 0, 1, 0, 75, 2
pre-proc-coef, 67, 16, 0, 1, 0, 84, 2
pre-proc-coef, 60, 16, 0, 1, 0, 77, 2
pre-proc-coef, 63, 16, 0, 1, 0, 80, 2
pre-proc-coef, 61, 16, 0, 1, 0, 78, 2
pre-proc-coef, 62, 16, 0, 1, 0, 79, 2
pre-proc-coef, 58, 16, 0, 1, 0, 75, 2
pre-proc-coef, 60, 16, 0, 1, 0, 77, 2
pre-proc-coef, 62, 16, 0, 1, 0, 79, 2
pre-proc-coef, 74, 16, 0, 1, 0, 91, 2
pre-proc-coef, 61, 16, 0, 1, 0, 78, 2
pre-proc-coef, 60, 16, 0, 1, 0, 77, 2
pre-proc-coef, 62, 16, 1, 1, 0, 80, 2
pre-proc-coef, 59, 16, 0, 1, 0, 76, 2
pre-proc-coef, 62, 16, 0, 1, 0, 79, 2
pre-proc-coef, 58, 16, 0, 1, 0, 75, 2
pre-proc-coef, 59, 16, 0, 1, 0, 76, 2
pre-proc-coef, 66, 16, 0, 1, 0, 83, 2
pre-proc-coef, 71, 18, 1, 1, 0, 91, 2
pre-proc-coef, 59, 16, 0, 1, 0, 76, 2
pre-proc-coef, 58, 17, 0, 1, 0, 76, 2
pre-proc-coef, 61, 16, 0, 1, 0, 78, 2
pre-proc-coef, 62, 15, 0, 1, 0, 78, 2
pre-proc-coef, 60, 16, 0, 1, 0, 77, 2
pre-proc-coef, 58, 16, 0, 1, 0, 75, 2
pre-proc-coef, 59, 15, 0, 1, 0, 75, 2
pre-proc-coef, 59, 15, 0, 1, 0, 75, 2
pre-proc-coef, 60, 16, 0, 1, 0, 77, 2
pre-proc-coef, 59, 15, 0, 1, 0, 75, 2
pre-proc-coef, 68, 16, 0, 1, 0, 85, 2
pre-proc-coef, 58, 15, 0, 1, 0, 74, 2
pre-proc-coef, 67, 16, 0, 1, 0, 84, 2
pre-proc-coef, 58, 16, 0, 1, 0, 75, 2
pre-proc-coef, 60, 15, 0, 1, 0, 76, 2
pre-proc-coef, 58, 15, 1, 1, 0, 75, 2
pre-proc-coef, 59, 16, 0, 1, 0, 76, 2
pre-proc-coef, 58, 15, 0, 1, 0, 74, 2
pre-proc-coef, 59, 16, 0, 1, 0, 76, 2
pre-proc-coef, 63, 16, 0, 1, 0, 80, 2
pre-proc-coef, 59, 16, 0, 1, 0, 76, 2
pre-proc-coef, 62, 16, 0, 1, 0, 79, 2
pre-proc-coef, 61, 15, 0, 1, 0, 77, 2
pre-proc-coef, 57, 16, 1, 1, 0, 75, 2
pre-proc-coef, 64, 16, 0, 1, 0, 81, 2
pre-proc-coef, 61, 16, 0, 1, 0, 78, 2
pre-proc-coef, 58, 16, 0, 1, 0, 75, 2
pre-proc-coef, 65, 16, 0, 1, 0, 82, 2
pre-proc-coef, 59, 16, 0, 1, 0, 76, 2
pre-proc-coef, 65, 15, 0, 1, 0, 81, 2
pre-proc-coef, 59, 16, 1, 1, 0, 77, 2
pre-proc-coef, 67, 16, 0, 1, 0, 84, 2
pre-proc-coef, 64, 16, 0, 1, 0, 81, 2
pre-proc-coef, 64, 16, 0, 1, 0, 81, 2
pre-proc-coef, 58, 15, 0, 1, 0, 74, 2
pre-proc-coef, 60, 16, 0, 1, 0, 77, 2
pre-proc-coef, 58, 16, 0, 1, 0, 75, 2
pre-proc-coef, 65, 16, 0, 1, 0, 82, 2
pre-proc-coef, 59, 15, 0, 1, 0, 75, 2
pre-proc-coef, 61, 16, 0, 1, 0, 78, 2
pre-proc-coef, 58, 15, 0, 1, 0, 74, 2
pre-proc-coef, 63, 16, 0, 1, 0, 80, 2
pre-proc-coef, 62, 16, 0, 1, 0, 79, 2
pre-proc-coef, 59, 16, 0, 1, 0, 76, 2
pre-proc-coef, 68, 22, 0, 1, 0, 91, 2
pre-proc-coef, 58, 16, 0, 1, 0, 75, 2
pre-proc-coef, 62, 16, 1, 1, 0, 80, 2
pre-proc-coef, 59, 16, 0, 1, 0, 76, 2
pre-proc-coef, 62, 16, 0, 1, 0, 79, 2
pre-proc-coef, 58, 15, 0, 1, 0, 74, 2
pre-proc-coef, 59, 19, 0, 1, 0, 79, 2
pre-proc-coef, 61, 16, 0, 1, 0, 78, 2
pre-proc-coef, 62, 16, 0, 1, 0, 79, 2
pre-proc-coef, 62, 16, 0, 1, 0, 79, 2
pre-proc-coef, 57, 15, 0, 1, 0, 73, 2
pre-proc-coef, 60, 15, 0, 1, 0, 76, 2
pre-proc-coef, 59, 15, 0, 1, 0, 75, 2
pre-proc-coef, 58, 15, 1, 1, 0, 75, 2
pre-proc-coef, 61, 16, 0, 1, 0, 78, 2
pre-proc-coef, 60, 16, 0, 1, 0, 77, 2
pre-proc-coef, 61, 16, 0, 1, 0, 78, 2
pre-proc-coef, 61, 16, 1, 1, 0, 79, 2
pre-proc-coef, 61, 16, 0, 1, 0, 78, 2
pre-proc-coef, 58, 16, 0, 1, 0, 75, 2
pre-proc-coef, 63, 16, 0, 1, 0, 80, 2
pre-proc-coef, 63, 19, 0, 1, 0, 83, 2
pre-proc-coef, 59, 16, 0, 1, 0, 76, 2
pre-proc-coef, 61, 16, 0, 1, 0, 78, 2
pre-proc-coef, 69, 16, 0, 1, 0, 86, 2
pre-proc-coef, 61, 16, 0, 1, 0, 78, 2
pre-proc-coef, 60, 15, 0, 1, 0, 76, 2
pre-proc-coef, 57, 19, 0, 1, 0, 77, 2
pre-proc-coef, 59, 16, 0, 1, 0, 76, 2
pre-proc-coef, 59, 16, 0, 1, 0, 76, 2
pre-proc-coef, 58, 16, 0, 1, 0, 75, 2
pre-proc-coef, 59, 16, 0, 1, 0, 76, 2
pre-proc-coef, 63, 16, 0, 1, 0, 80, 2
pre-proc-coef, 58, 15, 0, 1, 0, 74, 2
pre-proc-coef, 64, 16, 0, 1, 0, 81, 2
pre-proc-coef, 62, 16, 0, 1, 0, 79, 2
pre-proc-coef, 64, 16, 0, 1, 0, 81, 2
pre-proc-coef, 61, 16, 0, 1, 0, 78, 2
pre-proc-coef, 58, 16, 0, 1, 0, 75, 2
pre-proc-coef, 60, 16, 0, 1, 0, 77, 2
pre-proc-coef, 59, 16, 0, 1, 0, 76, 2
pre-proc-coef, 58, 16, 0, 1, 0, 75, 2
pre-proc-coef, 59, 16, 0, 1, 0, 76, 2
pre-proc-coef, 59, 16, 0, 1, 0, 76, 2
pre-proc-coef, 59, 17, 0, 1, 0, 77, 2
pre-proc-coef, 58, 16, 0, 1, 0, 75, 2
pre-proc-coef, 59, 16, 0, 1, 0, 76, 2
pre-proc-coef, 65, 16, 0, 1, 0, 82, 2
pre-proc-coef, 60, 20, 0, 1, 0, 81, 2
pre-proc-coef, 62, 16, 0, 1, 0, 79, 2
pre-proc-coef, 60, 16, 0, 1, 0, 77, 2
pre-proc-coef, 59, 16, 0, 1, 0, 76, 2
pre-proc-coef, 58, 15, 0, 1, 0, 74, 2
pre-proc-coef, 70, 15, 0, 1, 0, 86, 2
pre-proc-coef, 59, 16, 0, 1, 0, 76, 2
pre-proc-coef, 60, 16, 0, 1, 0, 77, 2
pre-proc-coef, 58, 16, 0, 1, 0, 75, 2
pre-proc-coef, 59, 15, 0, 1, 0, 75, 2
pre-proc-coef, 60, 16, 0, 1, 0, 77, 2
pre-proc-coef, 68, 16, 0, 1, 0, 85, 2
pre-proc-coef, 58, 15, 0, 1, 0, 74, 2
pre-proc-coef, 60, 16, 0, 1, 0, 77, 2
pre-proc-coef, 60, 16, 0, 1, 0, 77, 2
pre-proc-coef, 62, 16, 0, 1, 0, 79, 2
pre-proc-coef, 60, 20, 0, 1, 0, 81, 2
pre-proc-coef, 62, 16, 0, 1, 0, 79, 2
pre-proc-coef, 59, 16, 0, 1, 0, 76, 2
pre-proc-coef, 65, 16, 0, 1, 0, 82, 2
pre-proc-coef, 64, 16, 0, 1, 0, 81, 2
pre-proc-coef, 63, 16, 0, 1, 0, 80, 2
pre-proc-coef, 61, 15, 0, 8, 0, 84, 2
pre-proc-coef, 59, 16, 0, 1, 0, 76, 2
pre-proc-coef, 59, 15, 0, 1, 0, 75, 2
pre-proc-coef, 58, 15, 0, 1, 0, 74, 2
pre-proc-coef, 59, 16, 0, 1, 0, 76, 2
pre-proc-coef, 60, 16, 0, 1, 0, 77, 2
pre-proc-coef, 62, 16, 0, 1, 0, 79, 2
pre-proc-coef, 62, 16, 1, 1, 0, 80, 2
pre-proc-coef, 64, 15, 0, 1, 0, 80, 2
pre-proc-coef, 61, 16, 0, 1, 0, 78, 2
pre-proc-coef, 59, 15, 0, 1, 0, 75, 2
pre-proc-coef, 59, 16, 0, 1, 0, 76, 2
pre-proc-coef, 58, 16, 0, 1, 0, 75, 2
pre-proc-coef, 58, 16, 0, 1, 0, 75, 2
pre-proc-coef, 59, 16, 0, 1, 0, 76, 2
pre-proc-coef, 59, 16, 0, 1, 0, 76, 2
pre-proc-coef, 58, 15, 0, 1, 0, 74, 2
pre-proc-coef, 60, 15, 0, 1, 0, 76, 2
pre-proc-coef, 59, 15, 0, 1, 0, 75, 2
pre-proc-coef, 64, 15, 0, 1, 0, 80, 2
pre-proc-coef, 62, 18, 0, 1, 0, 81, 2
pre-proc-coef, 59, 16, 0, 1, 0, 76, 2
pre-proc-coef, 63, 15, 0, 1, 0, 79, 2
pre-proc-coef, 59, 15, 0, 1, 0, 75, 2
pre-proc-coef, 63, 16, 0, 1, 0, 80, 2
pre-proc-coef, 59, 16, 0, 1, 0, 76, 2
pre-proc-coef, 58, 15, 1, 1, 0, 75, 2
pre-proc-coef, 58, 16, 0, 1, 0, 75, 2
pre-proc-coef, 62, 16, 0, 1, 0, 79, 2
pre-proc-coef, 63, 16, 0, 1, 0, 80, 2
pre-proc-coef, 59, 16, 0, 1, 0, 76, 2
pre-proc-coef, 60, 16, 0, 1, 0, 77, 2
pre-proc-coef, 60, 16, 0, 1, 0, 77, 2
pre-proc-coef, 58, 16, 0, 1, 0, 75, 2
pre-proc-coef, 57, 16, 0, 1, 0, 74, 2
pre-proc-coef, 58, 16, 0, 1, 0, 75, 2
pre-proc-coef, 60, 16, 0, 1, 0, 77, 2
pre-proc-coef, 62, 16, 0, 1, 0, 79, 2
pre-proc-coef, 58, 16, 0, 1, 0, 75, 2
pre-proc-coef, 58, 15, 0, 1, 0, 74, 2
pre-proc-coef, 68, 16, 0, 1, 0, 85, 2
pre-proc-coef, 63, 16, 0, 1, 0, 80, 2
pre-proc-coef, 64, 16, 0, 1, 0, 81, 2
pre-proc-coef, 61, 16, 0, 1, 0, 78, 2
pre-proc-coef, 62, 16, 0, 1, 0, 79, 2
pre-proc-coef, 64, 16, 0, 1, 0, 81, 2
pre-proc-coef, 60, 16, 0, 1, 0, 77, 2
pre-proc-coef, 58, 15, 7, 18, 0, 98, 2
pre-proc-coef, 60, 18, 0, 1, 0, 79, 2
pre-proc-coef, 61, 16, 0, 1, 0, 78, 2
pre-proc-coef, 62, 15, 0, 1, 0, 78, 2
pre-proc-coef, 59, 15, 0, 1, 0, 75, 2
pre-proc-coef, 59, 16, 0, 1, 0, 76, 2
pre-proc-coef, 66, 17, 0, 1, 0, 84, 2
pre-proc-coef, 58, 16, 0, 1, 0, 75, 2
pre-proc-coef, 62, 16, 0, 1, 0, 79, 2
pre-proc-coef, 59, 16, 0, 1, 0, 76, 2
pre-proc-coef, 63, 15, 0, 1, 0, 79, 2
pre-proc-coef, 59, 15, 0, 1, 0, 75, 2
pre-proc-coef, 64, 16, 0, 1, 0, 81, 2
pre-proc-coef, 66, 16, 0, 1, 0, 83, 2
pre-proc-coef, 62, 15, 0, 1, 0, 78, 2
pre-proc-coef, 62, 16, 0, 1, 0, 79, 2
pre-proc-coef, 61, 16, 0, 1, 0, 78, 2
pre-proc-coef, 63, 16, 0, 1, 0, 80, 2
pre-proc-coef, 60, 16, 0, 1, 0, 77, 2
pre-proc-coef, 61, 16, 1, 1, 0, 79, 2
pre-proc-coef, 60, 15, 1, 1, 0, 77, 2
pre-proc-coef, 58, 16, 0, 1, 0, 75, 2
pre-proc-coef, 62, 16, 0, 1, 0, 79, 2
pre-proc-coef, 62, 16, 0, 6, 0, 84, 2
pre-proc-coef, 60, 16, 0, 1, 0, 77, 2
pre-proc-coef, 61, 16, 0, 1, 0, 78, 2
pre-proc-coef, 60, 16, 0, 1, 0, 77, 2
pre-proc-coef, 63, 16, 0, 1, 0, 80, 2
pre-proc-coef, 61, 16, 0, 1, 0, 78, 2
pre-proc-coef, 59, 16, 0, 1, 0, 76, 2
pre-proc-coef, 59, 15, 0, 1, 0, 75, 2
pre-proc-coef, 59, 18, 0, 1, 0, 78, 2
pre-proc-coef, 58, 16, 0, 1, 0, 75, 2
pre-proc-coef, 58, 15, 0, 1, 0, 74, 2
pre-proc-coef, 62, 16, 0, 1, 0, 79, 2
pre-proc-coef, 60, 16, 0, 1, 0, 77, 2
pre-proc-coef, 62, 15, 0, 1, 0, 78, 2
pre-proc-coef, 60, 15, 0, 1, 0, 76, 2
pre-proc-coef, 58, 16, 0, 1, 0, 75, 2
pre-proc-coef, 64, 16, 0, 1, 0, 81, 2
pre-proc-coef, 58, 15, 0, 1, 0, 74, 2
pre-proc-coef, 59, 16, 0, 1, 0, 76, 2
pre-proc-coef, 58, 16, 0, 1, 0, 75, 2
pre-proc-coef, 60, 16, 0, 1, 0, 77, 2
pre-proc-coef, 62, 16, 0, 1, 0, 79, 2
pre-proc-coef, 59, 17, 0, 1, 0, 77, 2
pre-proc-coef, 65, 16, 0, 1, 0, 82, 2
pre-proc-coef, 63, 16, 0, 1, 0, 80, 2
pre-proc-coef, 58, 16, 0, 1, 0, 75, 2
pre-proc-coef, 60, 16, 0, 1, 0, 77, 2
pre-proc-coef, 62, 18, 0, 1, 0, 81, 2
pre-proc-coef, 60, 15, 0, 1, 0, 76, 2
pre-proc-coef, 58, 16, 0, 1, 0, 75, 2
pre-proc-coef, 69, 15, 0, 1, 0, 85, 2
pre-proc-coef, 65, 16, 0, 1, 0, 82, 2
pre-proc-coef, 59, 16, 0, 1, 0, 76, 2
pre-proc-coef, 63, 16, 0, 1, 0, 80, 2
pre-proc-coef, 60, 16, 0, 1, 0, 77, 2
pre-proc-coef, 60, 16, 0, 1, 0, 77, 2
pre-proc-coef, 59, 16, 0, 1, 0, 76, 2
pre-proc-coef, 59, 15, 0, 1, 0, 75, 2
pre-proc-coef, 62, 16, 0, 1, 0, 79, 2
pre-proc-coef, 60, 16, 0, 1, 0, 77, 2
pre-proc-coef, 63, 15, 0, 1, 0, 79, 2
pre-proc-coef, 58, 16, 0, 1, 0, 75, 2
pre-proc-coef, 58, 16, 0, 1, 0, 75, 2
pre-proc-coef, 59, 15, 0, 1, 0, 75, 2
pre-proc-coef, 59, 16, 0, 1, 0, 76, 2
pre-proc-coef, 63, 15, 0, 1, 0, 79, 2
pre-proc-coef, 58, 15, 0, 1, 0, 74, 2
pre-proc-coef, 60, 29, 2, 1, 0, 92, 2
pre-proc-coef, 59, 15, 0, 1, 0, 75, 2
pre-proc-coef, 60, 16, 0, 1, 0, 77, 2
pre-proc-coef, 59, 16, 0, 1, 0, 76, 2
pre-proc-coef, 58, 16, 0, 1, 0, 75, 2
pre-proc-coef, 61, 16, 0, 1, 0, 78, 2
pre-proc-coef, 57, 16, 0, 1, 0, 74, 2
pre-proc-coef, 62, 15, 0, 1, 0, 78, 2
pre-proc-coef, 59, 16, 0, 1, 0, 76, 2
pre-proc-coef, 58, 16, 0, 1, 0, 75, 2
pre-proc-coef, 65, 15, 0, 1, 0, 81, 2
pre-proc-coef, 59, 16, 0, 1, 0, 76, 2
pre-proc-coef, 60, 16, 0, 1, 0, 77, 2
pre-proc-coef, 59, 15, 0, 1, 0, 75, 2
pre-proc-coef, 59, 16, 0, 1, 0, 76, 2
pre-proc-coef, 67, 16, 0, 1, 0, 84, 2
pre-proc-coef, 59, 18, 1, 1, 0, 79, 2
pre-proc-coef, 59, 16, 0, 1, 0, 76, 2
pre-proc-coef, 63, 16, 0, 1, 0, 80, 2
pre-proc-coef, 60, 16, 0, 1, 0, 77, 2
pre-proc-coef, 58, 16, 0, 1, 0, 75, 2
pre-proc-coef, 59, 16, 0, 1, 0, 76, 2
pre-proc-coef, 59, 16, 1, 1, 0, 77, 2
pre-proc-coef, 61, 16, 0, 1, 0, 78, 2
pre-proc-coef, 58, 16, 0, 1, 0, 75, 2
pre-proc-coef, 64, 16, 0, 1, 0, 81, 2
pre-proc-coef, 64, 16, 0, 1, 0, 81, 2
pre-proc-coef, 61, 16, 0, 1, 0, 78, 2
pre-proc-coef, 59, 16, 0, 1, 0, 76, 2
pre-proc-coef, 58, 16, 0, 1, 0, 75, 2
pre-proc-coef, 65, 15, 0, 1, 0, 81, 2
pre-proc-coef, 61, 16, 0, 1, 0, 78, 2
pre-proc-coef, 66, 16, 0, 1, 0, 83, 2
pre-proc-coef, 60, 16, 0, 1, 0, 77, 2
pre-proc-coef, 60, 16, 0, 1, 0, 77, 2
pre-proc-coef, 69, 16, 0, 1, 0, 86, 2
pre-proc-coef, 59, 16, 0, 1, 0, 76, 2
pre-proc-coef, 61, 16, 0, 1, 0, 78, 2
pre-proc-coef, 59, 16, 0, 1, 0, 76, 2
pre-proc-coef, 59, 16, 0, 1, 0, 76, 2
pre-proc-coef, 62, 15, 0, 1, 0, 78, 2
pre-proc-coef, 66, 16, 0, 1, 0, 83, 2
pre-proc-coef, 60, 17, 0, 1, 0, 78, 2
pre-proc-coef, 61, 16, 0, 1, 0, 78, 2
pre-proc-coef, 63, 17, 0, 1, 0, 81, 2
pre-proc-coef, 62, 17, 0, 1, 0, 80, 2
pre-proc-coef, 59, 15, 0, 1, 0, 75, 2
pre-proc-coef, 76, 15, 0, 1, 0, 92, 2
pre-proc-coef, 59, 16, 0, 1, 0, 76, 2
pre-proc-coef, 59, 16, 0, 1, 0, 76, 2
pre-proc-coef, 62, 16, 0, 1, 0, 79, 2
pre-proc-coef, 59, 16, 1, 1, 0, 77, 2
pre-proc-coef, 62, 16, 0, 1, 0, 79, 2
pre-proc-coef, 62, 16, 0, 1, 0, 79, 2
pre-proc-coef, 62, 16, 0, 1, 0, 79, 2
pre-proc-coef, 60, 15, 0, 1, 0, 76, 2
pre-proc-coef, 61, 16, 1, 1, 0, 79, 2
pre-proc-coef, 58, 16, 0, 1, 0, 75, 2
pre-proc-coef, 59, 16, 0, 1, 0, 76, 2
pre-proc-coef, 63, 16, 0, 1, 0, 80, 2
pre-proc-coef, 61, 16, 0, 1, 0, 78, 2
pre-proc-coef, 63, 15, 0, 1, 0, 79, 2
pre-proc-coef, 59, 16, 0, 1, 0, 76, 2
pre-proc-coef, 63, 16, 0, 1, 0, 80, 2
pre-proc-coef, 59, 16, 0, 1, 0, 76, 2
pre-proc-coef, 61, 16, 0, 1, 0, 78, 2
pre-proc-coef, 58, 16, 0, 1, 0, 75, 2
pre-proc-coef, 59, 16, 0, 1, 0, 76, 2
pre-proc-coef, 60, 16, 0, 1, 0, 77, 2
pre-proc-coef, 61, 16, 0, 1, 0, 78, 2
pre-proc-coef, 68, 17, 0, 1, 0, 86, 2
pre-proc-coef, 60, 16, 0, 1, 0, 77, 2
pre-proc-coef, 58, 16, 0, 1, 0, 75, 2
pre-proc-coef, 62, 16, 0, 1, 0, 79, 2
pre-proc-coef, 59, 15, 0, 1, 0, 75, 2
pre-proc-coef, 60, 16, 0, 1, 0, 77, 2
pre-proc-coef, 67, 16, 1, 1, 0, 85, 2
pre-proc-coef, 61, 16, 0, 1, 0, 78, 2
pre-proc-coef, 63, 16, 0, 1, 0, 80, 2
pre-proc-coef, 65, 16, 0, 1, 0, 82, 2
pre-proc-coef, 60, 16, 0, 1, 0, 77, 2
pre-proc-coef, 60, 16, 0, 1, 0, 77, 2
pre-proc-coef, 61, 16, 0, 1, 0, 78, 2
pre-proc-coef, 60, 16, 0, 1, 0, 77, 2
pre-proc-coef, 58, 15, 0, 1, 0, 74, 2
pre-proc-coef, 58, 16, 0, 1, 0, 75, 2
pre-proc-coef, 59, 16, 0, 1, 0, 76, 2
pre-proc-coef, 60, 16, 0, 1, 0, 77, 2
pre-proc-coef, 62, 16, 0, 1, 0, 79, 2
pre-proc-coef, 62, 16, 0, 1, 0, 79, 2
pre-proc-coef, 59, 16, 0, 1, 0, 76, 2
pre-proc-coef, 58, 16, 0, 1, 0, 75, 2
pre-proc-coef, 62, 16, 0, 1, 0, 79, 2
pre-proc-coef, 59, 16, 0, 1, 0, 76, 2
pre-proc-coef, 62, 15, 0, 1, 0, 78, 2
pre-proc-coef, 59, 16, 0, 1, 0, 76, 2
pre-proc-coef, 63, 17, 0, 1, 0, 81, 2
pre-proc-coef, 61, 16, 0, 1, 0, 78, 2
pre-proc-coef, 61, 16, 0, 1, 0, 78, 2
pre-proc-coef, 62, 16, 0, 1, 0, 79, 2
pre-proc-coef, 61, 16, 0, 1, 0, 78, 2
pre-proc-coef, 63, 16, 0, 1, 0, 80, 2
pre-proc-coef, 60, 15, 0, 1, 0, 76, 2
pre-proc-coef, 60, 16, 0, 1, 0, 77, 2
pre-proc-coef, 60, 16, 0, 1, 0, 77, 2
pre-proc-coef, 58, 16, 0, 1, 0, 75, 2
pre-proc-coef, 58, 15, 0, 1, 0, 74, 2
pre-proc-coef, 59, 16, 0, 1, 0, 76, 2
pre-proc-coef, 66, 19, 0, 1, 0, 86, 2
pre-proc-coef, 60, 16, 0, 1, 0, 77, 2
pre-proc-coef, 61, 15, 0, 1, 0, 77, 2
pre-proc-coef, 63, 16, 0, 1, 0, 80, 2
pre-proc-coef, 59, 18, 0, 1, 0, 78, 2
pre-proc-coef, 60, 16, 0, 1, 0, 77, 2
pre-proc-coef, 64, 16, 1, 1, 0, 82, 2
pre-proc-coef, 66, 16, 0, 1, 0, 83, 2
pre-proc-coef, 62, 16, 0, 1, 0, 79, 2
pre-proc-coef, 71, 16, 1, 1, 0, 89, 2
pre-proc-coef, 60, 15, 0, 1, 0, 76, 2
pre-proc-coef, 58, 15, 0, 1, 0, 74, 2
pre-proc-coef, 61, 16, 0, 1, 0, 78, 2
pre-proc-coef, 57, 16, 0, 1, 0, 74, 2
pre-proc-coef, 63, 16, 0, 1, 0, 80, 2
pre-proc-coef, 67, 15, 0, 1, 0, 83, 2
pre-proc-coef, 61, 15, 0, 1, 0, 77, 2
pre-proc-coef, 58, 16, 0, 1, 0, 75, 2
pre-proc-coef, 62, 16, 0, 1, 0, 79, 2
pre-proc-coef, 62, 16, 0, 1, 0, 79, 2
pre-proc-coef, 57, 16, 0, 1, 0, 74, 2
pre-proc-coef, 60, 16, 0, 1, 0, 77, 2
pre-proc-coef, 58, 16, 0, 1, 0, 75, 2
pre-proc-coef, 59, 17, 0, 1, 0, 77, 2
pre-proc-coef, 60, 16, 1, 1, 0, 78, 2
pre-proc-coef, 59, 17, 0, 1, 0, 77, 2
pre-proc-coef, 61, 16, 0, 1, 0, 78, 2
pre-proc-coef, 58, 15, 0, 1, 0, 74, 2
pre-proc-coef, 59, 16, 0, 1, 0, 76, 2
pre-proc-coef, 67, 16, 0, 1, 0, 84, 2
pre-proc-coef, 63, 16, 0, 1, 0, 80, 2
pre-proc-coef, 64, 16, 1, 1, 0, 82, 2
pre-proc-coef, 60, 21, 0, 4, 0, 85, 2
pre-proc-coef, 59, 15, 0, 1, 0, 75, 2
pre-proc-coef, 62, 16, 0, 1, 0, 79, 2
pre-proc-coef, 59, 18, 0, 1, 0, 78, 2
pre-proc-coef, 60, 16, 0, 1, 0, 77, 2
pre-proc-coef, 62, 16, 0, 1, 0, 79, 2
pre-proc-coef, 58, 16, 0, 1, 0, 75, 2
pre-proc-coef, 58, 15, 0, 1, 0, 74, 2
pre-proc-coef, 59, 15, 0, 1, 0, 75, 2
pre-proc-coef, 59, 16, 0, 1, 0, 76, 2
pre-proc-coef, 61, 16, 0, 1, 0, 78, 2
pre-proc-coef, 64, 15, 0, 1, 0, 80, 2
pre-proc-coef, 58, 16, 0, 1, 0, 75, 2
pre-proc-coef, 61, 16, 0, 1, 0, 78, 2
pre-proc-coef, 63, 16, 0, 1, 0, 80, 2
pre-proc-coef, 65, 16, 0, 1, 0, 82, 2
pre-proc-coef, 62, 16, 0, 1, 0, 79, 2
pre-proc-coef, 63, 16, 0, 1, 0, 80, 2
pre-proc-coef, 63, 15, 0, 1, 0, 79, 2
pre-proc-coef, 61, 16, 0, 1, 0, 78, 2
pre-proc-coef, 59, 16, 0, 1, 0, 76, 2
pre-proc-coef, 62, 16, 0, 1, 0, 79, 2
pre-proc-coef, 64, 16, 0, 1, 0, 81, 2
pre-proc-coef, 61, 16, 0, 1, 0, 78, 2
pre-proc-coef, 62, 16, 0, 1, 0, 79, 2
pre-proc-coef, 62, 16, 0, 1, 0, 79, 2
pre-proc-coef, 60, 16, 0, 1, 0, 77, 2
pre-proc-coef, 58, 16, 0, 1, 0, 75, 2
pre-proc-coef, 68, 16, 0, 1, 0, 85, 2
pre-proc-coef, 61, 16, 0, 1, 0, 78, 2
pre-proc-coef, 58, 16, 0, 1, 0, 75, 2
pre-proc-coef, 59, 18, 0, 1, 0, 78, 2
pre-proc-coef, 60, 16, 0, 1, 0, 77, 2
pre-proc-coef, 62, 16, 0, 1, 0, 79, 2
pre-proc-coef, 59, 16, 0, 1, 0, 76, 2
pre-proc-coef, 61, 16, 0, 1, 0, 78, 2
pre-proc-coef, 61, 15, 0, 1, 0, 77, 2
pre-proc-coef, 61, 15, 0, 1, 0, 77, 2
pre-proc-coef, 64, 16, 0, 1, 0, 81, 2
pre-proc-coef, 65, 16, 0, 1, 0, 82, 2
pre-proc-coef, 59, 16, 0, 1, 0, 76, 2
pre-proc-coef, 59, 16, 0, 1, 0, 76, 2
pre-proc-coef, 62, 16, 0, 1, 0, 79, 2
pre-proc-coef, 58, 16, 0, 1, 0, 75, 2
pre-proc-coef, 59, 15, 0, 1, 0, 75, 2
pre-proc-coef, 59, 16, 1, 1, 0, 77, 2
pre-proc-coef, 58, 15, 0, 1, 0, 74, 2
pre-proc-coef, 66, 17, 0, 1, 0, 84, 2
pre-proc-coef, 59, 16, 0, 1, 0, 76, 2
pre-proc-coef, 62, 16, 0, 1, 0, 79, 2
pre-proc-coef, 60, 16, 0, 1, 0, 77, 2
pre-proc-coef, 61, 16, 0, 1, 0, 78, 2
pre-proc-coef, 63, 16, 0, 1, 0, 80, 2
pre-proc-coef, 61, 16, 0, 1, 0, 78, 2
pre-proc-coef, 62, 16, 0, 1, 0, 79, 2
pre-proc-coef, 69, 16, 0, 1, 0, 86, 2
pre-proc-coef, 67, 16, 0, 1, 0, 84, 2
pre-proc-coef, 59, 17, 0, 1, 0, 77, 2
pre-proc-coef, 62, 16, 0, 1, 0, 79, 2
pre-proc-coef, 61, 16, 0, 1, 0, 78, 2
pre-proc-coef, 58, 16, 0, 1, 0, 75, 2
pre-proc-coef, 59, 16, 0, 1, 0, 76, 2
pre-proc-coef, 60, 15, 0, 1, 0, 76, 2
pre-proc-coef, 61, 16, 0, 1, 0, 78, 2
pre-proc-coef, 59, 16, 0, 1, 0, 76, 2
pre-proc-coef, 64, 15, 0, 1, 0, 80, 2
pre-proc-coef, 59, 16, 0, 1, 0, 76, 2
pre-proc-coef, 59, 18, 0, 1, 0, 78, 2
pre-proc-coef, 58, 15, 0, 1, 0, 74, 2
pre-proc-coef, 61, 16, 0, 1, 0, 78, 2
pre-proc-coef, 67, 18, 0, 1, 0, 86, 2
pre-proc-coef, 62, 16, 0, 1, 0, 79, 2
pre-proc-coef, 58, 16, 0, 1, 0, 75, 2
pre-proc-coef, 65, 15, 0, 1, 0, 81, 2
pre-proc-coef, 58, 15, 0, 1, 0, 74, 2
pre-proc-coef, 61, 16, 0, 1, 0, 78, 2
pre-proc-coef, 59, 16, 0, 1, 0, 76, 2
pre-proc-coef, 59, 16, 0, 1, 0, 76, 2
pre-proc-coef, 59, 17, 0, 1, 0, 77, 2
pre-proc-coef, 61, 15, 0, 1, 0, 77, 2
pre-proc-coef, 62, 16, 0, 1, 0, 79, 2
pre-proc-coef, 58, 16, 0, 1, 0, 75, 2
pre-proc-coef, 60, 15, 0, 1, 0, 76, 2
pre-proc-coef, 58, 16, 0, 1, 0, 75, 2
pre-proc-coef, 64, 16, 0, 1, 0, 81, 2
pre-proc-coef, 63, 16, 0, 1, 0, 80, 2
pre-proc-coef, 58, 16, 0, 1, 0, 75, 2
pre-proc-coef, 59, 16, 0, 1, 0, 76, 2
pre-proc-coef, 59, 16, 1, 1, 0, 77, 2
pre-proc-coef, 58, 16, 0, 1, 0, 75, 2
pre-proc-coef, 66, 16, 0, 1, 0, 83, 2
pre-proc-coef, 63, 16, 0, 1, 0, 80, 2
pre-proc-coef, 62, 16, 0, 1, 0, 79, 2
pre-proc-coef, 59, 16, 0, 1, 0, 76, 2
pre-proc-coef, 62, 16, 0, 1, 0, 79, 2
pre-proc-coef, 61, 16, 0, 1, 0, 78, 2
pre-proc-coef, 59, 15, 0, 1, 0, 75, 2
pre-proc-coef, 59, 19, 0, 1, 0, 79, 2
pre-proc-coef, 59, 16, 0, 1, 0, 76, 2
pre-proc-coef, 58, 15, 1, 1, 0, 75, 2
pre-proc-coef, 63, 16, 0, 1, 0, 80, 2
pre-proc-coef, 59, 16, 0, 1, 0, 76, 2
pre-proc-coef, 74, 15, 0, 1, 0, 90, 2
pre-proc-coef, 61, 16, 0, 1, 0, 78, 2
pre-proc-coef, 61, 15, 0, 1, 0, 77, 2
pre-proc-coef, 59, 16, 0, 1, 0, 76, 2
pre-proc-coef, 62, 15, 0, 1, 0, 78, 2
pre-proc-coef, 60, 19, 0, 1, 0, 80, 2
pre-proc-coef, 60, 16, 0, 1, 0, 77, 2
pre-proc-coef, 62, 16, 0, 1, 0, 79, 2
pre-proc-coef, 62, 19, 0, 1, 0, 82, 2
pre-proc-coef, 60, 16, 0, 1, 0, 77, 2
pre-proc-coef, 66, 16, 1, 1, 0, 84, 2
pre-proc-coef, 63, 15, 0, 1, 0, 79, 2
pre-proc-coef, 62, 16, 0, 1, 0, 79, 2
pre-proc-coef, 59, 16, 0, 1, 0, 76, 2
pre-proc-coef, 59, 15, 0, 1, 0, 75, 2
pre-proc-coef, 76, 15, 0, 1, 0, 92, 2
pre-proc-coef, 59, 15, 0, 1, 0, 75, 2
pre-proc-coef, 61, 16, 0, 1, 0, 78, 2
pre-proc-coef, 59, 16, 0, 1, 0, 76, 2
pre-proc-coef, 64, 16, 0, 1, 0, 81, 2
pre-proc-coef, 61, 15, 0, 1, 0, 77, 2
pre-proc-coef, 59, 16, 0, 1, 0, 76, 2
pre-proc-coef, 59, 16, 0, 1, 0, 76, 2
pre-proc-coef, 63, 16, 0, 1, 0, 80, 2
pre-proc-coef, 62, 16, 0, 1, 0, 79, 2
pre-proc-coef, 59, 16, 0, 1, 0, 76, 2
pre-proc-coef, 60, 16, 0, 1, 0, 77, 2
pre-proc-coef, 59, 16, 0, 1, 0, 76, 2
pre-proc-coef, 63, 20, 0, 1, 0, 84, 2
pre-proc-coef, 61, 16, 1, 1, 0, 79, 2
pre-proc-coef, 59, 15, 0, 1, 0, 75, 2
pre-proc-coef, 60, 16, 0, 1, 0, 77, 2
pre-proc-coef, 62, 16, 0, 1, 0, 79, 2
pre-proc-coef, 61, 16, 0, 1, 0, 78, 2
pre-proc-coef, 59, 16, 0, 1, 0, 76, 2
pre-proc-coef, 62, 16, 0, 1, 0, 79, 2
pre-proc-coef, 60, 16, 0, 1, 0, 77, 2
pre-proc-coef, 59, 15, 0, 1, 0, 75, 2
pre-proc-coef, 71, 16, 0, 1, 0, 88, 2
pre-proc-coef, 59, 16, 0, 1, 0, 76, 2
pre-proc-coef, 61, 17, 0, 1, 0, 79, 2
pre-proc-coef, 63, 16, 0, 1, 0, 80, 2
pre-proc-coef, 66, 16, 0, 1, 0, 83, 2
pre-proc-coef, 61, 15, 0, 1, 0, 77, 2
pre-proc-coef, 58, 16, 0, 1, 0, 75, 2
pre-proc-coef, 60, 16, 0, 1, 0, 77, 2
pre-proc-coef, 59, 16, 0, 1, 0, 76, 2
pre-proc-coef, 59, 16, 0, 1, 0, 76, 2
pre-proc-coef, 59, 16, 0, 1, 0, 76, 2
pre-proc-coef, 58, 15, 0, 1, 0, 74, 2
pre-proc-coef, 63, 16, 0, 1, 0, 80, 2
pre-proc-coef, 59, 16, 0, 1, 0, 76, 2
pre-proc-coef, 58, 16, 0, 1, 0, 75, 2
pre-proc-coef, 65, 15, 0, 1, 0, 81, 2
pre-proc-coef, 61, 16, 0, 1, 0, 78, 2
pre-proc-coef, 59, 16, 0, 1, 0, 76, 2
pre-proc-coef, 59, 15, 0, 1, 0, 75, 2
pre-proc-coef, 64, 16, 0, 1, 0, 81, 2
pre-proc-coef, 64, 15, 0, 1, 0, 80, 2
pre-proc-coef, 58, 16, 0, 1, 0, 75, 2
pre-proc-coef, 61, 15, 0, 1, 0, 77, 2
pre-proc-coef, 63, 16, 0, 1, 0, 80, 2
pre-proc-coef, 62, 16, 0, 1, 0, 79, 2
pre-proc-coef, 59, 16, 0, 1, 0, 76, 2
pre-proc-coef, 68, 16, 0, 1, 0, 85, 2
pre-proc-coef, 63, 15, 0, 1, 0, 79, 2
pre-proc-coef, 61, 16, 0, 1, 0, 78, 2
pre-proc-coef, 60, 16, 0, 1, 0, 77, 2
pre-proc-coef, 62, 16, 0, 1, 0, 79, 2
pre-proc-coef, 58, 15, 0, 1, 0, 74, 2
pre-proc-coef, 65, 16, 0, 1, 0, 82, 2
pre-proc-coef, 57, 16, 0, 1, 0, 74, 2
pre-proc-coef, 58, 16, 0, 1, 0, 75, 2
pre-proc-coef, 61, 20, 0, 1, 0, 82, 2
pre-proc-coef, 62, 16, 0, 1, 0, 79, 2
pre-proc-coef, 59, 16, 0, 1, 0, 76, 2
pre-proc-coef, 62, 16, 0, 1, 0, 79, 2
pre-proc-coef, 59, 16, 0, 1, 0, 76, 2
pre-proc-coef, 59, 15, 0, 1, 0, 75, 2
pre-proc-coef, 59, 16, 0, 1, 0, 76, 2
pre-proc-coef, 62, 16, 0, 1, 0, 79, 2
pre-proc-coef, 60, 16, 0, 1, 0, 77, 2
pre-proc-coef, 64, 15, 0, 1, 0, 80, 2
pre-proc-coef, 61, 16, 0, 1, 0, 78, 2
pre-proc-coef, 59, 16, 0, 1, 0, 76, 2
pre-proc-coef, 65, 16, 0, 1, 0, 82, 2
pre-proc-coef, 60, 15, 0, 1, 0, 76, 2
pre-proc-coef, 59, 20, 0, 1, 0, 80, 2
pre-proc-coef, 62, 16, 0, 1, 0, 79, 2
pre-proc-coef, 61, 16, 0, 1, 0, 78, 2
pre-proc-coef, 60, 16, 0, 1, 0, 77, 2
pre-proc-coef, 62, 16, 0, 1, 0, 79, 2
pre-proc-coef, 63, 15, 0, 1, 0, 79, 2
pre-proc-coef, 59, 16, 1, 1, 0, 77, 2
pre-proc-coef, 58, 16, 0, 1, 0, 75, 2
pre-proc-coef, 71, 15, 0, 1, 0, 87, 2
pre-proc-coef, 58, 18, 0, 1, 0, 77, 2
pre-proc-coef, 61, 16, 0, 1, 0, 78, 2
pre-proc-coef, 58, 15, 1, 1, 0, 75, 2
pre-proc-coef, 59, 16, 0, 1, 0, 76, 2
pre-proc-coef, 59, 16, 0, 1, 0, 76, 2
pre-proc-coef, 60, 16, 0, 1, 0, 77, 2
pre-proc-coef, 61, 16, 0, 1, 0, 78, 2
pre-proc-coef, 59, 16, 0, 1, 0, 76, 2
pre-proc-coef, 60, 16, 0, 1, 0, 77, 2
pre-proc-coef, 61, 15, 0, 1, 0, 77, 2
pre-proc-coef, 62, 16, 0, 1, 0, 79, 2
pre-proc-coef, 61, 15, 0, 1, 0, 77, 2
pre-proc-coef, 67, 16, 0, 1, 0, 84, 2
pre-proc-coef, 59, 16, 0, 1, 0, 76, 2
pre-proc-coef, 58, 16, 0, 1, 0, 75, 2
pre-proc-coef, 59, 16, 0, 1, 0, 76, 2
pre-proc-coef, 60, 15, 0, 1, 0, 76, 2
pre-proc-coef, 62, 15, 1, 1, 0, 79, 2
pre-proc-coef, 59, 15, 0, 1, 0, 75, 2
pre-proc-coef, 59, 16, 0, 1, 0, 76, 2
pre-proc-coef, 63, 15, 0, 1, 0, 79, 2
pre-proc-coef, 59, 15, 0, 1, 0, 75, 2
pre-proc-coef, 60, 16, 0, 1, 0, 77, 2
pre-proc-coef, 58, 19, 0, 1, 0, 78, 2
pre-proc-coef, 58, 16, 0, 1, 0, 75, 2
pre-proc-coef, 58, 15, 0, 1, 0, 74, 2
pre-proc-coef, 60, 16, 0, 1, 0, 77, 2
pre-proc-coef, 61, 15, 0, 1, 0, 77, 2
pre-proc-coef, 62, 16, 0, 1, 0, 79, 2
pre-proc-coef, 59, 16, 0, 1, 0, 76, 2
pre-proc-coef, 59, 16, 0, 1, 0, 76, 2
pre-proc-coef, 59, 16, 0, 1, 0, 76, 2
pre-proc-coef, 61, 16, 0, 1, 0, 78, 2
pre-proc-coef, 68, 16, 0, 1, 0, 85, 2
pre-proc-coef, 63, 16, 0, 1, 0, 80, 2
pre-proc-coef, 59, 16, 0, 1, 0, 76, 2
pre-proc-coef, 79, 16, 0, 1, 0, 96, 2
pre-proc-coef, 59, 16, 0, 1, 0, 76, 2
pre-proc-coef, 58, 16, 0, 1, 0, 75, 2
pre-proc-coef, 59, 16, 0, 1, 0, 76, 2
pre-proc-coef, 62, 15, 0, 1, 0, 78, 2
pre-proc-coef, 57, 15, 0, 1, 0, 73, 2
pre-proc-coef, 59, 16, 0, 1, 0, 76, 2
pre-proc-coef, 67, 16, 0, 1, 0, 84, 2
pre-proc-coef, 61, 19, 0, 1, 0, 81, 2
pre-proc-coef, 64, 16, 0, 1, 0, 81, 2
pre-proc-coef, 59, 16, 0, 1, 0, 76, 2
pre-proc-coef, 58, 15, 0, 1, 0, 74, 2
pre-proc-coef, 59, 16, 0, 1, 0, 76, 2
pre-proc-coef, 61, 15, 0, 1, 0, 77, 2
pre-proc-coef, 61, 18, 0, 1, 0, 80, 2
pre-proc-coef, 58, 16, 0, 1, 0, 75, 2
pre-proc-coef, 60, 16, 0, 1, 0, 77, 2
pre-proc-coef, 58, 16, 0, 1, 0, 75, 2
pre-proc-coef, 60, 15, 0, 1, 0, 76, 2
pre-proc-coef, 58, 16, 0, 1, 0, 75, 2
pre-proc-coef, 60, 18, 0, 1, 0, 79, 2
pre-proc-coef, 59, 19, 0, 1, 0, 79, 2
pre-proc-coef, 60, 16, 0, 1, 0, 77, 2
pre-proc-coef, 62, 21, 0, 1, 0, 84, 2
pre-proc-coef, 61, 15, 0, 1, 0, 77, 2
pre-proc-coef, 60, 16, 0, 1, 0, 77, 2
pre-proc-coef, 62, 16, 0, 1, 0, 79, 2
pre-proc-coef, 62, 16, 1, 1, 0, 80, 2
pre-proc-coef, 58, 16, 0, 1, 0, 75, 2
pre-proc-coef, 59, 16, 0, 1, 0, 76, 2
pre-proc-coef, 59, 16, 0, 1, 0, 76, 2
pre-proc-coef, 59, 16, 0, 1, 0, 76, 2
pre-proc-coef, 59, 16, 0, 1, 0, 76, 2
pre-proc-coef, 59, 16, 0, 1, 0, 76, 2
pre-proc-coef, 62, 16, 0, 1, 0, 79, 2
pre-proc-coef, 63, 16, 0, 1, 0, 80, 2
pre-proc-coef, 70, 15, 0, 1, 0, 86, 2
pre-proc-coef, 61, 15, 0, 1, 0, 77, 2
pre-proc-coef, 59, 16, 0, 1, 0, 76, 2
pre-proc-coef, 64, 16, 0, 1, 0, 81, 2
pre-proc-coef, 62, 16, 0, 1, 0, 79, 2
pre-proc-coef, 59, 16, 0, 1, 0, 76, 2
pre-proc-coef, 58, 15, 0, 1, 0, 74, 2
coef-rot, 53440, 31, 8985, 1, 0, 62457, 0.0136719
coef-rot, 53049, 15, 9089, 1, 0, 62154, 0.0136719
coef-rot, 52856, 15, 8959, 1, 0, 61831, 0.0136719
coef-rot, 52895, 15, 9120, 1, 0, 62031, 0.0136719
coef-rot, 53168, 15, 9021, 1, 0, 62205, 0.0136719
coef-rot, 53059, 16, 9082, 1, 0, 62158, 0.0136719
coef-rot, 53039, 16, 9157, 1, 0, 62213, 0.0136719
coef-rot, 52848, 16, 8867, 1, 0, 61732, 0.0136719
coef-rot, 53099, 16, 9237, 1, 0, 62353, 0.0136719
coef-rot, 53218, 15, 9081, 1, 0, 62315, 0.0136719
