type, setup, encryption, homomorphic, decryption, plaintext, total, value

deduced-slot, 442, 27, 333, 1, 0, 803, 0.666626
deduced-slot, 373, 13, 194, 1, 0, 581, 0.666626
deduced-slot, 283, 11, 163, 1, 0, 458, 0.666626
deduced-slot, 293, 11, 155, 1, 0, 460, 0.666626
deduced-slot, 300, 11, 153, 1, 0, 465, 0.666626
deduced-slot, 307, 11, 157, 1, 0, 476, 0.666626
deduced-slot, 284, 14, 161, 1, 0, 460, 0.666626
deduced-slot, 288, 11, 174, 1, 0, 474, 0.666626
deduced-slot, 337, 17, 1087, 1, 0, 1442, 0.666626
deduced-slot, 610, 33, 306, 1, 0, 950, 0.666626
deduced-slot, 289, 11, 164, 1, 0, 465, 0.666626
deduced-slot, 330, 13, 158, 1, 0, 502, 0.666626
deduced-slot, 300, 11, 160, 1, 0, 472, 0.666626
deduced-slot, 306, 11, 159, 1, 0, 477, 0.666626
deduced-slot, 835, 48, 246, 1, 0, 1130, 0.666626
deduced-slot, 298, 11, 886, 5, 0, 1200, 0.666626
deduced-slot, 303, 11, 155, 1, 0, 470, 0.666626
deduced-slot, 430, 25, 331, 1, 0, 787, 0.666626
deduced-slot, 501, 11, 194, 1, 0, 707, 0.666626
deduced-slot, 460, 14, 220, 1, 0, 695, 0.666626
deduced-slot, 297, 12, 191, 1, 0, 501, 0.666626
deduced-slot, 295, 11, 243, 1, 0, 550, 0.666626
deduced-slot, 390, 22, 326, 1, 0, 739, 0.666626
deduced-slot, 292, 11, 200, 1, 0, 504, 0.666626
deduced-slot, 350, 38, 500, 1, 0, 889, 0.666626
deduced-slot, 1022, 28, 486, 1, 0, 1537, 0.666626
deduced-slot, 742, 33, 327, 1, 0, 1103, 0.666626
deduced-slot, 454, 30, 280, 1, 0, 765, 0.666626
deduced-slot, 462, 22, 261, 1, 0, 746, 0.666626
deduced-slot, 352, 19, 212, 1, 0, 584, 0.666626
deduced-slot, 366, 18, 227, 1, 0, 612, 0.666626
deduced-slot, 432, 11, 218, 1, 0, 662, 0.666626
deduced-slot, 371, 11, 220, 1, 0, 603, 0.666626
deduced-slot, 295, 11, 156, 1, 0, 463, 0.666626
deduced-slot, 367, 22, 220, 1, 0, 610, 0.666626
deduced-slot, 380, 11, 218, 1, 0, 610, 0.666626
deduced-slot, 335, 12, 237, 1, 0, 585, 0.666626
deduced-slot, 291, 11, 152, 1, 0, 455, 0.666626
deduced-slot, 297, 11, 158, 1, 0, 467, 0.666626
deduced-slot, 303, 11, 159, 1, 0, 474, 0.666626
deduced-slot, 290, 11, 165, 1, 0, 467, 0.666626
deduced-slot, 634, 14, 449, 1, 0, 1098, 0.666626
deduced-slot, 448, 12, 215, 1, 0, 676, 0.666626
deduced-slot, 605, 11, 289, 1, 0, 906, 0.666626
deduced-slot, 327, 11, 154, 1, 0, 493, 0.666626
deduced-slot, 301, 11, 154, 1, 0, 467, 0.666626
deduced-slot, 301, 11, 155, 1, 0, 468, 0.666626
deduced-slot, 529, 12, 335, 1, 0, 877, 0.666626
deduced-slot, 707, 85, 655, 1, 0, 1448, 0.666626
deduced-slot, 424, 11, 197, 1, 0, 633, 0.666626
deduced-slot, 295, 14, 227, 1, 0, 537, 0.666626
deduced-slot, 313, 12, 153, 1, 0, 479, 0.666626
deduced-slot, 326, 11, 462, 1, 0, 800, 0.666626
deduced-slot, 385, 12, 181, 1, 0, 579, 0.666626
deduced-slot, 289, 11, 173, 1, 0, 474, 0.666626
deduced-slot, 304, 12, 158, 1, 0, 475, 0.666626
deduced-slot, 297, 11, 154, 1, 0, 463, 0.666626
deduced-slot, 596, 11, 158, 1, 0, 766, 0.666626
deduced-slot, 302, 11, 153, 1, 0, 467, 0.666626
deduced-slot, 291, 11, 155, 1, 0, 458, 0.666626
deduced-slot, 290, 11, 151, 1, 0, 453, 0.666626
deduced-slot, 287, 11, 153, 1, 0, 452, 0.666626
deduced-slot, 287, 11, 155, 1, 0, 454, 0.666626
deduced-slot, 287, 11, 155, 1, 0, 454, 0.666626
deduced-slot, 291, 11, 153, 1, 0, 456, 0.666626
deduced-slot, 291, 11, 161, 1, 0, 464, 0.666626
deduced-slot, 290, 11, 156, 1, 0, 458, 0.666626
deduced-slot, 290, 11, 158, 1, 0, 460, 0.666626
deduced-slot, 294, 11, 157, 1, 0, 463, 0.666626
deduced-slot, 290, 12, 156, 1, 0, 459, 0.666626
deduced-slot, 283, 11, 160, 1, 0, 455, 0.666626
deduced-slot, 286, 11, 156, 1, 0, 454, 0.666626
deduced-slot, 290, 11, 155, 1, 0, 457, 0.666626
deduced-slot, 285, 11, 160, 1, 0, 457, 0.666626
deduced-slot, 287, 11, 159, 1, 0, 458, 0.666626
deduced-slot, 287, 11, 155, 1, 0, 454, 0.666626
deduced-slot, 286, 11, 155, 1, 0, 453, 0.666626
deduced-slot, 286, 11, 150, 1, 0, 448, 0.666626
deduced-slot, 308, 12, 156, 1, 0, 477, 0.666626
deduced-slot, 294, 11, 158, 1, 0, 464, 0.666626
deduced-slot, 288, 11, 160, 1, 0, 460, 0.666626
deduced-slot, 293, 11, 150, 1, 0, 455, 0.666626
deduced-slot, 291, 11, 149, 1, 0, 452, 0.666626
deduced-slot, 286, 11, 158, 1, 0, 456, 0.666626
deduced-slot, 288, 11, 152, 1, 0, 452, 0.666626
deduced-slot, 286, 11, 155, 1, 0, 453, 0.666626
deduced-slot, 300, 11, 154, 1, 0, 466, 0.666626
deduced-slot, 286, 11, 155, 1, 0, 453, 0.666626
deduced-slot, 285, 11, 159, 1, 0, 456, 0.666626
deduced-slot, 290, 11, 153, 1, 0, 455, 0.666626
deduced-slot, 288, 11, 159, 1, 0, 459, 0.666626
deduced-slot, 286, 11, 154, 1, 0, 452, 0.666626
deduced-slot, 282, 11, 159, 1, 0, 453, 0.666626
deduced-slot, 290, 11, 155, 1, 0, 457, 0.666626
deduced-slot, 284, 11, 151, 1, 0, 447, 0.666626
deduced-slot, 293, 11, 156, 1, 0, 461, 0.666626
deduced-slot, 287, 11, 162, 1, 0, 461, 0.666626
deduced-slot, 291, 11, 159, 1, 0, 462, 0.666626
deduced-slot, 283, 11, 151, 1, 0, 446, 0.666626
deduced-slot, 291, 11, 157, 1, 0, 460, 0.666626
deduced-slot, 288, 11, 152, 1, 0, 452, 0.666626
deduced-slot, 286, 18, 161, 1, 0, 466, 0.666626
deduced-slot, 287, 11, 154, 1, 0, 453, 0.666626
deduced-slot, 292, 11, 158, 1, 0, 462, 0.666626
deduced-slot, 291, 12, 158, 1, 0, 462, 0.666626
deduced-slot, 286, 16, 162, 1, 0, 465, 0.666626
deduced-slot, 289, 11, 158, 1, 0, 459, 0.666626
deduced-slot, 292, 11, 155, 1, 0, 459, 0.666626
deduced-slot, 290, 11, 158, 1, 0, 460, 0.666626
deduced-slot, 293, 11, 155, 1, 0, 460, 0.666626
deduced-slot, 284, 11, 154, 1, 0, 450, 0.666626
deduced-slot, 288, 11, 156, 1, 0, 456, 0.666626
deduced-slot, 291, 11, 150, 1, 0, 453, 0.666626
deduced-slot, 293, 11, 151, 1, 0, 456, 0.666626
deduced-slot, 290, 12, 154, 1, 0, 457, 0.666626
deduced-slot, 287, 11, 157, 1, 0, 456, 0.666626
deduced-slot, 298, 11, 158, 1, 0, 468, 0.666626
deduced-slot, 291, 11, 158, 1, 0, 461, 0.666626
deduced-slot, 293, 11, 157, 1, 0, 462, 0.666626
deduced-slot, 287, 11, 159, 1, 0, 458, 0.666626
deduced-slot, 286, 11, 158, 1, 0, 456, 0.666626
deduced-slot, 289, 11, 155, 1, 0, 456, 0.666626
deduced-slot, 300, 11, 158, 1, 0, 470, 0.666626
deduced-slot, 287, 11, 155, 1, 0, 454, 0.666626
deduced-slot, 306, 11, 159, 1, 0, 477, 0.666626
deduced-slot, 293, 11, 150, 1, 0, 455, 0.666626
deduced-slot, 292, 11, 150, 1, 0, 454, 0.666626
deduced-slot, 291, 11, 157, 1, 0, 460, 0.666626
deduced-slot, 288, 11, 159, 1, 0, 459, 0.666626
deduced-slot, 288, 11, 161, 5, 0, 465, 0.666626
deduced-slot, 296, 12, 162, 1, 0, 471, 0.666626
deduced-slot, 289, 11, 155, 1, 0, 456, 0.666626
deduced-slot, 294, 11, 154, 1, 0, 460, 0.666626
deduced-slot, 288, 11, 160, 1, 0, 460, 0.666626
deduced-slot, 295, 11, 155, 1, 0, 462, 0.666626
deduced-slot, 289, 11, 157, 1, 0, 458, 0.666626
deduced-slot, 289, 11, 158, 1, 0, 459, 0.666626
deduced-slot, 292, 14, 159, 1, 0, 466, 0.666626
deduced-slot, 290, 11, 161, 1, 0, 463, 0.666626
deduced-slot, 290, 11, 159, 1, 0, 461, 0.666626
deduced-slot, 290, 11, 156, 1, 0, 458, 0.666626
deduced-slot, 288, 11, 148, 1, 0, 448, 0.666626
deduced-slot, 284, 11, 153, 1, 0, 449, 0.666626
deduced-slot, 286, 11, 156, 1, 0, 454, 0.666626
deduced-slot, 295, 11, 158, 1, 0, 465, 0.666626
deduced-slot, 291, 11, 154, 1, 0, 457, 0.666626
deduced-slot, 295, 12, 154, 1, 0, 462, 0.666626
deduced-slot, 285, 12, 164, 1, 0, 462, 0.666626
deduced-slot, 290, 11, 157, 1, 0, 459, 0.666626
deduced-slot, 292, 11, 154, 1, 0, 458, 0.666626
deduced-slot, 297, 11, 159, 1, 0, 468, 0.666626
deduced-slot, 286, 11, 164, 1, 0, 462, 0.666626
deduced-slot, 287, 12, 156, 1, 0, 456, 0.666626
deduced-slot, 294, 11, 153, 1, 0, 459, 0.666626
deduced-slot, 293, 11, 159, 1, 0, 464, 0.666626
deduced-slot, 298, 11, 156, 1, 0, 466, 0.666626
deduced-slot, 288, 11, 162, 1, 0, 462, 0.666626
deduced-slot, 291, 11, 158, 1, 0, 461, 0.666626
deduced-slot, 287, 11, 152, 1, 0, 451, 0.666626
deduced-slot, 290, 11, 155, 1, 0, 457, 0.666626
deduced-slot, 286, 11, 156, 1, 0, 454, 0.666626
deduced-slot, 291, 11, 157, 1, 0, 460, 0.666626
deduced-slot, 288, 11, 161, 1, 0, 461, 0.666626
deduced-slot, 287, 11, 152, 1, 0, 451, 0.666626
deduced-slot, 287, 11, 149, 1, 0, 448, 0.666626
deduced-slot, 290, 11, 155, 1, 0, 457, 0.666626
deduced-slot, 283, 11, 149, 1, 0, 444, 0.666626
deduced-slot, 289, 12, 159, 1, 0, 461, 0.666626
deduced-slot, 286, 11, 154, 1, 0, 452, 0.666626
deduced-slot, 288, 11, 160, 1, 0, 460, 0.666626
deduced-slot, 287, 11, 169, 1, 0, 468, 0.666626
deduced-slot, 287, 12, 152, 1, 0, 452, 0.666626
deduced-slot, 289, 11, 157, 1, 0, 458, 0.666626
deduced-slot, 288, 11, 155, 1, 0, 455, 0.666626
deduced-slot, 294, 11, 157, 1, 0, 463, 0.666626
deduced-slot, 285, 11, 152, 1, 0, 449, 0.666626
deduced-slot, 290, 11, 153, 1, 0, 455, 0.666626
deduced-slot, 288, 11, 155, 1, 0, 455, 0.666626
deduced-slot, 286, 11, 155, 1, 0, 453, 0.666626
deduced-slot, 288, 11, 152, 1, 0, 452, 0.666626
deduced-slot, 285, 11, 154, 1, 0, 451, 0.666626
deduced-slot, 286, 12, 157, 1, 0, 456, 0.666626
deduced-slot, 287, 11, 158, 1, 0, 457, 0.666626
deduced-slot, 294, 11, 161, 1, 0, 467, 0.666626
deduced-slot, 292, 11, 158, 1, 0, 462, 0.666626
deduced-slot, 288, 11, 158, 1, 0, 458, 0.666626
deduced-slot, 286, 11, 156, 1, 0, 454, 0.666626
deduced-slot, 289, 11, 160, 1, 0, 461, 0.666626
deduced-slot, 291, 11, 155, 1, 0, 458, 0.666626
deduced-slot, 293, 11, 158, 1, 0, 463, 0.666626
deduced-slot, 291, 11, 157, 1, 0, 460, 0.666626
deduced-slot, 285, 11, 152, 1, 0, 449, 0.666626
deduced-slot, 285, 11, 159, 1, 0, 456, 0.666626
deduced-slot, 286, 11, 158, 1, 0, 456, 0.666626
deduced-slot, 289, 11, 160, 1, 0, 461, 0.666626
deduced-slot, 285, 11, 178, 1, 0, 475, 0.666626
deduced-slot, 293, 11, 155, 1, 0, 460, 0.666626
deduced-slot, 288, 11, 162, 1, 0, 462, 0.666626
deduced-slot, 291, 11, 156, 1, 0, 459, 0.666626
deduced-slot, 290, 11, 155, 1, 0, 457, 0.666626
deduced-slot, 287, 11, 156, 1, 0, 455, 0.666626
deduced-slot, 293, 11, 158, 1, 0, 463, 0.666626
deduced-slot, 291, 11, 163, 1, 0, 466, 0.666626
deduced-slot, 285, 11, 155, 1, 0, 452, 0.666626
deduced-slot, 290, 11, 152, 1, 0, 454, 0.666626
deduced-slot, 285, 11, 152, 1, 0, 449, 0.666626
deduced-slot, 286, 11, 148, 1, 0, 446, 0.666626
deduced-slot, 287, 11, 151, 1, 0, 450, 0.666626
deduced-slot, 289, 11, 157, 1, 0, 458, 0.666626
deduced-slot, 290, 11, 158, 1, 0, 460, 0.666626
deduced-slot, 288, 11, 159, 1, 0, 459, 0.666626
deduced-slot, 285, 11, 152, 1, 0, 449, 0.666626
deduced-slot, 284, 11, 152, 1, 0, 448, 0.666626
deduced-slot, 290, 11, 153, 1, 0, 455, 0.666626
deduced-slot, 289, 11, 157, 1, 0, 458, 0.666626
deduced-slot, 286, 11, 157, 1, 0, 455, 0.666626
deduced-slot, 284, 11, 159, 1, 0, 455, 0.666626
deduced-slot, 289, 11, 157, 1, 0, 458, 0.666626
deduced-slot, 288, 11, 153, 1, 0, 453, 0.666626
deduced-slot, 291, 11, 153, 1, 0, 456, 0.666626
deduced-slot, 288, 12, 156, 1, 0, 457, 0.666626
deduced-slot, 291, 12, 159, 1, 0, 463, 0.666626
deduced-slot, 289, 11, 157, 1, 0, 458, 0.666626
deduced-slot, 294, 11, 157, 1, 0, 463, 0.666626
deduced-slot, 289, 12, 157, 1, 0, 459, 0.666626
deduced-slot, 293, 15, 158, 1, 0, 467, 0.666626
deduced-slot, 292, 12, 156, 1, 0, 461, 0.666626
deduced-slot, 290, 11, 161, 1, 0, 463, 0.666626
deduced-slot, 288, 11, 157, 1, 0, 457, 0.666626
deduced-slot, 287, 11, 158, 1, 0, 457, 0.666626
deduced-slot, 288, 11, 157, 1, 0, 457, 0.666626
deduced-slot, 293, 11, 155, 1, 0, 460, 0.666626
deduced-slot, 286, 11, 149, 1, 0, 447, 0.666626
deduced-slot, 283, 11, 152, 1, 0, 447, 0.666626
deduced-slot, 285, 11, 154, 1, 0, 451, 0.666626
deduced-slot, 289, 11, 156, 1, 0, 457, 0.666626
deduced-slot, 291, 11, 157, 1, 0, 460, 0.666626
deduced-slot, 287, 11, 162, 1, 0, 461, 0.666626
deduced-slot, 292, 11, 156, 1, 0, 460, 0.666626
deduced-slot, 287, 11, 159, 1, 0, 458, 0.666626
deduced-slot, 293, 11, 159, 1, 0, 464, 0.666626
deduced-slot, 285, 11, 152, 1, 0, 449, 0.666626
deduced-slot, 284, 11, 152, 1, 0, 448, 0.666626
deduced-slot, 287, 11, 152, 1, 0, 451, 0.666626
deduced-slot, 287, 11, 153, 1, 0, 452, 0.666626
deduced-slot, 287, 11, 156, 1, 0, 455, 0.666626
deduced-slot, 288, 12, 157, 1, 0, 458, 0.666626
deduced-slot, 291, 11, 156, 1, 0, 459, 0.666626
deduced-slot, 292, 11, 155, 1, 0, 459, 0.666626
deduced-slot, 285, 11, 154, 1, 0, 451, 0.666626
deduced-slot, 289, 11, 157, 1, 0, 458, 0.666626
deduced-slot, 289, 11, 155, 1, 0, 456, 0.666626
deduced-slot, 293, 11, 154, 1, 0, 459, 0.666626
deduced-slot, 290, 11, 156, 1, 0, 458, 0.666626
deduced-slot, 288, 11, 152, 1, 0, 452, 0.666626
deduced-slot, 283, 11, 157, 1, 0, 452, 0.666626
deduced-slot, 286, 11, 151, 1, 0, 449, 0.666626
deduced-slot, 288, 11, 151, 1, 0, 451, 0.666626
deduced-slot, 288, 11, 153, 1, 0, 453, 0.666626
deduced-slot, 291, 11, 158, 1, 0, 461, 0.666626
deduced-slot, 290, 11, 155, 1, 0, 457, 0.666626
deduced-slot, 287, 11, 161, 1, 0, 460, 0.666626
deduced-slot, 298, 11, 161, 1, 0, 471, 0.666626
deduced-slot, 289, 11, 156, 1, 0, 457, 0.666626
deduced-slot, 289, 11, 157, 1, 0, 458, 0.666626
deduced-slot, 292, 11, 157, 1, 0, 461, 0.666626
deduced-slot, 291, 11, 154, 1, 0, 457, 0.666626
deduced-slot, 292, 11, 159, 1, 0, 463, 0.666626
deduced-slot, 288, 11, 158, 1, 0, 458, 0.666626
deduced-slot, 286, 11, 155, 1, 0, 453, 0.666626
deduced-slot, 285, 11, 155, 1, 0, 452, 0.666626
deduced-slot, 283, 11, 152, 1, 0, 447, 0.666626
deduced-slot, 284, 11, 156, 1, 0, 452, 0.666626
deduced-slot, 285, 11, 153, 1, 0, 450, 0.666626
deduced-slot, 288, 11, 157, 1, 0, 457, 0.666626
deduced-slot, 290, 11, 158, 1, 0, 460, 0.666626
deduced-slot, 288, 11, 155, 1, 0, 455, 0.666626
deduced-slot, 287, 11, 151, 1, 0, 450, 0.666626
deduced-slot, 284, 11, 152, 1, 0, 448, 0.666626
deduced-slot, 290, 11, 157, 1, 0, 459, 0.666626
deduced-slot, 288, 11, 155, 1, 0, 455, 0.666626
deduced-slot, 288, 12, 155, 1, 0, 456, 0.666626
deduced-slot, 296, 11, 162, 1, 0, 470, 0.666626
deduced-slot, 293, 11, 154, 1, 0, 459, 0.666626
deduced-slot, 292, 11, 156, 1, 0, 460, 0.666626
deduced-slot, 289, 11, 159, 1, 0, 460, 0.666626
deduced-slot, 286, 11, 160, 1, 0, 458, 0.666626
deduced-slot, 287, 11, 162, 1, 0, 461, 0.666626
deduced-slot, 288, 11, 163, 1, 0, 463, 0.666626
deduced-slot, 288, 11, 159, 1, 0, 459, 0.666626
deduced-slot, 288, 11, 153, 1, 0, 453, 0.666626
deduced-slot, 289, 11, 161, 1, 0, 462, 0.666626
deduced-slot, 291, 11, 156, 1, 0, 459, 0.666626
deduced-slot, 293, 12, 159, 1, 0, 465, 0.666626
deduced-slot, 292, 11, 150, 1, 0, 454, 0.666626
deduced-slot, 284, 12, 157, 1, 0, 454, 0.666626
deduced-slot, 287, 13, 156, 1, 0, 457, 0.666626
deduced-slot, 287, 11, 153, 1, 0, 452, 0.666626
deduced-slot, 285, 11, 151, 1, 0, 448, 0.666626
deduced-slot, 286, 11, 153, 1, 0, 451, 0.666626
deduced-slot, 283, 11, 157, 1, 0, 452, 0.666626
deduced-slot, 287, 11, 160, 1, 0, 459, 0.666626
deduced-slot, 290, 12, 163, 1, 0, 466, 0.666626
deduced-slot, 290, 11, 154, 1, 0, 456, 0.666626
deduced-slot, 288, 11, 162, 1, 0, 462, 0.666626
deduced-slot, 287, 11, 162, 1, 0, 461, 0.666626
deduced-slot, 289, 11, 164, 1, 0, 465, 0.666626
deduced-slot, 290, 11, 155, 1, 0, 457, 0.666626
deduced-slot, 288, 11, 154, 1, 0, 454, 0.666626
deduced-slot, 292, 11, 151, 1, 0, 455, 0.666626
deduced-slot, 289, 11, 155, 1, 0, 456, 0.666626
deduced-slot, 288, 12, 156, 1, 0, 457, 0.666626
deduced-slot, 288, 11, 163, 1, 0, 463, 0.666626
deduced-slot, 291, 11, 158, 1, 0, 461, 0.666626
deduced-slot, 292, 11, 161, 1, 0, 465, 0.666626
deduced-slot, 290, 12, 157, 1, 0, 460, 0.666626
deduced-slot, 288, 11, 156, 1, 0, 456, 0.666626
deduced-slot, 289, 12, 163, 1, 0, 465, 0.666626
deduced-slot, 287, 11, 155, 1, 0, 454, 0.666626
deduced-slot, 284, 11, 154, 1, 0, 450, 0.666626
deduced-slot, 286, 11, 159, 1, 0, 457, 0.666626
deduced-slot, 290, 11, 159, 1, 0, 461, 0.666626
deduced-slot, 291, 11, 154, 1, 0, 457, 0.666626
deduced-slot, 288, 11, 158, 1, 0, 458, 0.666626
deduced-slot, 308, 11, 157, 1, 0, 477, 0.666626
deduced-slot, 288, 11, 154, 1, 0, 454, 0.666626
deduced-slot, 301, 11, 157, 1, 0, 470, 0.666626
deduced-slot, 288, 12, 160, 1, 0, 461, 0.666626
deduced-slot, 289, 12, 158, 1, 0, 460, 0.666626
deduced-slot, 285, 11, 157, 1, 0, 454, 0.666626
deduced-slot, 294, 12, 161, 1, 0, 468, 0.666626
deduced-slot, 291, 11, 157, 1, 0, 460, 0.666626
deduced-slot, 285, 11, 157, 1, 0, 454, 0.666626
deduced-slot, 314, 11, 163, 1, 0, 489, 0.666626
deduced-slot, 292, 12, 155, 1, 0, 460, 0.666626
deduced-slot, 295, 11, 155, 1, 0, 462, 0.666626
deduced-slot, 288, 12, 154, 1, 0, 455, 0.666626
deduced-slot, 288, 11, 148, 1, 0, 448, 0.666626
deduced-slot, 285, 11, 156, 1, 0, 453, 0.666626
deduced-slot, 288, 11, 165, 1, 0, 465, 0.666626
deduced-slot, 288, 11, 158, 1, 0, 458, 0.666626
deduced-slot, 289, 11, 153, 1, 0, 454, 0.666626
deduced-slot, 286, 11, 151, 1, 0, 449, 0.666626
deduced-slot, 286, 11, 152, 1, 0, 450, 0.666626
deduced-slot, 283, 12, 157, 1, 0, 453, 0.666626
deduced-slot, 289, 11, 155, 1, 0, 456, 0.666626
deduced-slot, 287, 11, 157, 1, 0, 456, 0.666626
deduced-slot, 290, 12, 160, 1, 0, 463, 0.666626
deduced-slot, 286, 11, 152, 1, 0, 450, 0.666626
deduced-slot, 287, 11, 156, 1, 0, 455, 0.666626
deduced-slot, 288, 11, 152, 1, 0, 452, 0.666626
deduced-slot, 293, 11, 159, 1, 0, 464, 0.666626
deduced-slot, 287, 11, 161, 1, 0, 460, 0.666626
deduced-slot, 291, 11, 160, 1, 0, 463, 0.666626
deduced-slot, 291, 11, 156, 1, 0, 459, 0.666626
deduced-slot, 286, 11, 158, 1, 0, 456, 0.666626
deduced-slot, 289, 11, 155, 1, 0, 456, 0.666626
deduced-slot, 284, 11, 155, 1, 0, 451, 0.666626
deduced-slot, 295, 11, 158, 1, 0, 465, 0.666626
deduced-slot, 294, 11, 158, 1, 0, 464, 0.666626
deduced-slot, 285, 11, 152, 1, 0, 449, 0.666626
deduced-slot, 286, 11, 152, 1, 0, 450, 0.666626
deduced-slot, 288, 11, 150, 1, 0, 450, 0.666626
deduced-slot, 287, 11, 150, 1, 0, 449, 0.666626
deduced-slot, 288, 11, 151, 1, 0, 451, 0.666626
deduced-slot, 285, 11, 148, 1, 0, 445, 0.666626
deduced-slot, 288, 11, 155, 1, 0, 455, 0.666626
deduced-slot, 291, 11, 157, 1, 0, 460, 0.666626
deduced-slot, 288, 12, 161, 1, 0, 462, 0.666626
deduced-slot, 290, 11, 157, 1, 0, 459, 0.666626
deduced-slot, 289, 11, 162, 1, 0, 463, 0.666626
deduced-slot, 287, 11, 157, 1, 0, 456, 0.666626
deduced-slot, 284, 11, 154, 1, 0, 450, 0.666626
deduced-slot, 291, 11, 155, 1, 0, 458, 0.666626
deduced-slot, 292, 11, 157, 1, 0, 461, 0.666626
deduced-slot, 287, 16, 153, 1, 0, 457, 0.666626
deduced-slot, 294, 11, 158, 1, 0, 464, 0.666626
deduced-slot, 291, 12, 156, 1, 0, 460, 0.666626
deduced-slot, 288, 11, 153, 1, 0, 453, 0.666626
deduced-slot, 286, 11, 157, 1, 0, 455, 0.666626
deduced-slot, 295, 11, 155, 1, 0, 462, 0.666626
deduced-slot, 288, 12, 156, 1, 0, 457, 0.666626
deduced-slot, 289, 11, 157, 1, 0, 458, 0.666626
deduced-slot, 288, 11, 158, 1, 0, 458, 0.666626
deduced-slot, 286, 11, 159, 1, 0, 457, 0.666626
deduced-slot, 285, 11, 151, 1, 0, 448, 0.666626
deduced-slot, 286, 11, 152, 1, 0, 450, 0.666626
deduced-slot, 287, 11, 153, 1, 0, 452, 0.666626
deduced-slot, 287, 11, 158, 1, 0, 457, 0.666626
deduced-slot, 289, 11, 157, 1, 0, 458, 0.666626
deduced-slot, 290, 11, 156, 1, 0, 458, 0.666626
deduced-slot, 289, 11, 160, 1, 0, 461, 0.666626
deduced-slot, 304, 11, 160, 1, 0, 476, 0.666626
deduced-slot, 287, 11, 154, 1, 0, 453, 0.666626
deduced-slot, 292, 11, 155, 1, 0, 459, 0.666626
deduced-slot, 293, 11, 161, 1, 0, 466, 0.666626
deduced-slot, 286, 11, 154, 1, 0, 452, 0.666626
deduced-slot, 285, 11, 155, 1, 0, 452, 0.666626
deduced-slot, 288, 11, 152, 1, 0, 452, 0.666626
deduced-slot, 285, 11, 156, 1, 0, 453, 0.666626
deduced-slot, 285, 11, 155, 1, 0, 452, 0.666626
deduced-slot, 288, 11, 152, 1, 0, 452, 0.666626
deduced-slot, 285, 11, 148, 1, 0, 445, 0.666626
deduced-slot, 288, 11, 153, 1, 0, 453, 0.666626
deduced-slot, 287, 11, 153, 1, 0, 452, 0.666626
deduced-slot, 287, 11, 155, 1, 0, 454, 0.666626
deduced-slot, 285, 11, 156, 1, 0, 453, 0.666626
deduced-slot, 293, 11, 159, 1, 0, 464, 0.666626
deduced-slot, 283, 11, 154, 1, 0, 449, 0.666626
deduced-slot, 287, 11, 153, 1, 0, 452, 0.666626
deduced-slot, 287, 11, 158, 1, 0, 457, 0.666626
deduced-slot, 284, 11, 170, 1, 0, 466, 0.666626
deduced-slot, 288, 11, 154, 1, 0, 454, 0.666626
deduced-slot, 284, 11, 155, 1, 0, 451, 0.666626
deduced-slot, 289, 11, 154, 1, 0, 455, 0.666626
deduced-slot, 286, 11, 155, 1, 0, 453, 0.666626
deduced-slot, 284, 11, 154, 1, 0, 450, 0.666626
deduced-slot, 291, 11, 154, 1, 0, 457, 0.666626
deduced-slot, 290, 11, 154, 1, 0, 456, 0.666626
deduced-slot, 290, 11, 160, 1, 0, 462, 0.666626
deduced-slot, 290, 11, 157, 1, 0, 459, 0.666626
deduced-slot, 292, 11, 158, 1, 0, 462, 0.666626
deduced-slot, 288, 11, 157, 1, 0, 457, 0.666626
deduced-slot, 288, 11, 159, 1, 0, 459, 0.666626
deduced-slot, 296, 11, 158, 1, 0, 466, 0.666626
deduced-slot, 289, 11, 158, 1, 0, 459, 0.666626
deduced-slot, 293, 11, 157, 1, 0, 462, 0.666626
deduced-slot, 285, 11, 150, 1, 0, 447, 0.666626
deduced-slot, 285, 11, 150, 1, 0, 447, 0.666626
deduced-slot, 285, 11, 152, 1, 0, 449, 0.666626
deduced-slot, 288, 11, 153, 1, 0, 453, 0.666626
deduced-slot, 290, 11, 152, 1, 0, 454, 0.666626
deduced-slot, 290, 11, 154, 1, 0, 456, 0.666626
deduced-slot, 293, 11, 162, 1, 0, 467, 0.666626
deduced-slot, 286, 11, 158, 1, 0, 456, 0.666626
deduced-slot, 288, 11, 160, 1, 0, 460, 0.666626
deduced-slot, 293, 11, 155, 1, 0, 460, 0.666626
deduced-slot, 287, 11, 153, 1, 0, 452, 0.666626
deduced-slot, 293, 11, 150, 1, 0, 455, 0.666626
deduced-slot, 291, 11, 152, 1, 0, 455, 0.666626
deduced-slot, 283, 11, 154, 1, 0, 449, 0.666626
deduced-slot, 285, 11, 151, 1, 0, 448, 0.666626
deduced-slot, 287, 11, 154, 1, 0, 453, 0.666626
deduced-slot, 289, 11, 158, 1, 0, 459, 0.666626
deduced-slot, 288, 11, 160, 1, 0, 460, 0.666626
deduced-slot, 289, 11, 159, 1, 0, 460, 0.666626
deduced-slot, 289, 11, 154, 1, 0, 455, 0.666626
deduced-slot, 288, 12, 155, 1, 0, 456, 0.666626
deduced-slot, 290, 11, 156, 1, 0, 458, 0.666626
deduced-slot, 287, 12, 155, 1, 0, 455, 0.666626
deduced-slot, 292, 12, 157, 1, 0, 462, 0.666626
deduced-slot, 282, 11, 150, 1, 0, 444, 0.666626
deduced-slot, 287, 11, 168, 1, 0, 467, 0.666626
deduced-slot, 287, 11, 151, 1, 0, 450, 0.666626
deduced-slot, 287, 11, 156, 1, 0, 455, 0.666626
deduced-slot, 290, 11, 156, 1, 0, 458, 0.666626
deduced-slot, 290, 11, 159, 1, 0, 461, 0.666626
deduced-slot, 291, 11, 155, 1, 0, 458, 0.666626
deduced-slot, 294, 11, 159, 1, 0, 465, 0.666626
deduced-slot, 284, 11, 157, 1, 0, 453, 0.666626
deduced-slot, 289, 11, 158, 1, 0, 459, 0.666626
deduced-slot, 291, 11, 156, 1, 0, 459, 0.666626
deduced-slot, 291, 12, 156, 1, 0, 460, 0.666626
deduced-slot, 285, 11, 155, 1, 0, 452, 0.666626
deduced-slot, 287, 11, 158, 1, 0, 457, 0.666626
deduced-slot, 289, 11, 155, 1, 0, 456, 0.666626
deduced-slot, 291, 11, 156, 1, 0, 459, 0.666626
deduced-slot, 298, 11, 160, 1, 0, 470, 0.666626
deduced-slot, 288, 11, 150, 1, 0, 450, 0.666626
deduced-slot, 284, 11, 152, 1, 0, 448, 0.666626
deduced-slot, 287, 11, 159, 1, 0, 458, 0.666626
deduced-slot, 286, 11, 159, 1, 0, 457, 0.666626
deduced-slot, 283, 11, 157, 1, 0, 452, 0.666626
deduced-slot, 289, 11, 156, 1, 0, 457, 0.666626
deduced-slot, 285, 11, 151, 1, 0, 448, 0.666626
deduced-slot, 286, 11, 151, 1, 0, 449, 0.666626
deduced-slot, 294, 11, 155, 1, 0, 461, 0.666626
deduced-slot, 284, 11, 156, 1, 0, 452, 0.666626
deduced-slot, 296, 11, 156, 1, 0, 464, 0.666626
deduced-slot, 284, 11, 156, 1, 0, 452, 0.666626
deduced-slot, 292, 11, 153, 1, 0, 457, 0.666626
deduced-slot, 290, 11, 155, 1, 0, 457, 0.666626
deduced-slot, 287, 11, 158, 1, 0, 457, 0.666626
deduced-slot, 292, 11, 158, 1, 0, 462, 0.666626
deduced-slot, 288, 11, 161, 1, 0, 461, 0.666626
deduced-slot, 289, 11, 159, 1, 0, 460, 0.666626
deduced-slot, 291, 11, 160, 1, 0, 463, 0.666626
deduced-slot, 291, 11, 157, 1, 0, 460, 0.666626
deduced-slot, 287, 11, 159, 1, 0, 458, 0.666626
deduced-slot, 285, 11, 154, 1, 0, 451, 0.666626
deduced-slot, 287, 11, 153, 1, 0, 452, 0.666626
deduced-slot, 287, 11, 150, 1, 0, 449, 0.666626
deduced-slot, 287, 11, 150, 1, 0, 449, 0.666626
deduced-slot, 284, 11, 156, 1, 0, 452, 0.666626
deduced-slot, 286, 11, 152, 1, 0, 450, 0.666626
deduced-slot, 286, 11, 154, 1, 0, 452, 0.666626
deduced-slot, 284, 12, 153, 1, 0, 450, 0.666626
deduced-slot, 289, 11, 159, 1, 0, 460, 0.666626
deduced-slot, 286, 11, 155, 1, 0, 453, 0.666626
deduced-slot, 292, 11, 157, 1, 0, 461, 0.666626
deduced-slot, 289, 11, 154, 1, 0, 455, 0.666626
deduced-slot, 288, 11, 156, 1, 0, 456, 0.666626
deduced-slot, 290, 12, 159, 1, 0, 462, 0.666626
deduced-slot, 292, 11, 159, 1, 0, 463, 0.666626
deduced-slot, 291, 11, 152, 1, 0, 455, 0.666626
deduced-slot, 287, 11, 154, 1, 0, 453, 0.666626
deduced-slot, 289, 11, 153, 1, 0, 454, 0.666626
deduced-slot, 283, 11, 151, 1, 0, 446, 0.666626
deduced-slot, 292, 11, 161, 1, 0, 465, 0.666626
deduced-slot, 290, 11, 153, 1, 0, 455, 0.666626
deduced-slot, 287, 11, 157, 1, 0, 456, 0.666626
deduced-slot, 288, 11, 151, 1, 0, 451, 0.666626
deduced-slot, 290, 11, 160, 1, 0, 462, 0.666626
deduced-slot, 291, 11, 159, 1, 0, 462, 0.666626
deduced-slot, 288, 11, 156, 1, 0, 456, 0.666626
deduced-slot, 285, 11, 157, 1, 0, 454, 0.666626
deduced-slot, 291, 12, 159, 1, 0, 463, 0.666626
deduced-slot, 289, 11, 151, 1, 0, 452, 0.666626
deduced-slot, 290, 11, 165, 1, 0, 467, 0.666626
deduced-slot, 285, 11, 150, 1, 0, 447, 0.666626
deduced-slot, 285, 11, 152, 1, 0, 449, 0.666626
deduced-slot, 287, 11, 157, 1, 0, 456, 0.666626
deduced-slot, 291, 11, 156, 1, 0, 459, 0.666626
deduced-slot, 288, 11, 154, 1, 0, 454, 0.666626
deduced-slot, 289, 11, 155, 1, 0, 456, 0.666626
deduced-slot, 286, 11, 157, 1, 0, 455, 0.666626
deduced-slot, 292, 11, 159, 1, 0, 463, 0.666626
deduced-slot, 290, 11, 159, 1, 0, 461, 0.666626
deduced-slot, 289, 11, 156, 1, 0, 457, 0.666626
deduced-slot, 291, 11, 155, 1, 0, 458, 0.666626
deduced-slot, 289, 11, 158, 1, 0, 459, 0.666626
deduced-slot, 288, 11, 160, 1, 0, 460, 0.666626
deduced-slot, 287, 11, 153, 1, 0, 452, 0.666626
deduced-slot, 296, 11, 154, 1, 0, 462, 0.666626
deduced-slot, 287, 11, 151, 1, 0, 450, 0.666626
deduced-slot, 285, 11, 155, 1, 0, 452, 0.666626
deduced-slot, 287, 11, 157, 1, 0, 456, 0.666626
deduced-slot, 296, 11, 158, 1, 0, 466, 0.666626
deduced-slot, 293, 11, 158, 1, 0, 463, 0.666626
deduced-slot, 291, 11, 152, 1, 0, 455, 0.666626
deduced-slot, 288, 11, 156, 1, 0, 456, 0.666626
deduced-slot, 292, 11, 157, 1, 0, 461, 0.666626
deduced-slot, 291, 11, 155, 1, 0, 458, 0.666626
deduced-slot, 289, 11, 155, 1, 0, 456, 0.666626
deduced-slot, 285, 11, 158, 1, 0, 455, 0.666626
deduced-slot, 291, 11, 158, 1, 0, 461, 0.666626
deduced-slot, 291, 11, 154, 1, 0, 457, 0.666626
deduced-slot, 290, 11, 156, 1, 0, 458, 0.666626
deduced-slot, 287, 11, 155, 1, 0, 454, 0.666626
deduced-slot, 289, 11, 157, 1, 0, 458, 0.666626
deduced-slot, 287, 11, 154, 1, 0, 453, 0.666626
deduced-slot, 285, 11, 153, 1, 0, 450, 0.666626
deduced-slot, 288, 11, 157, 1, 0, 457, 0.666626
deduced-slot, 287, 11, 154, 1, 0, 453, 0.666626
deduced-slot, 286, 11, 154, 1, 0, 452, 0.666626
deduced-slot, 289, 11, 156, 1, 0, 457, 0.666626
deduced-slot, 289, 11, 156, 1, 0, 457, 0.666626
deduced-slot, 288, 11, 154, 1, 0, 454, 0.666626
deduced-slot, 287, 11, 159, 1, 0, 458, 0.666626
deduced-slot, 291, 12, 156, 1, 0, 460, 0.666626
deduced-slot, 288, 11, 151, 1, 0, 451, 0.666626
deduced-slot, 287, 11, 154, 1, 0, 453, 0.666626
deduced-slot, 288, 12, 158, 1, 0, 459, 0.666626
deduced-slot, 287, 11, 156, 1, 0, 455, 0.666626
deduced-slot, 286, 11, 157, 1, 0, 455, 0.666626
deduced-slot, 287, 11, 154, 1, 0, 453, 0.666626
deduced-slot, 296, 11, 158, 1, 0, 466, 0.666626
deduced-slot, 288, 11, 168, 1, 0, 468, 0.666626
deduced-slot, 285, 11, 151, 1, 0, 448, 0.666626
deduced-slot, 288, 11, 157, 1, 0, 457, 0.666626
deduced-slot, 289, 11, 153, 1, 0, 454, 0.666626
deduced-slot, 288, 11, 152, 1, 0, 452, 0.666626
deduced-slot, 289, 11, 152, 1, 0, 453, 0.666626
deduced-slot, 291, 11, 154, 1, 0, 457, 0.666626
deduced-slot, 292, 11, 158, 1, 0, 462, 0.666626
deduced-slot, 289, 11, 156, 1, 0, 457, 0.666626
deduced-slot, 291, 11, 158, 1, 0, 461, 0.666626
deduced-slot, 284, 12, 156, 1, 0, 453, 0.666626
deduced-slot, 291, 11, 157, 1, 0, 460, 0.666626
deduced-slot, 291, 11, 158, 1, 0, 461, 0.666626
deduced-slot, 294, 11, 158, 1, 0, 464, 0.666626
deduced-slot, 306, 11, 158, 1, 0, 476, 0.666626
deduced-slot, 289, 11, 153, 1, 0, 454, 0.666626
deduced-slot, 287, 11, 152, 1, 0, 451, 0.666626
deduced-slot, 286, 11, 155, 1, 0, 453, 0.666626
deduced-slot, 288, 11, 158, 1, 0, 458, 0.666626
deduced-slot, 290, 11, 159, 1, 0, 461, 0.666626
deduced-slot, 291, 11, 159, 1, 0, 462, 0.666626
deduced-slot, 288, 11, 159, 1, 0, 459, 0.666626
deduced-slot, 291, 12, 163, 1, 0, 467, 0.666626
deduced-slot, 291, 11, 157, 1, 0, 460, 0.666626
deduced-slot, 288, 11, 159, 1, 0, 459, 0.666626
deduced-slot, 295, 11, 161, 1, 0, 468, 0.666626
deduced-slot, 289, 11, 163, 1, 0, 464, 0.666626
deduced-slot, 290, 11, 155, 1, 0, 457, 0.666626
deduced-slot, 287, 11, 153, 1, 0, 452, 0.666626
deduced-slot, 289, 11, 156, 1, 0, 457, 0.666626
deduced-slot, 290, 12, 160, 1, 0, 463, 0.666626
deduced-slot, 290, 12, 157, 1, 0, 460, 0.666626
deduced-slot, 288, 11, 158, 1, 0, 458, 0.666626
deduced-slot, 286, 11, 154, 1, 0, 452, 0.666626
deduced-slot, 291, 11, 156, 1, 0, 459, 0.666626
deduced-slot, 290, 11, 158, 1, 0, 460, 0.666626
deduced-slot, 290, 11, 158, 1, 0, 460, 0.666626
deduced-slot, 287, 11, 155, 1, 0, 454, 0.666626
deduced-slot, 290, 11, 151, 1, 0, 453, 0.666626
deduced-slot, 289, 11, 158, 1, 0, 459, 0.666626
deduced-slot, 285, 11, 157, 1, 0, 454, 0.666626
deduced-slot, 290, 11, 160, 1, 0, 462, 0.666626
deduced-slot, 290, 11, 159, 1, 0, 461, 0.666626
deduced-slot, 293, 12, 162, 1, 0, 468, 0.666626
deduced-slot, 291, 11, 157, 1, 0, 460, 0.666626
deduced-slot, 289, 11, 159, 1, 0, 460, 0.666626
deduced-slot, 294, 11, 156, 1, 0, 462, 0.666626
deduced-slot, 291, 11, 158, 1, 0, 461, 0.666626
deduced-slot, 294, 12, 156, 1, 0, 463, 0.666626
deduced-slot, 298, 12, 159, 1, 0, 470, 0.666626
deduced-slot, 291, 11, 157, 1, 0, 460, 0.666626
deduced-slot, 290, 11, 159, 1, 0, 461, 0.666626
deduced-slot, 288, 11, 158, 1, 0, 458, 0.666626
deduced-slot, 291, 12, 159, 1, 0, 463, 0.666626
deduced-slot, 290, 11, 153, 1, 0, 455, 0.666626
deduced-slot, 289, 11, 150, 1, 0, 451, 0.666626
deduced-slot, 290, 14, 155, 1, 0, 460, 0.666626
deduced-slot, 288, 11, 157, 1, 0, 457, 0.666626
deduced-slot, 283, 11, 154, 1, 0, 449, 0.666626
deduced-slot, 288, 11, 151, 1, 0, 451, 0.666626
deduced-slot, 284, 11, 154, 1, 0, 450, 0.666626
deduced-slot, 288, 11, 155, 1, 0, 455, 0.666626
deduced-slot, 292, 12, 159, 1, 0, 464, 0.666626
deduced-slot, 290, 11, 161, 1, 0, 463, 0.666626
deduced-slot, 293, 11, 164, 1, 0, 469, 0.666626
deduced-slot, 291, 11, 154, 1, 0, 457, 0.666626
deduced-slot, 289, 11, 157, 1, 0, 458, 0.666626
deduced-slot, 285, 11, 150, 1, 0, 447, 0.666626
deduced-slot, 288, 11, 156, 1, 0, 456, 0.666626
deduced-slot, 288, 11, 153, 1, 0, 453, 0.666626
deduced-slot, 288, 11, 152, 1, 0, 452, 0.666626
deduced-slot, 286, 11, 158, 1, 0, 456, 0.666626
deduced-slot, 289, 11, 154, 1, 0, 455, 0.666626
deduced-slot, 290, 11, 156, 1, 0, 458, 0.666626
deduced-slot, 294, 11, 158, 1, 0, 464, 0.666626
deduced-slot, 288, 11, 158, 1, 0, 458, 0.666626
deduced-slot, 291, 11, 156, 1, 0, 459, 0.666626
deduced-slot, 297, 11, 158, 1, 0, 467, 0.666626
deduced-slot, 288, 12, 163, 1, 0, 464, 0.666626
deduced-slot, 288, 12, 158, 1, 0, 459, 0.666626
deduced-slot, 290, 11, 151, 1, 0, 453, 0.666626
deduced-slot, 292, 11, 160, 1, 0, 464, 0.666626
deduced-slot, 284, 11, 152, 1, 0, 448, 0.666626
deduced-slot, 289, 11, 151, 1, 0, 452, 0.666626
deduced-slot, 285, 11, 158, 1, 0, 455, 0.666626
deduced-slot, 292, 11, 159, 1, 0, 463, 0.666626
deduced-slot, 287, 11, 156, 1, 0, 455, 0.666626
deduced-slot, 288, 11, 153, 1, 0, 453, 0.666626
deduced-slot, 291, 12, 158, 1, 0, 462, 0.666626
deduced-slot, 292, 11, 154, 1, 0, 458, 0.666626
deduced-slot, 292, 11, 153, 1, 0, 457, 0.666626
deduced-slot, 288, 11, 161, 1, 0, 461, 0.666626
deduced-slot, 286, 11, 156, 1, 0, 454, 0.666626
deduced-slot, 297, 11, 157, 1, 0, 466, 0.666626
deduced-slot, 294, 11, 155, 1, 0, 461, 0.666626
deduced-slot, 288, 11, 153, 1, 0, 453, 0.666626
deduced-slot, 289, 11, 157, 1, 0, 458, 0.666626
deduced-slot, 290, 11, 160, 1, 0, 462, 0.666626
deduced-slot, 286, 11, 154, 1, 0, 452, 0.666626
deduced-slot, 292, 11, 159, 1, 0, 463, 0.666626
deduced-slot, 290, 11, 155, 1, 0, 457, 0.666626
deduced-slot, 289, 12, 160, 1, 0, 462, 0.666626
deduced-slot, 288, 11, 154, 1, 0, 454, 0.666626
deduced-slot, 288, 11, 155, 1, 0, 455, 0.666626
deduced-slot, 283, 11, 149, 1, 0, 444, 0.666626
deduced-slot, 287, 11, 157, 1, 0, 456, 0.666626
deduced-slot, 286, 11, 156, 1, 0, 454, 0.666626
deduced-slot, 286, 11, 155, 1, 0, 453, 0.666626
deduced-slot, 295, 11, 154, 1, 0, 461, 0.666626
deduced-slot, 284, 11, 156, 1, 0, 452, 0.666626
deduced-slot, 291, 12, 161, 1, 0, 465, 0.666626
deduced-slot, 287, 12, 157, 1, 0, 457, 0.666626
deduced-slot, 289, 11, 160, 1, 0, 461, 0.666626
deduced-slot, 289, 12, 160, 1, 0, 462, 0.666626
deduced-slot, 297, 12, 159, 1, 0, 469, 0.666626
deduced-slot, 290, 11, 152, 1, 0, 454, 0.666626
deduced-slot, 285, 11, 155, 1, 0, 452, 0.666626
deduced-slot, 288, 11, 157, 1, 0, 457, 0.666626
deduced-slot, 287, 11, 157, 1, 0, 456, 0.666626
deduced-slot, 286, 11, 156, 1, 0, 454, 0.666626
deduced-slot, 291, 11, 152, 1, 0, 455, 0.666626
deduced-slot, 284, 13, 151, 1, 0, 449, 0.666626
deduced-slot, 289, 11, 150, 1, 0, 451, 0.666626
deduced-slot, 288, 11, 153, 1, 0, 453, 0.666626
deduced-slot, 290, 11, 156, 1, 0, 458, 0.666626
deduced-slot, 286, 11, 155, 1, 0, 453, 0.666626
deduced-slot, 295, 11, 155, 1, 0, 462, 0.666626
deduced-slot, 290, 11, 154, 1, 0, 456, 0.666626
deduced-slot, 288, 11, 158, 1, 0, 458, 0.666626
deduced-slot, 288, 12, 161, 1, 0, 462, 0.666626
deduced-slot, 287, 11, 158, 1, 0, 457, 0.666626
deduced-slot, 291, 11, 163, 1, 0, 466, 0.666626
deduced-slot, 290, 11, 153, 1, 0, 455, 0.666626
deduced-slot, 290, 11, 163, 1, 0, 465, 0.666626
deduced-slot, 291, 11, 153, 1, 0, 456, 0.666626
deduced-slot, 287, 11, 155, 1, 0, 454, 0.666626
deduced-slot, 314, 11, 157, 1, 0, 483, 0.666626
deduced-slot, 287, 11, 158, 1, 0, 457, 0.666626
deduced-slot, 288, 12, 157, 1, 0, 458, 0.666626
deduced-slot, 290, 11, 159, 1, 0, 461, 0.666626
deduced-slot, 289, 11, 155, 1, 0, 456, 0.666626
deduced-slot, 292, 12, 162, 1, 0, 467, 0.666626
deduced-slot, 305, 12, 157, 1, 0, 475, 0.666626
deduced-slot, 290, 11, 163, 1, 0, 465, 0.666626
deduced-slot, 292, 11, 158, 1, 0, 462, 0.666626
deduced-slot, 284, 11, 156, 1, 0, 452, 0.666626
deduced-slot, 286, 11, 154, 1, 0, 452, 0.666626
deduced-slot, 287, 12, 158, 1, 0, 458, 0.666626
deduced-slot, 289, 11, 155, 1, 0, 456, 0.666626
deduced-slot, 287, 11, 155, 1, 0, 454, 0.666626
deduced-slot, 290, 11, 161, 1, 0, 463, 0.666626
deduced-slot, 291, 11, 158, 1, 0, 461, 0.666626
deduced-slot, 286, 11, 155, 1, 0, 453, 0.666626
deduced-slot, 288, 11, 154, 1, 0, 454, 0.666626
deduced-slot, 289, 11, 165, 1, 0, 466, 0.666626
deduced-slot, 290, 11, 157, 1, 0, 459, 0.666626
deduced-slot, 290, 11, 163, 1, 0, 465, 0.666626
deduced-slot, 288, 12, 158, 1, 0, 459, 0.666626
deduced-slot, 290, 11, 158, 1, 0, 460, 0.666626
deduced-slot, 290, 11, 155, 1, 0, 457, 0.666626
deduced-slot, 286, 11, 155, 1, 0, 453, 0.666626
deduced-slot, 292, 11, 157, 1, 0, 461, 0.666626
deduced-slot, 288, 11, 153, 1, 0, 453, 0.666626
deduced-slot, 285, 11, 152, 1, 0, 449, 0.666626
deduced-slot, 289, 11, 156, 1, 0, 457, 0.666626
deduced-slot, 291, 12, 163, 1, 0, 467, 0.666626
deduced-slot, 287, 11, 157, 1, 0, 456, 0.666626
deduced-slot, 294, 12, 158, 1, 0, 465, 0.666626
deduced-slot, 290, 11, 154, 1, 0, 456, 0.666626
deduced-slot, 285, 12, 152, 1, 0, 450, 0.666626
deduced-slot, 290, 11, 155, 1, 0, 457, 0.666626
deduced-slot, 290, 11, 155, 1, 0, 457, 0.666626
deduced-slot, 288, 11, 157, 1, 0, 457, 0.666626
deduced-slot, 291, 11, 155, 1, 0, 458, 0.666626
deduced-slot, 294, 11, 157, 1, 0, 463, 0.666626
deduced-slot, 289, 11, 160, 1, 0, 461, 0.666626
deduced-slot, 290, 11, 159, 1, 0, 461, 0.666626
deduced-slot, 288, 11, 164, 1, 0, 464, 0.666626
deduced-slot, 292, 11, 156, 1, 0, 460, 0.666626
deduced-slot, 287, 11, 156, 1, 0, 455, 0.666626
deduced-slot, 294, 11, 158, 1, 0, 464, 0.666626
deduced-slot, 288, 11, 157, 1, 0, 457, 0.666626
deduced-slot, 283, 11, 161, 1, 0, 456, 0.666626
deduced-slot, 298, 12, 157, 1, 0, 468, 0.666626
deduced-slot, 296, 11, 156, 1, 0, 464, 0.666626
deduced-slot, 286, 11, 151, 1, 0, 449, 0.666626
deduced-slot, 285, 11, 153, 1, 0, 450, 0.666626
deduced-slot, 289, 11, 156, 1, 0, 457, 0.666626
deduced-slot, 286, 11, 152, 1, 0, 450, 0.666626
deduced-slot, 285, 11, 153, 1, 0, 450, 0.666626
deduced-slot, 285, 11, 157, 1, 0, 454, 0.666626
deduced-slot, 289, 11, 157, 1, 0, 458, 0.666626
deduced-slot, 297, 11, 156, 1, 0, 465, 0.666626
deduced-slot, 291, 11, 156, 1, 0, 459, 0.666626
deduced-slot, 288, 12, 158, 1, 0, 459, 0.666626
deduced-slot, 291, 11, 156, 1, 0, 459, 0.666626
deduced-slot, 284, 11, 159, 1, 0, 455, 0.666626
deduced-slot, 287, 11, 153, 1, 0, 452, 0.666626
deduced-slot, 285, 11, 153, 1, 0, 450, 0.666626
deduced-slot, 287, 12, 156, 1, 0, 456, 0.666626
deduced-slot, 292, 11, 151, 1, 0, 455, 0.666626
deduced-slot, 287, 11, 150, 1, 0, 449, 0.666626
deduced-slot, 286, 12, 156, 1, 0, 455, 0.666626
deduced-slot, 291, 11, 156, 1, 0, 459, 0.666626
deduced-slot, 289, 11, 155, 1, 0, 456, 0.666626
deduced-slot, 287, 12, 160, 1, 0, 460, 0.666626
deduced-slot, 295, 12, 160, 1, 0, 468, 0.666626
deduced-slot, 293, 11, 160, 1, 0, 465, 0.666626
deduced-slot, 299, 11, 157, 1, 0, 468, 0.666626
deduced-slot, 284, 12, 159, 1, 0, 456, 0.666626
deduced-slot, 290, 11, 155, 1, 0, 457, 0.666626
deduced-slot, 290, 11, 156, 1, 0, 458, 0.666626
deduced-slot, 287, 11, 155, 1, 0, 454, 0.666626
deduced-slot, 301, 11, 158, 1, 0, 471, 0.666626
deduced-slot, 284, 11, 156, 1, 0, 452, 0.666626
deduced-slot, 284, 11, 154, 1, 0, 450, 0.666626
deduced-slot, 285, 11, 156, 1, 0, 453, 0.666626
deduced-slot, 287, 11, 154, 1, 0, 453, 0.666626
deduced-slot, 287, 11, 158, 1, 0, 457, 0.666626
deduced-slot, 289, 12, 159, 1, 0, 461, 0.666626
deduced-slot, 289, 11, 156, 1, 0, 457, 0.666626
deduced-slot, 289, 11, 155, 1, 0, 456, 0.666626
deduced-slot, 290, 11, 156, 1, 0, 458, 0.666626
deduced-slot, 286, 11, 156, 1, 0, 454, 0.666626
deduced-slot, 285, 11, 159, 1, 0, 456, 0.666626
deduced-slot, 298, 11, 160, 1, 0, 470, 0.666626
deduced-slot, 287, 11, 159, 1, 0, 458, 0.666626
deduced-slot, 288, 12, 157, 1, 0, 458, 0.666626
deduced-slot, 287, 11, 154, 1, 0, 453, 0.666626
deduced-slot, 290, 11, 155, 1, 0, 457, 0.666626
deduced-slot, 287, 11, 159, 1, 0, 458, 0.666626
deduced-slot, 289, 11, 159, 1, 0, 460, 0.666626
deduced-slot, 290, 11, 154, 1, 0, 456, 0.666626
deduced-slot, 289, 11, 153, 1, 0, 454, 0.666626
deduced-slot, 308, 11, 149, 1, 0, 469, 0.666626
deduced-slot, 288, 11, 155, 1, 0, 455, 0.666626
deduced-slot, 290, 11, 153, 1, 0, 455, 0.666626
deduced-slot, 286, 11, 159, 1, 0, 457, 0.666626
deduced-slot, 294, 11, 160, 1, 0, 466, 0.666626
deduced-slot, 287, 11, 154, 1, 0, 453, 0.666626
deduced-slot, 287, 12, 158, 1, 0, 458, 0.666626
deduced-slot, 289, 11, 153, 1, 0, 454, 0.666626
deduced-slot, 291, 14, 159, 1, 0, 465, 0.666626
deduced-slot, 288, 11, 154, 1, 0, 454, 0.666626
deduced-slot, 284, 11, 158, 1, 0, 454, 0.666626
deduced-slot, 292, 11, 157, 1, 0, 461, 0.666626
deduced-slot, 290, 11, 158, 1, 0, 460, 0.666626
deduced-slot, 288, 11, 157, 1, 0, 457, 0.666626
deduced-slot, 289, 11, 158, 1, 0, 459, 0.666626
deduced-slot, 289, 11, 151, 1, 0, 452, 0.666626
deduced-slot, 287, 11, 158, 1, 0, 457, 0.666626
deduced-slot, 294, 11, 161, 1, 0, 467, 0.666626
deduced-slot, 291, 11, 156, 1, 0, 459, 0.666626
deduced-slot, 289, 11, 155, 1, 0, 456, 0.666626
deduced-slot, 288, 11, 150, 1, 0, 450, 0.666626
deduced-slot, 287, 11, 157, 1, 0, 456, 0.666626
deduced-slot, 291, 11, 160, 1, 0, 463, 0.666626
deduced-slot, 304, 11, 153, 1, 0, 469, 0.666626
deduced-slot, 288, 11, 156, 1, 0, 456, 0.666626
deduced-slot, 290, 11, 159, 1, 0, 461, 0.666626
deduced-slot, 285, 11, 156, 1, 0, 453, 0.666626
deduced-slot, 287, 11, 156, 1, 0, 455, 0.666626
deduced-slot, 290, 11, 157, 1, 0, 459, 0.666626
deduced-slot, 284, 11, 155, 1, 0, 451, 0.666626
deduced-slot, 285, 11, 150, 1, 0, 447, 0.666626
deduced-slot, 287, 11, 153, 1, 0, 452, 0.666626
deduced-slot, 287, 11, 151, 1, 0, 450, 0.666626
deduced-slot, 292, 11, 152, 1, 0, 456, 0.666626
deduced-slot, 297, 11, 160, 1, 0, 469, 0.666626
deduced-slot, 288, 11, 155, 1, 0, 455, 0.666626
deduced-slot, 290, 11, 172, 1, 0, 474, 0.666626
deduced-slot, 288, 11, 154, 1, 0, 454, 0.666626
deduced-slot, 291, 12, 165, 1, 0, 469, 0.666626
deduced-slot, 292, 11, 151, 1, 0, 455, 0.666626
deduced-slot, 290, 11, 158, 1, 0, 460, 0.666626
deduced-slot, 286, 11, 157, 1, 0, 455, 0.666626
deduced-slot, 285, 11, 156, 1, 0, 453, 0.666626
deduced-slot, 287, 11, 154, 1, 0, 453, 0.666626
deduced-slot, 286, 11, 153, 1, 0, 451, 0.666626
deduced-slot, 295, 11, 153, 1, 0, 460, 0.666626
deduced-slot, 282, 11, 151, 1, 0, 445, 0.666626
deduced-slot, 289, 11, 156, 1, 0, 457, 0.666626
deduced-slot, 286, 11, 160, 1, 0, 458, 0.666626
deduced-slot, 288, 11, 155, 1, 0, 455, 0.666626
deduced-slot, 288, 11, 156, 1, 0, 456, 0.666626
deduced-slot, 290, 11, 159, 1, 0, 461, 0.666626
deduced-slot, 288, 11, 161, 1, 0, 461, 0.666626
deduced-slot, 291, 12, 158, 1, 0, 462, 0.666626
deduced-slot, 287, 12, 157, 1, 0, 457, 0.666626
deduced-slot, 287, 11, 157, 1, 0, 456, 0.666626
deduced-slot, 291, 11, 157, 1, 0, 460, 0.666626
deduced-slot, 292, 12, 158, 1, 0, 463, 0.666626
deduced-slot, 289, 11, 156, 1, 0, 457, 0.666626
deduced-slot, 287, 12, 157, 1, 0, 457, 0.666626
deduced-slot, 289, 11, 156, 1, 0, 457, 0.666626
deduced-slot, 286, 11, 159, 1, 0, 457, 0.666626
deduced-slot, 289, 11, 156, 1, 0, 457, 0.666626
deduced-slot, 290, 11, 163, 1, 0, 465, 0.666626
deduced-slot, 289, 11, 157, 1, 0, 458, 0.666626
deduced-slot, 287, 11, 153, 1, 0, 452, 0.666626
deduced-slot, 285, 11, 151, 1, 0, 448, 0.666626
deduced-slot, 285, 12, 160, 1, 0, 458, 0.666626
deduced-slot, 290, 12, 156, 1, 0, 459, 0.666626
deduced-slot, 289, 11, 155, 1, 0, 456, 0.666626
deduced-slot, 290, 11, 162, 1, 0, 464, 0.666626
deduced-slot, 286, 11, 157, 1, 0, 455, 0.666626
deduced-slot, 295, 11, 156, 1, 0, 463, 0.666626
deduced-slot, 287, 11, 157, 1, 0, 456, 0.666626
deduced-slot, 290, 11, 158, 1, 0, 460, 0.666626
deduced-slot, 290, 11, 155, 1, 0, 457, 0.666626
deduced-slot, 291, 11, 157, 1, 0, 460, 0.666626
deduced-slot, 291, 11, 158, 1, 0, 461, 0.666626
deduced-slot, 289, 12, 160, 1, 0, 462, 0.666626
deduced-slot, 292, 11, 157, 1, 0, 461, 0.666626
deduced-slot, 293, 11, 156, 1, 0, 461, 0.666626
deduced-slot, 287, 12, 161, 1, 0, 461, 0.666626
deduced-slot, 285, 11, 151, 1, 0, 448, 0.666626
deduced-slot, 287, 11, 157, 1, 0, 456, 0.666626
deduced-slot, 288, 11, 152, 1, 0, 452, 0.666626
deduced-slot, 286, 11, 173, 1, 0, 471, 0.666626
deduced-slot, 468, 15, 160, 1, 0, 644, 0.666626
deduced-slot, 291, 11, 160, 1, 0, 463, 0.666626
deduced-slot, 288, 11, 160, 1, 0, 460, 0.666626
deduced-slot, 289, 12, 155, 1, 0, 457, 0.666626
deduced-slot, 285, 11, 156, 1, 0, 453, 0.666626
deduced-slot, 289, 12, 161, 1, 0, 463, 0.666626
deduced-slot, 284, 11, 157, 1, 0, 453, 0.666626
deduced-slot, 286, 11, 154, 1, 0, 452, 0.666626
deduced-slot, 288, 11, 152, 1, 0, 452, 0.666626
deduced-slot, 286, 11, 153, 1, 0, 451, 0.666626
deduced-slot, 290, 11, 152, 1, 0, 454, 0.666626
deduced-slot, 287, 11, 155, 1, 0, 454, 0.666626
deduced-slot, 289, 11, 157, 1, 0, 458, 0.666626
deduced-slot, 287, 11, 155, 1, 0, 454, 0.666626
deduced-slot, 286, 11, 153, 1, 0, 451, 0.666626
deduced-slot, 293, 11, 154, 1, 0, 459, 0.666626
deduced-slot, 293, 12, 158, 1, 0, 464, 0.666626
deduced-slot, 290, 11, 159, 1, 0, 461, 0.666626
deduced-slot, 291, 12, 158, 1, 0, 462, 0.666626
deduced-slot, 292, 11, 158, 1, 0, 462, 0.666626
deduced-slot, 295, 11, 179, 1, 0, 486, 0.666626
deduced-slot, 296, 11, 160, 1, 0, 468, 0.666626
deduced-slot, 288, 11, 153, 1, 0, 453, 0.666626
deduced-slot, 289, 11, 157, 1, 0, 458, 0.666626
deduced-slot, 285, 11, 157, 1, 0, 454, 0.666626
deduced-slot, 291, 11, 155, 1, 0, 458, 0.666626
deduced-slot, 286, 11, 162, 1, 0, 460, 0.666626
deduced-slot, 289, 11, 151, 1, 0, 452, 0.666626
deduced-slot, 293, 11, 156, 1, 0, 461, 0.666626
deduced-slot, 291, 11, 155, 1, 0, 458, 0.666626
deduced-slot, 289, 11, 154, 1, 0, 455, 0.666626
deduced-slot, 295, 11, 156, 1, 0, 463, 0.666626
deduced-slot, 289, 11, 162, 1, 0, 463, 0.666626
deduced-slot, 300, 11, 160, 1, 0, 472, 0.666626
deduced-slot, 287, 11, 155, 1, 0, 454, 0.666626
deduced-slot, 294, 12, 157, 1, 0, 464, 0.666626
deduced-slot, 285, 11, 156, 1, 0, 453, 0.666626
deduced-slot, 288, 11, 162, 1, 0, 462, 0.666626
deduced-slot, 291, 11, 152, 1, 0, 455, 0.666626
deduced-slot, 282, 11, 152, 1, 0, 446, 0.666626
deduced-slot, 292, 11, 155, 1, 0, 459, 0.666626
deduced-slot, 291, 11, 157, 1, 0, 460, 0.666626
deduced-slot, 289, 11, 158, 1, 0, 459, 0.666626
deduced-slot, 291, 11, 157, 1, 0, 460, 0.666626
deduced-slot, 293, 11, 150, 1, 0, 455, 0.666626
deduced-slot, 286, 11, 150, 1, 0, 448, 0.666626
deduced-slot, 291, 11, 159, 1, 0, 462, 0.666626
deduced-slot, 286, 11, 157, 1, 0, 455, 0.666626
deduced-slot, 291, 11, 155, 1, 0, 458, 0.666626
deduced-slot, 288, 11, 157, 1, 0, 457, 0.666626
deduced-slot, 284, 11, 156, 1, 0, 452, 0.666626
deduced-slot, 289, 11, 155, 1, 0, 456, 0.666626
deduced-slot, 287, 11, 157, 1, 0, 456, 0.666626
deduced-slot, 289, 11, 157, 1, 0, 458, 0.666626
deduced-slot, 291, 11, 157, 1, 0, 460, 0.666626
deduced-slot, 288, 11, 158, 1, 0, 458, 0.666626
deduced-slot, 300, 12, 162, 1, 0, 475, 0.666626
deduced-slot, 295, 12, 162, 1, 0, 470, 0.666626
deduced-slot, 294, 12, 162, 1, 0, 469, 0.666626
deduced-slot, 297, 11, 159, 1, 0, 468, 0.666626
deduced-slot, 288, 11, 160, 1, 0, 460, 0.666626
deduced-slot, 292, 11, 158, 1, 0, 462, 0.666626
deduced-slot, 285, 11, 156, 1, 0, 453, 0.666626
deduced-slot, 289, 11, 155, 1, 0, 456, 0.666626
deduced-slot, 286, 11, 156, 1, 0, 454, 0.666626
deduced-slot, 287, 11, 158, 1, 0, 457, 0.666626
deduced-slot, 287, 11, 157, 1, 0, 456, 0.666626
deduced-slot, 293, 12, 159, 1, 0, 465, 0.666626
deduced-slot, 292, 11, 160, 1, 0, 464, 0.666626
deduced-slot, 290, 11, 160, 1, 0, 462, 0.666626
deduced-slot, 291, 11, 156, 1, 0, 459, 0.666626
deduced-slot, 288, 11, 159, 1, 0, 459, 0.666626
deduced-slot, 290, 11, 155, 1, 0, 457, 0.666626
deduced-slot, 287, 11, 156, 1, 0, 455, 0.666626
deduced-slot, 285, 11, 155, 1, 0, 452, 0.666626
deduced-slot, 286, 11, 155, 1, 0, 453, 0.666626
deduced-slot, 292, 11, 155, 1, 0, 459, 0.666626
deduced-slot, 290, 11, 154, 1, 0, 456, 0.666626
deduced-slot, 304, 12, 156, 1, 0, 473, 0.666626
deduced-slot, 290, 11, 159, 1, 0, 461, 0.666626
deduced-slot, 295, 12, 161, 1, 0, 469, 0.666626
deduced-slot, 290, 11, 157, 1, 0, 459, 0.666626
deduced-slot, 293, 11, 157, 1, 0, 462, 0.666626
deduced-slot, 296, 11, 156, 1, 0, 464, 0.666626
deduced-slot, 287, 11, 155, 1, 0, 454, 0.666626
deduced-slot, 291, 11, 158, 1, 0, 461, 0.666626
deduced-slot, 294, 11, 154, 1, 0, 460, 0.666626
deduced-slot, 288, 11, 153, 1, 0, 453, 0.666626
deduced-slot, 295, 11, 159, 1, 0, 466, 0.666626
deduced-slot, 289, 11, 154, 1, 0, 455, 0.666626
deduced-slot, 290, 11, 154, 1, 0, 456, 0.666626
deduced-slot, 296, 11, 159, 1, 0, 467, 0.666626
deduced-slot, 290, 12, 162, 1, 0, 465, 0.666626
deduced-slot, 289, 12, 158, 1, 0, 460, 0.666626
deduced-slot, 291, 11, 156, 1, 0, 459, 0.666626
deduced-slot, 295, 11, 161, 1, 0, 468, 0.666626
deduced-slot, 293, 11, 162, 1, 0, 467, 0.666626
deduced-slot, 290, 11, 160, 1, 0, 462, 0.666626
deduced-slot, 296, 11, 160, 1, 0, 468, 0.666626
deduced-slot, 291, 12, 164, 1, 0, 468, 0.666626
deduced-slot, 293, 11, 161, 1, 0, 466, 0.666626
deduced-slot, 290, 12, 160, 1, 0, 463, 0.666626
deduced-slot, 293, 12, 153, 1, 0, 459, 0.666626
deduced-slot, 288, 11, 158, 1, 0, 458, 0.666626
deduced-slot, 289, 11, 154, 1, 0, 455, 0.666626
deduced-slot, 289, 11, 154, 1, 0, 455, 0.666626
deduced-slot, 290, 11, 164, 1, 0, 466, 0.666626
deduced-slot, 292, 11, 163, 1, 0, 467, 0.666626
deduced-slot, 292, 11, 160, 1, 0, 464, 0.666626
deduced-slot, 292, 11, 165, 1, 0, 469, 0.666626
deduced-slot, 287, 11, 153, 1, 0, 452, 0.666626
deduced-slot, 300, 11, 159, 1, 0, 471, 0.666626
deduced-slot, 290, 12, 157, 1, 0, 460, 0.666626
wu-haven-slot, 289, 12, 173, 1, 0, 475, 0.666626
wu-haven-slot, 290, 11, 174, 1, 0, 476, 0.666626
wu-haven-slot, 288, 11, 174, 1, 0, 474, 0.666626
wu-haven-slot, 290, 11, 176, 1, 0, 478, 0.666626
wu-haven-slot, 290, 11, 173, 1, 0, 475, 0.666626
wu-haven-slot, 287, 11, 177, 1, 0, 476, 0.666626
wu-haven-slot, 286, 11, 177, 1, 0, 475, 0.666626
wu-haven-slot, 290, 11, 181, 1, 0, 483, 0.666626
wu-haven-slot, 288, 12, 175, 1, 0, 476, 0.666626
wu-haven-slot, 287, 11, 177, 1, 0, 476, 0.666626
wu-haven-slot, 289, 11, 174, 1, 0, 475, 0.666626
wu-haven-slot, 289, 11, 172, 1, 0, 473, 0.666626
wu-haven-slot, 285, 11, 170, 1, 0, 467, 0.666626
wu-haven-slot, 285, 11, 171, 1, 0, 468, 0.666626
wu-haven-slot, 285, 11, 169, 1, 0, 466, 0.666626
wu-haven-slot, 286, 11, 173, 1, 0, 471, 0.666626
wu-haven-slot, 286, 11, 170, 1, 0, 468, 0.666626
wu-haven-slot, 289, 11, 172, 1, 0, 473, 0.666626
wu-haven-slot, 293, 11, 173, 1, 0, 478, 0.666626
wu-haven-slot, 285, 11, 174, 1, 0, 471, 0.666626
wu-haven-slot, 289, 11, 174, 1, 0, 475, 0.666626
wu-haven-slot, 295, 11, 176, 1, 0, 483, 0.666626
wu-haven-slot, 294, 11, 179, 1, 0, 485, 0.666626
wu-haven-slot, 291, 11, 178, 1, 0, 481, 0.666626
wu-haven-slot, 290, 11, 178, 1, 0, 480, 0.666626
wu-haven-slot, 295, 11, 176, 1, 0, 483, 0.666626
wu-haven-slot, 288, 11, 172, 1, 0, 472, 0.666626
wu-haven-slot, 285, 11, 173, 1, 0, 470, 0.666626
wu-haven-slot, 285, 11, 175, 1, 0, 472, 0.666626
wu-haven-slot, 290, 11, 173, 1, 0, 475, 0.666626
wu-haven-slot, 290, 11, 179, 1, 0, 481, 0.666626
wu-haven-slot, 297, 11, 172, 1, 0, 481, 0.666626
wu-haven-slot, 293, 11, 178, 1, 0, 483, 0.666626
wu-haven-slot, 288, 11, 175, 1, 0, 475, 0.666626
wu-haven-slot, 289, 12, 177, 1, 0, 479, 0.666626
wu-haven-slot, 297, 12, 177, 1, 0, 487, 0.666626
wu-haven-slot, 293, 12, 174, 1, 0, 480, 0.666626
wu-haven-slot, 287, 11, 171, 1, 0, 470, 0.666626
wu-haven-slot, 291, 11, 169, 1, 0, 472, 0.666626
wu-haven-slot, 298, 11, 176, 1, 0, 486, 0.666626
wu-haven-slot, 290, 11, 173, 1, 0, 475, 0.666626
wu-haven-slot, 288, 11, 175, 1, 0, 475, 0.666626
wu-haven-slot, 294, 11, 177, 1, 0, 483, 0.666626
wu-haven-slot, 288, 11, 175, 1, 0, 475, 0.666626
wu-haven-slot, 290, 11, 176, 1, 0, 478, 0.666626
wu-haven-slot, 296, 11, 180, 1, 0, 488, 0.666626
wu-haven-slot, 297, 11, 184, 1, 0, 493, 0.666626
wu-haven-slot, 288, 12, 177, 1, 0, 478, 0.666626
wu-haven-slot, 289, 11, 174, 1, 0, 475, 0.666626
wu-haven-slot, 295, 11, 175, 1, 0, 482, 0.666626
wu-haven-slot, 294, 11, 175, 1, 0, 481, 0.666626
wu-haven-slot, 290, 12, 178, 1, 0, 481, 0.666626
wu-haven-slot, 288, 12, 174, 1, 0, 475, 0.666626
wu-haven-slot, 288, 11, 174, 1, 0, 474, 0.666626
wu-haven-slot, 287, 11, 172, 1, 0, 471, 0.666626
wu-haven-slot, 288, 11, 169, 1, 0, 469, 0.666626
wu-haven-slot, 288, 11, 177, 1, 0, 477, 0.666626
wu-haven-slot, 287, 11, 173, 1, 0, 472, 0.666626
wu-haven-slot, 285, 11, 174, 1, 0, 471, 0.666626
wu-haven-slot, 292, 11, 174, 1, 0, 478, 0.666626
wu-haven-slot, 287, 11, 170, 1, 0, 469, 0.666626
wu-haven-slot, 282, 11, 171, 1, 0, 465, 0.666626
wu-haven-slot, 288, 11, 173, 1, 0, 473, 0.666626
wu-haven-slot, 285, 11, 171, 1, 0, 468, 0.666626
wu-haven-slot, 289, 11, 174, 1, 0, 475, 0.666626
wu-haven-slot, 296, 11, 176, 1, 0, 484, 0.666626
wu-haven-slot, 286, 11, 171, 1, 0, 469, 0.666626
wu-haven-slot, 289, 12, 176, 1, 0, 478, 0.666626
wu-haven-slot, 297, 11, 179, 1, 0, 488, 0.666626
wu-haven-slot, 289, 11, 176, 1, 0, 477, 0.666626
wu-haven-slot, 287, 12, 179, 1, 0, 479, 0.666626
wu-haven-slot, 294, 12, 176, 1, 0, 483, 0.666626
wu-haven-slot, 289, 11, 178, 1, 0, 479, 0.666626
wu-haven-slot, 293, 11, 174, 1, 0, 479, 0.666626
wu-haven-slot, 296, 12, 175, 1, 0, 484, 0.666626
wu-haven-slot, 285, 11, 166, 1, 0, 463, 0.666626
wu-haven-slot, 290, 11, 175, 1, 0, 477, 0.666626
wu-haven-slot, 287, 11, 175, 1, 0, 474, 0.666626
wu-haven-slot, 286, 11, 171, 1, 0, 469, 0.666626
wu-haven-slot, 285, 11, 172, 1, 0, 469, 0.666626
wu-haven-slot, 282, 11, 168, 1, 0, 462, 0.666626
wu-haven-slot, 286, 11, 173, 1, 0, 471, 0.666626
wu-haven-slot, 290, 11, 177, 1, 0, 479, 0.666626
wu-haven-slot, 288, 11, 174, 1, 0, 474, 0.666626
wu-haven-slot, 288, 12, 175, 1, 0, 476, 0.666626
wu-haven-slot, 293, 12, 175, 1, 0, 481, 0.666626
wu-haven-slot, 289, 11, 169, 1, 0, 470, 0.666626
wu-haven-slot, 295, 11, 171, 1, 0, 478, 0.666626
wu-haven-slot, 286, 11, 170, 1, 0, 468, 0.666626
wu-haven-slot, 287, 11, 191, 1, 0, 490, 0.666626
wu-haven-slot, 289, 11, 170, 1, 0, 471, 0.666626
wu-haven-slot, 289, 11, 185, 1, 0, 486, 0.666626
wu-haven-slot, 293, 11, 172, 1, 0, 477, 0.666626
wu-haven-slot, 293, 12, 179, 1, 0, 485, 0.666626
wu-haven-slot, 287, 11, 170, 1, 0, 469, 0.666626
wu-haven-slot, 283, 11, 174, 1, 0, 469, 0.666626
wu-haven-slot, 289, 11, 173, 1, 0, 474, 0.666626
wu-haven-slot, 286, 11, 174, 1, 0, 472, 0.666626
wu-haven-slot, 291, 11, 172, 1, 0, 475, 0.666626
wu-haven-slot, 293, 12, 168, 1, 0, 474, 0.666626
wu-haven-slot, 286, 11, 173, 1, 0, 471, 0.666626
wu-haven-slot, 286, 12, 176, 1, 0, 475, 0.666626
wu-haven-slot, 286, 11, 168, 1, 0, 466, 0.666626
wu-haven-slot, 293, 11, 170, 1, 0, 475, 0.666626
wu-haven-slot, 286, 11, 174, 1, 0, 472, 0.666626
wu-haven-slot, 289, 11, 169, 1, 0, 470, 0.666626
wu-haven-slot, 287, 11, 171, 1, 0, 470, 0.666626
wu-haven-slot, 288, 11, 175, 1, 0, 475, 0.666626
wu-haven-slot, 297, 11, 178, 1, 0, 487, 0.666626
wu-haven-slot, 288, 11, 178, 1, 0, 478, 0.666626
wu-haven-slot, 286, 11, 171, 1, 0, 469, 0.666626
wu-haven-slot, 286, 11, 172, 1, 0, 470, 0.666626
wu-haven-slot, 289, 11, 173, 1, 0, 474, 0.666626
wu-haven-slot, 294, 11, 172, 1, 0, 478, 0.666626
wu-haven-slot, 288, 11, 171, 1, 0, 471, 0.666626
wu-haven-slot, 286, 11, 175, 1, 0, 473, 0.666626
wu-haven-slot, 290, 11, 177, 1, 0, 479, 0.666626
wu-haven-slot, 287, 11, 171, 1, 0, 470, 0.666626
wu-haven-slot, 286, 11, 169, 1, 0, 467, 0.666626
wu-haven-slot, 283, 11, 172, 1, 0, 467, 0.666626
wu-haven-slot, 288, 11, 174, 1, 0, 474, 0.666626
wu-haven-slot, 293, 11, 173, 1, 0, 478, 0.666626
wu-haven-slot, 291, 11, 178, 1, 0, 481, 0.666626
wu-haven-slot, 285, 11, 170, 1, 0, 467, 0.666626
wu-haven-slot, 285, 11, 172, 1, 0, 469, 0.666626
wu-haven-slot, 290, 12, 170, 1, 0, 473, 0.666626
wu-haven-slot, 290, 11, 175, 1, 0, 477, 0.666626
wu-haven-slot, 291, 11, 173, 1, 0, 476, 0.666626
wu-haven-slot, 286, 11, 172, 1, 0, 470, 0.666626
wu-haven-slot, 285, 11, 171, 1, 0, 468, 0.666626
wu-haven-slot, 283, 11, 171, 1, 0, 466, 0.666626
wu-haven-slot, 288, 11, 174, 1, 0, 474, 0.666626
wu-haven-slot, 292, 11, 175, 1, 0, 479, 0.666626
wu-haven-slot, 295, 12, 174, 1, 0, 482, 0.666626
wu-haven-slot, 284, 11, 168, 1, 0, 464, 0.666626
wu-haven-slot, 294, 11, 170, 1, 0, 476, 0.666626
wu-haven-slot, 290, 11, 173, 1, 0, 475, 0.666626
wu-haven-slot, 289, 11, 175, 1, 0, 476, 0.666626
wu-haven-slot, 298, 12, 180, 1, 0, 491, 0.666626
wu-haven-slot, 286, 11, 169, 1, 0, 467, 0.666626
wu-haven-slot, 286, 11, 169, 1, 0, 467, 0.666626
wu-haven-slot, 291, 11, 176, 1, 0, 479, 0.666626
wu-haven-slot, 291, 11, 172, 1, 0, 475, 0.666626
wu-haven-slot, 286, 11, 170, 1, 0, 468, 0.666626
wu-haven-slot, 292, 11, 168, 1, 0, 472, 0.666626
wu-haven-slot, 290, 12, 173, 1, 0, 476, 0.666626
wu-haven-slot, 287, 11, 174, 1, 0, 473, 0.666626
wu-haven-slot, 289, 11, 177, 1, 0, 478, 0.666626
wu-haven-slot, 288, 11, 174, 1, 0, 474, 0.666626
wu-haven-slot, 290, 11, 178, 1, 0, 480, 0.666626
wu-haven-slot, 286, 11, 169, 1, 0, 467, 0.666626
wu-haven-slot, 289, 11, 168, 1, 0, 469, 0.666626
wu-haven-slot, 282, 11, 163, 1, 0, 457, 0.666626
wu-haven-slot, 292, 11, 173, 1, 0, 477, 0.666626
wu-haven-slot, 286, 11, 169, 1, 0, 467, 0.666626
wu-haven-slot, 297, 11, 176, 1, 0, 485, 0.666626
wu-haven-slot, 289, 11, 176, 1, 0, 477, 0.666626
wu-haven-slot, 288, 11, 173, 1, 0, 473, 0.666626
wu-haven-slot, 291, 11, 181, 1, 0, 484, 0.666626
wu-haven-slot, 294, 11, 173, 1, 0, 479, 0.666626
wu-haven-slot, 292, 11, 171, 1, 0, 475, 0.666626
wu-haven-slot, 289, 11, 172, 1, 0, 473, 0.666626
wu-haven-slot, 298, 11, 174, 1, 0, 484, 0.666626
wu-haven-slot, 286, 11, 166, 1, 0, 464, 0.666626
wu-haven-slot, 291, 12, 176, 1, 0, 480, 0.666626
wu-haven-slot, 294, 11, 167, 1, 0, 473, 0.666626
wu-haven-slot, 290, 11, 171, 1, 0, 473, 0.666626
wu-haven-slot, 286, 11, 171, 1, 0, 469, 0.666626
wu-haven-slot, 291, 11, 174, 1, 0, 477, 0.666626
wu-haven-slot, 285, 12, 175, 1, 0, 473, 0.666626
wu-haven-slot, 293, 11, 175, 1, 0, 480, 0.666626
wu-haven-slot, 293, 11, 176, 1, 0, 481, 0.666626
wu-haven-slot, 287, 11, 173, 1, 0, 472, 0.666626
wu-haven-slot, 288, 11, 173, 1, 0, 473, 0.666626
wu-haven-slot, 294, 11, 180, 1, 0, 486, 0.666626
wu-haven-slot, 289, 11, 170, 1, 0, 471, 0.666626
wu-haven-slot, 290, 11, 174, 1, 0, 476, 0.666626
wu-haven-slot, 289, 11, 173, 1, 0, 474, 0.666626
wu-haven-slot, 288, 11, 176, 1, 0, 476, 0.666626
wu-haven-slot, 288, 11, 174, 1, 0, 474, 0.666626
wu-haven-slot, 292, 11, 171, 1, 0, 475, 0.666626
wu-haven-slot, 284, 11, 171, 1, 0, 467, 0.666626
wu-haven-slot, 287, 11, 173, 1, 0, 472, 0.666626
wu-haven-slot, 292, 11, 180, 1, 0, 484, 0.666626
wu-haven-slot, 292, 12, 179, 1, 0, 484, 0.666626
wu-haven-slot, 288, 11, 173, 1, 0, 473, 0.666626
wu-haven-slot, 293, 11, 173, 1, 0, 478, 0.666626
wu-haven-slot, 284, 11, 172, 1, 0, 468, 0.666626
wu-haven-slot, 289, 11, 171, 1, 0, 472, 0.666626
wu-haven-slot, 287, 11, 174, 1, 0, 473, 0.666626
wu-haven-slot, 294, 11, 177, 1, 0, 483, 0.666626
wu-haven-slot, 286, 12, 174, 1, 0, 473, 0.666626
wu-haven-slot, 291, 11, 175, 1, 0, 478, 0.666626
wu-haven-slot, 291, 11, 172, 1, 0, 475, 0.666626
wu-haven-slot, 286, 12, 180, 1, 0, 479, 0.666626
wu-haven-slot, 291, 12, 180, 1, 0, 484, 0.666626
wu-haven-slot, 290, 12, 175, 1, 0, 478, 0.666626
wu-haven-slot, 293, 11, 171, 1, 0, 476, 0.666626
wu-haven-slot, 288, 11, 174, 1, 0, 474, 0.666626
wu-haven-slot, 290, 11, 176, 1, 0, 478, 0.666626
wu-haven-slot, 291, 11, 179, 1, 0, 482, 0.666626
wu-haven-slot, 294, 11, 174, 1, 0, 480, 0.666626
wu-haven-slot, 285, 11, 171, 1, 0, 468, 0.666626
wu-haven-slot, 288, 11, 173, 1, 0, 473, 0.666626
wu-haven-slot, 287, 11, 169, 1, 0, 468, 0.666626
wu-haven-slot, 286, 11, 170, 1, 0, 468, 0.666626
wu-haven-slot, 288, 11, 172, 1, 0, 472, 0.666626
wu-haven-slot, 286, 11, 171, 1, 0, 469, 0.666626
wu-haven-slot, 286, 11, 174, 1, 0, 472, 0.666626
wu-haven-slot, 297, 12, 177, 1, 0, 487, 0.666626
wu-haven-slot, 299, 12, 173, 1, 0, 485, 0.666626
wu-haven-slot, 291, 11, 175, 1, 0, 478, 0.666626
wu-haven-slot, 286, 11, 172, 1, 0, 470, 0.666626
wu-haven-slot, 286, 11, 189, 1, 0, 487, 0.666626
wu-haven-slot, 287, 11, 170, 1, 0, 469, 0.666626
wu-haven-slot, 285, 11, 172, 1, 0, 469, 0.666626
wu-haven-slot, 289, 11, 171, 1, 0, 472, 0.666626
wu-haven-slot, 285, 11, 173, 1, 0, 470, 0.666626
wu-haven-slot, 291, 11, 171, 1, 0, 474, 0.666626
wu-haven-slot, 286, 11, 175, 1, 0, 473, 0.666626
wu-haven-slot, 288, 11, 172, 1, 0, 472, 0.666626
wu-haven-slot, 291, 11, 173, 1, 0, 476, 0.666626
wu-haven-slot, 290, 11, 171, 1, 0, 473, 0.666626
wu-haven-slot, 290, 11, 173, 1, 0, 475, 0.666626
wu-haven-slot, 292, 11, 177, 1, 0, 481, 0.666626
wu-haven-slot, 287, 11, 174, 1, 0, 473, 0.666626
wu-haven-slot, 285, 11, 173, 1, 0, 470, 0.666626
wu-haven-slot, 285, 11, 173, 1, 0, 470, 0.666626
wu-haven-slot, 285, 11, 166, 1, 0, 463, 0.666626
wu-haven-slot, 288, 11, 176, 1, 0, 476, 0.666626
wu-haven-slot, 289, 12, 173, 1, 0, 475, 0.666626
wu-haven-slot, 294, 11, 172, 1, 0, 478, 0.666626
wu-haven-slot, 285, 12, 171, 1, 0, 469, 0.666626
wu-haven-slot, 298, 11, 175, 1, 0, 485, 0.666626
wu-haven-slot, 293, 11, 177, 1, 0, 482, 0.666626
wu-haven-slot, 290, 12, 179, 1, 0, 482, 0.666626
wu-haven-slot, 292, 12, 176, 1, 0, 481, 0.666626
wu-haven-slot, 290, 11, 176, 1, 0, 478, 0.666626
wu-haven-slot, 293, 12, 176, 1, 0, 482, 0.666626
wu-haven-slot, 289, 11, 170, 1, 0, 471, 0.666626
wu-haven-slot, 288, 12, 174, 1, 0, 475, 0.666626
wu-haven-slot, 291, 11, 174, 1, 0, 477, 0.666626
wu-haven-slot, 287, 11, 175, 1, 0, 474, 0.666626
wu-haven-slot, 286, 11, 167, 1, 0, 465, 0.666626
wu-haven-slot, 287, 11, 171, 1, 0, 470, 0.666626
wu-haven-slot, 292, 11, 172, 1, 0, 476, 0.666626
wu-haven-slot, 290, 11, 174, 1, 0, 476, 0.666626
wu-haven-slot, 291, 11, 177, 1, 0, 480, 0.666626
wu-haven-slot, 290, 11, 173, 1, 0, 475, 0.666626
wu-haven-slot, 289, 11, 171, 1, 0, 472, 0.666626
wu-haven-slot, 289, 11, 171, 1, 0, 472, 0.666626
wu-haven-slot, 287, 12, 171, 1, 0, 471, 0.666626
wu-haven-slot, 288, 11, 176, 1, 0, 476, 0.666626
wu-haven-slot, 291, 11, 174, 1, 0, 477, 0.666626
wu-haven-slot, 288, 14, 179, 1, 0, 482, 0.666626
wu-haven-slot, 294, 11, 175, 1, 0, 481, 0.666626
wu-haven-slot, 291, 12, 179, 1, 0, 483, 0.666626
wu-haven-slot, 293, 11, 176, 1, 0, 481, 0.666626
wu-haven-slot, 290, 11, 178, 1, 0, 480, 0.666626
wu-haven-slot, 288, 11, 174, 1, 0, 474, 0.666626
wu-haven-slot, 288, 11, 174, 1, 0, 474, 0.666626
wu-haven-slot, 285, 11, 173, 1, 0, 470, 0.666626
wu-haven-slot, 287, 11, 172, 1, 0, 471, 0.666626
wu-haven-slot, 291, 11, 172, 1, 0, 475, 0.666626
wu-haven-slot, 284, 11, 168, 1, 0, 464, 0.666626
wu-haven-slot, 286, 11, 170, 1, 0, 468, 0.666626
wu-haven-slot, 288, 11, 174, 1, 0, 474, 0.666626
wu-haven-slot, 288, 11, 171, 1, 0, 471, 0.666626
wu-haven-slot, 288, 11, 168, 1, 0, 468, 0.666626
wu-haven-slot, 287, 11, 166, 1, 0, 465, 0.666626
wu-haven-slot, 288, 11, 168, 1, 0, 468, 0.666626
wu-haven-slot, 288, 11, 177, 1, 0, 477, 0.666626
wu-haven-slot, 291, 12, 173, 1, 0, 477, 0.666626
wu-haven-slot, 299, 11, 177, 1, 0, 488, 0.666626
wu-haven-slot, 290, 11, 177, 1, 0, 479, 0.666626
wu-haven-slot, 296, 11, 175, 1, 0, 483, 0.666626
wu-haven-slot, 291, 11, 168, 1, 0, 471, 0.666626
wu-haven-slot, 289, 11, 173, 1, 0, 474, 0.666626
wu-haven-slot, 287, 11, 170, 1, 0, 469, 0.666626
wu-haven-slot, 296, 11, 172, 1, 0, 480, 0.666626
wu-haven-slot, 287, 11, 172, 1, 0, 471, 0.666626
wu-haven-slot, 287, 11, 173, 1, 0, 472, 0.666626
wu-haven-slot, 287, 11, 175, 1, 0, 474, 0.666626
wu-haven-slot, 293, 11, 176, 1, 0, 481, 0.666626
wu-haven-slot, 288, 11, 177, 1, 0, 477, 0.666626
wu-haven-slot, 286, 11, 176, 1, 0, 474, 0.666626
wu-haven-slot, 288, 11, 172, 1, 0, 472, 0.666626
wu-haven-slot, 295, 11, 174, 1, 0, 481, 0.666626
wu-haven-slot, 294, 11, 173, 1, 0, 479, 0.666626
wu-haven-slot, 292, 11, 171, 1, 0, 475, 0.666626
wu-haven-slot, 285, 11, 167, 1, 0, 464, 0.666626
wu-haven-slot, 286, 11, 170, 1, 0, 468, 0.666626
wu-haven-slot, 286, 11, 172, 1, 0, 470, 0.666626
wu-haven-slot, 297, 11, 175, 1, 0, 484, 0.666626
wu-haven-slot, 289, 11, 174, 1, 0, 475, 0.666626
wu-haven-slot, 290, 12, 174, 1, 0, 477, 0.666626
wu-haven-slot, 288, 11, 171, 1, 0, 471, 0.666626
wu-haven-slot, 291, 11, 174, 1, 0, 477, 0.666626
wu-haven-slot, 290, 11, 175, 1, 0, 477, 0.666626
wu-haven-slot, 291, 12, 175, 1, 0, 479, 0.666626
wu-haven-slot, 289, 11, 172, 1, 0, 473, 0.666626
wu-haven-slot, 286, 12, 171, 1, 0, 470, 0.666626
wu-haven-slot, 293, 11, 174, 1, 0, 479, 0.666626
wu-haven-slot, 289, 11, 171, 1, 0, 472, 0.666626
wu-haven-slot, 292, 11, 171, 1, 0, 475, 0.666626
wu-haven-slot, 287, 12, 176, 1, 0, 476, 0.666626
wu-haven-slot, 285, 11, 165, 1, 0, 462, 0.666626
wu-haven-slot, 291, 11, 171, 1, 0, 474, 0.666626
wu-haven-slot, 287, 11, 172, 1, 0, 471, 0.666626
wu-haven-slot, 289, 11, 179, 1, 0, 480, 0.666626
wu-haven-slot, 285, 11, 172, 1, 0, 469, 0.666626
wu-haven-slot, 288, 11, 169, 1, 0, 469, 0.666626
wu-haven-slot, 283, 11, 170, 1, 0, 465, 0.666626
wu-haven-slot, 285, 11, 178, 1, 0, 475, 0.666626
wu-haven-slot, 284, 11, 169, 1, 0, 465, 0.666626
wu-haven-slot, 287, 11, 177, 1, 0, 476, 0.666626
wu-haven-slot, 290, 11, 177, 1, 0, 479, 0.666626
wu-haven-slot, 286, 11, 172, 1, 0, 470, 0.666626
wu-haven-slot, 285, 11, 176, 1, 0, 473, 0.666626
wu-haven-slot, 291, 11, 175, 1, 0, 478, 0.666626
wu-haven-slot, 287, 11, 176, 1, 0, 475, 0.666626
wu-haven-slot, 291, 11, 178, 1, 0, 481, 0.666626
wu-haven-slot, 286, 11, 173, 1, 0, 471, 0.666626
wu-haven-slot, 289, 11, 174, 1, 0, 475, 0.666626
wu-haven-slot, 292, 11, 176, 1, 0, 480, 0.666626
wu-haven-slot, 292, 11, 170, 1, 0, 474, 0.666626
wu-haven-slot, 290, 12, 171, 1, 0, 474, 0.666626
wu-haven-slot, 288, 11, 171, 1, 0, 471, 0.666626
wu-haven-slot, 294, 11, 166, 1, 0, 472, 0.666626
wu-haven-slot, 295, 11, 172, 1, 0, 479, 0.666626
wu-haven-slot, 286, 11, 170, 1, 0, 468, 0.666626
wu-haven-slot, 283, 11, 168, 1, 0, 463, 0.666626
wu-haven-slot, 290, 12, 175, 1, 0, 478, 0.666626
wu-haven-slot, 287, 11, 169, 1, 0, 468, 0.666626
wu-haven-slot, 288, 11, 172, 1, 0, 472, 0.666626
wu-haven-slot, 291, 11, 174, 1, 0, 477, 0.666626
wu-haven-slot, 288, 11, 173, 1, 0, 473, 0.666626
wu-haven-slot, 303, 12, 175, 1, 0, 491, 0.666626
wu-haven-slot, 289, 12, 171, 1, 0, 473, 0.666626
wu-haven-slot, 286, 11, 169, 1, 0, 467, 0.666626
wu-haven-slot, 287, 11, 171, 1, 0, 470, 0.666626
wu-haven-slot, 288, 11, 172, 1, 0, 472, 0.666626
wu-haven-slot, 283, 11, 165, 1, 0, 460, 0.666626
wu-haven-slot, 290, 11, 174, 1, 0, 476, 0.666626
wu-haven-slot, 289, 11, 174, 1, 0, 475, 0.666626
wu-haven-slot, 289, 11, 173, 1, 0, 474, 0.666626
wu-haven-slot, 285, 12, 175, 1, 0, 473, 0.666626
wu-haven-slot, 287, 11, 173, 1, 0, 472, 0.666626
wu-haven-slot, 288, 11, 172, 1, 0, 472, 0.666626
wu-haven-slot, 288, 11, 175, 1, 0, 475, 0.666626
wu-haven-slot, 293, 11, 175, 1, 0, 480, 0.666626
wu-haven-slot, 286, 11, 171, 1, 0, 469, 0.666626
wu-haven-slot, 284, 11, 166, 1, 0, 462, 0.666626
wu-haven-slot, 293, 11, 171, 1, 0, 476, 0.666626
wu-haven-slot, 285, 11, 168, 1, 0, 465, 0.666626
wu-haven-slot, 287, 11, 168, 1, 0, 467, 0.666626
wu-haven-slot, 284, 11, 172, 1, 0, 468, 0.666626
wu-haven-slot, 287, 11, 169, 1, 0, 468, 0.666626
wu-haven-slot, 287, 11, 172, 1, 0, 471, 0.666626
wu-haven-slot, 287, 11, 172, 1, 0, 471, 0.666626
wu-haven-slot, 292, 12, 171, 1, 0, 476, 0.666626
wu-haven-slot, 288, 11, 173, 1, 0, 473, 0.666626
wu-haven-slot, 288, 11, 169, 1, 0, 469, 0.666626
wu-haven-slot, 288, 11, 169, 1, 0, 469, 0.666626
wu-haven-slot, 289, 12, 175, 1, 0, 477, 0.666626
wu-haven-slot, 289, 11, 171, 1, 0, 472, 0.666626
wu-haven-slot, 290, 11, 175, 1, 0, 477, 0.666626
wu-haven-slot, 287, 11, 174, 1, 0, 473, 0.666626
wu-haven-slot, 286, 11, 166, 1, 0, 464, 0.666626
wu-haven-slot, 286, 11, 171, 1, 0, 469, 0.666626
wu-haven-slot, 291, 12, 169, 1, 0, 473, 0.666626
wu-haven-slot, 289, 11, 175, 1, 0, 476, 0.666626
wu-haven-slot, 290, 11, 174, 1, 0, 476, 0.666626
wu-haven-slot, 285, 11, 170, 1, 0, 467, 0.666626
wu-haven-slot, 287, 11, 171, 1, 0, 470, 0.666626
wu-haven-slot, 294, 12, 173, 1, 0, 480, 0.666626
wu-haven-slot, 286, 11, 176, 1, 0, 474, 0.666626
wu-haven-slot, 287, 11, 168, 1, 0, 467, 0.666626
wu-haven-slot, 297, 11, 174, 1, 0, 483, 0.666626
wu-haven-slot, 287, 11, 173, 1, 0, 472, 0.666626
wu-haven-slot, 288, 11, 172, 1, 0, 472, 0.666626
wu-haven-slot, 287, 11, 172, 1, 0, 471, 0.666626
wu-haven-slot, 291, 11, 173, 1, 0, 476, 0.666626
wu-haven-slot, 289, 11, 172, 1, 0, 473, 0.666626
wu-haven-slot, 288, 11, 173, 1, 0, 473, 0.666626
wu-haven-slot, 288, 11, 171, 1, 0, 471, 0.666626
wu-haven-slot, 288, 11, 176, 1, 0, 476, 0.666626
wu-haven-slot, 291, 11, 167, 1, 0, 470, 0.666626
wu-haven-slot, 285, 12, 168, 1, 0, 466, 0.666626
wu-haven-slot, 290, 11, 174, 1, 0, 476, 0.666626
wu-haven-slot, 286, 11, 172, 1, 0, 470, 0.666626
wu-haven-slot, 285, 11, 168, 1, 0, 465, 0.666626
wu-haven-slot, 286, 11, 171, 1, 0, 469, 0.666626
wu-haven-slot, 286, 11, 171, 1, 0, 469, 0.666626
wu-haven-slot, 284, 11, 169, 1, 0, 465, 0.666626
wu-haven-slot, 287, 11, 170, 1, 0, 469, 0.666626
wu-haven-slot, 286, 11, 176, 1, 0, 474, 0.666626
wu-haven-slot, 290, 11, 176, 1, 0, 478, 0.666626
wu-haven-slot, 288, 11, 173, 1, 0, 473, 0.666626
wu-haven-slot, 292, 12, 180, 1, 0, 485, 0.666626
wu-haven-slot, 287, 11, 176, 1, 0, 475, 0.666626
wu-haven-slot, 292, 12, 176, 1, 0, 481, 0.666626
wu-haven-slot, 290, 11, 177, 1, 0, 479, 0.666626
wu-haven-slot, 286, 11, 171, 1, 0, 469, 0.666626
wu-haven-slot, 285, 11, 169, 1, 0, 466, 0.666626
wu-haven-slot, 285, 11, 173, 1, 0, 470, 0.666626
wu-haven-slot, 283, 11, 170, 1, 0, 465, 0.666626
wu-haven-slot, 289, 11, 178, 1, 0, 479, 0.666626
wu-haven-slot, 289, 11, 170, 1, 0, 471, 0.666626
wu-haven-slot, 289, 11, 174, 1, 0, 475, 0.666626
wu-haven-slot, 291, 11, 171, 1, 0, 474, 0.666626
wu-haven-slot, 287, 11, 171, 1, 0, 470, 0.666626
wu-haven-slot, 287, 11, 171, 1, 0, 470, 0.666626
wu-haven-slot, 292, 11, 171, 1, 0, 475, 0.666626
wu-haven-slot, 293, 11, 174, 1, 0, 479, 0.666626
wu-haven-slot, 286, 11, 172, 1, 0, 470, 0.666626
wu-haven-slot, 304, 11, 171, 1, 0, 487, 0.666626
wu-haven-slot, 288, 11, 179, 1, 0, 479, 0.666626
wu-haven-slot, 293, 11, 171, 1, 0, 476, 0.666626
wu-haven-slot, 292, 11, 172, 1, 0, 476, 0.666626
wu-haven-slot, 287, 11, 172, 1, 0, 471, 0.666626
wu-haven-slot, 290, 11, 174, 1, 0, 476, 0.666626
wu-haven-slot, 290, 12, 176, 1, 0, 479, 0.666626
wu-haven-slot, 291, 11, 177, 1, 0, 480, 0.666626
wu-haven-slot, 288, 11, 175, 1, 0, 475, 0.666626
wu-haven-slot, 288, 11, 174, 1, 0, 474, 0.666626
wu-haven-slot, 290, 11, 173, 1, 0, 475, 0.666626
wu-haven-slot, 299, 11, 174, 1, 0, 485, 0.666626
wu-haven-slot, 304, 12, 176, 1, 0, 493, 0.666626
wu-haven-slot, 289, 11, 174, 1, 0, 475, 0.666626
wu-haven-slot, 288, 11, 171, 1, 0, 471, 0.666626
wu-haven-slot, 290, 11, 171, 1, 0, 473, 0.666626
wu-haven-slot, 294, 12, 176, 1, 0, 483, 0.666626
wu-haven-slot, 286, 11, 175, 1, 0, 473, 0.666626
wu-haven-slot, 291, 11, 174, 1, 0, 477, 0.666626
wu-haven-slot, 288, 12, 171, 1, 0, 472, 0.666626
wu-haven-slot, 288, 12, 178, 1, 0, 479, 0.666626
wu-haven-slot, 292, 11, 175, 1, 0, 479, 0.666626
wu-haven-slot, 290, 11, 176, 1, 0, 478, 0.666626
wu-haven-slot, 286, 11, 173, 1, 0, 471, 0.666626
wu-haven-slot, 289, 12, 175, 1, 0, 477, 0.666626
wu-haven-slot, 292, 11, 179, 1, 0, 483, 0.666626
wu-haven-slot, 287, 11, 180, 1, 0, 479, 0.666626
wu-haven-slot, 292, 11, 177, 1, 0, 481, 0.666626
wu-haven-slot, 288, 11, 179, 1, 0, 479, 0.666626
wu-haven-slot, 288, 12, 172, 1, 0, 473, 0.666626
wu-haven-slot, 285, 11, 170, 1, 0, 467, 0.666626
wu-haven-slot, 290, 11, 171, 1, 0, 473, 0.666626
wu-haven-slot, 290, 11, 177, 1, 0, 479, 0.666626
wu-haven-slot, 289, 11, 176, 1, 0, 477, 0.666626
wu-haven-slot, 291, 11, 175, 1, 0, 478, 0.666626
wu-haven-slot, 289, 11, 172, 1, 0, 473, 0.666626
wu-haven-slot, 295, 11, 173, 1, 0, 480, 0.666626
wu-haven-slot, 288, 12, 171, 1, 0, 472, 0.666626
wu-haven-slot, 282, 11, 169, 1, 0, 463, 0.666626
wu-haven-slot, 290, 11, 170, 1, 0, 472, 0.666626
wu-haven-slot, 286, 13, 169, 1, 0, 469, 0.666626
wu-haven-slot, 289, 12, 168, 1, 0, 470, 0.666626
wu-haven-slot, 289, 11, 170, 1, 0, 471, 0.666626
wu-haven-slot, 288, 11, 175, 1, 0, 475, 0.666626
wu-haven-slot, 287, 11, 173, 1, 0, 472, 0.666626
wu-haven-slot, 305, 11, 172, 1, 0, 489, 0.666626
wu-haven-slot, 290, 11, 174, 1, 0, 476, 0.666626
wu-haven-slot, 287, 11, 171, 1, 0, 470, 0.666626
wu-haven-slot, 289, 11, 172, 1, 0, 473, 0.666626
wu-haven-slot, 295, 12, 176, 1, 0, 484, 0.666626
wu-haven-slot, 290, 11, 168, 1, 0, 470, 0.666626
wu-haven-slot, 285, 11, 169, 1, 0, 466, 0.666626
wu-haven-slot, 285, 11, 174, 1, 0, 471, 0.666626
wu-haven-slot, 287, 11, 168, 1, 0, 467, 0.666626
wu-haven-slot, 294, 11, 174, 1, 0, 480, 0.666626
wu-haven-slot, 288, 11, 173, 1, 0, 473, 0.666626
wu-haven-slot, 287, 12, 173, 1, 0, 473, 0.666626
wu-haven-slot, 286, 11, 176, 1, 0, 474, 0.666626
wu-haven-slot, 293, 11, 175, 1, 0, 480, 0.666626
wu-haven-slot, 288, 11, 171, 1, 0, 471, 0.666626
wu-haven-slot, 288, 11, 173, 1, 0, 473, 0.666626
wu-haven-slot, 291, 12, 178, 1, 0, 482, 0.666626
wu-haven-slot, 289, 11, 177, 1, 0, 478, 0.666626
wu-haven-slot, 288, 11, 168, 1, 0, 468, 0.666626
wu-haven-slot, 288, 11, 176, 1, 0, 476, 0.666626
wu-haven-slot, 287, 11, 172, 1, 0, 471, 0.666626
wu-haven-slot, 288, 11, 172, 1, 0, 472, 0.666626
wu-haven-slot, 293, 11, 172, 1, 0, 477, 0.666626
wu-haven-slot, 293, 11, 177, 1, 0, 482, 0.666626
wu-haven-slot, 289, 11, 173, 1, 0, 474, 0.666626
wu-haven-slot, 291, 11, 171, 1, 0, 474, 0.666626
wu-haven-slot, 290, 11, 172, 1, 0, 474, 0.666626
wu-haven-slot, 286, 11, 174, 1, 0, 472, 0.666626
wu-haven-slot, 293, 12, 173, 1, 0, 479, 0.666626
wu-haven-slot, 292, 11, 173, 1, 0, 477, 0.666626
wu-haven-slot, 289, 11, 175, 1, 0, 476, 0.666626
wu-haven-slot, 292, 11, 172, 1, 0, 476, 0.666626
wu-haven-slot, 288, 11, 166, 1, 0, 466, 0.666626
wu-haven-slot, 286, 11, 170, 1, 0, 468, 0.666626
wu-haven-slot, 291, 11, 175, 1, 0, 478, 0.666626
wu-haven-slot, 290, 11, 177, 1, 0, 479, 0.666626
wu-haven-slot, 293, 11, 170, 1, 0, 475, 0.666626
wu-haven-slot, 288, 11, 175, 1, 0, 475, 0.666626
wu-haven-slot, 290, 11, 178, 1, 0, 480, 0.666626
wu-haven-slot, 290, 12, 176, 1, 0, 479, 0.666626
wu-haven-slot, 284, 11, 170, 1, 0, 466, 0.666626
wu-haven-slot, 287, 11, 174, 1, 0, 473, 0.666626
wu-haven-slot, 286, 11, 176, 1, 0, 474, 0.666626
wu-haven-slot, 291, 11, 177, 1, 0, 480, 0.666626
wu-haven-slot, 294, 12, 174, 1, 0, 481, 0.666626
wu-haven-slot, 293, 11, 175, 1, 0, 480, 0.666626
wu-haven-slot, 287, 11, 176, 1, 0, 475, 0.666626
wu-haven-slot, 293, 11, 174, 1, 0, 479, 0.666626
wu-haven-slot, 289, 11, 176, 1, 0, 477, 0.666626
wu-haven-slot, 291, 11, 171, 1, 0, 474, 0.666626
wu-haven-slot, 288, 11, 171, 1, 0, 471, 0.666626
wu-haven-slot, 289, 12, 174, 1, 0, 476, 0.666626
wu-haven-slot, 294, 11, 180, 1, 0, 486, 0.666626
wu-haven-slot, 283, 11, 170, 1, 0, 465, 0.666626
wu-haven-slot, 287, 11, 174, 1, 0, 473, 0.666626
wu-haven-slot, 290, 11, 172, 1, 0, 474, 0.666626
wu-haven-slot, 291, 11, 170, 1, 0, 473, 0.666626
wu-haven-slot, 283, 11, 168, 1, 0, 463, 0.666626
wu-haven-slot, 289, 11, 167, 1, 0, 468, 0.666626
wu-haven-slot, 288, 12, 171, 1, 0, 472, 0.666626
wu-haven-slot, 292, 11, 172, 1, 0, 476, 0.666626
wu-haven-slot, 290, 11, 172, 1, 0, 474, 0.666626
wu-haven-slot, 290, 11, 172, 1, 0, 474, 0.666626
wu-haven-slot, 289, 11, 173, 1, 0, 474, 0.666626
wu-haven-slot, 293, 11, 173, 1, 0, 478, 0.666626
wu-haven-slot, 289, 11, 177, 1, 0, 478, 0.666626
wu-haven-slot, 292, 11, 176, 1, 0, 480, 0.666626
wu-haven-slot, 288, 11, 171, 1, 0, 471, 0.666626
wu-haven-slot, 285, 11, 169, 1, 0, 466, 0.666626
wu-haven-slot, 285, 11, 168, 1, 0, 465, 0.666626
wu-haven-slot, 287, 11, 170, 1, 0, 469, 0.666626
wu-haven-slot, 287, 11, 170, 1, 0, 469, 0.666626
wu-haven-slot, 288, 11, 174, 1, 0, 474, 0.666626
wu-haven-slot, 285, 12, 174, 1, 0, 472, 0.666626
wu-haven-slot, 291, 11, 172, 1, 0, 475, 0.666626
wu-haven-slot, 287, 11, 172, 1, 0, 471, 0.666626
wu-haven-slot, 285, 11, 168, 1, 0, 465, 0.666626
wu-haven-slot, 289, 11, 169, 1, 0, 470, 0.666626
wu-haven-slot, 288, 11, 175, 1, 0, 475, 0.666626
wu-haven-slot, 293, 11, 172, 1, 0, 477, 0.666626
wu-haven-slot, 288, 11, 177, 1, 0, 477, 0.666626
wu-haven-slot, 291, 11, 177, 1, 0, 480, 0.666626
wu-haven-slot, 289, 11, 170, 1, 0, 471, 0.666626
wu-haven-slot, 287, 11, 168, 1, 0, 467, 0.666626
wu-haven-slot, 290, 11, 169, 1, 0, 471, 0.666626
wu-haven-slot, 291, 11, 172, 1, 0, 475, 0.666626
wu-haven-slot, 292, 11, 180, 1, 0, 484, 0.666626
wu-haven-slot, 293, 12, 173, 1, 0, 479, 0.666626
wu-haven-slot, 295, 11, 174, 1, 0, 481, 0.666626
wu-haven-slot, 290, 11, 173, 1, 0, 475, 0.666626
wu-haven-slot, 290, 11, 171, 1, 0, 473, 0.666626
wu-haven-slot, 291, 12, 174, 1, 0, 478, 0.666626
wu-haven-slot, 290, 11, 173, 1, 0, 475, 0.666626
wu-haven-slot, 288, 12, 179, 1, 0, 480, 0.666626
wu-haven-slot, 288, 11, 172, 1, 0, 472, 0.666626
wu-haven-slot, 293, 11, 171, 1, 0, 476, 0.666626
wu-haven-slot, 288, 11, 172, 1, 0, 472, 0.666626
wu-haven-slot, 290, 11, 167, 1, 0, 469, 0.666626
wu-haven-slot, 284, 12, 177, 1, 0, 474, 0.666626
wu-haven-slot, 295, 11, 177, 1, 0, 484, 0.666626
wu-haven-slot, 289, 11, 180, 1, 0, 481, 0.666626
wu-haven-slot, 293, 11, 174, 1, 0, 479, 0.666626
wu-haven-slot, 295, 11, 180, 1, 0, 487, 0.666626
wu-haven-slot, 305, 11, 175, 1, 0, 492, 0.666626
wu-haven-slot, 285, 11, 170, 1, 0, 467, 0.666626
wu-haven-slot, 296, 12, 179, 1, 0, 488, 0.666626
wu-haven-slot, 291, 12, 179, 1, 0, 483, 0.666626
wu-haven-slot, 292, 12, 180, 1, 0, 485, 0.666626
wu-haven-slot, 288, 11, 175, 1, 0, 475, 0.666626
wu-haven-slot, 289, 11, 176, 1, 0, 477, 0.666626
wu-haven-slot, 304, 11, 177, 1, 0, 493, 0.666626
wu-haven-slot, 298, 11, 178, 1, 0, 488, 0.666626
wu-haven-slot, 290, 11, 174, 1, 0, 476, 0.666626
wu-haven-slot, 286, 11, 173, 1, 0, 471, 0.666626
wu-haven-slot, 286, 12, 178, 1, 0, 477, 0.666626
wu-haven-slot, 287, 11, 175, 1, 0, 474, 0.666626
wu-haven-slot, 287, 11, 172, 1, 0, 471, 0.666626
wu-haven-slot, 287, 11, 177, 1, 0, 476, 0.666626
wu-haven-slot, 287, 11, 168, 1, 0, 467, 0.666626
wu-haven-slot, 285, 12, 172, 1, 0, 470, 0.666626
wu-haven-slot, 289, 11, 170, 1, 0, 471, 0.666626
wu-haven-slot, 285, 11, 172, 1, 0, 469, 0.666626
wu-haven-slot, 287, 11, 173, 1, 0, 472, 0.666626
wu-haven-slot, 286, 11, 174, 1, 0, 472, 0.666626
wu-haven-slot, 306, 11, 171, 1, 0, 489, 0.666626
wu-haven-slot, 290, 11, 171, 1, 0, 473, 0.666626
wu-haven-slot, 297, 12, 175, 1, 0, 485, 0.666626
wu-haven-slot, 293, 12, 183, 1, 0, 489, 0.666626
wu-haven-slot, 293, 11, 170, 1, 0, 475, 0.666626
wu-haven-slot, 288, 11, 172, 1, 0, 472, 0.666626
wu-haven-slot, 287, 11, 170, 1, 0, 469, 0.666626
wu-haven-slot, 290, 11, 172, 1, 0, 474, 0.666626
wu-haven-slot, 288, 11, 168, 1, 0, 468, 0.666626
wu-haven-slot, 289, 11, 169, 1, 0, 470, 0.666626
wu-haven-slot, 291, 12, 173, 1, 0, 477, 0.666626
wu-haven-slot, 285, 12, 176, 1, 0, 474, 0.666626
wu-haven-slot, 292, 11, 177, 1, 0, 481, 0.666626
wu-haven-slot, 286, 11, 173, 1, 0, 471, 0.666626
wu-haven-slot, 288, 12, 172, 1, 0, 473, 0.666626
wu-haven-slot, 287, 11, 168, 1, 0, 467, 0.666626
wu-haven-slot, 284, 12, 170, 1, 0, 467, 0.666626
wu-haven-slot, 292, 11, 175, 1, 0, 479, 0.666626
wu-haven-slot, 295, 11, 176, 1, 0, 483, 0.666626
wu-haven-slot, 288, 12, 178, 1, 0, 479, 0.666626
wu-haven-slot, 292, 12, 175, 1, 0, 480, 0.666626
wu-haven-slot, 289, 11, 173, 1, 0, 474, 0.666626
wu-haven-slot, 285, 15, 174, 1, 0, 475, 0.666626
wu-haven-slot, 289, 11, 166, 1, 0, 467, 0.666626
wu-haven-slot, 288, 11, 173, 1, 0, 473, 0.666626
wu-haven-slot, 286, 11, 171, 1, 0, 469, 0.666626
wu-haven-slot, 287, 11, 175, 1, 0, 474, 0.666626
wu-haven-slot, 293, 11, 177, 1, 0, 482, 0.666626
wu-haven-slot, 291, 11, 175, 1, 0, 478, 0.666626
wu-haven-slot, 290, 11, 175, 1, 0, 477, 0.666626
wu-haven-slot, 285, 11, 178, 1, 0, 475, 0.666626
wu-haven-slot, 292, 11, 175, 1, 0, 479, 0.666626
wu-haven-slot, 288, 11, 172, 2, 0, 473, 0.666626
wu-haven-slot, 291, 11, 173, 1, 0, 476, 0.666626
wu-haven-slot, 297, 12, 176, 1, 0, 486, 0.666626
wu-haven-slot, 294, 11, 171, 1, 0, 477, 0.666626
wu-haven-slot, 285, 11, 167, 1, 0, 464, 0.666626
wu-haven-slot, 291, 12, 172, 1, 0, 476, 0.666626
wu-haven-slot, 294, 11, 176, 1, 0, 482, 0.666626
wu-haven-slot, 296, 11, 175, 1, 0, 483, 0.666626
wu-haven-slot, 287, 11, 177, 1, 0, 476, 0.666626
wu-haven-slot, 296, 11, 176, 1, 0, 484, 0.666626
wu-haven-slot, 292, 11, 179, 1, 0, 483, 0.666626
wu-haven-slot, 293, 11, 173, 1, 0, 478, 0.666626
wu-haven-slot, 285, 11, 168, 1, 0, 465, 0.666626
wu-haven-slot, 286, 11, 176, 1, 0, 474, 0.666626
wu-haven-slot, 290, 11, 171, 1, 0, 473, 0.666626
wu-haven-slot, 292, 11, 178, 1, 0, 482, 0.666626
wu-haven-slot, 289, 11, 173, 1, 0, 474, 0.666626
wu-haven-slot, 293, 11, 175, 1, 0, 480, 0.666626
wu-haven-slot, 289, 11, 173, 1, 0, 474, 0.666626
wu-haven-slot, 289, 11, 177, 1, 0, 478, 0.666626
wu-haven-slot, 291, 11, 175, 1, 0, 478, 0.666626
wu-haven-slot, 287, 12, 180, 1, 0, 480, 0.666626
wu-haven-slot, 292, 11, 172, 1, 0, 476, 0.666626
wu-haven-slot, 291, 11, 179, 1, 0, 482, 0.666626
wu-haven-slot, 292, 11, 175, 1, 0, 479, 0.666626
wu-haven-slot, 286, 12, 177, 1, 0, 476, 0.666626
wu-haven-slot, 287, 11, 172, 1, 0, 471, 0.666626
wu-haven-slot, 287, 11, 168, 1, 0, 467, 0.666626
wu-haven-slot, 287, 11, 169, 1, 0, 468, 0.666626
wu-haven-slot, 287, 11, 176, 1, 0, 475, 0.666626
wu-haven-slot, 291, 11, 172, 1, 0, 475, 0.666626
wu-haven-slot, 285, 11, 172, 1, 0, 469, 0.666626
wu-haven-slot, 285, 11, 171, 1, 0, 468, 0.666626
wu-haven-slot, 289, 11, 168, 1, 0, 469, 0.666626
wu-haven-slot, 297, 11, 170, 1, 0, 479, 0.666626
wu-haven-slot, 286, 11, 171, 1, 0, 469, 0.666626
wu-haven-slot, 287, 11, 172, 1, 0, 471, 0.666626
wu-haven-slot, 286, 11, 170, 1, 0, 468, 0.666626
wu-haven-slot, 288, 11, 171, 1, 0, 471, 0.666626
wu-haven-slot, 288, 11, 170, 1, 0, 470, 0.666626
wu-haven-slot, 287, 11, 169, 1, 0, 468, 0.666626
wu-haven-slot, 290, 11, 179, 1, 0, 481, 0.666626
wu-haven-slot, 294, 12, 173, 1, 0, 480, 0.666626
wu-haven-slot, 292, 11, 174, 1, 0, 478, 0.666626
wu-haven-slot, 291, 11, 176, 1, 0, 479, 0.666626
wu-haven-slot, 294, 11, 174, 1, 0, 480, 0.666626
wu-haven-slot, 287, 11, 173, 1, 0, 472, 0.666626
wu-haven-slot, 286, 11, 175, 1, 0, 473, 0.666626
wu-haven-slot, 293, 11, 176, 1, 0, 481, 0.666626
wu-haven-slot, 295, 11, 170, 1, 0, 477, 0.666626
wu-haven-slot, 286, 11, 171, 1, 0, 469, 0.666626
wu-haven-slot, 288, 11, 174, 1, 0, 474, 0.666626
wu-haven-slot, 290, 11, 171, 1, 0, 473, 0.666626
wu-haven-slot, 289, 11, 169, 1, 0, 470, 0.666626
wu-haven-slot, 287, 12, 171, 1, 0, 471, 0.666626
wu-haven-slot, 284, 11, 169, 1, 0, 465, 0.666626
wu-haven-slot, 287, 11, 170, 1, 0, 469, 0.666626
wu-haven-slot, 295, 11, 177, 1, 0, 484, 0.666626
wu-haven-slot, 289, 12, 172, 1, 0, 474, 0.666626
wu-haven-slot, 288, 11, 173, 1, 0, 473, 0.666626
wu-haven-slot, 287, 12, 178, 1, 0, 478, 0.666626
wu-haven-slot, 287, 11, 175, 1, 0, 474, 0.666626
wu-haven-slot, 292, 11, 181, 1, 0, 485, 0.666626
wu-haven-slot, 291, 11, 175, 1, 0, 478, 0.666626
wu-haven-slot, 290, 11, 174, 1, 0, 476, 0.666626
wu-haven-slot, 288, 11, 173, 1, 0, 473, 0.666626
wu-haven-slot, 288, 12, 173, 1, 0, 474, 0.666626
wu-haven-slot, 290, 11, 174, 1, 0, 476, 0.666626
wu-haven-slot, 288, 11, 171, 1, 0, 471, 0.666626
wu-haven-slot, 290, 11, 175, 1, 0, 477, 0.666626
wu-haven-slot, 287, 11, 175, 1, 0, 474, 0.666626
wu-haven-slot, 291, 11, 171, 1, 0, 474, 0.666626
wu-haven-slot, 290, 11, 176, 1, 0, 478, 0.666626
wu-haven-slot, 294, 12, 180, 1, 0, 487, 0.666626
wu-haven-slot, 287, 12, 177, 1, 0, 477, 0.666626
wu-haven-slot, 290, 11, 173, 1, 0, 475, 0.666626
wu-haven-slot, 290, 11, 170, 1, 0, 472, 0.666626
wu-haven-slot, 291, 11, 175, 1, 0, 478, 0.666626
wu-haven-slot, 289, 12, 177, 1, 0, 479, 0.666626
wu-haven-slot, 288, 11, 172, 1, 0, 472, 0.666626
wu-haven-slot, 292, 11, 183, 1, 0, 487, 0.666626
wu-haven-slot, 295, 11, 174, 1, 0, 481, 0.666626
wu-haven-slot, 290, 11, 175, 1, 0, 477, 0.666626
wu-haven-slot, 288, 11, 180, 1, 0, 480, 0.666626
wu-haven-slot, 290, 11, 180, 1, 0, 482, 0.666626
wu-haven-slot, 292, 12, 174, 1, 0, 479, 0.666626
wu-haven-slot, 288, 11, 175, 1, 0, 475, 0.666626
wu-haven-slot, 295, 12, 174, 1, 0, 482, 0.666626
wu-haven-slot, 296, 12, 172, 1, 0, 481, 0.666626
wu-haven-slot, 289, 11, 172, 1, 0, 473, 0.666626
wu-haven-slot, 288, 11, 169, 1, 0, 469, 0.666626
wu-haven-slot, 287, 11, 190, 1, 0, 489, 0.666626
wu-haven-slot, 295, 11, 172, 1, 0, 479, 0.666626
wu-haven-slot, 285, 11, 174, 1, 0, 471, 0.666626
wu-haven-slot, 289, 11, 172, 1, 0, 473, 0.666626
wu-haven-slot, 289, 11, 174, 1, 0, 475, 0.666626
wu-haven-slot, 286, 11, 174, 1, 0, 472, 0.666626
wu-haven-slot, 290, 11, 175, 1, 0, 477, 0.666626
wu-haven-slot, 289, 12, 176, 1, 0, 478, 0.666626
wu-haven-slot, 291, 11, 176, 1, 0, 479, 0.666626
wu-haven-slot, 299, 11, 173, 1, 0, 484, 0.666626
wu-haven-slot, 287, 11, 170, 1, 0, 469, 0.666626
wu-haven-slot, 290, 11, 173, 1, 0, 475, 0.666626
wu-haven-slot, 286, 11, 172, 1, 0, 470, 0.666626
wu-haven-slot, 290, 11, 171, 1, 0, 473, 0.666626
wu-haven-slot, 290, 12, 174, 1, 0, 477, 0.666626
wu-haven-slot, 286, 11, 170, 1, 0, 468, 0.666626
wu-haven-slot, 289, 11, 172, 1, 0, 473, 0.666626
wu-haven-slot, 289, 11, 169, 1, 0, 470, 0.666626
wu-haven-slot, 287, 11, 170, 1, 0, 469, 0.666626
wu-haven-slot, 287, 11, 172, 1, 0, 471, 0.666626
wu-haven-slot, 288, 11, 178, 1, 0, 478, 0.666626
wu-haven-slot, 287, 11, 169, 1, 0, 468, 0.666626
wu-haven-slot, 290, 11, 172, 1, 0, 474, 0.666626
wu-haven-slot, 290, 11, 173, 1, 0, 475, 0.666626
wu-haven-slot, 287, 11, 172, 1, 0, 471, 0.666626
wu-haven-slot, 289, 11, 178, 1, 0, 479, 0.666626
wu-haven-slot, 286, 11, 168, 1, 0, 466, 0.666626
wu-haven-slot, 289, 11, 172, 1, 0, 473, 0.666626
wu-haven-slot, 288, 11, 176, 1, 0, 476, 0.666626
wu-haven-slot, 291, 11, 175, 1, 0, 478, 0.666626
wu-haven-slot, 293, 11, 178, 1, 0, 483, 0.666626
wu-haven-slot, 292, 11, 175, 1, 0, 479, 0.666626
wu-haven-slot, 288, 11, 171, 1, 0, 471, 0.666626
wu-haven-slot, 292, 11, 179, 1, 0, 483, 0.666626
wu-haven-slot, 287, 11, 177, 1, 0, 476, 0.666626
wu-haven-slot, 288, 11, 176, 1, 0, 476, 0.666626
wu-haven-slot, 287, 11, 172, 1, 0, 471, 0.666626
wu-haven-slot, 289, 11, 174, 1, 0, 475, 0.666626
wu-haven-slot, 288, 11, 172, 1, 0, 472, 0.666626
wu-haven-slot, 287, 11, 169, 1, 0, 468, 0.666626
wu-haven-slot, 286, 12, 173, 1, 0, 472, 0.666626
wu-haven-slot, 291, 11, 178, 1, 0, 481, 0.666626
wu-haven-slot, 288, 11, 170, 1, 0, 470, 0.666626
wu-haven-slot, 291, 11, 178, 1, 0, 481, 0.666626
wu-haven-slot, 289, 11, 174, 1, 0, 475, 0.666626
wu-haven-slot, 292, 12, 176, 1, 0, 481, 0.666626
wu-haven-slot, 293, 11, 167, 1, 0, 472, 0.666626
wu-haven-slot, 287, 11, 173, 1, 0, 472, 0.666626
wu-haven-slot, 287, 11, 174, 1, 0, 473, 0.666626
wu-haven-slot, 294, 11, 175, 1, 0, 481, 0.666626
wu-haven-slot, 287, 11, 170, 1, 0, 469, 0.666626
wu-haven-slot, 292, 11, 171, 1, 0, 475, 0.666626
wu-haven-slot, 294, 11, 173, 1, 0, 479, 0.666626
wu-haven-slot, 287, 11, 173, 1, 0, 472, 0.666626
wu-haven-slot, 289, 11, 171, 1, 0, 472, 0.666626
wu-haven-slot, 287, 11, 171, 1, 0, 470, 0.666626
wu-haven-slot, 291, 11, 171, 1, 0, 474, 0.666626
wu-haven-slot, 287, 11, 169, 1, 0, 468, 0.666626
wu-haven-slot, 290, 11, 172, 1, 0, 474, 0.666626
wu-haven-slot, 297, 11, 177, 1, 0, 486, 0.666626
wu-haven-slot, 292, 11, 176, 1, 0, 480, 0.666626
wu-haven-slot, 292, 11, 178, 1, 0, 482, 0.666626
wu-haven-slot, 287, 11, 170, 1, 0, 469, 0.666626
wu-haven-slot, 284, 11, 169, 1, 0, 465, 0.666626
wu-haven-slot, 284, 12, 170, 1, 0, 467, 0.666626
wu-haven-slot, 288, 11, 172, 1, 0, 472, 0.666626
wu-haven-slot, 287, 11, 169, 1, 0, 468, 0.666626
wu-haven-slot, 285, 11, 171, 1, 0, 468, 0.666626
wu-haven-slot, 291, 11, 173, 1, 0, 476, 0.666626
wu-haven-slot, 285, 11, 175, 1, 0, 472, 0.666626
wu-haven-slot, 290, 11, 177, 1, 0, 479, 0.666626
wu-haven-slot, 287, 11, 171, 1, 0, 470, 0.666626
wu-haven-slot, 287, 11, 173, 1, 0, 472, 0.666626
wu-haven-slot, 290, 11, 178, 1, 0, 480, 0.666626
wu-haven-slot, 284, 11, 170, 1, 0, 466, 0.666626
wu-haven-slot, 289, 11, 169, 1, 0, 470, 0.666626
wu-haven-slot, 288, 11, 171, 1, 0, 471, 0.666626
wu-haven-slot, 290, 11, 174, 1, 0, 476, 0.666626
wu-haven-slot, 297, 11, 180, 1, 0, 489, 0.666626
wu-haven-slot, 289, 11, 173, 1, 0, 474, 0.666626
wu-haven-slot, 288, 11, 171, 1, 0, 471, 0.666626
wu-haven-slot, 285, 11, 165, 1, 0, 462, 0.666626
wu-haven-slot, 288, 11, 174, 1, 0, 474, 0.666626
wu-haven-slot, 292, 11, 181, 1, 0, 485, 0.666626
wu-haven-slot, 290, 11, 176, 1, 0, 478, 0.666626
wu-haven-slot, 295, 12, 176, 1, 0, 484, 0.666626
wu-haven-slot, 285, 12, 174, 1, 0, 472, 0.666626
wu-haven-slot, 291, 11, 173, 1, 0, 476, 0.666626
wu-haven-slot, 288, 11, 173, 1, 0, 473, 0.666626
wu-haven-slot, 286, 11, 171, 1, 0, 469, 0.666626
wu-haven-slot, 290, 12, 177, 1, 0, 480, 0.666626
wu-haven-slot, 293, 11, 173, 1, 0, 478, 0.666626
wu-haven-slot, 286, 11, 174, 1, 0, 472, 0.666626
wu-haven-slot, 291, 12, 175, 1, 0, 479, 0.666626
wu-haven-slot, 285, 11, 171, 1, 0, 468, 0.666626
wu-haven-slot, 292, 11, 176, 1, 0, 480, 0.666626
wu-haven-slot, 285, 11, 175, 1, 0, 472, 0.666626
wu-haven-slot, 291, 12, 177, 1, 0, 481, 0.666626
wu-haven-slot, 289, 11, 173, 1, 0, 474, 0.666626
wu-haven-slot, 288, 11, 174, 1, 0, 474, 0.666626
wu-haven-slot, 287, 11, 176, 1, 0, 475, 0.666626
wu-haven-slot, 288, 11, 176, 1, 0, 476, 0.666626
wu-haven-slot, 293, 11, 171, 1, 0, 476, 0.666626
wu-haven-slot, 289, 11, 172, 1, 0, 473, 0.666626
wu-haven-slot, 289, 11, 175, 1, 0, 476, 0.666626
wu-haven-slot, 294, 12, 180, 1, 0, 487, 0.666626
wu-haven-slot, 286, 12, 175, 1, 0, 474, 0.666626
wu-haven-slot, 289, 11, 179, 1, 0, 480, 0.666626
wu-haven-slot, 300, 11, 175, 1, 0, 487, 0.666626
wu-haven-slot, 288, 11, 170, 1, 0, 470, 0.666626
wu-haven-slot, 288, 11, 170, 1, 0, 470, 0.666626
wu-haven-slot, 289, 12, 181, 1, 0, 483, 0.666626
wu-haven-slot, 294, 11, 174, 1, 0, 480, 0.666626
wu-haven-slot, 291, 11, 178, 1, 0, 481, 0.666626
wu-haven-slot, 287, 11, 175, 1, 0, 474, 0.666626
wu-haven-slot, 292, 11, 172, 1, 0, 476, 0.666626
wu-haven-slot, 290, 11, 180, 1, 0, 482, 0.666626
wu-haven-slot, 288, 11, 174, 1, 0, 474, 0.666626
wu-haven-slot, 296, 11, 173, 1, 0, 481, 0.666626
wu-haven-slot, 288, 12, 172, 1, 0, 473, 0.666626
wu-haven-slot, 291, 11, 168, 1, 0, 471, 0.666626
wu-haven-slot, 292, 11, 174, 1, 0, 478, 0.666626
wu-haven-slot, 288, 11, 174, 1, 0, 474, 0.666626
wu-haven-slot, 288, 12, 174, 1, 0, 475, 0.666626
wu-haven-slot, 312, 11, 173, 1, 0, 497, 0.666626
wu-haven-slot, 286, 11, 168, 1, 0, 466, 0.666626
wu-haven-slot, 287, 11, 169, 1, 0, 468, 0.666626
wu-haven-slot, 290, 11, 176, 1, 0, 478, 0.666626
wu-haven-slot, 290, 11, 176, 1, 0, 478, 0.666626
wu-haven-slot, 286, 11, 171, 1, 0, 469, 0.666626
wu-haven-slot, 291, 11, 170, 1, 0, 473, 0.666626
wu-haven-slot, 290, 12, 177, 1, 0, 480, 0.666626
wu-haven-slot, 287, 11, 173, 1, 0, 472, 0.666626
wu-haven-slot, 285, 11, 169, 1, 0, 466, 0.666626
wu-haven-slot, 287, 11, 172, 1, 0, 471, 0.666626
wu-haven-slot, 293, 11, 171, 1, 0, 476, 0.666626
wu-haven-slot, 285, 11, 176, 1, 0, 473, 0.666626
wu-haven-slot, 286, 11, 176, 1, 0, 474, 0.666626
wu-haven-slot, 285, 11, 170, 1, 0, 467, 0.666626
wu-haven-slot, 284, 11, 168, 1, 0, 464, 0.666626
wu-haven-slot, 286, 11, 178, 1, 0, 476, 0.666626
wu-haven-slot, 289, 11, 177, 1, 0, 478, 0.666626
wu-haven-slot, 292, 11, 175, 1, 0, 479, 0.666626
wu-haven-slot, 290, 11, 174, 1, 0, 476, 0.666626
wu-haven-slot, 284, 11, 166, 1, 0, 462, 0.666626
wu-haven-slot, 288, 11, 173, 1, 0, 473, 0.666626
wu-haven-slot, 290, 12, 177, 1, 0, 480, 0.666626
wu-haven-slot, 291, 11, 177, 1, 0, 480, 0.666626
wu-haven-slot, 289, 11, 174, 1, 0, 475, 0.666626
wu-haven-slot, 291, 11, 172, 1, 0, 475, 0.666626
wu-haven-slot, 292, 11, 172, 1, 0, 476, 0.666626
wu-haven-slot, 287, 11, 167, 1, 0, 466, 0.666626
wu-haven-slot, 289, 11, 168, 1, 0, 469, 0.666626
wu-haven-slot, 287, 11, 170, 1, 0, 469, 0.666626
wu-haven-slot, 286, 11, 177, 1, 0, 475, 0.666626
wu-haven-slot, 289, 11, 175, 1, 0, 476, 0.666626
wu-haven-slot, 288, 11, 173, 1, 0, 473, 0.666626
wu-haven-slot, 295, 12, 175, 1, 0, 483, 0.666626
wu-haven-slot, 286, 11, 177, 1, 0, 475, 0.666626
wu-haven-slot, 287, 11, 172, 1, 0, 471, 0.666626
wu-haven-slot, 284, 11, 176, 1, 0, 472, 0.666626
wu-haven-slot, 285, 11, 171, 1, 0, 468, 0.666626
wu-haven-slot, 286, 11, 169, 1, 0, 467, 0.666626
wu-haven-slot, 285, 12, 175, 1, 0, 473, 0.666626
wu-haven-slot, 288, 11, 171, 1, 0, 471, 0.666626
wu-haven-slot, 292, 11, 173, 1, 0, 477, 0.666626
wu-haven-slot, 285, 11, 171, 1, 0, 468, 0.666626
wu-haven-slot, 292, 11, 181, 1, 0, 485, 0.666626
wu-haven-slot, 289, 11, 176, 1, 0, 477, 0.666626
wu-haven-slot, 286, 11, 175, 1, 0, 473, 0.666626
wu-haven-slot, 305, 12, 176, 1, 0, 494, 0.666626
wu-haven-slot, 286, 12, 177, 1, 0, 476, 0.666626
wu-haven-slot, 291, 11, 172, 1, 0, 475, 0.666626
wu-haven-slot, 288, 11, 172, 1, 0, 472, 0.666626
wu-haven-slot, 291, 11, 176, 1, 0, 479, 0.666626
wu-haven-slot, 285, 11, 169, 1, 0, 466, 0.666626
wu-haven-slot, 296, 11, 174, 1, 0, 482, 0.666626
wu-haven-slot, 289, 11, 172, 1, 0, 473, 0.666626
wu-haven-slot, 289, 11, 177, 1, 0, 478, 0.666626
wu-haven-slot, 298, 11, 176, 1, 0, 486, 0.666626
wu-haven-slot, 295, 11, 174, 1, 0, 481, 0.666626
wu-haven-slot, 289, 12, 173, 1, 0, 475, 0.666626
wu-haven-slot, 285, 11, 168, 1, 0, 465, 0.666626
wu-haven-slot, 289, 11, 171, 1, 0, 472, 0.666626
wu-haven-slot, 292, 12, 173, 1, 0, 478, 0.666626
wu-haven-slot, 287, 11, 178, 1, 0, 477, 0.666626
wu-haven-slot, 291, 11, 175, 1, 0, 478, 0.666626
wu-haven-slot, 286, 11, 175, 1, 0, 473, 0.666626
wu-haven-slot, 288, 11, 171, 1, 0, 471, 0.666626
wu-haven-slot, 284, 11, 172, 1, 0, 468, 0.666626
wu-haven-slot, 288, 12, 172, 1, 0, 473, 0.666626
wu-haven-slot, 286, 11, 170, 1, 0, 468, 0.666626
wu-haven-slot, 288, 11, 173, 1, 0, 473, 0.666626
wu-haven-slot, 289, 11, 168, 1, 0, 469, 0.666626
wu-haven-slot, 286, 11, 173, 1, 0, 471, 0.666626
wu-haven-slot, 290, 11, 171, 1, 0, 473, 0.666626
wu-haven-slot, 289, 12, 177, 1, 0, 479, 0.666626
wu-haven-slot, 286, 11, 175, 1, 0, 473, 0.666626
wu-haven-slot, 293, 11, 178, 1, 0, 483, 0.666626
wu-haven-slot, 291, 11, 175, 1, 0, 478, 0.666626
wu-haven-slot, 289, 11, 170, 1, 0, 471, 0.666626
wu-haven-slot, 288, 11, 171, 1, 0, 471, 0.666626
wu-haven-slot, 287, 11, 175, 1, 0, 474, 0.666626
wu-haven-slot, 292, 11, 177, 1, 0, 481, 0.666626
wu-haven-slot, 291, 12, 174, 1, 0, 478, 0.666626
wu-haven-slot, 288, 12, 178, 1, 0, 479, 0.666626
wu-haven-slot, 292, 11, 178, 1, 0, 482, 0.666626
wu-haven-slot, 286, 11, 171, 1, 0, 469, 0.666626
wu-haven-slot, 285, 11, 169, 1, 0, 466, 0.666626
wu-haven-slot, 287, 11, 172, 1, 0, 471, 0.666626
wu-haven-slot, 291, 11, 177, 1, 0, 480, 0.666626
wu-haven-slot, 291, 11, 170, 1, 0, 473, 0.666626
wu-haven-slot, 290, 11, 176, 1, 0, 478, 0.666626
wu-haven-slot, 291, 11, 171, 1, 0, 474, 0.666626
wu-haven-slot, 293, 11, 171, 1, 0, 476, 0.666626
wu-haven-slot, 287, 11, 168, 1, 0, 467, 0.666626
wu-haven-slot, 290, 11, 176, 1, 0, 478, 0.666626
wu-haven-slot, 290, 11, 176, 1, 0, 478, 0.666626
wu-haven-slot, 296, 11, 172, 1, 0, 480, 0.666626
wu-haven-slot, 292, 11, 177, 1, 0, 481, 0.666626
wu-haven-slot, 289, 21, 173, 1, 0, 484, 0.666626
wu-haven-slot, 288, 12, 176, 1, 0, 477, 0.666626
wu-haven-slot, 296, 11, 174, 1, 0, 482, 0.666626
wu-haven-slot, 287, 11, 175, 1, 0, 474, 0.666626
wu-haven-slot, 287, 11, 173, 1, 0, 472, 0.666626
wu-haven-slot, 291, 11, 173, 1, 0, 476, 0.666626
wu-haven-slot, 290, 11, 174, 1, 0, 476, 0.666626
wu-haven-slot, 294, 11, 172, 1, 0, 478, 0.666626
wu-haven-slot, 290, 11, 169, 1, 0, 471, 0.666626
wu-haven-slot, 287, 11, 177, 1, 0, 476, 0.666626
wu-haven-slot, 290, 11, 176, 1, 0, 478, 0.666626
wu-haven-slot, 293, 11, 176, 1, 0, 481, 0.666626
wu-haven-slot, 292, 11, 174, 1, 0, 478, 0.666626
wu-haven-slot, 290, 11, 175, 1, 0, 477, 0.666626
wu-haven-slot, 291, 11, 177, 1, 0, 480, 0.666626
wu-haven-slot, 286, 11, 167, 1, 0, 465, 0.666626
wu-haven-slot, 287, 11, 171, 1, 0, 470, 0.666626
wu-haven-slot, 295, 12, 176, 1, 0, 484, 0.666626
wu-haven-slot, 286, 11, 171, 1, 0, 469, 0.666626
wu-haven-slot, 289, 12, 177, 1, 0, 479, 0.666626
wu-haven-slot, 293, 11, 173, 1, 0, 478, 0.666626
wu-haven-slot, 287, 11, 176, 1, 0, 475, 0.666626
wu-haven-slot, 291, 11, 177, 1, 0, 480, 0.666626
wu-haven-slot, 286, 11, 174, 1, 0, 472, 0.666626
wu-haven-slot, 291, 11, 179, 1, 0, 482, 0.666626
wu-haven-slot, 291, 11, 178, 1, 0, 481, 0.666626
wu-haven-slot, 299, 11, 171, 1, 0, 482, 0.666626
wu-haven-slot, 292, 11, 180, 1, 0, 484, 0.666626
wu-haven-slot, 302, 11, 173, 1, 0, 487, 0.666626
wu-haven-slot, 287, 12, 175, 1, 0, 475, 0.666626
wu-haven-slot, 292, 11, 171, 1, 0, 475, 0.666626
wu-haven-slot, 290, 11, 173, 1, 0, 475, 0.666626
wu-haven-slot, 289, 11, 170, 1, 0, 471, 0.666626
wu-haven-slot, 287, 11, 176, 1, 0, 475, 0.666626
wu-haven-slot, 289, 11, 168, 1, 0, 469, 0.666626
wu-haven-slot, 287, 11, 168, 1, 0, 467, 0.666626
wu-haven-slot, 290, 11, 170, 1, 0, 472, 0.666626
wu-haven-slot, 291, 11, 175, 1, 0, 478, 0.666626
wu-haven-slot, 287, 12, 172, 1, 0, 472, 0.666626
wu-haven-slot, 287, 11, 176, 1, 0, 475, 0.666626
wu-haven-slot, 287, 11, 176, 1, 0, 475, 0.666626
wu-haven-slot, 291, 11, 173, 1, 0, 476, 0.666626
wu-haven-slot, 290, 11, 175, 1, 0, 477, 0.666626
wu-haven-slot, 287, 11, 170, 1, 0, 469, 0.666626
wu-haven-slot, 289, 11, 171, 1, 0, 472, 0.666626
wu-haven-slot, 290, 11, 176, 1, 0, 478, 0.666626
wu-haven-slot, 297, 11, 174, 1, 0, 483, 0.666626
wu-haven-slot, 284, 11, 172, 1, 0, 468, 0.666626
wu-haven-slot, 293, 11, 178, 1, 0, 483, 0.666626
wu-haven-slot, 285, 11, 169, 1, 0, 466, 0.666626
wu-haven-slot, 286, 11, 176, 1, 0, 474, 0.666626
wu-haven-slot, 289, 11, 172, 1, 0, 473, 0.666626
wu-haven-slot, 288, 11, 172, 1, 0, 472, 0.666626
wu-haven-slot, 287, 12, 173, 1, 0, 473, 0.666626
wu-haven-slot, 291, 11, 173, 1, 0, 476, 0.666626
wu-haven-slot, 290, 12, 182, 1, 0, 485, 0.666626
wu-haven-slot, 289, 11, 172, 1, 0, 473, 0.666626
wu-haven-slot, 288, 11, 166, 1, 0, 466, 0.666626
wu-haven-slot, 289, 11, 175, 1, 0, 476, 0.666626
wu-haven-slot, 286, 11, 169, 1, 0, 467, 0.666626
wu-haven-slot, 286, 11, 171, 1, 0, 469, 0.666626
wu-haven-slot, 288, 11, 175, 1, 0, 475, 0.666626
wu-haven-slot, 290, 11, 175, 1, 0, 477, 0.666626
wu-haven-slot, 287, 11, 172, 1, 0, 471, 0.666626
wu-haven-slot, 286, 11, 172, 1, 0, 470, 0.666626
wu-haven-slot, 290, 11, 171, 1, 0, 473, 0.666626
wu-haven-slot, 295, 11, 172, 1, 0, 479, 0.666626
wu-haven-slot, 295, 11, 170, 1, 0, 477, 0.666626
wu-haven-slot, 284, 11, 172, 1, 0, 468, 0.666626
wu-haven-slot, 291, 11, 170, 1, 0, 473, 0.666626
wu-haven-slot, 286, 11, 175, 1, 0, 473, 0.666626
wu-haven-slot, 292, 11, 171, 1, 0, 475, 0.666626
half-size-wu-haven-coef, 136, 57, 90, 1, 0, 284, 0.666626
half-size-wu-haven-coef, 134, 57, 90, 1, 0, 282, 0.666626
half-size-wu-haven-coef, 136, 57, 90, 1, 0, 284, 0.666626
half-size-wu-haven-coef, 133, 58, 91, 1, 0, 283, 0.666626
half-size-wu-haven-coef, 137, 57, 92, 1, 0, 287, 0.666626
half-size-wu-haven-coef, 134, 58, 96, 1, 0, 289, 0.666626
half-size-wu-haven-coef, 136, 57, 90, 1, 0, 284, 0.666626
half-size-wu-haven-coef, 134, 57, 94, 1, 0, 286, 0.666626
half-size-wu-haven-coef, 139, 57, 93, 1, 0, 290, 0.666626
half-size-wu-haven-coef, 135, 59, 92, 1, 0, 287, 0.666626
half-size-wu-haven-coef, 136, 58, 90, 1, 0, 285, 0.666626
half-size-wu-haven-coef, 135, 57, 90, 1, 0, 283, 0.666626
half-size-wu-haven-coef, 137, 58, 93, 1, 0, 289, 0.666626
half-size-wu-haven-coef, 139, 57, 91, 1, 0, 288, 0.666626
half-size-wu-haven-coef, 133, 58, 91, 1, 0, 283, 0.666626
half-size-wu-haven-coef, 135, 58, 92, 1, 0, 286, 0.666626
half-size-wu-haven-coef, 141, 57, 92, 1, 0, 291, 0.666626
half-size-wu-haven-coef, 135, 58, 93, 1, 0, 287, 0.666626
half-size-wu-haven-coef, 136, 58, 93, 1, 0, 288, 0.666626
half-size-wu-haven-coef, 134, 57, 90, 1, 0, 282, 0.666626
half-size-wu-haven-coef, 134, 58, 91, 1, 0, 284, 0.666626
half-size-wu-haven-coef, 133, 58, 91, 1, 0, 283, 0.666626
half-size-wu-haven-coef, 138, 58, 91, 1, 0, 288, 0.666626
half-size-wu-haven-coef, 143, 59, 92, 1, 0, 295, 0.666626
half-size-wu-haven-coef, 138, 58, 92, 1, 0, 289, 0.666626
half-size-wu-haven-coef, 135, 59, 95, 1, 0, 290, 0.666626
half-size-wu-haven-coef, 135, 57, 91, 1, 0, 284, 0.666626
half-size-wu-haven-coef, 134, 58, 92, 1, 0, 285, 0.666626
half-size-wu-haven-coef, 136, 59, 92, 1, 0, 288, 0.666626
half-size-wu-haven-coef, 138, 58, 91, 1, 0, 288, 0.666626
half-size-wu-haven-coef, 139, 58, 94, 1, 0, 292, 0.666626
half-size-wu-haven-coef, 137, 58, 92, 1, 0, 288, 0.666626
half-size-wu-haven-coef, 139, 58, 92, 1, 0, 290, 0.666626
half-size-wu-haven-coef, 133, 57, 90, 1, 0, 281, 0.666626
half-size-wu-haven-coef, 141, 58, 91, 1, 0, 291, 0.666626
half-size-wu-haven-coef, 135, 58, 92, 1, 0, 286, 0.666626
half-size-wu-haven-coef, 138, 57, 89, 1, 0, 285, 0.666626
half-size-wu-haven-coef, 137, 57, 90, 1, 0, 285, 0.666626
half-size-wu-haven-coef, 139, 57, 89, 1, 0, 286, 0.666626
half-size-wu-haven-coef, 134, 57, 89, 1, 0, 281, 0.666626
half-size-wu-haven-coef, 138, 58, 90, 1, 0, 287, 0.666626
half-size-wu-haven-coef, 141, 58, 92, 1, 0, 292, 0.666626
half-size-wu-haven-coef, 137, 57, 89, 1, 0, 284, 0.666626
half-size-wu-haven-coef, 136, 57, 92, 1, 0, 286, 0.666626
half-size-wu-haven-coef, 136, 58, 90, 1, 0, 285, 0.666626
half-size-wu-haven-coef, 134, 57, 93, 1, 0, 285, 0.666626
half-size-wu-haven-coef, 134, 57, 91, 1, 0, 283, 0.666626
half-size-wu-haven-coef, 138, 57, 93, 1, 0, 289, 0.666626
half-size-wu-haven-coef, 135, 58, 93, 1, 0, 287, 0.666626
half-size-wu-haven-coef, 139, 58, 91, 1, 0, 289, 0.666626
half-size-wu-haven-coef, 134, 57, 92, 1, 0, 284, 0.666626
half-size-wu-haven-coef, 136, 58, 94, 1, 0, 289, 0.666626
half-size-wu-haven-coef, 134, 57, 93, 1, 0, 285, 0.666626
half-size-wu-haven-coef, 138, 57, 90, 1, 0, 286, 0.666626
half-size-wu-haven-coef, 133, 57, 90, 1, 0, 281, 0.666626
half-size-wu-haven-coef, 135, 58, 90, 1, 0, 284, 0.666626
half-size-wu-haven-coef, 137, 57, 90, 1, 0, 285, 0.666626
half-size-wu-haven-coef, 135, 57, 90, 1, 0, 283, 0.666626
half-size-wu-haven-coef, 138, 58, 91, 1, 0, 288, 0.666626
half-size-wu-haven-coef, 136, 58, 91, 1, 0, 286, 0.666626
half-size-wu-haven-coef, 134, 57, 93, 1, 0, 285, 0.666626
half-size-wu-haven-coef, 146, 58, 92, 1, 0, 297, 0.666626
half-size-wu-haven-coef, 136, 58, 93, 1, 0, 288, 0.666626
half-size-wu-haven-coef, 133, 58, 92, 1, 0, 284, 0.666626
half-size-wu-haven-coef, 137, 58, 92, 1, 0, 288, 0.666626
half-size-wu-haven-coef, 135, 58, 93, 1, 0, 287, 0.666626
half-size-wu-haven-coef, 134, 58, 92, 1, 0, 285, 0.666626
half-size-wu-haven-coef, 135, 58, 89, 1, 0, 283, 0.666626
half-size-wu-haven-coef, 144, 57, 92, 1, 0, 294, 0.666626
half-size-wu-haven-coef, 133, 60, 94, 1, 0, 288, 0.666626
half-size-wu-haven-coef, 134, 58, 91, 1, 0, 284, 0.666626
half-size-wu-haven-coef, 140, 57, 92, 1, 0, 290, 0.666626
half-size-wu-haven-coef, 140, 64, 91, 1, 0, 296, 0.666626
half-size-wu-haven-coef, 140, 57, 92, 1, 0, 290, 0.666626
half-size-wu-haven-coef, 136, 57, 90, 1, 0, 284, 0.666626
half-size-wu-haven-coef, 137, 58, 92, 1, 0, 288, 0.666626
half-size-wu-haven-coef, 134, 57, 91, 1, 0, 283, 0.666626
half-size-wu-haven-coef, 136, 58, 91, 1, 0, 286, 0.666626
half-size-wu-haven-coef, 131, 58, 90, 1, 0, 280, 0.666626
half-size-wu-haven-coef, 136, 58, 90, 1, 0, 285, 0.666626
half-size-wu-haven-coef, 134, 57, 90, 1, 0, 282, 0.666626
half-size-wu-haven-coef, 134, 57, 90, 1, 0, 282, 0.666626
half-size-wu-haven-coef, 136, 58, 90, 1, 0, 285, 0.666626
half-size-wu-haven-coef, 139, 57, 91, 1, 0, 288, 0.666626
half-size-wu-haven-coef, 135, 57, 94, 1, 0, 287, 0.666626
half-size-wu-haven-coef, 137, 58, 92, 1, 0, 288, 0.666626
half-size-wu-haven-coef, 137, 58, 93, 1, 0, 289, 0.666626
half-size-wu-haven-coef, 134, 57, 92, 1, 0, 284, 0.666626
half-size-wu-haven-coef, 139, 57, 93, 1, 0, 290, 0.666626
half-size-wu-haven-coef, 136, 58, 93, 1, 0, 288, 0.666626
half-size-wu-haven-coef, 141, 58, 92, 1, 0, 292, 0.666626
half-size-wu-haven-coef, 136, 58, 92, 1, 0, 287, 0.666626
half-size-wu-haven-coef, 142, 58, 92, 1, 0, 293, 0.666626
half-size-wu-haven-coef, 136, 58, 92, 1, 0, 287, 0.666626
half-size-wu-haven-coef, 143, 58, 95, 1, 0, 297, 0.666626
half-size-wu-haven-coef, 138, 58, 95, 1, 0, 292, 0.666626
half-size-wu-haven-coef, 136, 57, 92, 1, 0, 286, 0.666626
half-size-wu-haven-coef, 143, 58, 95, 1, 0, 297, 0.666626
half-size-wu-haven-coef, 142, 58, 96, 1, 0, 297, 0.666626
half-size-wu-haven-coef, 138, 59, 95, 1, 0, 293, 0.666626
half-size-wu-haven-coef, 135, 58, 90, 1, 0, 284, 0.666626
half-size-wu-haven-coef, 140, 57, 94, 1, 0, 292, 0.666626
half-size-wu-haven-coef, 144, 58, 93, 1, 0, 296, 0.666626
half-size-wu-haven-coef, 135, 58, 95, 1, 0, 289, 0.666626
half-size-wu-haven-coef, 134, 58, 91, 1, 0, 284, 0.666626
half-size-wu-haven-coef, 135, 58, 91, 1, 0, 285, 0.666626
half-size-wu-haven-coef, 136, 57, 91, 1, 0, 285, 0.666626
half-size-wu-haven-coef, 133, 57, 91, 1, 0, 282, 0.666626
half-size-wu-haven-coef, 132, 57, 93, 1, 0, 283, 0.666626
half-size-wu-haven-coef, 138, 58, 89, 1, 0, 286, 0.666626
half-size-wu-haven-coef, 133, 58, 92, 1, 0, 284, 0.666626
half-size-wu-haven-coef, 134, 58, 91, 1, 0, 284, 0.666626
half-size-wu-haven-coef, 142, 58, 91, 1, 0, 292, 0.666626
half-size-wu-haven-coef, 134, 58, 91, 1, 0, 284, 0.666626
half-size-wu-haven-coef, 135, 58, 91, 1, 0, 285, 0.666626
half-size-wu-haven-coef, 136, 58, 91, 1, 0, 286, 0.666626
half-size-wu-haven-coef, 138, 58, 91, 1, 0, 288, 0.666626
half-size-wu-haven-coef, 133, 58, 91, 1, 0, 283, 0.666626
half-size-wu-haven-coef, 137, 58, 93, 1, 0, 289, 0.666626
half-size-wu-haven-coef, 142, 58, 95, 1, 0, 296, 0.666626
half-size-wu-haven-coef, 144, 58, 92, 1, 0, 295, 0.666626
half-size-wu-haven-coef, 141, 57, 93, 1, 0, 292, 0.666626
half-size-wu-haven-coef, 137, 58, 94, 1, 0, 290, 0.666626
half-size-wu-haven-coef, 132, 57, 91, 1, 0, 281, 0.666626
half-size-wu-haven-coef, 134, 58, 91, 1, 0, 284, 0.666626
half-size-wu-haven-coef, 134, 58, 92, 1, 0, 285, 0.666626
half-size-wu-haven-coef, 137, 58, 91, 1, 0, 287, 0.666626
half-size-wu-haven-coef, 138, 57, 94, 1, 0, 290, 0.666626
half-size-wu-haven-coef, 135, 58, 92, 1, 0, 286, 0.666626
half-size-wu-haven-coef, 151, 58, 94, 1, 0, 304, 0.666626
half-size-wu-haven-coef, 134, 58, 90, 1, 0, 283, 0.666626
half-size-wu-haven-coef, 135, 57, 92, 1, 0, 285, 0.666626
half-size-wu-haven-coef, 140, 58, 93, 1, 0, 292, 0.666626
half-size-wu-haven-coef, 138, 58, 93, 1, 0, 290, 0.666626
half-size-wu-haven-coef, 138, 58, 92, 1, 0, 289, 0.666626
half-size-wu-haven-coef, 135, 58, 92, 1, 0, 286, 0.666626
half-size-wu-haven-coef, 141, 58, 91, 1, 0, 291, 0.666626
half-size-wu-haven-coef, 141, 59, 94, 1, 0, 295, 0.666626
half-size-wu-haven-coef, 140, 58, 92, 1, 0, 291, 0.666626
half-size-wu-haven-coef, 135, 57, 90, 1, 0, 283, 0.666626
half-size-wu-haven-coef, 134, 57, 92, 1, 0, 284, 0.666626
half-size-wu-haven-coef, 135, 57, 91, 1, 0, 284, 0.666626
half-size-wu-haven-coef, 134, 57, 94, 1, 0, 286, 0.666626
half-size-wu-haven-coef, 138, 57, 91, 1, 0, 287, 0.666626
half-size-wu-haven-coef, 138, 57, 92, 1, 0, 288, 0.666626
half-size-wu-haven-coef, 137, 57, 90, 1, 0, 285, 0.666626
half-size-wu-haven-coef, 134, 57, 92, 1, 0, 284, 0.666626
half-size-wu-haven-coef, 135, 58, 90, 1, 0, 284, 0.666626
half-size-wu-haven-coef, 134, 58, 93, 1, 0, 286, 0.666626
half-size-wu-haven-coef, 135, 58, 93, 1, 0, 287, 0.666626
half-size-wu-haven-coef, 134, 58, 92, 1, 0, 285, 0.666626
half-size-wu-haven-coef, 136, 57, 94, 1, 0, 288, 0.666626
half-size-wu-haven-coef, 146, 58, 92, 1, 0, 297, 0.666626
half-size-wu-haven-coef, 137, 57, 95, 1, 0, 290, 0.666626
half-size-wu-haven-coef, 137, 58, 92, 1, 0, 288, 0.666626
half-size-wu-haven-coef, 139, 58, 92, 1, 0, 290, 0.666626
half-size-wu-haven-coef, 138, 58, 91, 1, 0, 288, 0.666626
half-size-wu-haven-coef, 137, 58, 94, 1, 0, 290, 0.666626
half-size-wu-haven-coef, 137, 57, 93, 1, 0, 288, 0.666626
half-size-wu-haven-coef, 136, 57, 90, 1, 0, 284, 0.666626
half-size-wu-haven-coef, 136, 57, 93, 1, 0, 287, 0.666626
half-size-wu-haven-coef, 138, 58, 93, 1, 0, 290, 0.666626
half-size-wu-haven-coef, 139, 58, 92, 1, 0, 290, 0.666626
half-size-wu-haven-coef, 139, 58, 94, 1, 0, 292, 0.666626
half-size-wu-haven-coef, 136, 59, 95, 1, 0, 291, 0.666626
half-size-wu-haven-coef, 138, 59, 92, 1, 0, 290, 0.666626
half-size-wu-haven-coef, 138, 57, 91, 1, 0, 287, 0.666626
half-size-wu-haven-coef, 133, 58, 92, 1, 0, 284, 0.666626
half-size-wu-haven-coef, 135, 57, 92, 1, 0, 285, 0.666626
half-size-wu-haven-coef, 138, 58, 91, 1, 0, 288, 0.666626
half-size-wu-haven-coef, 137, 58, 91, 1, 0, 287, 0.666626
half-size-wu-haven-coef, 134, 58, 94, 1, 0, 287, 0.666626
half-size-wu-haven-coef, 139, 58, 93, 1, 0, 291, 0.666626
half-size-wu-haven-coef, 137, 60, 92, 1, 0, 290, 0.666626
half-size-wu-haven-coef, 136, 58, 91, 1, 0, 286, 0.666626
half-size-wu-haven-coef, 138, 58, 92, 1, 0, 289, 0.666626
half-size-wu-haven-coef, 137, 58, 91, 1, 0, 287, 0.666626
half-size-wu-haven-coef, 138, 59, 93, 1, 0, 291, 0.666626
half-size-wu-haven-coef, 139, 59, 95, 1, 0, 294, 0.666626
half-size-wu-haven-coef, 136, 58, 91, 1, 0, 286, 0.666626
half-size-wu-haven-coef, 137, 58, 91, 1, 0, 287, 0.666626
half-size-wu-haven-coef, 135, 57, 92, 1, 0, 285, 0.666626
half-size-wu-haven-coef, 140, 58, 93, 1, 0, 292, 0.666626
half-size-wu-haven-coef, 141, 57, 90, 1, 0, 289, 0.666626
half-size-wu-haven-coef, 140, 58, 92, 1, 0, 291, 0.666626
half-size-wu-haven-coef, 139, 58, 95, 1, 0, 293, 0.666626
half-size-wu-haven-coef, 140, 58, 93, 1, 0, 292, 0.666626
half-size-wu-haven-coef, 136, 57, 91, 1, 0, 285, 0.666626
half-size-wu-haven-coef, 139, 58, 95, 1, 0, 293, 0.666626
half-size-wu-haven-coef, 136, 58, 92, 1, 0, 287, 0.666626
half-size-wu-haven-coef, 136, 58, 90, 1, 0, 285, 0.666626
half-size-wu-haven-coef, 141, 57, 91, 1, 0, 290, 0.666626
half-size-wu-haven-coef, 138, 57, 94, 1, 0, 290, 0.666626
half-size-wu-haven-coef, 138, 58, 92, 1, 0, 289, 0.666626
half-size-wu-haven-coef, 136, 59, 92, 1, 0, 288, 0.666626
half-size-wu-haven-coef, 142, 58, 94, 1, 0, 295, 0.666626
half-size-wu-haven-coef, 137, 58, 92, 1, 0, 288, 0.666626
half-size-wu-haven-coef, 140, 57, 91, 1, 0, 289, 0.666626
half-size-wu-haven-coef, 140, 60, 93, 1, 0, 294, 0.666626
half-size-wu-haven-coef, 139, 58, 91, 1, 0, 289, 0.666626
half-size-wu-haven-coef, 134, 58, 91, 1, 0, 284, 0.666626
half-size-wu-haven-coef, 138, 62, 93, 1, 0, 294, 0.666626
half-size-wu-haven-coef, 136, 57, 90, 1, 0, 284, 0.666626
half-size-wu-haven-coef, 138, 58, 93, 1, 0, 290, 0.666626
half-size-wu-haven-coef, 135, 58, 91, 1, 0, 285, 0.666626
half-size-wu-haven-coef, 141, 58, 92, 1, 0, 292, 0.666626
half-size-wu-haven-coef, 136, 57, 91, 1, 0, 285, 0.666626
half-size-wu-haven-coef, 137, 58, 94, 1, 0, 290, 0.666626
half-size-wu-haven-coef, 135, 58, 92, 1, 0, 286, 0.666626
half-size-wu-haven-coef, 134, 61, 90, 1, 0, 286, 0.666626
half-size-wu-haven-coef, 133, 58, 91, 1, 0, 283, 0.666626
half-size-wu-haven-coef, 139, 58, 93, 1, 0, 291, 0.666626
half-size-wu-haven-coef, 134, 58, 91, 1, 0, 284, 0.666626
half-size-wu-haven-coef, 137, 58, 93, 1, 0, 289, 0.666626
half-size-wu-haven-coef, 142, 58, 92, 1, 0, 293, 0.666626
half-size-wu-haven-coef, 134, 58, 91, 1, 0, 284, 0.666626
half-size-wu-haven-coef, 137, 58, 92, 1, 0, 288, 0.666626
half-size-wu-haven-coef, 139, 58, 93, 1, 0, 291, 0.666626
half-size-wu-haven-coef, 143, 58, 92, 1, 0, 294, 0.666626
half-size-wu-haven-coef, 136, 58, 92, 1, 0, 287, 0.666626
half-size-wu-haven-coef, 140, 58, 94, 1, 0, 293, 0.666626
half-size-wu-haven-coef, 137, 58, 95, 1, 0, 291, 0.666626
half-size-wu-haven-coef, 135, 58, 91, 1, 0, 285, 0.666626
half-size-wu-haven-coef, 137, 58, 94, 1, 0, 290, 0.666626
half-size-wu-haven-coef, 135, 58, 93, 1, 0, 287, 0.666626
half-size-wu-haven-coef, 134, 58, 92, 1, 0, 285, 0.666626
half-size-wu-haven-coef, 134, 58, 91, 1, 0, 284, 0.666626
half-size-wu-haven-coef, 138, 58, 93, 1, 0, 290, 0.666626
half-size-wu-haven-coef, 136, 59, 92, 1, 0, 288, 0.666626
half-size-wu-haven-coef, 140, 58, 92, 1, 0, 291, 0.666626
half-size-wu-haven-coef, 137, 58, 91, 1, 0, 287, 0.666626
half-size-wu-haven-coef, 133, 59, 96, 1, 0, 289, 0.666626
half-size-wu-haven-coef, 134, 58, 90, 1, 0, 283, 0.666626
half-size-wu-haven-coef, 146, 58, 93, 1, 0, 298, 0.666626
half-size-wu-haven-coef, 134, 57, 91, 1, 0, 283, 0.666626
half-size-wu-haven-coef, 134, 58, 91, 1, 0, 284, 0.666626
half-size-wu-haven-coef, 136, 58, 91, 1, 0, 286, 0.666626
half-size-wu-haven-coef, 138, 58, 94, 1, 0, 291, 0.666626
half-size-wu-haven-coef, 137, 58, 91, 1, 0, 287, 0.666626
half-size-wu-haven-coef, 133, 58, 92, 1, 0, 284, 0.666626
half-size-wu-haven-coef, 138, 58, 92, 1, 0, 289, 0.666626
half-size-wu-haven-coef, 140, 57, 92, 1, 0, 290, 0.666626
half-size-wu-haven-coef, 134, 58, 93, 1, 0, 286, 0.666626
half-size-wu-haven-coef, 133, 57, 91, 1, 0, 282, 0.666626
half-size-wu-haven-coef, 138, 57, 93, 1, 0, 289, 0.666626
half-size-wu-haven-coef, 137, 58, 93, 1, 0, 289, 0.666626
half-size-wu-haven-coef, 138, 58, 92, 1, 0, 289, 0.666626
half-size-wu-haven-coef, 137, 57, 90, 1, 0, 285, 0.666626
half-size-wu-haven-coef, 135, 58, 91, 1, 0, 285, 0.666626
half-size-wu-haven-coef, 135, 58, 92, 1, 0, 286, 0.666626
half-size-wu-haven-coef, 137, 59, 94, 1, 0, 291, 0.666626
half-size-wu-haven-coef, 137, 58, 92, 1, 0, 288, 0.666626
half-size-wu-haven-coef, 137, 58, 92, 1, 0, 288, 0.666626
half-size-wu-haven-coef, 138, 58, 93, 1, 0, 290, 0.666626
half-size-wu-haven-coef, 134, 57, 92, 1, 0, 284, 0.666626
half-size-wu-haven-coef, 134, 58, 92, 1, 0, 285, 0.666626
half-size-wu-haven-coef, 137, 58, 91, 1, 0, 287, 0.666626
half-size-wu-haven-coef, 139, 58, 92, 1, 0, 290, 0.666626
half-size-wu-haven-coef, 145, 58, 92, 1, 0, 296, 0.666626
half-size-wu-haven-coef, 135, 58, 96, 1, 0, 290, 0.666626
half-size-wu-haven-coef, 135, 58, 92, 1, 0, 286, 0.666626
half-size-wu-haven-coef, 136, 58, 91, 1, 0, 286, 0.666626
half-size-wu-haven-coef, 139, 58, 91, 1, 0, 289, 0.666626
half-size-wu-haven-coef, 134, 58, 91, 1, 0, 284, 0.666626
half-size-wu-haven-coef, 138, 58, 92, 1, 0, 289, 0.666626
half-size-wu-haven-coef, 141, 59, 92, 1, 0, 293, 0.666626
half-size-wu-haven-coef, 136, 57, 91, 1, 0, 285, 0.666626
half-size-wu-haven-coef, 138, 57, 92, 1, 0, 288, 0.666626
half-size-wu-haven-coef, 137, 58, 93, 1, 0, 289, 0.666626
half-size-wu-haven-coef, 138, 58, 91, 1, 0, 288, 0.666626
half-size-wu-haven-coef, 134, 58, 92, 1, 0, 285, 0.666626
half-size-wu-haven-coef, 137, 58, 91, 1, 0, 287, 0.666626
half-size-wu-haven-coef, 140, 58, 91, 1, 0, 290, 0.666626
half-size-wu-haven-coef, 138, 57, 92, 1, 0, 288, 0.666626
half-size-wu-haven-coef, 141, 58, 93, 1, 0, 293, 0.666626
half-size-wu-haven-coef, 135, 58, 91, 1, 0, 285, 0.666626
half-size-wu-haven-coef, 137, 58, 94, 1, 0, 290, 0.666626
half-size-wu-haven-coef, 134, 57, 92, 1, 0, 284, 0.666626
half-size-wu-haven-coef, 138, 58, 91, 1, 0, 288, 0.666626
half-size-wu-haven-coef, 136, 58, 92, 1, 0, 287, 0.666626
half-size-wu-haven-coef, 137, 58, 94, 1, 0, 290, 0.666626
half-size-wu-haven-coef, 133, 58, 91, 1, 0, 283, 0.666626
half-size-wu-haven-coef, 133, 57, 93, 1, 0, 284, 0.666626
half-size-wu-haven-coef, 135, 57, 90, 1, 0, 283, 0.666626
half-size-wu-haven-coef, 139, 65, 90, 1, 0, 295, 0.666626
half-size-wu-haven-coef, 135, 57, 92, 1, 0, 285, 0.666626
half-size-wu-haven-coef, 133, 57, 90, 1, 0, 281, 0.666626
half-size-wu-haven-coef, 135, 57, 95, 1, 0, 288, 0.666626
half-size-wu-haven-coef, 146, 57, 94, 1, 0, 298, 0.666626
half-size-wu-haven-coef, 144, 59, 93, 1, 0, 297, 0.666626
half-size-wu-haven-coef, 137, 58, 93, 1, 0, 289, 0.666626
half-size-wu-haven-coef, 135, 60, 92, 1, 0, 288, 0.666626
half-size-wu-haven-coef, 133, 57, 91, 1, 0, 282, 0.666626
half-size-wu-haven-coef, 145, 60, 94, 1, 0, 300, 0.666626
half-size-wu-haven-coef, 134, 58, 91, 1, 0, 284, 0.666626
half-size-wu-haven-coef, 138, 59, 92, 1, 0, 290, 0.666626
half-size-wu-haven-coef, 137, 58, 91, 1, 0, 287, 0.666626
half-size-wu-haven-coef, 138, 58, 95, 1, 0, 292, 0.666626
half-size-wu-haven-coef, 136, 58, 93, 1, 0, 288, 0.666626
half-size-wu-haven-coef, 137, 58, 92, 1, 0, 288, 0.666626
half-size-wu-haven-coef, 137, 58, 92, 1, 0, 288, 0.666626
half-size-wu-haven-coef, 137, 58, 93, 1, 0, 289, 0.666626
half-size-wu-haven-coef, 139, 58, 94, 1, 0, 292, 0.666626
half-size-wu-haven-coef, 140, 58, 93, 1, 0, 292, 0.666626
half-size-wu-haven-coef, 135, 58, 95, 1, 0, 289, 0.666626
half-size-wu-haven-coef, 137, 58, 91, 1, 0, 287, 0.666626
half-size-wu-haven-coef, 134, 58, 91, 1, 0, 284, 0.666626
half-size-wu-haven-coef, 138, 57, 91, 1, 0, 287, 0.666626
half-size-wu-haven-coef, 141, 58, 94, 1, 0, 294, 0.666626
half-size-wu-haven-coef, 133, 58, 91, 1, 0, 283, 0.666626
half-size-wu-haven-coef, 138, 58, 91, 1, 0, 288, 0.666626
half-size-wu-haven-coef, 141, 59, 92, 1, 0, 293, 0.666626
half-size-wu-haven-coef, 140, 58, 91, 1, 0, 290, 0.666626
half-size-wu-haven-coef, 133, 58, 90, 1, 0, 282, 0.666626
half-size-wu-haven-coef, 135, 58, 91, 1, 0, 285, 0.666626
half-size-wu-haven-coef, 135, 57, 90, 1, 0, 283, 0.666626
half-size-wu-haven-coef, 133, 58, 90, 1, 0, 282, 0.666626
half-size-wu-haven-coef, 139, 57, 91, 1, 0, 288, 0.666626
half-size-wu-haven-coef, 138, 58, 90, 1, 0, 287, 0.666626
half-size-wu-haven-coef, 136, 57, 91, 1, 0, 285, 0.666626
half-size-wu-haven-coef, 136, 57, 89, 1, 0, 283, 0.666626
half-size-wu-haven-coef, 137, 58, 92, 1, 0, 288, 0.666626
half-size-wu-haven-coef, 137, 57, 92, 1, 0, 287, 0.666626
half-size-wu-haven-coef, 135, 58, 93, 1, 0, 287, 0.666626
half-size-wu-haven-coef, 138, 58, 94, 1, 0, 291, 0.666626
half-size-wu-haven-coef, 142, 57, 93, 1, 0, 293, 0.666626
half-size-wu-haven-coef, 140, 58, 92, 1, 0, 291, 0.666626
half-size-wu-haven-coef, 141, 58, 91, 1, 0, 291, 0.666626
half-size-wu-haven-coef, 144, 58, 94, 1, 0, 297, 0.666626
half-size-wu-haven-coef, 139, 57, 94, 1, 0, 291, 0.666626
half-size-wu-haven-coef, 136, 58, 90, 1, 0, 285, 0.666626
half-size-wu-haven-coef, 137, 59, 93, 1, 0, 290, 0.666626
half-size-wu-haven-coef, 136, 58, 92, 1, 0, 287, 0.666626
half-size-wu-haven-coef, 141, 58, 94, 1, 0, 294, 0.666626
half-size-wu-haven-coef, 136, 58, 91, 1, 0, 286, 0.666626
half-size-wu-haven-coef, 135, 59, 94, 1, 0, 289, 0.666626
half-size-wu-haven-coef, 138, 59, 94, 1, 0, 292, 0.666626
half-size-wu-haven-coef, 138, 62, 91, 1, 0, 292, 0.666626
half-size-wu-haven-coef, 136, 58, 91, 1, 0, 286, 0.666626
half-size-wu-haven-coef, 133, 58, 92, 1, 0, 284, 0.666626
half-size-wu-haven-coef, 138, 58, 94, 1, 0, 291, 0.666626
half-size-wu-haven-coef, 143, 58, 93, 1, 0, 295, 0.666626
half-size-wu-haven-coef, 138, 57, 90, 1, 0, 286, 0.666626
half-size-wu-haven-coef, 134, 57, 90, 1, 0, 282, 0.666626
half-size-wu-haven-coef, 135, 58, 93, 1, 0, 287, 0.666626
half-size-wu-haven-coef, 137, 58, 94, 1, 0, 290, 0.666626
half-size-wu-haven-coef, 138, 58, 94, 1, 0, 291, 0.666626
half-size-wu-haven-coef, 139, 58, 94, 1, 0, 292, 0.666626
half-size-wu-haven-coef, 139, 58, 94, 1, 0, 292, 0.666626
half-size-wu-haven-coef, 136, 57, 90, 1, 0, 284, 0.666626
half-size-wu-haven-coef, 136, 58, 92, 1, 0, 287, 0.666626
half-size-wu-haven-coef, 136, 57, 91, 1, 0, 285, 0.666626
half-size-wu-haven-coef, 133, 57, 90, 1, 0, 281, 0.666626
half-size-wu-haven-coef, 135, 58, 90, 1, 0, 284, 0.666626
half-size-wu-haven-coef, 134, 57, 94, 1, 0, 286, 0.666626
half-size-wu-haven-coef, 137, 57, 90, 1, 0, 285, 0.666626
half-size-wu-haven-coef, 139, 57, 92, 1, 0, 289, 0.666626
half-size-wu-haven-coef, 136, 58, 91, 1, 0, 286, 0.666626
half-size-wu-haven-coef, 133, 59, 91, 1, 0, 284, 0.666626
half-size-wu-haven-coef, 136, 59, 93, 1, 0, 289, 0.666626
half-size-wu-haven-coef, 144, 58, 92, 1, 0, 295, 0.666626
half-size-wu-haven-coef, 136, 61, 92, 1, 0, 290, 0.666626
half-size-wu-haven-coef, 136, 57, 91, 1, 0, 285, 0.666626
half-size-wu-haven-coef, 137, 57, 90, 1, 0, 285, 0.666626
half-size-wu-haven-coef, 135, 58, 91, 1, 0, 285, 0.666626
half-size-wu-haven-coef, 133, 58, 91, 1, 0, 283, 0.666626
half-size-wu-haven-coef, 133, 58, 93, 1, 0, 285, 0.666626
half-size-wu-haven-coef, 135, 58, 93, 1, 0, 287, 0.666626
half-size-wu-haven-coef, 135, 62, 91, 1, 0, 289, 0.666626
half-size-wu-haven-coef, 132, 57, 92, 1, 0, 282, 0.666626
half-size-wu-haven-coef, 134, 61, 91, 1, 0, 287, 0.666626
half-size-wu-haven-coef, 139, 58, 94, 1, 0, 292, 0.666626
half-size-wu-haven-coef, 137, 59, 95, 1, 0, 292, 0.666626
half-size-wu-haven-coef, 138, 58, 91, 1, 0, 288, 0.666626
half-size-wu-haven-coef, 138, 58, 91, 1, 0, 288, 0.666626
half-size-wu-haven-coef, 137, 58, 92, 1, 0, 288, 0.666626
half-size-wu-haven-coef, 136, 58, 92, 1, 0, 287, 0.666626
half-size-wu-haven-coef, 136, 57, 92, 1, 0, 286, 0.666626
half-size-wu-haven-coef, 138, 58, 92, 1, 0, 289, 0.666626
half-size-wu-haven-coef, 138, 58, 91, 1, 0, 288, 0.666626
half-size-wu-haven-coef, 139, 58, 92, 1, 0, 290, 0.666626
half-size-wu-haven-coef, 141, 57, 91, 1, 0, 290, 0.666626
half-size-wu-haven-coef, 137, 57, 91, 1, 0, 286, 0.666626
half-size-wu-haven-coef, 137, 58, 91, 1, 0, 287, 0.666626
half-size-wu-haven-coef, 141, 58, 92, 1, 0, 292, 0.666626
half-size-wu-haven-coef, 138, 58, 90, 1, 0, 287, 0.666626
half-size-wu-haven-coef, 134, 57, 91, 1, 0, 283, 0.666626
half-size-wu-haven-coef, 133, 58, 92, 1, 0, 284, 0.666626
half-size-wu-haven-coef, 132, 58, 90, 1, 0, 281, 0.666626
half-size-wu-haven-coef, 134, 58, 91, 1, 0, 284, 0.666626
half-size-wu-haven-coef, 139, 58, 91, 1, 0, 289, 0.666626
half-size-wu-haven-coef, 139, 58, 91, 1, 0, 289, 0.666626
half-size-wu-haven-coef, 133, 58, 90, 1, 0, 282, 0.666626
half-size-wu-haven-coef, 135, 58, 95, 1, 0, 289, 0.666626
half-size-wu-haven-coef, 138, 58, 91, 1, 0, 288, 0.666626
half-size-wu-haven-coef, 135, 57, 91, 1, 0, 284, 0.666626
half-size-wu-haven-coef, 134, 57, 91, 1, 0, 283, 0.666626
half-size-wu-haven-coef, 137, 57, 92, 1, 0, 287, 0.666626
half-size-wu-haven-coef, 139, 58, 90, 1, 0, 288, 0.666626
half-size-wu-haven-coef, 135, 58, 91, 1, 0, 285, 0.666626
half-size-wu-haven-coef, 141, 58, 92, 1, 0, 292, 0.666626
half-size-wu-haven-coef, 137, 58, 92, 1, 0, 288, 0.666626
half-size-wu-haven-coef, 137, 58, 93, 1, 0, 289, 0.666626
half-size-wu-haven-coef, 138, 59, 95, 1, 0, 293, 0.666626
half-size-wu-haven-coef, 139, 58, 91, 1, 0, 289, 0.666626
half-size-wu-haven-coef, 135, 58, 91, 1, 0, 285, 0.666626
half-size-wu-haven-coef, 142, 58, 95, 1, 0, 296, 0.666626
half-size-wu-haven-coef, 137, 58, 92, 1, 0, 288, 0.666626
half-size-wu-haven-coef, 148, 58, 91, 1, 0, 298, 0.666626
half-size-wu-haven-coef, 137, 58, 92, 1, 0, 288, 0.666626
half-size-wu-haven-coef, 134, 58, 91, 1, 0, 284, 0.666626
half-size-wu-haven-coef, 136, 58, 92, 1, 0, 287, 0.666626
half-size-wu-haven-coef, 139, 58, 91, 1, 0, 289, 0.666626
half-size-wu-haven-coef, 149, 58, 91, 1, 0, 299, 0.666626
half-size-wu-haven-coef, 140, 57, 90, 1, 0, 288, 0.666626
half-size-wu-haven-coef, 136, 58, 94, 1, 0, 289, 0.666626
half-size-wu-haven-coef, 140, 58, 92, 1, 0, 291, 0.666626
half-size-wu-haven-coef, 136, 57, 91, 1, 0, 285, 0.666626
half-size-wu-haven-coef, 135, 58, 93, 1, 0, 287, 0.666626
half-size-wu-haven-coef, 137, 58, 91, 1, 0, 287, 0.666626
half-size-wu-haven-coef, 138, 58, 94, 1, 0, 291, 0.666626
half-size-wu-haven-coef, 134, 58, 90, 1, 0, 283, 0.666626
half-size-wu-haven-coef, 137, 59, 93, 1, 0, 290, 0.666626
half-size-wu-haven-coef, 135, 58, 90, 1, 0, 284, 0.666626
half-size-wu-haven-coef, 135, 58, 91, 1, 0, 285, 0.666626
half-size-wu-haven-coef, 135, 58, 92, 1, 0, 286, 0.666626
half-size-wu-haven-coef, 135, 58, 92, 1, 0, 286, 0.666626
half-size-wu-haven-coef, 140, 58, 95, 1, 0, 294, 0.666626
half-size-wu-haven-coef, 138, 58, 90, 1, 0, 287, 0.666626
half-size-wu-haven-coef, 133, 57, 90, 1, 0, 281, 0.666626
half-size-wu-haven-coef, 136, 59, 93, 1, 0, 289, 0.666626
half-size-wu-haven-coef, 142, 58, 93, 1, 0, 294, 0.666626
half-size-wu-haven-coef, 134, 58, 92, 1, 0, 285, 0.666626
half-size-wu-haven-coef, 137, 58, 92, 1, 0, 288, 0.666626
half-size-wu-haven-coef, 140, 58, 92, 1, 0, 291, 0.666626
half-size-wu-haven-coef, 135, 58, 95, 1, 0, 289, 0.666626
half-size-wu-haven-coef, 137, 58, 92, 1, 0, 288, 0.666626
half-size-wu-haven-coef, 138, 59, 94, 1, 0, 292, 0.666626
half-size-wu-haven-coef, 148, 60, 91, 1, 0, 300, 0.666626
half-size-wu-haven-coef, 140, 57, 92, 1, 0, 290, 0.666626
half-size-wu-haven-coef, 139, 58, 96, 1, 0, 294, 0.666626
half-size-wu-haven-coef, 136, 58, 91, 1, 0, 286, 0.666626
half-size-wu-haven-coef, 136, 58, 92, 1, 0, 287, 0.666626
half-size-wu-haven-coef, 134, 58, 91, 1, 0, 284, 0.666626
half-size-wu-haven-coef, 132, 57, 91, 1, 0, 281, 0.666626
half-size-wu-haven-coef, 136, 58, 91, 1, 0, 286, 0.666626
half-size-wu-haven-coef, 139, 58, 91, 1, 0, 289, 0.666626
half-size-wu-haven-coef, 139, 58, 94, 1, 0, 292, 0.666626
half-size-wu-haven-coef, 138, 58, 92, 1, 0, 289, 0.666626
half-size-wu-haven-coef, 140, 59, 95, 1, 0, 295, 0.666626
half-size-wu-haven-coef, 140, 58, 95, 1, 0, 294, 0.666626
half-size-wu-haven-coef, 136, 58, 91, 1, 0, 286, 0.666626
half-size-wu-haven-coef, 138, 58, 89, 1, 0, 286, 0.666626
half-size-wu-haven-coef, 134, 57, 93, 1, 0, 285, 0.666626
half-size-wu-haven-coef, 136, 58, 94, 1, 0, 289, 0.666626
half-size-wu-haven-coef, 139, 57, 91, 1, 0, 288, 0.666626
half-size-wu-haven-coef, 136, 58, 94, 1, 0, 289, 0.666626
half-size-wu-haven-coef, 141, 59, 92, 1, 0, 293, 0.666626
half-size-wu-haven-coef, 134, 58, 94, 1, 0, 287, 0.666626
half-size-wu-haven-coef, 134, 57, 94, 1, 0, 286, 0.666626
half-size-wu-haven-coef, 139, 58, 93, 1, 0, 291, 0.666626
half-size-wu-haven-coef, 135, 59, 92, 1, 0, 287, 0.666626
half-size-wu-haven-coef, 142, 58, 90, 1, 0, 291, 0.666626
half-size-wu-haven-coef, 134, 60, 93, 1, 0, 288, 0.666626
half-size-wu-haven-coef, 144, 58, 94, 1, 0, 297, 0.666626
half-size-wu-haven-coef, 138, 57, 91, 1, 0, 287, 0.666626
half-size-wu-haven-coef, 137, 58, 92, 1, 0, 288, 0.666626
half-size-wu-haven-coef, 137, 59, 93, 1, 0, 290, 0.666626
half-size-wu-haven-coef, 138, 57, 94, 1, 0, 290, 0.666626
half-size-wu-haven-coef, 138, 58, 92, 1, 0, 289, 0.666626
half-size-wu-haven-coef, 135, 58, 94, 1, 0, 288, 0.666626
half-size-wu-haven-coef, 135, 59, 91, 1, 0, 286, 0.666626
half-size-wu-haven-coef, 135, 58, 92, 1, 0, 286, 0.666626
half-size-wu-haven-coef, 139, 58, 96, 1, 0, 294, 0.666626
half-size-wu-haven-coef, 136, 58, 92, 1, 0, 287, 0.666626
half-size-wu-haven-coef, 140, 58, 92, 1, 0, 291, 0.666626
half-size-wu-haven-coef, 133, 57, 92, 1, 0, 283, 0.666626
half-size-wu-haven-coef, 136, 58, 93, 1, 0, 288, 0.666626
half-size-wu-haven-coef, 135, 58, 91, 1, 0, 285, 0.666626
half-size-wu-haven-coef, 135, 59, 92, 1, 0, 287, 0.666626
half-size-wu-haven-coef, 136, 59, 95, 1, 0, 291, 0.666626
half-size-wu-haven-coef, 134, 58, 92, 1, 0, 285, 0.666626
half-size-wu-haven-coef, 136, 58, 92, 1, 0, 287, 0.666626
half-size-wu-haven-coef, 137, 59, 94, 1, 0, 291, 0.666626
half-size-wu-haven-coef, 138, 59, 93, 1, 0, 291, 0.666626
half-size-wu-haven-coef, 135, 58, 91, 1, 0, 285, 0.666626
half-size-wu-haven-coef, 137, 58, 91, 1, 0, 287, 0.666626
half-size-wu-haven-coef, 135, 58, 92, 1, 0, 286, 0.666626
half-size-wu-haven-coef, 139, 58, 92, 1, 0, 290, 0.666626
half-size-wu-haven-coef, 136, 58, 90, 1, 0, 285, 0.666626
half-size-wu-haven-coef, 134, 57, 94, 1, 0, 286, 0.666626
half-size-wu-haven-coef, 139, 57, 92, 1, 0, 289, 0.666626
half-size-wu-haven-coef, 137, 57, 94, 1, 0, 289, 0.666626
half-size-wu-haven-coef, 140, 57, 100, 1, 0, 298, 0.666626
half-size-wu-haven-coef, 134, 57, 90, 1, 0, 282, 0.666626
half-size-wu-haven-coef, 137, 57, 95, 1, 0, 290, 0.666626
half-size-wu-haven-coef, 137, 57, 90, 1, 0, 285, 0.666626
half-size-wu-haven-coef, 133, 58, 91, 1, 0, 283, 0.666626
half-size-wu-haven-coef, 134, 58, 92, 1, 0, 285, 0.666626
half-size-wu-haven-coef, 136, 58, 92, 1, 0, 287, 0.666626
half-size-wu-haven-coef, 137, 58, 91, 1, 0, 287, 0.666626
half-size-wu-haven-coef, 137, 57, 91, 1, 0, 286, 0.666626
half-size-wu-haven-coef, 139, 58, 91, 1, 0, 289, 0.666626
half-size-wu-haven-coef, 132, 58, 91, 1, 0, 282, 0.666626
half-size-wu-haven-coef, 137, 58, 92, 1, 0, 288, 0.666626
half-size-wu-haven-coef, 134, 58, 91, 1, 0, 284, 0.666626
half-size-wu-haven-coef, 135, 58, 91, 1, 0, 285, 0.666626
half-size-wu-haven-coef, 137, 58, 93, 1, 0, 289, 0.666626
half-size-wu-haven-coef, 136, 58, 92, 1, 0, 287, 0.666626
half-size-wu-haven-coef, 137, 58, 94, 1, 0, 290, 0.666626
half-size-wu-haven-coef, 133, 58, 91, 1, 0, 283, 0.666626
half-size-wu-haven-coef, 133, 57, 89, 1, 0, 280, 0.666626
half-size-wu-haven-coef, 144, 57, 90, 1, 0, 292, 0.666626
half-size-wu-haven-coef, 134, 57, 91, 1, 0, 283, 0.666626
half-size-wu-haven-coef, 135, 58, 93, 1, 0, 287, 0.666626
half-size-wu-haven-coef, 134, 58, 91, 1, 0, 284, 0.666626
half-size-wu-haven-coef, 141, 58, 92, 1, 0, 292, 0.666626
half-size-wu-haven-coef, 142, 58, 92, 1, 0, 293, 0.666626
half-size-wu-haven-coef, 135, 58, 94, 1, 0, 288, 0.666626
half-size-wu-haven-coef, 143, 58, 92, 1, 0, 294, 0.666626
half-size-wu-haven-coef, 137, 58, 92, 1, 0, 288, 0.666626
half-size-wu-haven-coef, 136, 58, 93, 1, 0, 288, 0.666626
half-size-wu-haven-coef, 136, 59, 93, 1, 0, 289, 0.666626
half-size-wu-haven-coef, 140, 57, 93, 1, 0, 291, 0.666626
half-size-wu-haven-coef, 138, 58, 92, 1, 0, 289, 0.666626
half-size-wu-haven-coef, 140, 58, 90, 1, 0, 289, 0.666626
half-size-wu-haven-coef, 138, 58, 91, 1, 0, 288, 0.666626
half-size-wu-haven-coef, 139, 64, 91, 1, 0, 295, 0.666626
half-size-wu-haven-coef, 141, 58, 92, 1, 0, 292, 0.666626
half-size-wu-haven-coef, 137, 58, 91, 1, 0, 287, 0.666626
half-size-wu-haven-coef, 140, 59, 94, 1, 0, 294, 0.666626
half-size-wu-haven-coef, 137, 57, 91, 1, 0, 286, 0.666626
half-size-wu-haven-coef, 134, 57, 93, 1, 0, 285, 0.666626
half-size-wu-haven-coef, 133, 58, 95, 1, 0, 287, 0.666626
half-size-wu-haven-coef, 139, 59, 93, 1, 0, 292, 0.666626
half-size-wu-haven-coef, 136, 58, 93, 1, 0, 288, 0.666626
half-size-wu-haven-coef, 136, 58, 95, 1, 0, 290, 0.666626
half-size-wu-haven-coef, 135, 62, 91, 1, 0, 289, 0.666626
half-size-wu-haven-coef, 139, 58, 91, 1, 0, 289, 0.666626
half-size-wu-haven-coef, 132, 58, 91, 1, 0, 282, 0.666626
half-size-wu-haven-coef, 135, 58, 91, 1, 0, 285, 0.666626
half-size-wu-haven-coef, 135, 57, 94, 1, 0, 287, 0.666626
half-size-wu-haven-coef, 135, 57, 91, 1, 0, 284, 0.666626
half-size-wu-haven-coef, 134, 57, 91, 1, 0, 283, 0.666626
half-size-wu-haven-coef, 139, 57, 91, 1, 0, 288, 0.666626
half-size-wu-haven-coef, 148, 57, 91, 1, 0, 297, 0.666626
half-size-wu-haven-coef, 141, 58, 91, 1, 0, 291, 0.666626
half-size-wu-haven-coef, 142, 58, 95, 1, 0, 296, 0.666626
half-size-wu-haven-coef, 136, 58, 92, 1, 0, 287, 0.666626
half-size-wu-haven-coef, 137, 58, 93, 1, 0, 289, 0.666626
half-size-wu-haven-coef, 134, 58, 93, 1, 0, 286, 0.666626
half-size-wu-haven-coef, 140, 59, 91, 1, 0, 291, 0.666626
half-size-wu-haven-coef, 133, 57, 92, 1, 0, 283, 0.666626
half-size-wu-haven-coef, 133, 58, 92, 1, 0, 284, 0.666626
half-size-wu-haven-coef, 141, 58, 92, 1, 0, 292, 0.666626
half-size-wu-haven-coef, 148, 58, 93, 1, 0, 300, 0.666626
half-size-wu-haven-coef, 138, 58, 93, 1, 0, 290, 0.666626
half-size-wu-haven-coef, 138, 58, 94, 1, 0, 291, 0.666626
half-size-wu-haven-coef, 140, 58, 95, 1, 0, 294, 0.666626
half-size-wu-haven-coef, 136, 58, 92, 1, 0, 287, 0.666626
half-size-wu-haven-coef, 138, 58, 91, 1, 0, 288, 0.666626
half-size-wu-haven-coef, 139, 59, 95, 1, 0, 294, 0.666626
half-size-wu-haven-coef, 144, 58, 91, 1, 0, 294, 0.666626
half-size-wu-haven-coef, 135, 58, 92, 1, 0, 286, 0.666626
half-size-wu-haven-coef, 139, 58, 91, 1, 0, 289, 0.666626
half-size-wu-haven-coef, 134, 57, 91, 1, 0, 283, 0.666626
half-size-wu-haven-coef, 135, 58, 93, 1, 0, 287, 0.666626
half-size-wu-haven-coef, 139, 58, 94, 1, 0, 292, 0.666626
half-size-wu-haven-coef, 136, 57, 91, 1, 0, 285, 0.666626
half-size-wu-haven-coef, 139, 58, 91, 1, 0, 289, 0.666626
half-size-wu-haven-coef, 136, 58, 91, 1, 0, 286, 0.666626
half-size-wu-haven-coef, 137, 57, 93, 1, 0, 288, 0.666626
half-size-wu-haven-coef, 133, 58, 91, 1, 0, 283, 0.666626
half-size-wu-haven-coef, 135, 59, 92, 1, 0, 287, 0.666626
half-size-wu-haven-coef, 135, 58, 91, 1, 0, 285, 0.666626
half-size-wu-haven-coef, 135, 58, 92, 1, 0, 286, 0.666626
half-size-wu-haven-coef, 139, 58, 92, 1, 0, 290, 0.666626
half-size-wu-haven-coef, 138, 57, 91, 1, 0, 287, 0.666626
half-size-wu-haven-coef, 136, 58, 94, 1, 0, 289, 0.666626
half-size-wu-haven-coef, 140, 57, 91, 1, 0, 289, 0.666626
half-size-wu-haven-coef, 139, 58, 91, 1, 0, 289, 0.666626
half-size-wu-haven-coef, 146, 57, 91, 1, 0, 295, 0.666626
half-size-wu-haven-coef, 135, 59, 93, 1, 0, 288, 0.666626
half-size-wu-haven-coef, 137, 58, 95, 1, 0, 291, 0.666626
half-size-wu-haven-coef, 136, 58, 91, 1, 0, 286, 0.666626
half-size-wu-haven-coef, 134, 57, 92, 1, 0, 284, 0.666626
half-size-wu-haven-coef, 136, 58, 94, 1, 0, 289, 0.666626
half-size-wu-haven-coef, 141, 58, 92, 1, 0, 292, 0.666626
half-size-wu-haven-coef, 137, 58, 93, 1, 0, 289, 0.666626
half-size-wu-haven-coef, 138, 58, 91, 1, 0, 288, 0.666626
half-size-wu-haven-coef, 139, 57, 94, 1, 0, 291, 0.666626
half-size-wu-haven-coef, 137, 58, 91, 1, 0, 287, 0.666626
half-size-wu-haven-coef, 140, 58, 91, 1, 0, 290, 0.666626
half-size-wu-haven-coef, 133, 58, 93, 1, 0, 285, 0.666626
half-size-wu-haven-coef, 143, 58, 91, 1, 0, 293, 0.666626
half-size-wu-haven-coef, 133, 58, 93, 1, 0, 285, 0.666626
half-size-wu-haven-coef, 137, 58, 91, 1, 0, 287, 0.666626
half-size-wu-haven-coef, 136, 59, 93, 1, 0, 289, 0.666626
half-size-wu-haven-coef, 139, 58, 92, 1, 0, 290, 0.666626
half-size-wu-haven-coef, 133, 57, 90, 1, 0, 281, 0.666626
half-size-wu-haven-coef, 137, 57, 93, 1, 0, 288, 0.666626
half-size-wu-haven-coef, 137, 58, 92, 1, 0, 288, 0.666626
half-size-wu-haven-coef, 136, 58, 91, 1, 0, 286, 0.666626
half-size-wu-haven-coef, 135, 58, 92, 1, 0, 286, 0.666626
half-size-wu-haven-coef, 136, 57, 92, 1, 0, 286, 0.666626
half-size-wu-haven-coef, 133, 57, 92, 1, 0, 283, 0.666626
half-size-wu-haven-coef, 146, 58, 91, 1, 0, 296, 0.666626
half-size-wu-haven-coef, 137, 58, 91, 1, 0, 287, 0.666626
half-size-wu-haven-coef, 140, 58, 91, 1, 0, 290, 0.666626
half-size-wu-haven-coef, 142, 57, 91, 1, 0, 291, 0.666626
half-size-wu-haven-coef, 133, 58, 92, 1, 0, 284, 0.666626
half-size-wu-haven-coef, 134, 57, 89, 1, 0, 281, 0.666626
half-size-wu-haven-coef, 140, 58, 91, 1, 0, 290, 0.666626
half-size-wu-haven-coef, 138, 58, 90, 1, 0, 287, 0.666626
half-size-wu-haven-coef, 143, 57, 94, 1, 0, 295, 0.666626
half-size-wu-haven-coef, 135, 58, 92, 1, 0, 286, 0.666626
half-size-wu-haven-coef, 135, 58, 93, 1, 0, 287, 0.666626
half-size-wu-haven-coef, 140, 58, 92, 1, 0, 291, 0.666626
half-size-wu-haven-coef, 135, 58, 90, 1, 0, 284, 0.666626
half-size-wu-haven-coef, 134, 57, 93, 1, 0, 285, 0.666626
half-size-wu-haven-coef, 135, 57, 92, 1, 0, 285, 0.666626
half-size-wu-haven-coef, 139, 57, 93, 1, 0, 290, 0.666626
half-size-wu-haven-coef, 137, 58, 91, 1, 0, 287, 0.666626
half-size-wu-haven-coef, 138, 58, 93, 1, 0, 290, 0.666626
half-size-wu-haven-coef, 138, 57, 91, 1, 0, 287, 0.666626
half-size-wu-haven-coef, 140, 58, 93, 1, 0, 292, 0.666626
half-size-wu-haven-coef, 136, 58, 94, 1, 0, 289, 0.666626
half-size-wu-haven-coef, 135, 58, 91, 1, 0, 285, 0.666626
half-size-wu-haven-coef, 139, 57, 89, 1, 0, 286, 0.666626
half-size-wu-haven-coef, 133, 57, 92, 1, 0, 283, 0.666626
half-size-wu-haven-coef, 140, 58, 93, 1, 0, 292, 0.666626
half-size-wu-haven-coef, 137, 58, 92, 1, 0, 288, 0.666626
half-size-wu-haven-coef, 140, 58, 91, 1, 0, 290, 0.666626
half-size-wu-haven-coef, 134, 58, 91, 1, 0, 284, 0.666626
half-size-wu-haven-coef, 134, 57, 90, 1, 0, 282, 0.666626
half-size-wu-haven-coef, 134, 58, 92, 1, 0, 285, 0.666626
half-size-wu-haven-coef, 136, 58, 92, 1, 0, 287, 0.666626
half-size-wu-haven-coef, 135, 58, 90, 1, 0, 284, 0.666626
half-size-wu-haven-coef, 134, 58, 90, 1, 0, 283, 0.666626
half-size-wu-haven-coef, 135, 57, 93, 1, 0, 286, 0.666626
half-size-wu-haven-coef, 137, 57, 93, 1, 0, 288, 0.666626
half-size-wu-haven-coef, 135, 57, 92, 1, 0, 285, 0.666626
half-size-wu-haven-coef, 140, 58, 91, 1, 0, 290, 0.666626
half-size-wu-haven-coef, 137, 58, 94, 1, 0, 290, 0.666626
half-size-wu-haven-coef, 134, 57, 91, 1, 0, 283, 0.666626
half-size-wu-haven-coef, 138, 58, 93, 1, 0, 290, 0.666626
half-size-wu-haven-coef, 134, 60, 92, 1, 0, 287, 0.666626
half-size-wu-haven-coef, 133, 58, 91, 1, 0, 283, 0.666626
half-size-wu-haven-coef, 135, 58, 92, 1, 0, 286, 0.666626
half-size-wu-haven-coef, 139, 58, 93, 1, 0, 291, 0.666626
half-size-wu-haven-coef, 137, 58, 93, 1, 0, 289, 0.666626
half-size-wu-haven-coef, 135, 58, 93, 1, 0, 287, 0.666626
half-size-wu-haven-coef, 140, 58, 93, 1, 0, 292, 0.666626
half-size-wu-haven-coef, 134, 58, 91, 1, 0, 284, 0.666626
half-size-wu-haven-coef, 136, 57, 91, 1, 0, 285, 0.666626
half-size-wu-haven-coef, 133, 57, 93, 1, 0, 284, 0.666626
half-size-wu-haven-coef, 138, 58, 93, 1, 0, 290, 0.666626
half-size-wu-haven-coef, 135, 58, 91, 1, 0, 285, 0.666626
half-size-wu-haven-coef, 137, 58, 91, 1, 0, 287, 0.666626
half-size-wu-haven-coef, 137, 58, 92, 1, 0, 288, 0.666626
half-size-wu-haven-coef, 142, 58, 94, 1, 0, 295, 0.666626
half-size-wu-haven-coef, 136, 58, 91, 1, 0, 286, 0.666626
half-size-wu-haven-coef, 137, 57, 91, 1, 0, 286, 0.666626
half-size-wu-haven-coef, 134, 58, 93, 1, 0, 286, 0.666626
half-size-wu-haven-coef, 134, 58, 91, 1, 0, 284, 0.666626
half-size-wu-haven-coef, 137, 57, 95, 1, 0, 290, 0.666626
half-size-wu-haven-coef, 133, 57, 92, 1, 0, 283, 0.666626
half-size-wu-haven-coef, 137, 58, 91, 1, 0, 287, 0.666626
half-size-wu-haven-coef, 138, 58, 91, 1, 0, 288, 0.666626
half-size-wu-haven-coef, 136, 58, 91, 1, 0, 286, 0.666626
half-size-wu-haven-coef, 140, 58, 91, 1, 0, 290, 0.666626
half-size-wu-haven-coef, 138, 58, 95, 1, 0, 292, 0.666626
half-size-wu-haven-coef, 133, 57, 94, 1, 0, 285, 0.666626
half-size-wu-haven-coef, 134, 59, 93, 1, 0, 287, 0.666626
half-size-wu-haven-coef, 137, 58, 94, 1, 0, 290, 0.666626
half-size-wu-haven-coef, 132, 57, 91, 1, 0, 281, 0.666626
half-size-wu-haven-coef, 136, 58, 92, 1, 0, 287, 0.666626
half-size-wu-haven-coef, 137, 58, 93, 1, 0, 289, 0.666626
half-size-wu-haven-coef, 138, 58, 91, 1, 0, 288, 0.666626
half-size-wu-haven-coef, 136, 57, 90, 1, 0, 284, 0.666626
half-size-wu-haven-coef, 139, 57, 91, 1, 0, 288, 0.666626
half-size-wu-haven-coef, 140, 57, 90, 1, 0, 288, 0.666626
half-size-wu-haven-coef, 135, 58, 92, 1, 0, 286, 0.666626
half-size-wu-haven-coef, 133, 58, 90, 1, 0, 282, 0.666626
half-size-wu-haven-coef, 137, 57, 93, 1, 0, 288, 0.666626
half-size-wu-haven-coef, 136, 57, 91, 1, 0, 285, 0.666626
half-size-wu-haven-coef, 134, 58, 93, 1, 0, 286, 0.666626
half-size-wu-haven-coef, 139, 58, 91, 1, 0, 289, 0.666626
half-size-wu-haven-coef, 135, 58, 91, 1, 0, 285, 0.666626
half-size-wu-haven-coef, 141, 57, 93, 1, 0, 292, 0.666626
half-size-wu-haven-coef, 135, 59, 92, 1, 0, 287, 0.666626
half-size-wu-haven-coef, 135, 58, 94, 1, 0, 288, 0.666626
half-size-wu-haven-coef, 137, 58, 90, 1, 0, 286, 0.666626
half-size-wu-haven-coef, 134, 58, 92, 1, 0, 285, 0.666626
half-size-wu-haven-coef, 134, 57, 92, 1, 0, 284, 0.666626
half-size-wu-haven-coef, 133, 57, 91, 1, 0, 282, 0.666626
half-size-wu-haven-coef, 136, 59, 92, 1, 0, 288, 0.666626
half-size-wu-haven-coef, 138, 58, 94, 1, 0, 291, 0.666626
half-size-wu-haven-coef, 137, 58, 92, 1, 0, 288, 0.666626
half-size-wu-haven-coef, 135, 58, 91, 1, 0, 285, 0.666626
half-size-wu-haven-coef, 135, 57, 92, 1, 0, 285, 0.666626
half-size-wu-haven-coef, 135, 57, 90, 1, 0, 283, 0.666626
half-size-wu-haven-coef, 136, 58, 90, 1, 0, 285, 0.666626
half-size-wu-haven-coef, 134, 58, 89, 1, 0, 282, 0.666626
half-size-wu-haven-coef, 139, 57, 90, 1, 0, 287, 0.666626
half-size-wu-haven-coef, 135, 57, 90, 1, 0, 283, 0.666626
half-size-wu-haven-coef, 142, 58, 93, 1, 0, 294, 0.666626
half-size-wu-haven-coef, 137, 57, 91, 1, 0, 286, 0.666626
half-size-wu-haven-coef, 134, 58, 91, 1, 0, 284, 0.666626
half-size-wu-haven-coef, 144, 58, 92, 1, 0, 295, 0.666626
half-size-wu-haven-coef, 137, 58, 93, 1, 0, 289, 0.666626
half-size-wu-haven-coef, 140, 58, 91, 1, 0, 290, 0.666626
half-size-wu-haven-coef, 137, 57, 90, 1, 0, 285, 0.666626
half-size-wu-haven-coef, 135, 57, 89, 1, 0, 282, 0.666626
half-size-wu-haven-coef, 139, 58, 91, 1, 0, 289, 0.666626
half-size-wu-haven-coef, 134, 57, 91, 1, 0, 283, 0.666626
half-size-wu-haven-coef, 141, 58, 92, 1, 0, 292, 0.666626
half-size-wu-haven-coef, 138, 58, 90, 1, 0, 287, 0.666626
half-size-wu-haven-coef, 133, 58, 90, 1, 0, 282, 0.666626
half-size-wu-haven-coef, 135, 58, 92, 1, 0, 286, 0.666626
half-size-wu-haven-coef, 136, 58, 92, 1, 0, 287, 0.666626
half-size-wu-haven-coef, 133, 58, 91, 1, 0, 283, 0.666626
half-size-wu-haven-coef, 132, 58, 90, 1, 0, 281, 0.666626
half-size-wu-haven-coef, 135, 57, 91, 1, 0, 284, 0.666626
half-size-wu-haven-coef, 134, 57, 90, 1, 0, 282, 0.666626
half-size-wu-haven-coef, 138, 57, 93, 1, 0, 289, 0.666626
half-size-wu-haven-coef, 137, 58, 91, 1, 0, 287, 0.666626
half-size-wu-haven-coef, 153, 58, 92, 1, 0, 304, 0.666626
half-size-wu-haven-coef, 134, 57, 90, 1, 0, 282, 0.666626
half-size-wu-haven-coef, 136, 57, 90, 1, 0, 284, 0.666626
half-size-wu-haven-coef, 136, 58, 93, 1, 0, 288, 0.666626
half-size-wu-haven-coef, 133, 57, 90, 1, 0, 281, 0.666626
half-size-wu-haven-coef, 140, 58, 91, 1, 0, 290, 0.666626
half-size-wu-haven-coef, 142, 58, 90, 1, 0, 291, 0.666626
half-size-wu-haven-coef, 137, 58, 91, 1, 0, 287, 0.666626
half-size-wu-haven-coef, 136, 58, 92, 1, 0, 287, 0.666626
half-size-wu-haven-coef, 137, 58, 95, 1, 0, 291, 0.666626
half-size-wu-haven-coef, 145, 59, 90, 1, 0, 295, 0.666626
half-size-wu-haven-coef, 133, 58, 90, 1, 0, 282, 0.666626
half-size-wu-haven-coef, 133, 58, 91, 1, 0, 283, 0.666626
half-size-wu-haven-coef, 142, 58, 94, 1, 0, 295, 0.666626
half-size-wu-haven-coef, 134, 57, 90, 1, 0, 282, 0.666626
half-size-wu-haven-coef, 137, 57, 89, 1, 0, 284, 0.666626
half-size-wu-haven-coef, 136, 57, 91, 1, 0, 285, 0.666626
half-size-wu-haven-coef, 138, 59, 93, 1, 0, 291, 0.666626
half-size-wu-haven-coef, 136, 58, 91, 1, 0, 286, 0.666626
half-size-wu-haven-coef, 137, 57, 93, 1, 0, 288, 0.666626
half-size-wu-haven-coef, 144, 57, 93, 1, 0, 295, 0.666626
half-size-wu-haven-coef, 140, 58, 93, 1, 0, 292, 0.666626
half-size-wu-haven-coef, 135, 58, 93, 1, 0, 287, 0.666626
half-size-wu-haven-coef, 133, 57, 90, 1, 0, 281, 0.666626
half-size-wu-haven-coef, 137, 58, 93, 1, 0, 289, 0.666626
half-size-wu-haven-coef, 135, 58, 93, 1, 0, 287, 0.666626
half-size-wu-haven-coef, 143, 58, 91, 1, 0, 293, 0.666626
half-size-wu-haven-coef, 134, 58, 92, 1, 0, 285, 0.666626
half-size-wu-haven-coef, 141, 58, 93, 1, 0, 293, 0.666626
half-size-wu-haven-coef, 133, 57, 93, 1, 0, 284, 0.666626
half-size-wu-haven-coef, 137, 58, 91, 1, 0, 287, 0.666626
half-size-wu-haven-coef, 134, 57, 93, 1, 0, 285, 0.666626
half-size-wu-haven-coef, 135, 58, 96, 1, 0, 290, 0.666626
half-size-wu-haven-coef, 135, 58, 91, 1, 0, 285, 0.666626
half-size-wu-haven-coef, 142, 57, 90, 1, 0, 290, 0.666626
half-size-wu-haven-coef, 133, 58, 92, 1, 0, 284, 0.666626
half-size-wu-haven-coef, 133, 58, 90, 1, 0, 282, 0.666626
half-size-wu-haven-coef, 135, 58, 93, 1, 0, 287, 0.666626
half-size-wu-haven-coef, 135, 58, 93, 1, 0, 287, 0.666626
half-size-wu-haven-coef, 134, 58, 95, 1, 0, 288, 0.666626
half-size-wu-haven-coef, 138, 58, 92, 1, 0, 289, 0.666626
half-size-wu-haven-coef, 137, 57, 93, 1, 0, 288, 0.666626
half-size-wu-haven-coef, 139, 58, 92, 1, 0, 290, 0.666626
half-size-wu-haven-coef, 136, 58, 91, 1, 0, 286, 0.666626
half-size-wu-haven-coef, 138, 59, 94, 1, 0, 292, 0.666626
half-size-wu-haven-coef, 137, 58, 91, 1, 0, 287, 0.666626
half-size-wu-haven-coef, 140, 58, 91, 1, 0, 290, 0.666626
half-size-wu-haven-coef, 135, 57, 89, 1, 0, 282, 0.666626
half-size-wu-haven-coef, 138, 58, 93, 1, 0, 290, 0.666626
half-size-wu-haven-coef, 134, 57, 91, 1, 0, 283, 0.666626
half-size-wu-haven-coef, 134, 58, 93, 1, 0, 286, 0.666626
half-size-wu-haven-coef, 139, 58, 92, 1, 0, 290, 0.666626
half-size-wu-haven-coef, 139, 57, 91, 1, 0, 288, 0.666626
half-size-wu-haven-coef, 137, 57, 92, 1, 0, 287, 0.666626
half-size-wu-haven-coef, 135, 58, 92, 1, 0, 286, 0.666626
half-size-wu-haven-coef, 134, 58, 90, 1, 0, 283, 0.666626
half-size-wu-haven-coef, 136, 58, 93, 1, 0, 288, 0.666626
half-size-wu-haven-coef, 134, 58, 91, 1, 0, 284, 0.666626
half-size-wu-haven-coef, 138, 57, 91, 1, 0, 287, 0.666626
half-size-wu-haven-coef, 137, 58, 95, 1, 0, 291, 0.666626
half-size-wu-haven-coef, 135, 58, 91, 1, 0, 285, 0.666626
half-size-wu-haven-coef, 138, 58, 90, 1, 0, 287, 0.666626
half-size-wu-haven-coef, 138, 57, 91, 1, 0, 287, 0.666626
half-size-wu-haven-coef, 134, 58, 92, 1, 0, 285, 0.666626
half-size-wu-haven-coef, 141, 57, 91, 1, 0, 290, 0.666626
half-size-wu-haven-coef, 136, 58, 92, 1, 0, 287, 0.666626
half-size-wu-haven-coef, 133, 58, 90, 1, 0, 282, 0.666626
half-size-wu-haven-coef, 138, 57, 94, 1, 0, 290, 0.666626
half-size-wu-haven-coef, 134, 57, 93, 1, 0, 285, 0.666626
half-size-wu-haven-coef, 132, 59, 92, 1, 0, 284, 0.666626
half-size-wu-haven-coef, 137, 58, 92, 1, 0, 288, 0.666626
half-size-wu-haven-coef, 134, 58, 92, 1, 0, 285, 0.666626
half-size-wu-haven-coef, 142, 57, 90, 1, 0, 290, 0.666626
half-size-wu-haven-coef, 140, 57, 95, 1, 0, 293, 0.666626
half-size-wu-haven-coef, 134, 57, 90, 1, 0, 282, 0.666626
half-size-wu-haven-coef, 139, 59, 92, 1, 0, 291, 0.666626
half-size-wu-haven-coef, 138, 58, 92, 1, 0, 289, 0.666626
half-size-wu-haven-coef, 134, 57, 90, 1, 0, 282, 0.666626
half-size-wu-haven-coef, 135, 57, 91, 1, 0, 284, 0.666626
half-size-wu-haven-coef, 133, 57, 91, 1, 0, 282, 0.666626
half-size-wu-haven-coef, 136, 58, 92, 1, 0, 287, 0.666626
half-size-wu-haven-coef, 135, 58, 90, 1, 0, 284, 0.666626
half-size-wu-haven-coef, 135, 57, 90, 1, 0, 283, 0.666626
half-size-wu-haven-coef, 136, 58, 90, 1, 0, 285, 0.666626
half-size-wu-haven-coef, 138, 57, 92, 1, 0, 288, 0.666626
half-size-wu-haven-coef, 137, 58, 91, 1, 0, 287, 0.666626
half-size-wu-haven-coef, 137, 61, 94, 1, 0, 293, 0.666626
half-size-wu-haven-coef, 136, 57, 90, 1, 0, 284, 0.666626
half-size-wu-haven-coef, 142, 58, 93, 1, 0, 294, 0.666626
half-size-wu-haven-coef, 135, 59, 92, 1, 0, 287, 0.666626
half-size-wu-haven-coef, 135, 57, 94, 1, 0, 287, 0.666626
half-size-wu-haven-coef, 135, 57, 89, 1, 0, 282, 0.666626
half-size-wu-haven-coef, 146, 57, 89, 1, 0, 293, 0.666626
half-size-wu-haven-coef, 136, 58, 92, 1, 0, 287, 0.666626
half-size-wu-haven-coef, 138, 59, 93, 1, 0, 291, 0.666626
half-size-wu-haven-coef, 137, 58, 93, 1, 0, 289, 0.666626
half-size-wu-haven-coef, 142, 59, 90, 1, 0, 292, 0.666626
half-size-wu-haven-coef, 136, 58, 94, 1, 0, 289, 0.666626
half-size-wu-haven-coef, 133, 57, 92, 1, 0, 283, 0.666626
half-size-wu-haven-coef, 136, 57, 94, 1, 0, 288, 0.666626
half-size-wu-haven-coef, 136, 57, 90, 1, 0, 284, 0.666626
half-size-wu-haven-coef, 134, 57, 91, 1, 0, 283, 0.666626
half-size-wu-haven-coef, 145, 57, 91, 1, 0, 294, 0.666626
half-size-wu-haven-coef, 138, 57, 91, 1, 0, 287, 0.666626
half-size-wu-haven-coef, 134, 58, 90, 1, 0, 283, 0.666626
half-size-wu-haven-coef, 137, 57, 89, 1, 0, 284, 0.666626
half-size-wu-haven-coef, 135, 58, 90, 1, 0, 284, 0.666626
half-size-wu-haven-coef, 135, 57, 91, 1, 0, 284, 0.666626
half-size-wu-haven-coef, 133, 57, 91, 1, 0, 282, 0.666626
half-size-wu-haven-coef, 136, 58, 92, 1, 0, 287, 0.666626
half-size-wu-haven-coef, 141, 58, 92, 1, 0, 292, 0.666626
half-size-wu-haven-coef, 137, 58, 91, 1, 0, 287, 0.666626
half-size-wu-haven-coef, 137, 58, 91, 1, 0, 287, 0.666626
half-size-wu-haven-coef, 134, 58, 92, 1, 0, 285, 0.666626
half-size-wu-haven-coef, 134, 57, 90, 1, 0, 282, 0.666626
half-size-wu-haven-coef, 135, 58, 91, 1, 0, 285, 0.666626
half-size-wu-haven-coef, 138, 58, 91, 1, 0, 288, 0.666626
half-size-wu-haven-coef, 150, 58, 90, 1, 0, 299, 0.666626
half-size-wu-haven-coef, 134, 57, 93, 1, 0, 285, 0.666626
half-size-wu-haven-coef, 134, 58, 92, 1, 0, 285, 0.666626
half-size-wu-haven-coef, 143, 57, 92, 1, 0, 293, 0.666626
half-size-wu-haven-coef, 138, 57, 90, 1, 0, 286, 0.666626
half-size-wu-haven-coef, 138, 57, 93, 1, 0, 289, 0.666626
half-size-wu-haven-coef, 140, 58, 94, 1, 0, 293, 0.666626
half-size-wu-haven-coef, 136, 57, 90, 1, 0, 284, 0.666626
half-size-wu-haven-coef, 138, 58, 90, 1, 0, 287, 0.666626
half-size-wu-haven-coef, 136, 58, 94, 1, 0, 289, 0.666626
half-size-wu-haven-coef, 138, 57, 91, 1, 0, 287, 0.666626
half-size-wu-haven-coef, 134, 57, 92, 1, 0, 284, 0.666626
half-size-wu-haven-coef, 134, 58, 93, 1, 0, 286, 0.666626
half-size-wu-haven-coef, 140, 58, 93, 1, 0, 292, 0.666626
half-size-wu-haven-coef, 137, 58, 89, 1, 0, 285, 0.666626
half-size-wu-haven-coef, 135, 57, 92, 1, 0, 285, 0.666626
half-size-wu-haven-coef, 137, 58, 91, 1, 0, 287, 0.666626
half-size-wu-haven-coef, 134, 58, 90, 1, 0, 283, 0.666626
half-size-wu-haven-coef, 135, 59, 90, 1, 0, 285, 0.666626
half-size-wu-haven-coef, 135, 57, 90, 1, 0, 283, 0.666626
half-size-wu-haven-coef, 134, 57, 90, 1, 0, 282, 0.666626
half-size-wu-haven-coef, 136, 57, 92, 1, 0, 286, 0.666626
half-size-wu-haven-coef, 135, 58, 93, 1, 0, 287, 0.666626
half-size-wu-haven-coef, 141, 58, 90, 1, 0, 290, 0.666626
half-size-wu-haven-coef, 136, 57, 90, 1, 0, 284, 0.666626
half-size-wu-haven-coef, 134, 58, 91, 1, 0, 284, 0.666626
half-size-wu-haven-coef, 138, 58, 91, 1, 0, 288, 0.666626
half-size-wu-haven-coef, 137, 58, 96, 1, 0, 292, 0.666626
half-size-wu-haven-coef, 135, 58, 92, 1, 0, 286, 0.666626
half-size-wu-haven-coef, 136, 59, 92, 1, 0, 288, 0.666626
half-size-wu-haven-coef, 134, 58, 90, 1, 0, 283, 0.666626
half-size-wu-haven-coef, 138, 57, 94, 1, 0, 290, 0.666626
half-size-wu-haven-coef, 136, 58, 92, 1, 0, 287, 0.666626
half-size-wu-haven-coef, 138, 57, 92, 1, 0, 288, 0.666626
half-size-wu-haven-coef, 134, 57, 90, 1, 0, 282, 0.666626
half-size-wu-haven-coef, 133, 57, 91, 1, 0, 282, 0.666626
half-size-wu-haven-coef, 137, 60, 92, 1, 0, 290, 0.666626
half-size-wu-haven-coef, 135, 57, 91, 1, 0, 284, 0.666626
half-size-wu-haven-coef, 137, 58, 91, 1, 0, 287, 0.666626
half-size-wu-haven-coef, 135, 58, 92, 1, 0, 286, 0.666626
half-size-wu-haven-coef, 136, 57, 90, 1, 0, 284, 0.666626
half-size-wu-haven-coef, 134, 58, 93, 1, 0, 286, 0.666626
half-size-wu-haven-coef, 135, 58, 92, 1, 0, 286, 0.666626
half-size-wu-haven-coef, 139, 58, 91, 1, 0, 289, 0.666626
half-size-wu-haven-coef, 132, 58, 91, 1, 0, 282, 0.666626
half-size-wu-haven-coef, 133, 57, 90, 1, 0, 281, 0.666626
half-size-wu-haven-coef, 134, 58, 92, 1, 0, 285, 0.666626
half-size-wu-haven-coef, 134, 58, 97, 1, 0, 290, 0.666626
half-size-wu-haven-coef, 135, 62, 96, 1, 0, 294, 0.666626
half-size-wu-haven-coef, 137, 59, 93, 1, 0, 290, 0.666626
half-size-wu-haven-coef, 139, 57, 92, 1, 0, 289, 0.666626
half-size-wu-haven-coef, 146, 58, 92, 1, 0, 297, 0.666626
half-size-wu-haven-coef, 142, 58, 95, 1, 0, 296, 0.666626
half-size-wu-haven-coef, 137, 58, 94, 1, 0, 290, 0.666626
half-size-wu-haven-coef, 140, 58, 94, 1, 0, 293, 0.666626
half-size-wu-haven-coef, 135, 57, 92, 1, 0, 285, 0.666626
half-size-wu-haven-coef, 137, 58, 93, 1, 0, 289, 0.666626
half-size-wu-haven-coef, 138, 58, 91, 1, 0, 288, 0.666626
half-size-wu-haven-coef, 137, 58, 91, 1, 0, 287, 0.666626
half-size-wu-haven-coef, 137, 57, 92, 1, 0, 287, 0.666626
half-size-wu-haven-coef, 133, 57, 91, 1, 0, 282, 0.666626
half-size-wu-haven-coef, 133, 57, 90, 1, 0, 281, 0.666626
half-size-wu-haven-coef, 140, 57, 93, 1, 0, 291, 0.666626
half-size-wu-haven-coef, 133, 58, 90, 1, 0, 282, 0.666626
half-size-wu-haven-coef, 136, 57, 90, 1, 0, 284, 0.666626
half-size-wu-haven-coef, 138, 57, 93, 1, 0, 289, 0.666626
half-size-wu-haven-coef, 137, 58, 93, 1, 0, 289, 0.666626
half-size-wu-haven-coef, 138, 58, 94, 1, 0, 291, 0.666626
half-size-wu-haven-coef, 139, 58, 92, 1, 0, 290, 0.666626
half-size-wu-haven-coef, 137, 58, 92, 1, 0, 288, 0.666626
half-size-wu-haven-coef, 141, 58, 94, 1, 0, 294, 0.666626
half-size-wu-haven-coef, 139, 57, 91, 1, 0, 288, 0.666626
half-size-wu-haven-coef, 135, 58, 91, 1, 0, 285, 0.666626
half-size-wu-haven-coef, 134, 57, 89, 1, 0, 281, 0.666626
half-size-wu-haven-coef, 133, 57, 90, 1, 0, 281, 0.666626
half-size-wu-haven-coef, 137, 58, 91, 1, 0, 287, 0.666626
half-size-wu-haven-coef, 136, 59, 92, 1, 0, 288, 0.666626
half-size-wu-haven-coef, 140, 57, 91, 1, 0, 289, 0.666626
half-size-wu-haven-coef, 143, 57, 89, 1, 0, 290, 0.666626
half-size-wu-haven-coef, 135, 59, 92, 1, 0, 287, 0.666626
half-size-wu-haven-coef, 136, 57, 90, 1, 0, 284, 0.666626
half-size-wu-haven-coef, 137, 57, 91, 1, 0, 286, 0.666626
half-size-wu-haven-coef, 135, 58, 93, 1, 0, 287, 0.666626
half-size-wu-haven-coef, 138, 58, 93, 1, 0, 290, 0.666626
half-size-wu-haven-coef, 139, 57, 92, 1, 0, 289, 0.666626
half-size-wu-haven-coef, 137, 58, 92, 1, 0, 288, 0.666626
half-size-wu-haven-coef, 138, 58, 91, 1, 0, 288, 0.666626
half-size-wu-haven-coef, 139, 58, 90, 1, 0, 288, 0.666626
half-size-wu-haven-coef, 136, 58, 91, 1, 0, 286, 0.666626
half-size-wu-haven-coef, 136, 57, 90, 1, 0, 284, 0.666626
half-size-wu-haven-coef, 133, 57, 91, 1, 0, 282, 0.666626
half-size-wu-haven-coef, 137, 58, 92, 1, 0, 288, 0.666626
half-size-wu-haven-coef, 136, 57, 91, 1, 0, 285, 0.666626
half-size-wu-haven-coef, 140, 58, 90, 1, 0, 289, 0.666626
half-size-wu-haven-coef, 137, 58, 90, 1, 0, 286, 0.666626
half-size-wu-haven-coef, 136, 58, 92, 1, 0, 287, 0.666626
half-size-wu-haven-coef, 136, 58, 92, 1, 0, 287, 0.666626
half-size-wu-haven-coef, 136, 58, 91, 1, 0, 286, 0.666626
half-size-wu-haven-coef, 143, 57, 92, 1, 0, 293, 0.666626
half-size-wu-haven-coef, 133, 58, 91, 1, 0, 283, 0.666626
half-size-wu-haven-coef, 138, 57, 91, 1, 0, 287, 0.666626
half-size-wu-haven-coef, 133, 58, 91, 1, 0, 283, 0.666626
half-size-wu-haven-coef, 137, 58, 92, 1, 0, 288, 0.666626
half-size-wu-haven-coef, 133, 57, 91, 1, 0, 282, 0.666626
half-size-wu-haven-coef, 135, 57, 89, 1, 0, 282, 0.666626
half-size-wu-haven-coef, 137, 59, 94, 1, 0, 291, 0.666626
half-size-wu-haven-coef, 135, 58, 92, 1, 0, 286, 0.666626
half-size-wu-haven-coef, 137, 57, 92, 1, 0, 287, 0.666626
half-size-wu-haven-coef, 138, 57, 90, 1, 0, 286, 0.666626
half-size-wu-haven-coef, 138, 58, 91, 1, 0, 288, 0.666626
half-size-wu-haven-coef, 134, 57, 91, 1, 0, 283, 0.666626
half-size-wu-haven-coef, 137, 58, 92, 1, 0, 288, 0.666626
half-size-wu-haven-coef, 136, 58, 92, 1, 0, 287, 0.666626
half-size-wu-haven-coef, 138, 58, 93, 1, 0, 290, 0.666626
half-size-wu-haven-coef, 133, 58, 92, 1, 0, 284, 0.666626
half-size-wu-haven-coef, 141, 58, 92, 1, 0, 292, 0.666626
half-size-wu-haven-coef, 136, 57, 94, 1, 0, 288, 0.666626
half-size-wu-haven-coef, 136, 59, 91, 1, 0, 287, 0.666626
half-size-wu-haven-coef, 135, 58, 92, 1, 0, 286, 0.666626
half-size-wu-haven-coef, 138, 61, 93, 1, 0, 293, 0.666626
half-size-wu-haven-coef, 133, 57, 90, 1, 0, 281, 0.666626
half-size-wu-haven-coef, 144, 57, 89, 1, 0, 291, 0.666626
half-size-wu-haven-coef, 134, 58, 91, 1, 0, 284, 0.666626
half-size-wu-haven-coef, 135, 58, 91, 1, 0, 285, 0.666626
half-size-wu-haven-coef, 135, 57, 90, 1, 0, 283, 0.666626
half-size-wu-haven-coef, 134, 57, 91, 1, 0, 283, 0.666626
half-size-wu-haven-coef, 135, 58, 93, 1, 0, 287, 0.666626
half-size-wu-haven-coef, 138, 60, 97, 1, 0, 296, 0.666626
half-size-wu-haven-coef, 143, 57, 93, 1, 0, 294, 0.666626
half-size-wu-haven-coef, 138, 58, 92, 1, 0, 289, 0.666626
half-size-wu-haven-coef, 137, 57, 94, 1, 0, 289, 0.666626
half-size-wu-haven-coef, 136, 58, 92, 1, 0, 287, 0.666626
half-size-wu-haven-coef, 135, 58, 92, 1, 0, 286, 0.666626
half-size-wu-haven-coef, 136, 58, 92, 1, 0, 287, 0.666626
half-size-wu-haven-coef, 138, 58, 92, 1, 0, 289, 0.666626
half-size-wu-haven-coef, 132, 57, 93, 1, 0, 283, 0.666626
half-size-wu-haven-coef, 138, 57, 91, 1, 0, 287, 0.666626
half-size-wu-haven-coef, 142, 58, 91, 1, 0, 292, 0.666626
half-size-wu-haven-coef, 136, 58, 90, 1, 0, 285, 0.666626
half-size-wu-haven-coef, 135, 58, 92, 1, 0, 286, 0.666626
half-size-wu-haven-coef, 139, 58, 90, 1, 0, 288, 0.666626
half-size-wu-haven-coef, 139, 57, 90, 1, 0, 287, 0.666626
half-size-wu-haven-coef, 137, 58, 92, 1, 0, 288, 0.666626
half-size-wu-haven-coef, 134, 58, 91, 1, 0, 284, 0.666626
half-size-wu-haven-coef, 135, 57, 90, 1, 0, 283, 0.666626
half-size-wu-haven-coef, 138, 58, 91, 1, 0, 288, 0.666626
half-size-wu-haven-coef, 133, 58, 90, 1, 0, 282, 0.666626
half-size-wu-haven-coef, 135, 58, 92, 1, 0, 286, 0.666626
half-size-wu-haven-coef, 134, 58, 93, 1, 0, 286, 0.666626
half-size-wu-haven-coef, 138, 58, 91, 1, 0, 288, 0.666626
half-size-wu-haven-coef, 138, 58, 91, 1, 0, 288, 0.666626
half-size-wu-haven-coef, 137, 57, 90, 1, 0, 285, 0.666626
half-size-wu-haven-coef, 135, 58, 92, 1, 0, 286, 0.666626
half-size-wu-haven-coef, 132, 57, 88, 1, 0, 278, 0.666626
half-size-wu-haven-coef, 134, 58, 93, 1, 0, 286, 0.666626
half-size-wu-haven-coef, 135, 57, 90, 1, 0, 283, 0.666626
wu-haven-coef, 61, 42, 31, 1, 2, 137, 0.666626
wu-haven-coef, 57, 42, 30, 1, 2, 132, 0.666626
wu-haven-coef, 59, 42, 29, 1, 2, 133, 0.666626
wu-haven-coef, 56, 42, 29, 1, 2, 130, 0.666626
wu-haven-coef, 60, 42, 30, 1, 2, 135, 0.666626
wu-haven-coef, 56, 42, 29, 1, 2, 130, 0.666626
wu-haven-coef, 59, 42, 30, 1, 2, 134, 0.666626
wu-haven-coef, 59, 42, 30, 1, 2, 134, 0.666626
wu-haven-coef, 62, 42, 31, 1, 2, 138, 0.666626
wu-haven-coef, 57, 42, 30, 1, 2, 132, 0.666626
wu-haven-coef, 60, 42, 30, 1, 2, 135, 0.666626
wu-haven-coef, 58, 42, 31, 1, 2, 134, 0.666626
wu-haven-coef, 63, 42, 30, 1, 2, 138, 0.666626
wu-haven-coef, 63, 42, 31, 1, 2, 139, 0.666626
wu-haven-coef, 57, 42, 28, 1, 2, 130, 0.666626
wu-haven-coef, 60, 41, 29, 1, 2, 133, 0.666626
wu-haven-coef, 57, 42, 30, 1, 2, 132, 0.666626
wu-haven-coef, 59, 42, 30, 1, 2, 134, 0.666626
wu-haven-coef, 60, 42, 29, 1, 2, 134, 0.666626
wu-haven-coef, 60, 41, 31, 1, 2, 135, 0.666626
wu-haven-coef, 59, 43, 30, 1, 2, 135, 0.666626
wu-haven-coef, 59, 42, 30, 1, 2, 134, 0.666626
wu-haven-coef, 59, 46, 29, 1, 2, 137, 0.666626
wu-haven-coef, 60, 42, 30, 1, 2, 135, 0.666626
wu-haven-coef, 59, 42, 29, 1, 2, 133, 0.666626
wu-haven-coef, 56, 42, 30, 1, 2, 131, 0.666626
wu-haven-coef, 64, 42, 31, 1, 2, 140, 0.666626
wu-haven-coef, 61, 42, 29, 1, 2, 135, 0.666626
wu-haven-coef, 60, 42, 30, 1, 2, 135, 0.666626
wu-haven-coef, 60, 42, 29, 1, 2, 134, 0.666626
wu-haven-coef, 60, 42, 30, 1, 2, 135, 0.666626
wu-haven-coef, 59, 42, 32, 1, 2, 136, 0.666626
wu-haven-coef, 58, 42, 30, 1, 2, 133, 0.666626
wu-haven-coef, 63, 42, 31, 1, 2, 139, 0.666626
wu-haven-coef, 58, 42, 29, 1, 2, 132, 0.666626
wu-haven-coef, 59, 42, 29, 1, 2, 133, 0.666626
wu-haven-coef, 57, 42, 29, 1, 2, 131, 0.666626
wu-haven-coef, 56, 42, 29, 1, 2, 130, 0.666626
wu-haven-coef, 57, 42, 29, 1, 2, 131, 0.666626
wu-haven-coef, 61, 42, 31, 1, 2, 137, 0.666626
wu-haven-coef, 59, 42, 29, 1, 2, 133, 0.666626
wu-haven-coef, 56, 42, 30, 1, 2, 131, 0.666626
wu-haven-coef, 59, 42, 30, 1, 2, 134, 0.666626
wu-haven-coef, 59, 43, 29, 1, 2, 134, 0.666626
wu-haven-coef, 59, 42, 29, 1, 2, 133, 0.666626
wu-haven-coef, 56, 42, 29, 1, 2, 130, 0.666626
wu-haven-coef, 56, 42, 29, 1, 2, 130, 0.666626
wu-haven-coef, 57, 42, 29, 1, 2, 131, 0.666626
wu-haven-coef, 60, 42, 29, 1, 2, 134, 0.666626
wu-haven-coef, 57, 42, 29, 1, 2, 131, 0.666626
wu-haven-coef, 60, 42, 29, 1, 2, 134, 0.666626
wu-haven-coef, 57, 42, 29, 1, 2, 131, 0.666626
wu-haven-coef, 61, 43, 31, 1, 2, 138, 0.666626
wu-haven-coef, 60, 43, 30, 1, 2, 136, 0.666626
wu-haven-coef, 56, 42, 30, 1, 2, 131, 0.666626
wu-haven-coef, 58, 43, 30, 1, 2, 134, 0.666626
wu-haven-coef, 59, 42, 29, 1, 2, 133, 0.666626
wu-haven-coef, 56, 42, 29, 1, 2, 130, 0.666626
wu-haven-coef, 59, 42, 29, 1, 2, 133, 0.666626
wu-haven-coef, 60, 43, 30, 1, 2, 136, 0.666626
wu-haven-coef, 56, 42, 30, 1, 2, 131, 0.666626
wu-haven-coef, 59, 42, 30, 1, 2, 134, 0.666626
wu-haven-coef, 58, 42, 30, 1, 2, 133, 0.666626
wu-haven-coef, 59, 42, 30, 1, 2, 134, 0.666626
wu-haven-coef, 67, 42, 29, 1, 2, 141, 0.666626
wu-haven-coef, 65, 42, 31, 1, 2, 141, 0.666626
wu-haven-coef, 58, 42, 30, 1, 2, 133, 0.666626
wu-haven-coef, 60, 42, 30, 1, 2, 135, 0.666626
wu-haven-coef, 59, 42, 30, 1, 2, 134, 0.666626
wu-haven-coef, 56, 42, 29, 1, 2, 130, 0.666626
wu-haven-coef, 56, 42, 29, 1, 2, 130, 0.666626
wu-haven-coef, 59, 42, 31, 1, 2, 135, 0.666626
wu-haven-coef, 61, 42, 30, 1, 2, 136, 0.666626
wu-haven-coef, 57, 42, 29, 1, 2, 131, 0.666626
wu-haven-coef, 65, 42, 29, 1, 2, 139, 0.666626
wu-haven-coef, 59, 42, 29, 1, 2, 133, 0.666626
wu-haven-coef, 61, 42, 29, 1, 2, 135, 0.666626
wu-haven-coef, 59, 42, 30, 1, 2, 134, 0.666626
wu-haven-coef, 58, 42, 30, 1, 2, 133, 0.666626
wu-haven-coef, 59, 42, 30, 1, 2, 134, 0.666626
wu-haven-coef, 59, 46, 29, 1, 2, 137, 0.666626
wu-haven-coef, 56, 42, 30, 1, 2, 131, 0.666626
wu-haven-coef, 60, 42, 29, 1, 2, 134, 0.666626
wu-haven-coef, 60, 42, 30, 1, 2, 135, 0.666626
wu-haven-coef, 57, 42, 30, 1, 2, 132, 0.666626
wu-haven-coef, 66, 42, 29, 1, 2, 140, 0.666626
wu-haven-coef, 60, 42, 32, 1, 2, 137, 0.666626
wu-haven-coef, 56, 42, 29, 1, 2, 130, 0.666626
wu-haven-coef, 57, 42, 29, 1, 2, 131, 0.666626
wu-haven-coef, 56, 42, 29, 1, 2, 130, 0.666626
wu-haven-coef, 56, 42, 29, 1, 2, 130, 0.666626
wu-haven-coef, 60, 43, 29, 1, 2, 135, 0.666626
wu-haven-coef, 60, 42, 29, 1, 2, 134, 0.666626
wu-haven-coef, 59, 42, 30, 1, 2, 134, 0.666626
wu-haven-coef, 56, 42, 31, 1, 2, 132, 0.666626
wu-haven-coef, 58, 46, 30, 1, 2, 137, 0.666626
wu-haven-coef, 59, 43, 29, 1, 2, 134, 0.666626
wu-haven-coef, 63, 42, 30, 1, 2, 138, 0.666626
wu-haven-coef, 59, 42, 30, 1, 2, 134, 0.666626
wu-haven-coef, 60, 43, 30, 1, 2, 136, 0.666626
wu-haven-coef, 58, 42, 30, 1, 2, 133, 0.666626
wu-haven-coef, 59, 42, 29, 1, 2, 133, 0.666626
wu-haven-coef, 60, 44, 32, 1, 2, 139, 0.666626
wu-haven-coef, 59, 44, 30, 1, 2, 136, 0.666626
wu-haven-coef, 59, 42, 30, 1, 2, 134, 0.666626
wu-haven-coef, 59, 43, 30, 1, 2, 135, 0.666626
wu-haven-coef, 56, 42, 30, 1, 2, 131, 0.666626
wu-haven-coef, 58, 42, 29, 1, 2, 132, 0.666626
wu-haven-coef, 60, 42, 29, 1, 2, 134, 0.666626
wu-haven-coef, 56, 42, 29, 1, 2, 130, 0.666626
wu-haven-coef, 57, 42, 29, 1, 2, 131, 0.666626
wu-haven-coef, 56, 42, 29, 1, 2, 130, 0.666626
wu-haven-coef, 56, 42, 29, 1, 2, 130, 0.666626
wu-haven-coef, 61, 42, 30, 1, 2, 136, 0.666626
wu-haven-coef, 57, 42, 32, 1, 2, 134, 0.666626
wu-haven-coef, 58, 46, 29, 1, 2, 136, 0.666626
wu-haven-coef, 56, 43, 29, 1, 2, 131, 0.666626
wu-haven-coef, 59, 42, 30, 1, 2, 134, 0.666626
wu-haven-coef, 59, 42, 29, 1, 2, 133, 0.666626
wu-haven-coef, 59, 43, 31, 1, 2, 136, 0.666626
wu-haven-coef, 58, 42, 30, 1, 2, 133, 0.666626
wu-haven-coef, 63, 42, 30, 1, 2, 138, 0.666626
wu-haven-coef, 63, 42, 31, 1, 2, 139, 0.666626
wu-haven-coef, 59, 43, 30, 1, 2, 135, 0.666626
wu-haven-coef, 58, 42, 30, 1, 2, 133, 0.666626
wu-haven-coef, 59, 42, 30, 1, 2, 134, 0.666626
wu-haven-coef, 60, 42, 29, 1, 2, 134, 0.666626
wu-haven-coef, 56, 42, 29, 1, 2, 130, 0.666626
wu-haven-coef, 59, 42, 29, 1, 2, 133, 0.666626
wu-haven-coef, 60, 42, 30, 1, 2, 135, 0.666626
wu-haven-coef, 59, 43, 31, 1, 2, 136, 0.666626
wu-haven-coef, 61, 43, 31, 1, 2, 138, 0.666626
wu-haven-coef, 57, 43, 30, 1, 2, 133, 0.666626
wu-haven-coef, 58, 42, 30, 1, 2, 133, 0.666626
wu-haven-coef, 59, 42, 30, 1, 2, 134, 0.666626
wu-haven-coef, 60, 42, 29, 1, 2, 134, 0.666626
wu-haven-coef, 57, 42, 29, 1, 2, 131, 0.666626
wu-haven-coef, 56, 42, 29, 1, 2, 130, 0.666626
wu-haven-coef, 60, 42, 30, 1, 2, 135, 0.666626
wu-haven-coef, 69, 42, 31, 1, 2, 145, 0.666626
wu-haven-coef, 56, 42, 29, 1, 2, 130, 0.666626
wu-haven-coef, 56, 42, 29, 1, 2, 130, 0.666626
wu-haven-coef, 57, 42, 29, 1, 2, 131, 0.666626
wu-haven-coef, 64, 43, 30, 1, 2, 140, 0.666626
wu-haven-coef, 60, 42, 31, 1, 2, 136, 0.666626
wu-haven-coef, 65, 42, 31, 1, 2, 141, 0.666626
wu-haven-coef, 59, 43, 34, 1, 2, 139, 0.666626
wu-haven-coef, 59, 43, 30, 1, 2, 135, 0.666626
wu-haven-coef, 56, 42, 30, 1, 2, 131, 0.666626
wu-haven-coef, 57, 42, 30, 1, 2, 132, 0.666626
wu-haven-coef, 56, 42, 29, 1, 2, 130, 0.666626
wu-haven-coef, 62, 42, 31, 1, 2, 138, 0.666626
wu-haven-coef, 58, 42, 29, 1, 2, 132, 0.666626
wu-haven-coef, 56, 43, 29, 1, 2, 131, 0.666626
wu-haven-coef, 59, 42, 30, 1, 2, 134, 0.666626
wu-haven-coef, 59, 43, 29, 1, 2, 134, 0.666626
wu-haven-coef, 59, 43, 30, 1, 2, 135, 0.666626
wu-haven-coef, 59, 43, 29, 1, 2, 134, 0.666626
wu-haven-coef, 60, 42, 31, 1, 2, 136, 0.666626
wu-haven-coef, 59, 42, 30, 1, 2, 134, 0.666626
wu-haven-coef, 60, 43, 30, 1, 2, 136, 0.666626
wu-haven-coef, 62, 42, 31, 1, 2, 138, 0.666626
wu-haven-coef, 62, 42, 30, 1, 2, 137, 0.666626
wu-haven-coef, 59, 42, 32, 1, 2, 136, 0.666626
wu-haven-coef, 57, 42, 31, 1, 2, 133, 0.666626
wu-haven-coef, 58, 42, 30, 1, 2, 133, 0.666626
wu-haven-coef, 59, 43, 31, 1, 2, 136, 0.666626
wu-haven-coef, 58, 42, 29, 1, 2, 132, 0.666626
wu-haven-coef, 63, 42, 30, 1, 2, 138, 0.666626
wu-haven-coef, 60, 42, 30, 1, 2, 135, 0.666626
wu-haven-coef, 62, 42, 31, 1, 2, 138, 0.666626
wu-haven-coef, 58, 43, 31, 1, 2, 135, 0.666626
wu-haven-coef, 60, 42, 29, 1, 2, 134, 0.666626
wu-haven-coef, 60, 42, 29, 1, 2, 134, 0.666626
wu-haven-coef, 59, 42, 30, 1, 2, 134, 0.666626
wu-haven-coef, 61, 42, 30, 1, 2, 136, 0.666626
wu-haven-coef, 56, 42, 29, 1, 2, 130, 0.666626
wu-haven-coef, 56, 42, 29, 1, 2, 130, 0.666626
wu-haven-coef, 58, 42, 31, 1, 2, 134, 0.666626
wu-haven-coef, 58, 42, 29, 1, 2, 132, 0.666626
wu-haven-coef, 63, 42, 29, 1, 2, 137, 0.666626
wu-haven-coef, 60, 42, 31, 1, 2, 136, 0.666626
wu-haven-coef, 59, 42, 30, 1, 2, 134, 0.666626
wu-haven-coef, 58, 42, 29, 1, 2, 132, 0.666626
wu-haven-coef, 56, 42, 29, 1, 2, 130, 0.666626
wu-haven-coef, 64, 42, 30, 1, 2, 139, 0.666626
wu-haven-coef, 68, 42, 29, 1, 2, 142, 0.666626
wu-haven-coef, 59, 42, 29, 1, 2, 133, 0.666626
wu-haven-coef, 57, 42, 30, 1, 2, 132, 0.666626
wu-haven-coef, 63, 42, 31, 1, 2, 139, 0.666626
wu-haven-coef, 58, 42, 30, 1, 2, 133, 0.666626
wu-haven-coef, 62, 42, 29, 1, 2, 136, 0.666626
wu-haven-coef, 58, 42, 30, 1, 2, 133, 0.666626
wu-haven-coef, 59, 42, 29, 1, 2, 133, 0.666626
wu-haven-coef, 60, 43, 32, 1, 2, 138, 0.666626
wu-haven-coef, 60, 46, 29, 1, 2, 138, 0.666626
wu-haven-coef, 60, 42, 29, 1, 2, 134, 0.666626
wu-haven-coef, 60, 42, 31, 1, 2, 136, 0.666626
wu-haven-coef, 58, 43, 30, 1, 2, 134, 0.666626
wu-haven-coef, 58, 43, 30, 1, 2, 134, 0.666626
wu-haven-coef, 59, 42, 31, 1, 2, 135, 0.666626
wu-haven-coef, 58, 42, 30, 1, 2, 133, 0.666626
wu-haven-coef, 59, 42, 29, 1, 2, 133, 0.666626
wu-haven-coef, 64, 42, 29, 1, 2, 138, 0.666626
wu-haven-coef, 59, 42, 29, 1, 2, 133, 0.666626
wu-haven-coef, 60, 42, 29, 1, 2, 134, 0.666626
wu-haven-coef, 57, 42, 29, 1, 2, 131, 0.666626
wu-haven-coef, 60, 42, 31, 1, 2, 136, 0.666626
wu-haven-coef, 59, 42, 30, 1, 2, 134, 0.666626
wu-haven-coef, 63, 42, 32, 1, 2, 140, 0.666626
wu-haven-coef, 61, 42, 29, 1, 2, 135, 0.666626
wu-haven-coef, 56, 42, 29, 1, 2, 130, 0.666626
wu-haven-coef, 60, 46, 30, 1, 2, 139, 0.666626
wu-haven-coef, 60, 42, 30, 1, 2, 135, 0.666626
wu-haven-coef, 58, 42, 30, 1, 2, 133, 0.666626
wu-haven-coef, 60, 42, 31, 1, 2, 136, 0.666626
wu-haven-coef, 59, 42, 30, 1, 2, 134, 0.666626
wu-haven-coef, 59, 43, 29, 1, 2, 134, 0.666626
wu-haven-coef, 62, 42, 30, 1, 2, 137, 0.666626
wu-haven-coef, 62, 42, 29, 1, 2, 136, 0.666626
wu-haven-coef, 60, 43, 30, 1, 2, 136, 0.666626
wu-haven-coef, 59, 42, 30, 1, 2, 134, 0.666626
wu-haven-coef, 59, 43, 30, 1, 2, 135, 0.666626
wu-haven-coef, 59, 42, 30, 1, 2, 134, 0.666626
wu-haven-coef, 59, 42, 31, 1, 2, 135, 0.666626
wu-haven-coef, 58, 42, 29, 1, 2, 132, 0.666626
wu-haven-coef, 56, 42, 29, 1, 2, 130, 0.666626
wu-haven-coef, 60, 42, 29, 1, 2, 134, 0.666626
wu-haven-coef, 56, 42, 30, 1, 2, 131, 0.666626
wu-haven-coef, 60, 42, 31, 1, 2, 136, 0.666626
wu-haven-coef, 58, 42, 29, 1, 2, 132, 0.666626
wu-haven-coef, 57, 42, 29, 1, 2, 131, 0.666626
wu-haven-coef, 60, 42, 30, 1, 2, 135, 0.666626
wu-haven-coef, 59, 42, 29, 1, 2, 133, 0.666626
wu-haven-coef, 57, 42, 30, 1, 2, 132, 0.666626
wu-haven-coef, 59, 42, 29, 1, 2, 133, 0.666626
wu-haven-coef, 60, 42, 30, 1, 2, 135, 0.666626
wu-haven-coef, 57, 43, 30, 1, 2, 133, 0.666626
wu-haven-coef, 56, 42, 30, 1, 2, 131, 0.666626
wu-haven-coef, 57, 42, 29, 1, 2, 131, 0.666626
wu-haven-coef, 58, 42, 32, 1, 2, 135, 0.666626
wu-haven-coef, 57, 42, 30, 1, 2, 132, 0.666626
wu-haven-coef, 60, 42, 29, 1, 2, 134, 0.666626
wu-haven-coef, 60, 43, 29, 1, 2, 135, 0.666626
wu-haven-coef, 59, 42, 29, 1, 2, 133, 0.666626
wu-haven-coef, 56, 42, 29, 1, 2, 130, 0.666626
wu-haven-coef, 59, 42, 31, 1, 2, 135, 0.666626
wu-haven-coef, 63, 42, 29, 1, 2, 137, 0.666626
wu-haven-coef, 57, 42, 29, 1, 2, 131, 0.666626
wu-haven-coef, 57, 42, 29, 1, 3, 132, 0.666626
wu-haven-coef, 60, 42, 32, 1, 2, 137, 0.666626
wu-haven-coef, 57, 42, 31, 1, 2, 133, 0.666626
wu-haven-coef, 58, 42, 29, 1, 2, 132, 0.666626
wu-haven-coef, 56, 42, 30, 1, 2, 131, 0.666626
wu-haven-coef, 58, 42, 30, 1, 2, 133, 0.666626
wu-haven-coef, 59, 42, 29, 1, 2, 133, 0.666626
wu-haven-coef, 56, 42, 29, 1, 2, 130, 0.666626
wu-haven-coef, 57, 43, 30, 1, 2, 133, 0.666626
wu-haven-coef, 56, 42, 29, 1, 2, 130, 0.666626
wu-haven-coef, 60, 42, 30, 1, 2, 135, 0.666626
wu-haven-coef, 59, 42, 29, 1, 2, 133, 0.666626
wu-haven-coef, 60, 42, 29, 1, 2, 134, 0.666626
wu-haven-coef, 58, 42, 30, 1, 2, 133, 0.666626
wu-haven-coef, 59, 43, 30, 1, 2, 135, 0.666626
wu-haven-coef, 58, 42, 30, 1, 2, 133, 0.666626
wu-haven-coef, 63, 43, 30, 1, 2, 139, 0.666626
wu-haven-coef, 60, 42, 30, 1, 2, 135, 0.666626
wu-haven-coef, 56, 42, 29, 1, 2, 130, 0.666626
wu-haven-coef, 57, 42, 30, 1, 2, 132, 0.666626
wu-haven-coef, 59, 42, 31, 1, 2, 135, 0.666626
wu-haven-coef, 56, 42, 30, 1, 2, 131, 0.666626
wu-haven-coef, 58, 42, 32, 1, 2, 135, 0.666626
wu-haven-coef, 60, 42, 29, 1, 2, 134, 0.666626
wu-haven-coef, 59, 43, 30, 1, 2, 135, 0.666626
wu-haven-coef, 58, 42, 30, 1, 2, 133, 0.666626
wu-haven-coef, 59, 42, 31, 1, 2, 135, 0.666626
wu-haven-coef, 60, 43, 30, 1, 2, 136, 0.666626
wu-haven-coef, 63, 42, 30, 1, 2, 138, 0.666626
wu-haven-coef, 59, 43, 30, 1, 2, 135, 0.666626
wu-haven-coef, 59, 42, 29, 1, 2, 133, 0.666626
wu-haven-coef, 60, 42, 29, 1, 2, 134, 0.666626
wu-haven-coef, 57, 42, 31, 1, 2, 133, 0.666626
wu-haven-coef, 59, 42, 29, 1, 2, 133, 0.666626
wu-haven-coef, 56, 42, 29, 1, 2, 130, 0.666626
wu-haven-coef, 64, 42, 29, 1, 2, 138, 0.666626
wu-haven-coef, 56, 42, 29, 1, 2, 130, 0.666626
wu-haven-coef, 60, 42, 31, 1, 2, 136, 0.666626
wu-haven-coef, 63, 42, 29, 1, 2, 137, 0.666626
wu-haven-coef, 57, 43, 30, 1, 2, 133, 0.666626
wu-haven-coef, 59, 42, 29, 1, 2, 133, 0.666626
wu-haven-coef, 57, 42, 29, 1, 2, 131, 0.666626
wu-haven-coef, 63, 42, 31, 1, 2, 139, 0.666626
wu-haven-coef, 59, 42, 29, 1, 2, 133, 0.666626
wu-haven-coef, 60, 42, 30, 1, 2, 135, 0.666626
wu-haven-coef, 59, 42, 29, 1, 2, 133, 0.666626
wu-haven-coef, 56, 42, 29, 1, 2, 130, 0.666626
wu-haven-coef, 57, 42, 29, 1, 2, 131, 0.666626
wu-haven-coef, 57, 42, 31, 1, 2, 133, 0.666626
wu-haven-coef, 58, 42, 30, 1, 2, 133, 0.666626
wu-haven-coef, 59, 42, 29, 1, 2, 133, 0.666626
wu-haven-coef, 59, 42, 30, 1, 2, 134, 0.666626
wu-haven-coef, 65, 42, 29, 1, 2, 139, 0.666626
wu-haven-coef, 62, 42, 31, 1, 2, 138, 0.666626
wu-haven-coef, 57, 42, 30, 1, 2, 132, 0.666626
wu-haven-coef, 60, 43, 30, 1, 2, 136, 0.666626
wu-haven-coef, 59, 42, 30, 1, 2, 134, 0.666626
wu-haven-coef, 59, 42, 29, 1, 2, 133, 0.666626
wu-haven-coef, 60, 42, 29, 1, 2, 134, 0.666626
wu-haven-coef, 59, 42, 29, 1, 2, 133, 0.666626
wu-haven-coef, 60, 42, 30, 1, 2, 135, 0.666626
wu-haven-coef, 58, 42, 30, 1, 2, 133, 0.666626
wu-haven-coef, 59, 46, 31, 1, 2, 139, 0.666626
wu-haven-coef, 58, 42, 30, 1, 2, 133, 0.666626
wu-haven-coef, 57, 42, 29, 1, 2, 131, 0.666626
wu-haven-coef, 56, 42, 29, 1, 2, 130, 0.666626
wu-haven-coef, 57, 42, 30, 1, 2, 132, 0.666626
wu-haven-coef, 56, 42, 29, 1, 2, 130, 0.666626
wu-haven-coef, 59, 42, 30, 1, 2, 134, 0.666626
wu-haven-coef, 57, 42, 29, 1, 2, 131, 0.666626
wu-haven-coef, 58, 42, 29, 1, 2, 132, 0.666626
wu-haven-coef, 64, 42, 30, 1, 2, 139, 0.666626
wu-haven-coef, 59, 43, 30, 1, 2, 135, 0.666626
wu-haven-coef, 58, 42, 30, 1, 2, 133, 0.666626
wu-haven-coef, 59, 43, 30, 1, 2, 135, 0.666626
wu-haven-coef, 58, 42, 30, 1, 2, 133, 0.666626
wu-haven-coef, 60, 42, 29, 1, 2, 134, 0.666626
wu-haven-coef, 59, 42, 30, 1, 2, 134, 0.666626
wu-haven-coef, 58, 42, 29, 1, 2, 132, 0.666626
wu-haven-coef, 56, 42, 30, 1, 2, 131, 0.666626
wu-haven-coef, 57, 42, 30, 1, 2, 132, 0.666626
wu-haven-coef, 60, 43, 30, 1, 2, 136, 0.666626
wu-haven-coef, 56, 42, 30, 1, 2, 131, 0.666626
wu-haven-coef, 56, 42, 30, 1, 2, 131, 0.666626
wu-haven-coef, 57, 42, 31, 1, 2, 133, 0.666626
wu-haven-coef, 58, 42, 31, 1, 2, 134, 0.666626
wu-haven-coef, 58, 42, 29, 1, 2, 132, 0.666626
wu-haven-coef, 59, 42, 30, 1, 2, 134, 0.666626
wu-haven-coef, 59, 42, 29, 1, 2, 133, 0.666626
wu-haven-coef, 60, 42, 30, 1, 2, 135, 0.666626
wu-haven-coef, 59, 42, 30, 1, 2, 134, 0.666626
wu-haven-coef, 56, 42, 30, 1, 2, 131, 0.666626
wu-haven-coef, 57, 46, 29, 1, 2, 135, 0.666626
wu-haven-coef, 60, 42, 31, 1, 2, 136, 0.666626
wu-haven-coef, 59, 42, 29, 1, 2, 133, 0.666626
wu-haven-coef, 60, 42, 32, 1, 2, 137, 0.666626
wu-haven-coef, 58, 43, 30, 1, 2, 134, 0.666626
wu-haven-coef, 58, 42, 32, 1, 2, 135, 0.666626
wu-haven-coef, 56, 43, 29, 1, 2, 131, 0.666626
wu-haven-coef, 60, 42, 29, 1, 2, 134, 0.666626
wu-haven-coef, 61, 42, 31, 1, 2, 137, 0.666626
wu-haven-coef, 56, 42, 29, 1, 2, 130, 0.666626
wu-haven-coef, 58, 42, 31, 1, 2, 134, 0.666626
wu-haven-coef, 62, 42, 30, 1, 2, 137, 0.666626
wu-haven-coef, 59, 42, 29, 1, 2, 133, 0.666626
wu-haven-coef, 60, 42, 29, 1, 2, 134, 0.666626
wu-haven-coef, 60, 42, 31, 1, 2, 136, 0.666626
wu-haven-coef, 57, 42, 29, 1, 2, 131, 0.666626
wu-haven-coef, 60, 42, 30, 1, 2, 135, 0.666626
wu-haven-coef, 56, 43, 29, 1, 2, 131, 0.666626
wu-haven-coef, 61, 43, 31, 1, 2, 138, 0.666626
wu-haven-coef, 58, 42, 29, 1, 2, 132, 0.666626
wu-haven-coef, 60, 42, 30, 1, 2, 135, 0.666626
wu-haven-coef, 59, 42, 30, 1, 2, 134, 0.666626
wu-haven-coef, 59, 43, 32, 1, 2, 137, 0.666626
wu-haven-coef, 57, 42, 29, 1, 2, 131, 0.666626
wu-haven-coef, 60, 42, 30, 1, 2, 135, 0.666626
wu-haven-coef, 59, 42, 29, 1, 2, 133, 0.666626
wu-haven-coef, 59, 42, 30, 1, 2, 134, 0.666626
wu-haven-coef, 59, 42, 30, 1, 2, 134, 0.666626
wu-haven-coef, 65, 43, 32, 1, 2, 143, 0.666626
wu-haven-coef, 57, 42, 29, 1, 2, 131, 0.666626
wu-haven-coef, 56, 42, 30, 1, 2, 131, 0.666626
wu-haven-coef, 61, 43, 30, 1, 2, 137, 0.666626
wu-haven-coef, 59, 42, 29, 1, 2, 133, 0.666626
wu-haven-coef, 59, 43, 29, 1, 2, 134, 0.666626
wu-haven-coef, 59, 44, 31, 1, 2, 137, 0.666626
wu-haven-coef, 57, 43, 30, 1, 2, 133, 0.666626
wu-haven-coef, 59, 42, 29, 1, 2, 133, 0.666626
wu-haven-coef, 68, 43, 30, 1, 2, 144, 0.666626
wu-haven-coef, 60, 43, 30, 1, 2, 136, 0.666626
wu-haven-coef, 58, 43, 30, 1, 2, 134, 0.666626
wu-haven-coef, 58, 42, 30, 1, 2, 133, 0.666626
wu-haven-coef, 59, 42, 30, 1, 2, 134, 0.666626
wu-haven-coef, 63, 42, 30, 1, 2, 138, 0.666626
wu-haven-coef, 59, 43, 30, 1, 2, 135, 0.666626
wu-haven-coef, 59, 42, 29, 1, 2, 133, 0.666626
wu-haven-coef, 60, 42, 29, 1, 2, 134, 0.666626
wu-haven-coef, 61, 43, 30, 1, 2, 137, 0.666626
wu-haven-coef, 57, 42, 30, 1, 2, 132, 0.666626
wu-haven-coef, 57, 42, 30, 1, 2, 132, 0.666626
wu-haven-coef, 62, 42, 29, 1, 2, 136, 0.666626
wu-haven-coef, 60, 42, 30, 1, 2, 135, 0.666626
wu-haven-coef, 56, 42, 30, 1, 2, 131, 0.666626
wu-haven-coef, 58, 42, 30, 1, 2, 133, 0.666626
wu-haven-coef, 56, 42, 30, 1, 2, 131, 0.666626
wu-haven-coef, 66, 42, 31, 1, 2, 142, 0.666626
wu-haven-coef, 58, 46, 30, 1, 2, 137, 0.666626
wu-haven-coef, 59, 42, 31, 1, 2, 135, 0.666626
wu-haven-coef, 58, 42, 30, 1, 2, 133, 0.666626
wu-haven-coef, 59, 43, 29, 1, 2, 134, 0.666626
wu-haven-coef, 59, 43, 30, 1, 2, 135, 0.666626
wu-haven-coef, 62, 43, 29, 1, 2, 137, 0.666626
wu-haven-coef, 63, 42, 29, 1, 2, 137, 0.666626
wu-haven-coef, 60, 42, 30, 1, 2, 135, 0.666626
wu-haven-coef, 59, 43, 30, 1, 2, 135, 0.666626
wu-haven-coef, 61, 43, 31, 1, 2, 138, 0.666626
wu-haven-coef, 57, 42, 29, 1, 2, 131, 0.666626
wu-haven-coef, 57, 42, 30, 1, 2, 132, 0.666626
wu-haven-coef, 59, 43, 30, 1, 2, 135, 0.666626
wu-haven-coef, 58, 42, 31, 1, 2, 134, 0.666626
wu-haven-coef, 63, 43, 30, 1, 2, 139, 0.666626
wu-haven-coef, 59, 43, 29, 1, 2, 134, 0.666626
wu-haven-coef, 62, 42, 29, 1, 2, 136, 0.666626
wu-haven-coef, 56, 42, 30, 1, 2, 131, 0.666626
wu-haven-coef, 59, 42, 29, 1, 2, 133, 0.666626
wu-haven-coef, 57, 42, 30, 1, 2, 132, 0.666626
wu-haven-coef, 59, 42, 29, 1, 2, 133, 0.666626
wu-haven-coef, 60, 42, 29, 1, 2, 134, 0.666626
wu-haven-coef, 60, 42, 30, 1, 2, 135, 0.666626
wu-haven-coef, 59, 42, 30, 1, 2, 134, 0.666626
wu-haven-coef, 59, 42, 29, 1, 2, 133, 0.666626
wu-haven-coef, 60, 42, 30, 1, 2, 135, 0.666626
wu-haven-coef, 60, 42, 31, 1, 2, 136, 0.666626
wu-haven-coef, 58, 42, 29, 1, 2, 132, 0.666626
wu-haven-coef, 59, 42, 30, 1, 2, 134, 0.666626
wu-haven-coef, 58, 42, 29, 1, 2, 132, 0.666626
wu-haven-coef, 60, 43, 29, 1, 2, 135, 0.666626
wu-haven-coef, 58, 42, 30, 1, 2, 133, 0.666626
wu-haven-coef, 56, 43, 29, 1, 2, 131, 0.666626
wu-haven-coef, 62, 42, 31, 1, 2, 138, 0.666626
wu-haven-coef, 58, 42, 30, 1, 2, 133, 0.666626
wu-haven-coef, 59, 43, 30, 1, 2, 135, 0.666626
wu-haven-coef, 59, 42, 32, 1, 2, 136, 0.666626
wu-haven-coef, 57, 42, 32, 1, 2, 134, 0.666626
wu-haven-coef, 56, 42, 30, 1, 2, 131, 0.666626
wu-haven-coef, 57, 44, 31, 1, 2, 135, 0.666626
wu-haven-coef, 60, 42, 29, 1, 2, 134, 0.666626
wu-haven-coef, 61, 43, 30, 1, 2, 137, 0.666626
wu-haven-coef, 59, 42, 30, 1, 2, 134, 0.666626
wu-haven-coef, 58, 42, 30, 1, 2, 133, 0.666626
wu-haven-coef, 58, 42, 29, 1, 2, 132, 0.666626
wu-haven-coef, 60, 42, 30, 1, 2, 135, 0.666626
wu-haven-coef, 59, 42, 31, 1, 2, 135, 0.666626
wu-haven-coef, 58, 47, 30, 1, 2, 138, 0.666626
wu-haven-coef, 59, 43, 31, 1, 2, 136, 0.666626
wu-haven-coef, 59, 42, 29, 1, 2, 133, 0.666626
wu-haven-coef, 58, 42, 30, 1, 2, 133, 0.666626
wu-haven-coef, 64, 43, 30, 1, 2, 140, 0.666626
wu-haven-coef, 59, 42, 29, 1, 2, 133, 0.666626
wu-haven-coef, 60, 43, 31, 1, 2, 137, 0.666626
wu-haven-coef, 58, 42, 30, 1, 2, 133, 0.666626
wu-haven-coef, 60, 43, 31, 1, 2, 137, 0.666626
wu-haven-coef, 64, 43, 32, 1, 2, 142, 0.666626
wu-haven-coef, 60, 43, 29, 1, 2, 135, 0.666626
wu-haven-coef, 57, 42, 30, 1, 2, 132, 0.666626
wu-haven-coef, 62, 42, 30, 1, 2, 137, 0.666626
wu-haven-coef, 60, 42, 29, 1, 2, 134, 0.666626
wu-haven-coef, 56, 42, 29, 1, 2, 130, 0.666626
wu-haven-coef, 59, 42, 29, 1, 2, 133, 0.666626
wu-haven-coef, 57, 45, 30, 1, 2, 135, 0.666626
wu-haven-coef, 59, 43, 29, 1, 2, 134, 0.666626
wu-haven-coef, 56, 42, 30, 1, 2, 131, 0.666626
wu-haven-coef, 59, 42, 30, 1, 2, 134, 0.666626
wu-haven-coef, 58, 43, 29, 1, 2, 133, 0.666626
wu-haven-coef, 59, 42, 29, 1, 2, 133, 0.666626
wu-haven-coef, 57, 43, 30, 1, 2, 133, 0.666626
wu-haven-coef, 60, 42, 29, 1, 2, 134, 0.666626
wu-haven-coef, 60, 42, 31, 1, 2, 136, 0.666626
wu-haven-coef, 59, 46, 30, 1, 2, 138, 0.666626
wu-haven-coef, 59, 42, 30, 1, 2, 134, 0.666626
wu-haven-coef, 59, 42, 30, 1, 2, 134, 0.666626
wu-haven-coef, 63, 42, 31, 1, 2, 139, 0.666626
wu-haven-coef, 63, 43, 32, 1, 2, 141, 0.666626
wu-haven-coef, 57, 42, 29, 1, 2, 131, 0.666626
wu-haven-coef, 57, 42, 29, 1, 2, 131, 0.666626
wu-haven-coef, 60, 42, 31, 1, 2, 136, 0.666626
wu-haven-coef, 58, 42, 29, 1, 2, 132, 0.666626
wu-haven-coef, 61, 42, 31, 1, 2, 137, 0.666626
wu-haven-coef, 58, 42, 31, 1, 2, 134, 0.666626
wu-haven-coef, 59, 44, 29, 1, 2, 135, 0.666626
wu-haven-coef, 59, 42, 32, 1, 2, 136, 0.666626
wu-haven-coef, 56, 42, 29, 1, 2, 130, 0.666626
wu-haven-coef, 59, 42, 29, 1, 2, 133, 0.666626
wu-haven-coef, 60, 42, 29, 1, 2, 134, 0.666626
wu-haven-coef, 60, 43, 29, 1, 2, 135, 0.666626
wu-haven-coef, 56, 42, 30, 1, 2, 131, 0.666626
wu-haven-coef, 58, 42, 29, 1, 2, 132, 0.666626
wu-haven-coef, 59, 42, 30, 1, 2, 134, 0.666626
wu-haven-coef, 59, 42, 31, 1, 2, 135, 0.666626
wu-haven-coef, 58, 42, 31, 1, 2, 134, 0.666626
wu-haven-coef, 59, 42, 30, 1, 2, 134, 0.666626
wu-haven-coef, 59, 42, 31, 1, 2, 135, 0.666626
wu-haven-coef, 56, 42, 30, 1, 2, 131, 0.666626
wu-haven-coef, 60, 43, 29, 1, 2, 135, 0.666626
wu-haven-coef, 59, 42, 30, 1, 2, 134, 0.666626
wu-haven-coef, 59, 42, 30, 1, 2, 134, 0.666626
wu-haven-coef, 56, 42, 30, 1, 2, 131, 0.666626
wu-haven-coef, 59, 42, 30, 1, 2, 134, 0.666626
wu-haven-coef, 58, 42, 30, 1, 2, 133, 0.666626
wu-haven-coef, 60, 42, 31, 1, 2, 136, 0.666626
wu-haven-coef, 64, 42, 30, 1, 2, 139, 0.666626
wu-haven-coef, 57, 42, 29, 1, 2, 131, 0.666626
wu-haven-coef, 60, 42, 29, 1, 2, 134, 0.666626
wu-haven-coef, 64, 42, 29, 1, 2, 138, 0.666626
wu-haven-coef, 57, 42, 31, 1, 2, 133, 0.666626
wu-haven-coef, 62, 42, 30, 1, 2, 137, 0.666626
wu-haven-coef, 59, 42, 29, 1, 2, 133, 0.666626
wu-haven-coef, 60, 43, 29, 1, 2, 135, 0.666626
wu-haven-coef, 59, 42, 29, 1, 2, 133, 0.666626
wu-haven-coef, 62, 42, 29, 1, 2, 136, 0.666626
wu-haven-coef, 60, 42, 29, 1, 2, 134, 0.666626
wu-haven-coef, 60, 42, 29, 1, 2, 134, 0.666626
wu-haven-coef, 56, 42, 29, 1, 2, 130, 0.666626
wu-haven-coef, 57, 41, 29, 1, 2, 130, 0.666626
wu-haven-coef, 57, 43, 30, 1, 2, 133, 0.666626
wu-haven-coef, 59, 43, 30, 1, 2, 135, 0.666626
wu-haven-coef, 59, 42, 29, 1, 2, 133, 0.666626
wu-haven-coef, 63, 42, 31, 1, 2, 139, 0.666626
wu-haven-coef, 56, 42, 30, 1, 2, 131, 0.666626
wu-haven-coef, 62, 42, 31, 1, 2, 138, 0.666626
wu-haven-coef, 58, 42, 29, 1, 2, 132, 0.666626
wu-haven-coef, 60, 43, 30, 1, 2, 136, 0.666626
wu-haven-coef, 62, 42, 31, 1, 2, 138, 0.666626
wu-haven-coef, 62, 42, 29, 1, 2, 136, 0.666626
wu-haven-coef, 56, 42, 31, 1, 2, 132, 0.666626
wu-haven-coef, 57, 42, 29, 1, 2, 131, 0.666626
wu-haven-coef, 62, 42, 31, 1, 2, 138, 0.666626
wu-haven-coef, 58, 42, 29, 1, 2, 132, 0.666626
wu-haven-coef, 60, 42, 30, 1, 2, 135, 0.666626
wu-haven-coef, 59, 43, 30, 1, 2, 135, 0.666626
wu-haven-coef, 56, 42, 29, 1, 2, 130, 0.666626
wu-haven-coef, 57, 42, 30, 1, 2, 132, 0.666626
wu-haven-coef, 57, 42, 30, 1, 2, 132, 0.666626
wu-haven-coef, 58, 43, 32, 1, 2, 136, 0.666626
wu-haven-coef, 60, 42, 30, 1, 2, 135, 0.666626
wu-haven-coef, 57, 42, 29, 1, 2, 131, 0.666626
wu-haven-coef, 57, 42, 29, 1, 2, 131, 0.666626
wu-haven-coef, 56, 42, 29, 1, 2, 130, 0.666626
wu-haven-coef, 56, 42, 31, 1, 2, 132, 0.666626
wu-haven-coef, 58, 42, 30, 1, 2, 133, 0.666626
wu-haven-coef, 59, 42, 30, 1, 2, 134, 0.666626
wu-haven-coef, 59, 43, 30, 1, 2, 135, 0.666626
wu-haven-coef, 58, 43, 30, 1, 2, 134, 0.666626
wu-haven-coef, 58, 42, 29, 1, 2, 132, 0.666626
wu-haven-coef, 56, 42, 29, 1, 2, 130, 0.666626
wu-haven-coef, 56, 42, 29, 1, 2, 130, 0.666626
wu-haven-coef, 60, 42, 29, 1, 2, 134, 0.666626
wu-haven-coef, 64, 42, 29, 1, 2, 138, 0.666626
wu-haven-coef, 56, 42, 30, 1, 2, 131, 0.666626
wu-haven-coef, 60, 42, 29, 1, 2, 134, 0.666626
wu-haven-coef, 64, 42, 31, 1, 2, 140, 0.666626
wu-haven-coef, 58, 42, 29, 1, 2, 132, 0.666626
wu-haven-coef, 60, 43, 30, 1, 2, 136, 0.666626
wu-haven-coef, 59, 42, 31, 1, 2, 135, 0.666626
wu-haven-coef, 57, 42, 30, 1, 2, 132, 0.666626
wu-haven-coef, 63, 42, 29, 1, 2, 137, 0.666626
wu-haven-coef, 60, 42, 29, 1, 2, 134, 0.666626
wu-haven-coef, 60, 42, 29, 1, 2, 134, 0.666626
wu-haven-coef, 56, 42, 29, 1, 2, 130, 0.666626
wu-haven-coef, 59, 42, 30, 1, 2, 134, 0.666626
wu-haven-coef, 60, 42, 30, 1, 2, 135, 0.666626
wu-haven-coef, 59, 42, 31, 1, 2, 135, 0.666626
wu-haven-coef, 58, 42, 29, 1, 2, 132, 0.666626
wu-haven-coef, 60, 43, 31, 1, 2, 137, 0.666626
wu-haven-coef, 57, 42, 30, 1, 2, 132, 0.666626
wu-haven-coef, 59, 42, 32, 1, 2, 136, 0.666626
wu-haven-coef, 66, 43, 30, 1, 2, 142, 0.666626
wu-haven-coef, 58, 42, 30, 1, 2, 133, 0.666626
wu-haven-coef, 68, 42, 31, 1, 2, 144, 0.666626
wu-haven-coef, 57, 43, 30, 1, 2, 133, 0.666626
wu-haven-coef, 59, 42, 30, 1, 2, 134, 0.666626
wu-haven-coef, 63, 42, 30, 1, 2, 138, 0.666626
wu-haven-coef, 62, 42, 31, 1, 2, 138, 0.666626
wu-haven-coef, 58, 42, 30, 1, 2, 133, 0.666626
wu-haven-coef, 63, 43, 30, 1, 2, 139, 0.666626
wu-haven-coef, 59, 42, 30, 1, 2, 134, 0.666626
wu-haven-coef, 59, 42, 30, 1, 2, 134, 0.666626
wu-haven-coef, 59, 42, 29, 1, 2, 133, 0.666626
wu-haven-coef, 60, 42, 29, 1, 2, 134, 0.666626
wu-haven-coef, 63, 42, 30, 1, 2, 138, 0.666626
wu-haven-coef, 59, 42, 29, 1, 2, 133, 0.666626
wu-haven-coef, 60, 42, 29, 1, 2, 134, 0.666626
wu-haven-coef, 59, 42, 29, 1, 2, 133, 0.666626
wu-haven-coef, 60, 43, 30, 1, 2, 136, 0.666626
wu-haven-coef, 63, 42, 29, 1, 2, 137, 0.666626
wu-haven-coef, 59, 42, 30, 1, 2, 134, 0.666626
wu-haven-coef, 57, 42, 29, 1, 2, 131, 0.666626
wu-haven-coef, 64, 42, 29, 1, 2, 138, 0.666626
wu-haven-coef, 57, 42, 30, 1, 2, 132, 0.666626
wu-haven-coef, 58, 42, 29, 1, 2, 132, 0.666626
wu-haven-coef, 60, 42, 31, 1, 2, 136, 0.666626
wu-haven-coef, 62, 42, 29, 1, 2, 136, 0.666626
wu-haven-coef, 60, 43, 31, 1, 2, 137, 0.666626
wu-haven-coef, 57, 42, 29, 1, 2, 131, 0.666626
wu-haven-coef, 60, 42, 30, 1, 2, 135, 0.666626
wu-haven-coef, 60, 42, 29, 1, 2, 134, 0.666626
wu-haven-coef, 56, 42, 29, 1, 2, 130, 0.666626
wu-haven-coef, 58, 42, 29, 1, 2, 132, 0.666626
wu-haven-coef, 59, 42, 30, 1, 2, 134, 0.666626
wu-haven-coef, 59, 42, 30, 1, 2, 134, 0.666626
wu-haven-coef, 59, 42, 30, 1, 2, 134, 0.666626
wu-haven-coef, 59, 42, 29, 1, 2, 133, 0.666626
wu-haven-coef, 60, 42, 29, 1, 2, 134, 0.666626
wu-haven-coef, 58, 42, 29, 1, 2, 132, 0.666626
wu-haven-coef, 63, 43, 30, 1, 2, 139, 0.666626
wu-haven-coef, 59, 43, 30, 1, 2, 135, 0.666626
wu-haven-coef, 59, 42, 29, 1, 2, 133, 0.666626
wu-haven-coef, 60, 42, 29, 1, 2, 134, 0.666626
wu-haven-coef, 57, 42, 30, 1, 2, 132, 0.666626
wu-haven-coef, 59, 43, 30, 1, 2, 135, 0.666626
wu-haven-coef, 60, 42, 31, 1, 2, 136, 0.666626
wu-haven-coef, 61, 45, 30, 1, 2, 139, 0.666626
wu-haven-coef, 60, 43, 30, 1, 2, 136, 0.666626
wu-haven-coef, 62, 42, 29, 1, 2, 136, 0.666626
wu-haven-coef, 61, 42, 29, 1, 2, 135, 0.666626
wu-haven-coef, 56, 42, 30, 1, 2, 131, 0.666626
wu-haven-coef, 60, 43, 30, 1, 2, 136, 0.666626
wu-haven-coef, 61, 43, 31, 1, 2, 138, 0.666626
wu-haven-coef, 58, 43, 30, 1, 2, 134, 0.666626
wu-haven-coef, 58, 46, 29, 1, 2, 136, 0.666626
wu-haven-coef, 59, 43, 29, 1, 2, 134, 0.666626
wu-haven-coef, 60, 43, 30, 1, 2, 136, 0.666626
wu-haven-coef, 57, 42, 30, 1, 2, 132, 0.666626
wu-haven-coef, 60, 43, 31, 1, 2, 137, 0.666626
wu-haven-coef, 62, 43, 30, 1, 2, 138, 0.666626
wu-haven-coef, 59, 43, 30, 1, 2, 135, 0.666626
wu-haven-coef, 57, 43, 31, 1, 2, 134, 0.666626
wu-haven-coef, 57, 42, 29, 1, 2, 131, 0.666626
wu-haven-coef, 63, 42, 29, 1, 2, 137, 0.666626
wu-haven-coef, 56, 42, 30, 1, 2, 131, 0.666626
wu-haven-coef, 64, 57, 29, 1, 2, 153, 0.666626
wu-haven-coef, 57, 42, 31, 1, 2, 133, 0.666626
wu-haven-coef, 58, 42, 30, 1, 2, 133, 0.666626
wu-haven-coef, 60, 43, 30, 1, 2, 136, 0.666626
wu-haven-coef, 58, 42, 31, 1, 2, 134, 0.666626
wu-haven-coef, 59, 43, 30, 1, 2, 135, 0.666626
wu-haven-coef, 56, 42, 30, 1, 2, 131, 0.666626
wu-haven-coef, 62, 42, 30, 1, 2, 137, 0.666626
wu-haven-coef, 58, 42, 29, 1, 2, 132, 0.666626
wu-haven-coef, 64, 42, 30, 1, 2, 139, 0.666626
wu-haven-coef, 62, 42, 31, 1, 2, 138, 0.666626
wu-haven-coef, 59, 42, 29, 1, 2, 133, 0.666626
wu-haven-coef, 60, 42, 31, 1, 2, 136, 0.666626
wu-haven-coef, 56, 42, 30, 1, 2, 131, 0.666626
wu-haven-coef, 57, 42, 29, 1, 2, 131, 0.666626
wu-haven-coef, 56, 42, 29, 1, 2, 130, 0.666626
wu-haven-coef, 57, 42, 29, 1, 2, 131, 0.666626
wu-haven-coef, 59, 42, 29, 1, 2, 133, 0.666626
wu-haven-coef, 64, 42, 30, 1, 2, 139, 0.666626
wu-haven-coef, 59, 42, 30, 1, 2, 134, 0.666626
wu-haven-coef, 56, 46, 30, 1, 2, 135, 0.666626
wu-haven-coef, 59, 42, 29, 1, 2, 133, 0.666626
wu-haven-coef, 63, 42, 31, 1, 2, 139, 0.666626
wu-haven-coef, 62, 42, 31, 1, 2, 138, 0.666626
wu-haven-coef, 62, 43, 31, 1, 2, 139, 0.666626
wu-haven-coef, 57, 42, 30, 1, 2, 132, 0.666626
wu-haven-coef, 59, 42, 29, 1, 2, 133, 0.666626
wu-haven-coef, 57, 42, 31, 1, 2, 133, 0.666626
wu-haven-coef, 62, 42, 29, 1, 2, 136, 0.666626
wu-haven-coef, 59, 43, 31, 1, 2, 136, 0.666626
wu-haven-coef, 57, 45, 30, 1, 2, 135, 0.666626
wu-haven-coef, 61, 43, 29, 1, 2, 136, 0.666626
wu-haven-coef, 62, 43, 30, 1, 2, 138, 0.666626
wu-haven-coef, 57, 42, 30, 1, 2, 132, 0.666626
wu-haven-coef, 56, 42, 30, 1, 2, 131, 0.666626
wu-haven-coef, 57, 42, 29, 1, 2, 131, 0.666626
wu-haven-coef, 60, 42, 31, 1, 2, 136, 0.666626
wu-haven-coef, 59, 42, 30, 1, 2, 134, 0.666626
wu-haven-coef, 59, 42, 30, 1, 2, 134, 0.666626
wu-haven-coef, 59, 42, 32, 1, 2, 136, 0.666626
wu-haven-coef, 57, 42, 30, 1, 2, 132, 0.666626
wu-haven-coef, 59, 42, 29, 1, 2, 133, 0.666626
wu-haven-coef, 60, 42, 29, 1, 2, 134, 0.666626
wu-haven-coef, 58, 42, 30, 1, 2, 133, 0.666626
wu-haven-coef, 59, 42, 30, 1, 2, 134, 0.666626
wu-haven-coef, 59, 42, 29, 1, 2, 133, 0.666626
wu-haven-coef, 60, 42, 29, 1, 2, 134, 0.666626
wu-haven-coef, 60, 42, 30, 1, 2, 135, 0.666626
wu-haven-coef, 60, 42, 30, 1, 2, 135, 0.666626
wu-haven-coef, 62, 47, 30, 1, 2, 142, 0.666626
wu-haven-coef, 59, 42, 30, 1, 2, 134, 0.666626
wu-haven-coef, 59, 42, 30, 1, 2, 134, 0.666626
wu-haven-coef, 59, 42, 30, 1, 2, 134, 0.666626
wu-haven-coef, 59, 42, 30, 1, 2, 134, 0.666626
wu-haven-coef, 56, 42, 29, 1, 2, 130, 0.666626
wu-haven-coef, 60, 42, 29, 1, 2, 134, 0.666626
wu-haven-coef, 56, 42, 29, 1, 2, 130, 0.666626
wu-haven-coef, 57, 43, 30, 1, 2, 133, 0.666626
wu-haven-coef, 58, 43, 31, 1, 2, 135, 0.666626
wu-haven-coef, 57, 42, 32, 1, 2, 134, 0.666626
wu-haven-coef, 57, 42, 31, 1, 2, 133, 0.666626
wu-haven-coef, 58, 42, 29, 1, 2, 132, 0.666626
wu-haven-coef, 56, 42, 30, 1, 2, 131, 0.666626
wu-haven-coef, 56, 42, 30, 1, 2, 131, 0.666626
wu-haven-coef, 57, 43, 29, 1, 2, 132, 0.666626
wu-haven-coef, 59, 42, 30, 1, 2, 134, 0.666626
wu-haven-coef, 57, 42, 29, 1, 2, 131, 0.666626
wu-haven-coef, 58, 42, 29, 1, 2, 132, 0.666626
wu-haven-coef, 56, 42, 29, 1, 2, 130, 0.666626
wu-haven-coef, 58, 42, 30, 1, 2, 133, 0.666626
wu-haven-coef, 58, 42, 31, 1, 2, 134, 0.666626
wu-haven-coef, 58, 42, 30, 1, 2, 133, 0.666626
wu-haven-coef, 59, 42, 30, 1, 2, 134, 0.666626
wu-haven-coef, 63, 43, 30, 1, 2, 139, 0.666626
wu-haven-coef, 59, 43, 31, 1, 2, 136, 0.666626
wu-haven-coef, 58, 43, 29, 1, 2, 133, 0.666626
wu-haven-coef, 63, 42, 31, 1, 2, 139, 0.666626
wu-haven-coef, 61, 42, 31, 1, 2, 137, 0.666626
wu-haven-coef, 66, 42, 30, 1, 2, 141, 0.666626
wu-haven-coef, 63, 42, 31, 1, 2, 139, 0.666626
wu-haven-coef, 63, 43, 30, 1, 2, 139, 0.666626
wu-haven-coef, 58, 42, 30, 1, 2, 133, 0.666626
wu-haven-coef, 59, 42, 31, 1, 2, 135, 0.666626
wu-haven-coef, 58, 42, 29, 1, 2, 132, 0.666626
wu-haven-coef, 60, 42, 31, 1, 2, 136, 0.666626
wu-haven-coef, 64, 42, 30, 1, 2, 139, 0.666626
wu-haven-coef, 58, 42, 30, 1, 2, 133, 0.666626
wu-haven-coef, 57, 42, 29, 1, 2, 131, 0.666626
wu-haven-coef, 59, 42, 29, 1, 2, 133, 0.666626
wu-haven-coef, 61, 42, 29, 1, 2, 135, 0.666626
wu-haven-coef, 60, 42, 29, 1, 2, 134, 0.666626
wu-haven-coef, 60, 42, 30, 1, 2, 135, 0.666626
wu-haven-coef, 59, 42, 29, 1, 2, 133, 0.666626
wu-haven-coef, 57, 42, 29, 1, 2, 131, 0.666626
wu-haven-coef, 63, 42, 31, 1, 2, 139, 0.666626
wu-haven-coef, 56, 42, 29, 1, 2, 130, 0.666626
wu-haven-coef, 56, 42, 29, 1, 2, 130, 0.666626
wu-haven-coef, 56, 42, 29, 1, 2, 130, 0.666626
wu-haven-coef, 60, 42, 31, 1, 2, 136, 0.666626
wu-haven-coef, 58, 42, 29, 1, 2, 132, 0.666626
wu-haven-coef, 60, 42, 30, 1, 2, 135, 0.666626
wu-haven-coef, 56, 42, 29, 1, 2, 130, 0.666626
wu-haven-coef, 60, 42, 29, 1, 2, 134, 0.666626
wu-haven-coef, 63, 42, 31, 1, 2, 139, 0.666626
wu-haven-coef, 58, 42, 31, 1, 2, 134, 0.666626
wu-haven-coef, 58, 42, 30, 1, 2, 133, 0.666626
wu-haven-coef, 60, 42, 29, 1, 2, 134, 0.666626
wu-haven-coef, 60, 42, 30, 1, 2, 135, 0.666626
wu-haven-coef, 59, 42, 29, 1, 2, 133, 0.666626
wu-haven-coef, 63, 43, 30, 1, 2, 139, 0.666626
wu-haven-coef, 58, 42, 30, 1, 2, 133, 0.666626
wu-haven-coef, 60, 42, 30, 1, 2, 135, 0.666626
wu-haven-coef, 59, 42, 30, 1, 2, 134, 0.666626
wu-haven-coef, 60, 42, 29, 1, 2, 134, 0.666626
wu-haven-coef, 60, 42, 30, 1, 2, 135, 0.666626
wu-haven-coef, 59, 42, 29, 1, 2, 133, 0.666626
wu-haven-coef, 61, 43, 30, 1, 2, 137, 0.666626
wu-haven-coef, 57, 42, 30, 1, 2, 132, 0.666626
wu-haven-coef, 59, 42, 30, 1, 2, 134, 0.666626
wu-haven-coef, 56, 42, 30, 1, 2, 131, 0.666626
wu-haven-coef, 58, 43, 30, 1, 2, 134, 0.666626
wu-haven-coef, 64, 42, 33, 1, 2, 142, 0.666626
wu-haven-coef, 62, 43, 30, 1, 2, 138, 0.666626
wu-haven-coef, 59, 42, 30, 1, 2, 134, 0.666626
wu-haven-coef, 59, 42, 29, 1, 2, 133, 0.666626
wu-haven-coef, 64, 42, 30, 1, 2, 139, 0.666626
wu-haven-coef, 60, 42, 32, 1, 2, 137, 0.666626
wu-haven-coef, 57, 42, 30, 1, 2, 132, 0.666626
wu-haven-coef, 56, 42, 30, 1, 2, 131, 0.666626
wu-haven-coef, 58, 42, 29, 1, 2, 132, 0.666626
wu-haven-coef, 60, 42, 29, 1, 2, 134, 0.666626
wu-haven-coef, 56, 42, 30, 1, 2, 131, 0.666626
wu-haven-coef, 59, 42, 29, 1, 2, 133, 0.666626
wu-haven-coef, 56, 42, 30, 1, 2, 131, 0.666626
wu-haven-coef, 58, 42, 29, 1, 2, 132, 0.666626
wu-haven-coef, 60, 42, 31, 1, 2, 136, 0.666626
wu-haven-coef, 62, 42, 31, 1, 2, 138, 0.666626
wu-haven-coef, 56, 42, 30, 1, 2, 131, 0.666626
wu-haven-coef, 62, 42, 30, 1, 2, 137, 0.666626
wu-haven-coef, 59, 42, 30, 1, 2, 134, 0.666626
wu-haven-coef, 61, 42, 30, 1, 2, 136, 0.666626
wu-haven-coef, 58, 42, 29, 1, 2, 132, 0.666626
wu-haven-coef, 60, 42, 30, 1, 2, 135, 0.666626
wu-haven-coef, 59, 42, 30, 1, 2, 134, 0.666626
wu-haven-coef, 64, 43, 32, 1, 2, 142, 0.666626
wu-haven-coef, 60, 43, 31, 1, 2, 137, 0.666626
wu-haven-coef, 57, 42, 30, 1, 2, 132, 0.666626
wu-haven-coef, 60, 42, 32, 1, 2, 137, 0.666626
wu-haven-coef, 60, 43, 30, 1, 2, 136, 0.666626
wu-haven-coef, 58, 42, 29, 1, 2, 132, 0.666626
wu-haven-coef, 60, 42, 29, 1, 2, 134, 0.666626
wu-haven-coef, 57, 42, 29, 1, 2, 131, 0.666626
wu-haven-coef, 60, 43, 30, 1, 2, 136, 0.666626
wu-haven-coef, 63, 42, 31, 1, 2, 139, 0.666626
wu-haven-coef, 58, 42, 31, 1, 2, 134, 0.666626
wu-haven-coef, 58, 43, 30, 1, 2, 134, 0.666626
wu-haven-coef, 59, 42, 30, 1, 2, 134, 0.666626
wu-haven-coef, 63, 42, 29, 1, 2, 137, 0.666626
wu-haven-coef, 60, 44, 30, 1, 2, 137, 0.666626
wu-haven-coef, 58, 42, 30, 1, 2, 133, 0.666626
wu-haven-coef, 59, 42, 30, 1, 2, 134, 0.666626
wu-haven-coef, 60, 43, 30, 1, 2, 136, 0.666626
wu-haven-coef, 58, 42, 29, 1, 2, 132, 0.666626
wu-haven-coef, 56, 42, 29, 1, 2, 130, 0.666626
wu-haven-coef, 59, 43, 30, 1, 2, 135, 0.666626
wu-haven-coef, 59, 42, 29, 1, 2, 133, 0.666626
wu-haven-coef, 60, 43, 29, 1, 2, 135, 0.666626
wu-haven-coef, 59, 42, 31, 1, 2, 135, 0.666626
wu-haven-coef, 63, 42, 30, 1, 2, 138, 0.666626
wu-haven-coef, 57, 42, 30, 1, 2, 132, 0.666626
wu-haven-coef, 59, 42, 31, 1, 2, 135, 0.666626
wu-haven-coef, 58, 42, 29, 1, 2, 132, 0.666626
wu-haven-coef, 60, 42, 29, 1, 2, 134, 0.666626
wu-haven-coef, 57, 42, 29, 1, 2, 131, 0.666626
wu-haven-coef, 59, 42, 29, 1, 2, 133, 0.666626
wu-haven-coef, 61, 42, 30, 1, 2, 136, 0.666626
wu-haven-coef, 58, 42, 30, 1, 2, 133, 0.666626
wu-haven-coef, 65, 42, 30, 1, 2, 140, 0.666626
wu-haven-coef, 58, 42, 30, 1, 2, 133, 0.666626
wu-haven-coef, 60, 42, 29, 1, 2, 134, 0.666626
wu-haven-coef, 59, 42, 30, 1, 2, 134, 0.666626
wu-haven-coef, 64, 42, 32, 1, 2, 141, 0.666626
wu-haven-coef, 57, 43, 30, 1, 2, 133, 0.666626
wu-haven-coef, 59, 42, 31, 1, 2, 135, 0.666626
wu-haven-coef, 61, 43, 29, 1, 2, 136, 0.666626
wu-haven-coef, 59, 43, 30, 1, 2, 135, 0.666626
wu-haven-coef, 59, 42, 31, 1, 2, 135, 0.666626
wu-haven-coef, 58, 42, 31, 1, 2, 134, 0.666626
wu-haven-coef, 62, 42, 30, 1, 2, 137, 0.666626
wu-haven-coef, 57, 42, 30, 1, 2, 132, 0.666626
wu-haven-coef, 57, 42, 30, 1, 2, 132, 0.666626
wu-haven-coef, 59, 42, 29, 1, 2, 133, 0.666626
wu-haven-coef, 58, 43, 30, 1, 2, 134, 0.666626
wu-haven-coef, 61, 42, 30, 1, 2, 136, 0.666626
wu-haven-coef, 59, 42, 29, 1, 2, 133, 0.666626
wu-haven-coef, 60, 42, 30, 1, 2, 135, 0.666626
wu-haven-coef, 59, 42, 30, 1, 2, 134, 0.666626
wu-haven-coef, 59, 43, 30, 1, 2, 135, 0.666626
wu-haven-coef, 59, 42, 29, 1, 2, 133, 0.666626
wu-haven-coef, 56, 42, 30, 1, 2, 131, 0.666626
wu-haven-coef, 59, 42, 29, 1, 2, 133, 0.666626
wu-haven-coef, 56, 42, 30, 1, 2, 131, 0.666626
wu-haven-coef, 59, 42, 29, 1, 2, 133, 0.666626
wu-haven-coef, 60, 43, 30, 1, 2, 136, 0.666626
wu-haven-coef, 59, 42, 29, 1, 2, 133, 0.666626
wu-haven-coef, 60, 42, 30, 1, 2, 135, 0.666626
wu-haven-coef, 64, 42, 31, 1, 2, 140, 0.666626
wu-haven-coef, 56, 42, 29, 1, 2, 130, 0.666626
wu-haven-coef, 62, 42, 29, 1, 2, 136, 0.666626
wu-haven-coef, 68, 43, 31, 1, 2, 145, 0.666626
wu-haven-coef, 57, 42, 29, 1, 2, 131, 0.666626
wu-haven-coef, 60, 43, 30, 1, 2, 136, 0.666626
wu-haven-coef, 58, 45, 30, 1, 2, 136, 0.666626
wu-haven-coef, 61, 42, 30, 1, 2, 136, 0.666626
wu-haven-coef, 58, 42, 29, 1, 2, 132, 0.666626
wu-haven-coef, 60, 42, 30, 1, 2, 135, 0.666626
wu-haven-coef, 59, 43, 29, 1, 2, 134, 0.666626
wu-haven-coef, 56, 42, 30, 1, 2, 131, 0.666626
wu-haven-coef, 61, 42, 29, 1, 2, 135, 0.666626
wu-haven-coef, 60, 42, 29, 1, 2, 134, 0.666626
wu-haven-coef, 57, 42, 29, 1, 2, 131, 0.666626
wu-haven-coef, 56, 42, 30, 1, 2, 131, 0.666626
wu-haven-coef, 60, 42, 29, 1, 2, 134, 0.666626
wu-haven-coef, 60, 42, 30, 1, 2, 135, 0.666626
wu-haven-coef, 60, 42, 29, 1, 2, 134, 0.666626
wu-haven-coef, 56, 42, 29, 1, 2, 130, 0.666626
wu-haven-coef, 57, 42, 31, 1, 2, 133, 0.666626
wu-haven-coef, 63, 42, 31, 1, 2, 139, 0.666626
wu-haven-coef, 58, 46, 30, 1, 2, 137, 0.666626
wu-haven-coef, 56, 43, 29, 1, 2, 131, 0.666626
wu-haven-coef, 59, 42, 29, 1, 2, 133, 0.666626
wu-haven-coef, 59, 42, 29, 1, 2, 133, 0.666626
wu-haven-coef, 60, 42, 29, 1, 2, 134, 0.666626
wu-haven-coef, 60, 42, 30, 1, 2, 135, 0.666626
wu-haven-coef, 63, 42, 31, 1, 2, 139, 0.666626
wu-haven-coef, 59, 42, 29, 1, 2, 133, 0.666626
wu-haven-coef, 56, 42, 29, 1, 2, 130, 0.666626
wu-haven-coef, 56, 43, 29, 1, 2, 131, 0.666626
wu-haven-coef, 64, 42, 31, 1, 2, 140, 0.666626
wu-haven-coef, 58, 42, 30, 1, 2, 133, 0.666626
wu-haven-coef, 59, 42, 30, 1, 2, 134, 0.666626
wu-haven-coef, 60, 46, 29, 1, 2, 138, 0.666626
wu-haven-coef, 64, 43, 29, 1, 2, 139, 0.666626
wu-haven-coef, 59, 42, 29, 1, 2, 133, 0.666626
wu-haven-coef, 60, 42, 30, 1, 2, 135, 0.666626
wu-haven-coef, 59, 42, 29, 1, 2, 133, 0.666626
wu-haven-coef, 64, 42, 31, 1, 2, 140, 0.666626
wu-haven-coef, 62, 42, 31, 1, 2, 138, 0.666626
wu-haven-coef, 58, 42, 30, 1, 2, 133, 0.666626
wu-haven-coef, 60, 42, 29, 1, 2, 134, 0.666626
wu-haven-coef, 59, 42, 29, 1, 2, 133, 0.666626
wu-haven-coef, 60, 43, 30, 1, 2, 136, 0.666626
wu-haven-coef, 58, 42, 29, 1, 3, 133, 0.666626
wu-haven-coef, 59, 42, 35, 1, 2, 139, 0.666626
wu-haven-coef, 57, 42, 29, 1, 2, 131, 0.666626
wu-haven-coef, 57, 42, 29, 1, 2, 131, 0.666626
wu-haven-coef, 60, 42, 30, 1, 2, 135, 0.666626
wu-haven-coef, 59, 42, 31, 1, 2, 135, 0.666626
wu-haven-coef, 58, 42, 30, 1, 2, 133, 0.666626
wu-haven-coef, 59, 43, 30, 1, 2, 135, 0.666626
wu-haven-coef, 59, 46, 30, 1, 2, 138, 0.666626
wu-haven-coef, 56, 42, 29, 1, 2, 130, 0.666626
wu-haven-coef, 56, 42, 29, 1, 2, 130, 0.666626
wu-haven-coef, 58, 43, 29, 1, 2, 133, 0.666626
wu-haven-coef, 56, 42, 29, 1, 2, 130, 0.666626
wu-haven-coef, 62, 42, 30, 1, 2, 137, 0.666626
wu-haven-coef, 61, 42, 31, 1, 2, 137, 0.666626
wu-haven-coef, 59, 42, 29, 1, 2, 133, 0.666626
wu-haven-coef, 55, 42, 29, 1, 2, 129, 0.666626
wu-haven-coef, 57, 42, 29, 1, 2, 131, 0.666626
wu-haven-coef, 56, 42, 30, 1, 2, 131, 0.666626
wu-haven-coef, 59, 42, 31, 1, 2, 135, 0.666626
wu-haven-coef, 59, 42, 30, 1, 2, 134, 0.666626
wu-haven-coef, 60, 42, 29, 1, 2, 134, 0.666626
wu-haven-coef, 56, 42, 29, 1, 2, 130, 0.666626
wu-haven-coef, 61, 42, 31, 1, 2, 137, 0.666626
wu-haven-coef, 59, 42, 29, 1, 2, 133, 0.666626
wu-haven-coef, 56, 42, 29, 1, 2, 130, 0.666626
wu-haven-coef, 60, 42, 30, 1, 2, 135, 0.666626
wu-haven-coef, 59, 42, 29, 1, 2, 133, 0.666626
wu-haven-coef, 56, 50, 30, 1, 2, 139, 0.666626
wu-haven-coef, 60, 42, 36, 1, 2, 141, 0.666626
wu-haven-coef, 57, 43, 30, 1, 2, 133, 0.666626
wu-haven-coef, 58, 43, 29, 1, 2, 133, 0.666626
wu-haven-coef, 59, 43, 30, 1, 2, 135, 0.666626
wu-haven-coef, 62, 42, 31, 1, 2, 138, 0.666626
wu-haven-coef, 59, 42, 30, 1, 2, 134, 0.666626
wu-haven-coef, 63, 42, 30, 1, 2, 138, 0.666626
wu-haven-coef, 59, 42, 29, 1, 2, 133, 0.666626
wu-haven-coef, 57, 42, 29, 1, 2, 131, 0.666626
wu-haven-coef, 61, 42, 31, 1, 2, 137, 0.666626
wu-haven-coef, 59, 42, 29, 1, 2, 133, 0.666626
wu-haven-coef, 56, 42, 29, 1, 2, 130, 0.666626
wu-haven-coef, 63, 42, 30, 1, 2, 138, 0.666626
wu-haven-coef, 67, 43, 29, 1, 2, 142, 0.666626
wu-haven-coef, 67, 42, 29, 1, 2, 141, 0.666626
wu-haven-coef, 57, 42, 30, 1, 2, 132, 0.666626
wu-haven-coef, 56, 42, 29, 1, 2, 130, 0.666626
wu-haven-coef, 61, 42, 31, 1, 2, 137, 0.666626
wu-haven-coef, 58, 42, 30, 1, 2, 133, 0.666626
wu-haven-coef, 59, 42, 29, 1, 2, 133, 0.666626
wu-haven-coef, 56, 46, 29, 1, 2, 134, 0.666626
wu-haven-coef, 60, 42, 31, 1, 2, 136, 0.666626
wu-haven-coef, 58, 43, 29, 1, 2, 133, 0.666626
wu-haven-coef, 63, 42, 29, 1, 2, 137, 0.666626
wu-haven-coef, 60, 42, 29, 1, 2, 134, 0.666626
wu-haven-coef, 56, 42, 29, 1, 2, 130, 0.666626
wu-haven-coef, 57, 42, 30, 1, 2, 132, 0.666626
wu-haven-coef, 59, 42, 29, 1, 2, 133, 0.666626
wu-haven-coef, 60, 43, 30, 1, 2, 136, 0.666626
wu-haven-coef, 59, 42, 30, 1, 2, 134, 0.666626
wu-haven-coef, 60, 42, 29, 1, 2, 134, 0.666626
wu-haven-coef, 57, 42, 30, 1, 2, 132, 0.666626
wu-haven-coef, 56, 42, 29, 1, 2, 130, 0.666626
wu-haven-coef, 61, 43, 30, 1, 2, 137, 0.666626
wu-haven-coef, 57, 42, 30, 1, 2, 132, 0.666626
wu-haven-coef, 56, 42, 29, 1, 2, 130, 0.666626
wu-haven-coef, 58, 43, 29, 1, 2, 133, 0.666626
wu-haven-coef, 60, 42, 29, 1, 2, 134, 0.666626
wu-haven-coef, 60, 43, 29, 1, 2, 135, 0.666626
wu-haven-coef, 58, 42, 30, 1, 2, 133, 0.666626
wu-haven-coef, 58, 42, 29, 1, 2, 132, 0.666626
wu-haven-coef, 64, 42, 30, 1, 2, 139, 0.666626
wu-haven-coef, 59, 42, 29, 1, 2, 133, 0.666626
wu-haven-coef, 60, 42, 30, 1, 2, 135, 0.666626
wu-haven-coef, 59, 42, 29, 1, 2, 133, 0.666626
wu-haven-coef, 56, 42, 29, 1, 2, 130, 0.666626
wu-haven-coef, 62, 42, 29, 1, 2, 136, 0.666626
wu-haven-coef, 59, 42, 30, 1, 2, 134, 0.666626
wu-haven-coef, 58, 42, 29, 1, 2, 132, 0.666626
wu-haven-coef, 60, 42, 29, 1, 2, 134, 0.666626
wu-haven-coef, 60, 42, 30, 1, 2, 135, 0.666626
wu-haven-coef, 60, 42, 29, 1, 2, 134, 0.666626
wu-haven-coef, 64, 42, 29, 1, 2, 138, 0.666626
wu-haven-coef, 56, 43, 30, 1, 2, 132, 0.666626
wu-haven-coef, 57, 42, 29, 1, 2, 131, 0.666626
wu-haven-coef, 68, 43, 29, 1, 2, 143, 0.666626
wu-haven-coef, 59, 42, 29, 1, 2, 133, 0.666626
wu-haven-coef, 63, 42, 30, 1, 2, 138, 0.666626
wu-haven-coef, 59, 42, 29, 1, 2, 133, 0.666626
wu-haven-coef, 61, 42, 31, 1, 2, 137, 0.666626
wu-haven-coef, 60, 42, 29, 1, 2, 134, 0.666626
wu-haven-coef, 59, 42, 30, 1, 2, 134, 0.666626
wu-haven-coef, 59, 42, 29, 1, 2, 133, 0.666626
wu-haven-coef, 61, 42, 29, 1, 2, 135, 0.666626
wu-haven-coef, 56, 42, 30, 1, 2, 131, 0.666626
wu-haven-coef, 60, 42, 29, 1, 2, 134, 0.666626
wu-haven-coef, 56, 42, 29, 1, 2, 130, 0.666626
wu-haven-coef, 59, 42, 30, 1, 2, 134, 0.666626
wu-haven-coef, 58, 42, 31, 1, 2, 134, 0.666626
wu-haven-coef, 62, 42, 29, 1, 2, 136, 0.666626
wu-haven-coef, 60, 42, 30, 1, 2, 135, 0.666626
wu-haven-coef, 58, 43, 30, 1, 2, 134, 0.666626
wu-haven-coef, 59, 42, 31, 1, 2, 135, 0.666626
wu-haven-coef, 58, 42, 29, 1, 2, 132, 0.666626
wu-haven-coef, 56, 42, 31, 1, 2, 132, 0.666626
wu-haven-coef, 58, 42, 29, 1, 2, 132, 0.666626
wu-haven-coef, 56, 42, 29, 1, 2, 130, 0.666626
wu-haven-coef, 61, 43, 32, 1, 2, 139, 0.666626
wu-haven-coef, 57, 42, 30, 1, 2, 132, 0.666626
wu-haven-coef, 59, 42, 29, 1, 2, 133, 0.666626
wu-haven-coef, 56, 42, 29, 1, 2, 130, 0.666626
wu-haven-coef, 57, 43, 30, 1, 2, 133, 0.666626
wu-haven-coef, 66, 42, 31, 1, 2, 142, 0.666626
wu-haven-coef, 61, 42, 30, 1, 2, 136, 0.666626
wu-haven-coef, 57, 42, 29, 1, 2, 131, 0.666626
wu-haven-coef, 56, 42, 29, 1, 2, 130, 0.666626
wu-haven-coef, 57, 42, 30, 1, 2, 132, 0.666626
wu-haven-coef, 56, 42, 29, 1, 2, 130, 0.666626
wu-haven-coef, 59, 42, 30, 1, 2, 134, 0.666626
deduced-coef, 52, 37, 25, 1, 2, 117, 0.666626
deduced-coef, 55, 37, 25, 1, 2, 120, 0.666626
deduced-coef, 54, 38, 26, 1, 2, 121, 0.666626
deduced-coef, 52, 38, 25, 1, 2, 118, 0.666626
deduced-coef, 53, 38, 26, 1, 2, 120, 0.666626
deduced-coef, 53, 37, 25, 1, 2, 118, 0.666626
deduced-coef, 53, 38, 25, 1, 2, 119, 0.666626
deduced-coef, 50, 38, 25, 1, 2, 116, 0.666626
deduced-coef, 51, 37, 26, 1, 2, 117, 0.666626
deduced-coef, 53, 37, 25, 1, 2, 118, 0.666626
deduced-coef, 53, 38, 25, 1, 2, 119, 0.666626
deduced-coef, 53, 38, 25, 1, 2, 119, 0.666626
deduced-coef, 51, 37, 25, 1, 2, 116, 0.666626
deduced-coef, 53, 38, 25, 1, 2, 119, 0.666626
deduced-coef, 57, 37, 26, 1, 2, 123, 0.666626
deduced-coef, 52, 40, 25, 1, 2, 120, 0.666626
deduced-coef, 51, 37, 25, 1, 2, 116, 0.666626
deduced-coef, 54, 37, 25, 1, 2, 119, 0.666626
deduced-coef, 55, 37, 25, 1, 2, 120, 0.666626
deduced-coef, 53, 37, 25, 1, 2, 118, 0.666626
deduced-coef, 54, 37, 26, 1, 2, 120, 0.666626
deduced-coef, 52, 37, 26, 1, 2, 118, 0.666626
deduced-coef, 53, 38, 26, 1, 2, 120, 0.666626
deduced-coef, 50, 37, 25, 1, 2, 115, 0.666626
deduced-coef, 51, 38, 25, 1, 2, 117, 0.666626
deduced-coef, 54, 37, 25, 1, 2, 119, 0.666626
deduced-coef, 54, 40, 26, 1, 2, 123, 0.666626
deduced-coef, 54, 38, 27, 1, 2, 122, 0.666626
deduced-coef, 56, 37, 27, 1, 2, 123, 0.666626
deduced-coef, 57, 37, 27, 1, 2, 124, 0.666626
deduced-coef, 54, 38, 25, 1, 2, 120, 0.666626
deduced-coef, 53, 38, 26, 1, 2, 120, 0.666626
deduced-coef, 51, 37, 25, 1, 2, 116, 0.666626
deduced-coef, 54, 38, 25, 1, 2, 120, 0.666626
deduced-coef, 54, 37, 25, 1, 2, 119, 0.666626
deduced-coef, 52, 38, 25, 1, 2, 118, 0.666626
deduced-coef, 54, 37, 25, 1, 2, 119, 0.666626
deduced-coef, 51, 37, 26, 1, 2, 117, 0.666626
deduced-coef, 55, 42, 25, 1, 2, 125, 0.666626
deduced-coef, 53, 38, 26, 1, 2, 120, 0.666626
deduced-coef, 52, 38, 25, 1, 2, 118, 0.666626
deduced-coef, 53, 38, 25, 1, 2, 119, 0.666626
deduced-coef, 53, 37, 25, 1, 2, 118, 0.666626
deduced-coef, 53, 37, 25, 1, 2, 118, 0.666626
deduced-coef, 54, 37, 25, 1, 2, 119, 0.666626
deduced-coef, 54, 37, 25, 1, 2, 119, 0.666626
deduced-coef, 54, 38, 25, 1, 2, 120, 0.666626
deduced-coef, 53, 38, 27, 1, 2, 121, 0.666626
deduced-coef, 51, 38, 25, 1, 2, 117, 0.666626
deduced-coef, 54, 38, 25, 1, 2, 120, 0.666626
deduced-coef, 54, 37, 25, 1, 2, 119, 0.666626
deduced-coef, 53, 37, 25, 1, 2, 118, 0.666626
deduced-coef, 54, 38, 25, 1, 2, 120, 0.666626
deduced-coef, 51, 38, 25, 1, 2, 117, 0.666626
deduced-coef, 54, 37, 25, 1, 2, 119, 0.666626
deduced-coef, 54, 38, 25, 1, 2, 120, 0.666626
deduced-coef, 57, 37, 26, 1, 2, 123, 0.666626
deduced-coef, 53, 37, 25, 1, 2, 118, 0.666626
deduced-coef, 53, 38, 25, 1, 2, 119, 0.666626
deduced-coef, 53, 38, 25, 1, 2, 119, 0.666626
deduced-coef, 52, 38, 26, 1, 2, 119, 0.666626
deduced-coef, 52, 38, 26, 1, 2, 119, 0.666626
deduced-coef, 52, 37, 25, 1, 2, 117, 0.666626
deduced-coef, 54, 37, 26, 1, 2, 120, 0.666626
deduced-coef, 63, 38, 25, 1, 2, 129, 0.666626
deduced-coef, 52, 38, 25, 1, 2, 118, 0.666626
deduced-coef, 58, 38, 25, 1, 2, 124, 0.666626
deduced-coef, 54, 38, 26, 1, 2, 121, 0.666626
deduced-coef, 52, 38, 25, 1, 2, 118, 0.666626
deduced-coef, 53, 38, 25, 1, 2, 119, 0.666626
deduced-coef, 52, 38, 25, 1, 2, 118, 0.666626
deduced-coef, 54, 38, 25, 1, 2, 120, 0.666626
deduced-coef, 53, 38, 25, 1, 2, 119, 0.666626
deduced-coef, 54, 38, 25, 1, 2, 120, 0.666626
deduced-coef, 53, 37, 25, 1, 2, 118, 0.666626
deduced-coef, 54, 38, 25, 1, 2, 120, 0.666626
deduced-coef, 53, 38, 25, 1, 2, 119, 0.666626
deduced-coef, 53, 38, 26, 1, 2, 120, 0.666626
deduced-coef, 51, 38, 25, 1, 2, 117, 0.666626
deduced-coef, 53, 37, 25, 1, 2, 118, 0.666626
deduced-coef, 54, 37, 25, 1, 2, 119, 0.666626
deduced-coef, 55, 37, 25, 1, 2, 120, 0.666626
deduced-coef, 53, 37, 25, 1, 2, 118, 0.666626
deduced-coef, 53, 38, 25, 1, 2, 119, 0.666626
deduced-coef, 53, 37, 25, 1, 2, 118, 0.666626
deduced-coef, 54, 39, 26, 1, 2, 122, 0.666626
deduced-coef, 56, 38, 26, 1, 2, 123, 0.666626
deduced-coef, 58, 37, 26, 1, 2, 124, 0.666626
deduced-coef, 54, 37, 25, 1, 2, 119, 0.666626
deduced-coef, 52, 37, 25, 1, 2, 117, 0.666626
deduced-coef, 58, 38, 25, 1, 2, 124, 0.666626
deduced-coef, 53, 38, 25, 1, 2, 119, 0.666626
deduced-coef, 60, 37, 26, 1, 2, 126, 0.666626
deduced-coef, 52, 37, 25, 1, 2, 117, 0.666626
deduced-coef, 54, 38, 26, 1, 2, 121, 0.666626
deduced-coef, 51, 38, 25, 1, 2, 117, 0.666626
deduced-coef, 60, 38, 25, 1, 2, 126, 0.666626
deduced-coef, 56, 38, 26, 1, 2, 123, 0.666626
deduced-coef, 59, 38, 26, 1, 2, 126, 0.666626
deduced-coef, 53, 37, 25, 1, 2, 118, 0.666626
deduced-coef, 54, 37, 25, 1, 2, 119, 0.666626
deduced-coef, 54, 38, 25, 1, 2, 120, 0.666626
deduced-coef, 53, 37, 24, 1, 2, 117, 0.666626
deduced-coef, 51, 37, 25, 1, 2, 116, 0.666626
deduced-coef, 51, 37, 25, 1, 2, 116, 0.666626
deduced-coef, 54, 37, 25, 1, 2, 119, 0.666626
deduced-coef, 57, 37, 25, 1, 2, 122, 0.666626
deduced-coef, 53, 37, 25, 1, 2, 118, 0.666626
deduced-coef, 54, 37, 25, 1, 2, 119, 0.666626
deduced-coef, 62, 37, 26, 1, 2, 128, 0.666626
deduced-coef, 53, 38, 25, 1, 2, 119, 0.666626
deduced-coef, 53, 38, 25, 1, 2, 119, 0.666626
deduced-coef, 53, 38, 25, 1, 2, 119, 0.666626
deduced-coef, 53, 38, 25, 1, 2, 119, 0.666626
deduced-coef, 52, 38, 25, 1, 2, 118, 0.666626
deduced-coef, 53, 38, 25, 1, 2, 119, 0.666626
deduced-coef, 54, 38, 25, 1, 2, 120, 0.666626
deduced-coef, 53, 37, 25, 1, 2, 118, 0.666626
deduced-coef, 50, 38, 25, 1, 2, 116, 0.666626
deduced-coef, 50, 37, 25, 1, 2, 115, 0.666626
deduced-coef, 54, 38, 25, 1, 2, 120, 0.666626
deduced-coef, 51, 37, 25, 1, 2, 116, 0.666626
deduced-coef, 52, 37, 25, 1, 2, 117, 0.666626
deduced-coef, 54, 37, 25, 1, 2, 119, 0.666626
deduced-coef, 54, 37, 25, 1, 2, 119, 0.666626
deduced-coef, 54, 38, 25, 1, 2, 120, 0.666626
deduced-coef, 53, 37, 25, 1, 2, 118, 0.666626
deduced-coef, 53, 37, 25, 1, 2, 118, 0.666626
deduced-coef, 50, 38, 25, 1, 2, 116, 0.666626
deduced-coef, 53, 37, 24, 1, 2, 117, 0.666626
deduced-coef, 50, 37, 25, 1, 2, 115, 0.666626
deduced-coef, 55, 37, 26, 1, 2, 121, 0.666626
deduced-coef, 51, 38, 25, 1, 2, 117, 0.666626
deduced-coef, 54, 37, 26, 1, 2, 120, 0.666626
deduced-coef, 52, 38, 25, 1, 2, 118, 0.666626
deduced-coef, 52, 38, 26, 1, 2, 119, 0.666626
deduced-coef, 56, 38, 27, 1, 2, 124, 0.666626
deduced-coef, 55, 38, 25, 1, 2, 121, 0.666626
deduced-coef, 54, 38, 25, 1, 2, 120, 0.666626
deduced-coef, 56, 37, 26, 1, 2, 122, 0.666626
deduced-coef, 53, 37, 25, 1, 2, 118, 0.666626
deduced-coef, 57, 38, 26, 1, 2, 124, 0.666626
deduced-coef, 51, 37, 25, 1, 2, 116, 0.666626
deduced-coef, 58, 38, 26, 1, 2, 125, 0.666626
deduced-coef, 53, 38, 25, 1, 2, 119, 0.666626
deduced-coef, 52, 37, 25, 1, 2, 117, 0.666626
deduced-coef, 54, 38, 25, 1, 2, 120, 0.666626
deduced-coef, 53, 38, 25, 1, 2, 119, 0.666626
deduced-coef, 54, 38, 25, 1, 2, 120, 0.666626
deduced-coef, 53, 38, 25, 1, 2, 119, 0.666626
deduced-coef, 53, 38, 25, 1, 2, 119, 0.666626
deduced-coef, 53, 37, 25, 1, 2, 118, 0.666626
deduced-coef, 51, 37, 25, 1, 2, 116, 0.666626
deduced-coef, 53, 37, 25, 1, 2, 118, 0.666626
deduced-coef, 54, 38, 25, 1, 2, 120, 0.666626
deduced-coef, 54, 37, 25, 1, 2, 119, 0.666626
deduced-coef, 51, 37, 25, 1, 2, 116, 0.666626
deduced-coef, 60, 37, 25, 1, 2, 125, 0.666626
deduced-coef, 54, 37, 25, 1, 2, 119, 0.666626
deduced-coef, 50, 38, 25, 1, 2, 116, 0.666626
deduced-coef, 52, 37, 25, 1, 2, 117, 0.666626
deduced-coef, 54, 37, 25, 1, 2, 119, 0.666626
deduced-coef, 53, 37, 25, 1, 2, 118, 0.666626
deduced-coef, 54, 41, 26, 1, 2, 124, 0.666626
deduced-coef, 57, 38, 25, 1, 2, 123, 0.666626
deduced-coef, 53, 39, 25, 1, 2, 120, 0.666626
deduced-coef, 51, 37, 25, 1, 2, 116, 0.666626
deduced-coef, 52, 38, 26, 1, 2, 119, 0.666626
deduced-coef, 52, 37, 25, 1, 2, 117, 0.666626
deduced-coef, 54, 38, 25, 1, 2, 120, 0.666626
deduced-coef, 53, 37, 25, 1, 2, 118, 0.666626
deduced-coef, 54, 38, 26, 1, 2, 121, 0.666626
deduced-coef, 52, 38, 25, 1, 2, 118, 0.666626
deduced-coef, 57, 38, 26, 1, 2, 124, 0.666626
deduced-coef, 54, 37, 25, 1, 2, 119, 0.666626
deduced-coef, 54, 38, 25, 1, 2, 120, 0.666626
deduced-coef, 53, 37, 25, 1, 2, 118, 0.666626
deduced-coef, 53, 38, 25, 1, 2, 119, 0.666626
deduced-coef, 53, 38, 29, 1, 2, 123, 0.666626
deduced-coef, 53, 37, 26, 1, 2, 119, 0.666626
deduced-coef, 58, 39, 25, 1, 2, 125, 0.666626
deduced-coef, 51, 38, 25, 1, 2, 117, 0.666626
deduced-coef, 53, 38, 25, 1, 2, 119, 0.666626
deduced-coef, 53, 37, 25, 1, 2, 118, 0.666626
deduced-coef, 57, 38, 25, 1, 2, 123, 0.666626
deduced-coef, 53, 37, 25, 1, 2, 118, 0.666626
deduced-coef, 54, 37, 25, 1, 2, 119, 0.666626
deduced-coef, 54, 39, 30, 1, 2, 126, 0.666626
deduced-coef, 51, 38, 25, 1, 2, 117, 0.666626
deduced-coef, 53, 41, 28, 1, 2, 125, 0.666626
deduced-coef, 53, 37, 25, 1, 2, 118, 0.666626
deduced-coef, 50, 44, 25, 1, 2, 122, 0.666626
deduced-coef, 50, 37, 25, 1, 2, 115, 0.666626
deduced-coef, 50, 37, 25, 1, 2, 115, 0.666626
deduced-coef, 53, 37, 26, 1, 2, 119, 0.666626
deduced-coef, 53, 38, 25, 1, 2, 119, 0.666626
deduced-coef, 58, 37, 26, 1, 2, 124, 0.666626
deduced-coef, 51, 37, 25, 1, 2, 116, 0.666626
deduced-coef, 52, 37, 25, 1, 2, 117, 0.666626
deduced-coef, 50, 38, 25, 1, 2, 116, 0.666626
deduced-coef, 54, 37, 25, 1, 2, 119, 0.666626
deduced-coef, 54, 37, 25, 1, 2, 119, 0.666626
deduced-coef, 54, 37, 25, 1, 2, 119, 0.666626
deduced-coef, 54, 38, 25, 1, 2, 120, 0.666626
deduced-coef, 53, 38, 25, 1, 2, 119, 0.666626
deduced-coef, 51, 37, 25, 1, 2, 116, 0.666626
deduced-coef, 57, 37, 25, 1, 2, 122, 0.666626
deduced-coef, 55, 38, 27, 1, 2, 123, 0.666626
deduced-coef, 57, 37, 25, 1, 2, 122, 0.666626
deduced-coef, 57, 38, 25, 1, 2, 123, 0.666626
deduced-coef, 53, 38, 25, 1, 2, 119, 0.666626
deduced-coef, 51, 38, 25, 1, 2, 117, 0.666626
deduced-coef, 51, 37, 25, 1, 2, 116, 0.666626
deduced-coef, 52, 41, 25, 1, 2, 121, 0.666626
deduced-coef, 50, 37, 25, 1, 2, 115, 0.666626
deduced-coef, 55, 38, 26, 1, 2, 122, 0.666626
deduced-coef, 52, 38, 25, 1, 2, 118, 0.666626
deduced-coef, 53, 38, 25, 1, 2, 119, 0.666626
deduced-coef, 58, 37, 25, 1, 2, 123, 0.666626
deduced-coef, 54, 38, 25, 1, 2, 120, 0.666626
deduced-coef, 52, 38, 25, 1, 2, 118, 0.666626
deduced-coef, 53, 38, 26, 1, 2, 120, 0.666626
deduced-coef, 53, 38, 25, 1, 2, 119, 0.666626
deduced-coef, 52, 37, 25, 1, 2, 117, 0.666626
deduced-coef, 51, 37, 25, 1, 2, 116, 0.666626
deduced-coef, 52, 38, 25, 1, 2, 118, 0.666626
deduced-coef, 53, 38, 25, 1, 2, 119, 0.666626
deduced-coef, 52, 37, 25, 1, 2, 117, 0.666626
deduced-coef, 55, 38, 25, 1, 2, 121, 0.666626
deduced-coef, 53, 37, 25, 1, 2, 118, 0.666626
deduced-coef, 53, 37, 25, 1, 2, 118, 0.666626
deduced-coef, 51, 39, 26, 1, 2, 119, 0.666626
deduced-coef, 53, 38, 25, 1, 2, 119, 0.666626
deduced-coef, 53, 38, 25, 1, 2, 119, 0.666626
deduced-coef, 50, 37, 25, 1, 2, 115, 0.666626
deduced-coef, 50, 37, 25, 1, 2, 115, 0.666626
deduced-coef, 52, 37, 25, 1, 2, 117, 0.666626
deduced-coef, 51, 37, 25, 1, 2, 116, 0.666626
deduced-coef, 54, 37, 25, 1, 2, 119, 0.666626
deduced-coef, 54, 37, 25, 1, 2, 119, 0.666626
deduced-coef, 50, 37, 25, 1, 2, 115, 0.666626
deduced-coef, 53, 38, 25, 1, 2, 119, 0.666626
deduced-coef, 53, 37, 25, 1, 2, 118, 0.666626
deduced-coef, 53, 37, 25, 1, 2, 118, 0.666626
deduced-coef, 55, 37, 25, 1, 2, 120, 0.666626
deduced-coef, 52, 38, 25, 1, 2, 118, 0.666626
deduced-coef, 54, 37, 25, 1, 2, 119, 0.666626
deduced-coef, 54, 37, 25, 1, 2, 119, 0.666626
deduced-coef, 53, 38, 26, 1, 2, 120, 0.666626
deduced-coef, 52, 38, 25, 1, 2, 118, 0.666626
deduced-coef, 57, 37, 25, 1, 2, 122, 0.666626
deduced-coef, 53, 37, 25, 1, 2, 118, 0.666626
deduced-coef, 54, 37, 25, 1, 2, 119, 0.666626
deduced-coef, 54, 37, 25, 1, 2, 119, 0.666626
deduced-coef, 54, 38, 25, 1, 2, 120, 0.666626
deduced-coef, 53, 38, 25, 1, 2, 119, 0.666626
deduced-coef, 53, 37, 25, 1, 2, 118, 0.666626
deduced-coef, 54, 37, 25, 1, 2, 119, 0.666626
deduced-coef, 54, 37, 25, 1, 2, 119, 0.666626
deduced-coef, 56, 37, 25, 1, 2, 121, 0.666626
deduced-coef, 53, 37, 25, 1, 2, 118, 0.666626
deduced-coef, 54, 37, 25, 1, 2, 119, 0.666626
deduced-coef, 54, 38, 25, 1, 2, 120, 0.666626
deduced-coef, 53, 37, 25, 1, 2, 118, 0.666626
deduced-coef, 54, 38, 26, 1, 2, 121, 0.666626
deduced-coef, 52, 38, 25, 1, 2, 118, 0.666626
deduced-coef, 57, 37, 26, 1, 2, 123, 0.666626
deduced-coef, 53, 37, 25, 1, 2, 118, 0.666626
deduced-coef, 54, 38, 25, 1, 2, 120, 0.666626
deduced-coef, 53, 37, 25, 1, 2, 118, 0.666626
deduced-coef, 54, 37, 25, 1, 2, 119, 0.666626
deduced-coef, 54, 38, 25, 1, 2, 120, 0.666626
deduced-coef, 52, 37, 25, 1, 2, 117, 0.666626
deduced-coef, 54, 38, 25, 1, 2, 120, 0.666626
deduced-coef, 52, 37, 25, 1, 2, 117, 0.666626
deduced-coef, 51, 37, 25, 1, 2, 116, 0.666626
deduced-coef, 54, 37, 26, 1, 2, 120, 0.666626
deduced-coef, 52, 37, 25, 1, 2, 117, 0.666626
deduced-coef, 54, 37, 25, 1, 2, 119, 0.666626
deduced-coef, 58, 37, 25, 1, 2, 123, 0.666626
deduced-coef, 53, 38, 26, 1, 2, 120, 0.666626
deduced-coef, 53, 37, 25, 1, 2, 118, 0.666626
deduced-coef, 53, 37, 25, 1, 2, 118, 0.666626
deduced-coef, 54, 37, 25, 1, 2, 119, 0.666626
deduced-coef, 54, 37, 25, 1, 2, 119, 0.666626
deduced-coef, 55, 38, 25, 1, 2, 121, 0.666626
deduced-coef, 57, 37, 25, 1, 2, 122, 0.666626
deduced-coef, 53, 37, 25, 1, 2, 118, 0.666626
deduced-coef, 51, 37, 25, 1, 2, 116, 0.666626
deduced-coef, 52, 37, 25, 1, 2, 117, 0.666626
deduced-coef, 54, 38, 25, 1, 2, 120, 0.666626
deduced-coef, 53, 38, 25, 1, 2, 119, 0.666626
deduced-coef, 53, 37, 25, 1, 2, 118, 0.666626
deduced-coef, 54, 37, 25, 1, 2, 119, 0.666626
deduced-coef, 54, 37, 27, 1, 2, 121, 0.666626
deduced-coef, 51, 37, 25, 1, 2, 116, 0.666626
deduced-coef, 51, 37, 25, 1, 2, 116, 0.666626
deduced-coef, 55, 37, 25, 1, 2, 120, 0.666626
deduced-coef, 54, 38, 25, 1, 2, 120, 0.666626
deduced-coef, 52, 37, 25, 1, 2, 117, 0.666626
deduced-coef, 53, 38, 25, 1, 2, 119, 0.666626
deduced-coef, 53, 37, 25, 1, 2, 118, 0.666626
deduced-coef, 54, 38, 25, 1, 2, 120, 0.666626
deduced-coef, 55, 38, 25, 1, 2, 121, 0.666626
deduced-coef, 52, 38, 27, 1, 2, 120, 0.666626
deduced-coef, 51, 37, 26, 1, 2, 117, 0.666626
deduced-coef, 52, 37, 26, 1, 2, 118, 0.666626
deduced-coef, 51, 37, 25, 1, 2, 116, 0.666626
deduced-coef, 51, 38, 25, 1, 2, 117, 0.666626
deduced-coef, 53, 38, 26, 1, 2, 120, 0.666626
deduced-coef, 52, 38, 25, 1, 2, 118, 0.666626
deduced-coef, 56, 38, 26, 1, 2, 123, 0.666626
deduced-coef, 51, 38, 25, 1, 2, 117, 0.666626
deduced-coef, 51, 37, 25, 1, 2, 116, 0.666626
deduced-coef, 55, 37, 25, 1, 2, 120, 0.666626
deduced-coef, 54, 38, 25, 1, 2, 120, 0.666626
deduced-coef, 53, 37, 25, 1, 2, 118, 0.666626
deduced-coef, 54, 38, 25, 1, 2, 120, 0.666626
deduced-coef, 53, 37, 26, 1, 2, 119, 0.666626
deduced-coef, 65, 37, 26, 1, 2, 131, 0.666626
deduced-coef, 52, 37, 26, 1, 2, 118, 0.666626
deduced-coef, 53, 38, 26, 1, 2, 120, 0.666626
deduced-coef, 52, 37, 25, 1, 2, 117, 0.666626
deduced-coef, 51, 37, 25, 1, 2, 116, 0.666626
deduced-coef, 52, 38, 26, 1, 2, 119, 0.666626
deduced-coef, 51, 37, 25, 1, 2, 116, 0.666626
deduced-coef, 54, 37, 25, 1, 2, 119, 0.666626
deduced-coef, 51, 37, 25, 1, 2, 116, 0.666626
deduced-coef, 50, 37, 25, 1, 2, 115, 0.666626
deduced-coef, 52, 38, 25, 1, 2, 118, 0.666626
deduced-coef, 53, 37, 25, 1, 2, 118, 0.666626
deduced-coef, 54, 38, 25, 1, 2, 120, 0.666626
deduced-coef, 53, 38, 25, 1, 2, 119, 0.666626
deduced-coef, 53, 37, 26, 1, 2, 119, 0.666626
deduced-coef, 54, 37, 25, 1, 2, 119, 0.666626
deduced-coef, 50, 37, 25, 1, 2, 115, 0.666626
deduced-coef, 52, 37, 25, 1, 2, 117, 0.666626
deduced-coef, 51, 37, 25, 1, 2, 116, 0.666626
deduced-coef, 54, 38, 25, 1, 2, 120, 0.666626
deduced-coef, 57, 38, 25, 1, 2, 123, 0.666626
deduced-coef, 51, 38, 25, 1, 2, 117, 0.666626
deduced-coef, 53, 38, 25, 1, 2, 119, 0.666626
deduced-coef, 53, 37, 25, 1, 2, 118, 0.666626
deduced-coef, 61, 37, 26, 1, 2, 127, 0.666626
deduced-coef, 54, 38, 25, 1, 2, 120, 0.666626
deduced-coef, 57, 38, 25, 1, 2, 123, 0.666626
deduced-coef, 53, 37, 24, 1, 2, 117, 0.666626
deduced-coef, 52, 41, 25, 1, 2, 121, 0.666626
deduced-coef, 53, 37, 25, 1, 2, 118, 0.666626
deduced-coef, 51, 37, 25, 1, 2, 116, 0.666626
deduced-coef, 50, 37, 25, 1, 2, 115, 0.666626
deduced-coef, 50, 37, 25, 1, 2, 115, 0.666626
deduced-coef, 51, 37, 25, 1, 2, 116, 0.666626
deduced-coef, 57, 37, 26, 1, 2, 123, 0.666626
deduced-coef, 57, 37, 25, 1, 2, 122, 0.666626
deduced-coef, 57, 38, 25, 1, 2, 123, 0.666626
deduced-coef, 53, 37, 25, 1, 2, 118, 0.666626
deduced-coef, 54, 37, 25, 1, 2, 119, 0.666626
deduced-coef, 54, 37, 26, 1, 2, 120, 0.666626
deduced-coef, 50, 38, 25, 1, 2, 116, 0.666626
deduced-coef, 54, 37, 25, 1, 2, 119, 0.666626
deduced-coef, 50, 38, 25, 1, 2, 116, 0.666626
deduced-coef, 57, 37, 26, 1, 2, 123, 0.666626
deduced-coef, 53, 38, 26, 1, 2, 120, 0.666626
deduced-coef, 53, 38, 25, 1, 2, 119, 0.666626
deduced-coef, 57, 38, 26, 1, 2, 124, 0.666626
deduced-coef, 53, 38, 25, 1, 2, 119, 0.666626
deduced-coef, 53, 37, 25, 1, 2, 118, 0.666626
deduced-coef, 53, 38, 25, 1, 2, 119, 0.666626
deduced-coef, 54, 38, 25, 1, 2, 120, 0.666626
deduced-coef, 57, 38, 25, 1, 2, 123, 0.666626
deduced-coef, 54, 37, 25, 1, 2, 119, 0.666626
deduced-coef, 53, 37, 25, 1, 2, 118, 0.666626
deduced-coef, 50, 37, 25, 1, 2, 115, 0.666626
deduced-coef, 50, 37, 25, 1, 2, 115, 0.666626
deduced-coef, 54, 38, 26, 1, 2, 121, 0.666626
deduced-coef, 52, 37, 25, 1, 2, 117, 0.666626
deduced-coef, 54, 38, 25, 1, 2, 120, 0.666626
deduced-coef, 53, 41, 25, 1, 2, 122, 0.666626
deduced-coef, 54, 37, 25, 1, 2, 119, 0.666626
deduced-coef, 54, 37, 25, 1, 2, 119, 0.666626
deduced-coef, 51, 37, 25, 1, 2, 116, 0.666626
deduced-coef, 52, 37, 25, 1, 2, 117, 0.666626
deduced-coef, 57, 37, 25, 1, 2, 122, 0.666626
deduced-coef, 54, 37, 25, 1, 2, 119, 0.666626
deduced-coef, 54, 37, 25, 1, 2, 119, 0.666626
deduced-coef, 54, 38, 25, 1, 2, 120, 0.666626
deduced-coef, 51, 37, 25, 1, 2, 116, 0.666626
deduced-coef, 52, 38, 25, 1, 2, 118, 0.666626
deduced-coef, 54, 42, 25, 1, 2, 124, 0.666626
deduced-coef, 52, 37, 25, 1, 2, 117, 0.666626
deduced-coef, 54, 37, 26, 1, 2, 120, 0.666626
deduced-coef, 53, 37, 25, 1, 2, 118, 0.666626
deduced-coef, 54, 38, 25, 1, 2, 120, 0.666626
deduced-coef, 59, 38, 25, 1, 2, 125, 0.666626
deduced-coef, 52, 37, 24, 1, 2, 116, 0.666626
deduced-coef, 51, 38, 25, 1, 2, 117, 0.666626
deduced-coef, 53, 37, 25, 1, 2, 118, 0.666626
deduced-coef, 53, 38, 26, 1, 2, 120, 0.666626
deduced-coef, 52, 38, 25, 1, 2, 118, 0.666626
deduced-coef, 52, 38, 25, 1, 2, 118, 0.666626
deduced-coef, 57, 37, 25, 1, 2, 122, 0.666626
deduced-coef, 53, 38, 26, 1, 2, 120, 0.666626
deduced-coef, 51, 37, 25, 1, 2, 116, 0.666626
deduced-coef, 50, 38, 25, 1, 2, 116, 0.666626
deduced-coef, 57, 37, 26, 1, 2, 123, 0.666626
deduced-coef, 53, 38, 25, 1, 2, 119, 0.666626
deduced-coef, 53, 38, 25, 1, 2, 119, 0.666626
deduced-coef, 52, 38, 26, 1, 2, 119, 0.666626
deduced-coef, 51, 37, 26, 1, 2, 117, 0.666626
deduced-coef, 53, 37, 25, 1, 2, 118, 0.666626
deduced-coef, 53, 38, 26, 1, 2, 120, 0.666626
deduced-coef, 53, 38, 26, 1, 2, 120, 0.666626
deduced-coef, 56, 38, 26, 1, 2, 123, 0.666626
deduced-coef, 52, 38, 26, 1, 2, 119, 0.666626
deduced-coef, 57, 37, 25, 1, 2, 122, 0.666626
deduced-coef, 53, 37, 25, 1, 2, 118, 0.666626
deduced-coef, 54, 37, 25, 1, 2, 119, 0.666626
deduced-coef, 53, 38, 25, 1, 2, 119, 0.666626
deduced-coef, 52, 38, 26, 1, 2, 119, 0.666626
deduced-coef, 52, 37, 25, 1, 2, 117, 0.666626
deduced-coef, 53, 37, 25, 1, 2, 118, 0.666626
deduced-coef, 54, 38, 25, 1, 2, 120, 0.666626
deduced-coef, 54, 38, 25, 1, 2, 120, 0.666626
deduced-coef, 53, 38, 25, 1, 2, 119, 0.666626
deduced-coef, 53, 37, 25, 1, 2, 118, 0.666626
deduced-coef, 54, 37, 25, 1, 2, 119, 0.666626
deduced-coef, 50, 37, 25, 1, 2, 115, 0.666626
deduced-coef, 54, 37, 25, 1, 2, 119, 0.666626
deduced-coef, 52, 37, 25, 1, 2, 117, 0.666626
deduced-coef, 52, 38, 25, 1, 2, 118, 0.666626
deduced-coef, 55, 37, 25, 1, 2, 120, 0.666626
deduced-coef, 53, 38, 26, 1, 2, 120, 0.666626
deduced-coef, 52, 37, 26, 1, 2, 118, 0.666626
deduced-coef, 54, 38, 26, 1, 2, 121, 0.666626
deduced-coef, 52, 38, 25, 1, 2, 118, 0.666626
deduced-coef, 50, 37, 25, 1, 2, 115, 0.666626
deduced-coef, 53, 38, 26, 1, 2, 120, 0.666626
deduced-coef, 51, 38, 25, 1, 2, 117, 0.666626
deduced-coef, 55, 38, 25, 1, 2, 121, 0.666626
deduced-coef, 51, 37, 25, 1, 2, 116, 0.666626
deduced-coef, 54, 38, 26, 1, 2, 121, 0.666626
deduced-coef, 52, 37, 25, 1, 2, 117, 0.666626
deduced-coef, 53, 37, 25, 1, 2, 118, 0.666626
deduced-coef, 58, 38, 26, 1, 2, 125, 0.666626
deduced-coef, 53, 38, 26, 1, 2, 120, 0.666626
deduced-coef, 54, 38, 25, 1, 2, 120, 0.666626
deduced-coef, 52, 39, 26, 1, 2, 120, 0.666626
deduced-coef, 52, 37, 25, 1, 2, 117, 0.666626
deduced-coef, 50, 37, 25, 1, 2, 115, 0.666626
deduced-coef, 52, 37, 25, 1, 2, 117, 0.666626
deduced-coef, 53, 37, 25, 1, 2, 118, 0.666626
deduced-coef, 56, 37, 25, 1, 2, 121, 0.666626
deduced-coef, 54, 38, 25, 1, 2, 120, 0.666626
deduced-coef, 52, 37, 25, 1, 2, 117, 0.666626
deduced-coef, 54, 37, 25, 1, 2, 119, 0.666626
deduced-coef, 58, 37, 26, 1, 2, 124, 0.666626
deduced-coef, 53, 38, 25, 1, 2, 119, 0.666626
deduced-coef, 54, 38, 25, 1, 2, 120, 0.666626
deduced-coef, 51, 38, 25, 1, 2, 117, 0.666626
deduced-coef, 54, 38, 26, 1, 2, 121, 0.666626
deduced-coef, 52, 37, 25, 1, 2, 117, 0.666626
deduced-coef, 58, 37, 25, 1, 2, 123, 0.666626
deduced-coef, 54, 38, 25, 1, 2, 120, 0.666626
deduced-coef, 53, 37, 25, 1, 2, 118, 0.666626
deduced-coef, 54, 37, 25, 1, 2, 119, 0.666626
deduced-coef, 53, 37, 25, 1, 2, 118, 0.666626
deduced-coef, 54, 37, 25, 1, 2, 119, 0.666626
deduced-coef, 54, 38, 25, 1, 2, 120, 0.666626
deduced-coef, 52, 37, 25, 1, 2, 117, 0.666626
deduced-coef, 51, 38, 26, 1, 2, 118, 0.666626
deduced-coef, 51, 37, 26, 1, 2, 117, 0.666626
deduced-coef, 51, 38, 25, 1, 2, 117, 0.666626
deduced-coef, 53, 37, 25, 1, 2, 118, 0.666626
deduced-coef, 54, 38, 25, 1, 2, 120, 0.666626
deduced-coef, 52, 38, 25, 1, 2, 118, 0.666626
deduced-coef, 53, 38, 26, 1, 2, 120, 0.666626
deduced-coef, 52, 38, 25, 1, 2, 118, 0.666626
deduced-coef, 53, 38, 26, 1, 2, 120, 0.666626
deduced-coef, 53, 37, 25, 1, 2, 118, 0.666626
deduced-coef, 55, 38, 25, 1, 2, 121, 0.666626
deduced-coef, 54, 38, 25, 1, 2, 120, 0.666626
deduced-coef, 53, 40, 25, 1, 2, 121, 0.666626
deduced-coef, 51, 37, 28, 1, 2, 119, 0.666626
deduced-coef, 55, 39, 26, 1, 2, 123, 0.666626
deduced-coef, 55, 38, 25, 1, 2, 121, 0.666626
deduced-coef, 61, 37, 26, 1, 2, 127, 0.666626
deduced-coef, 53, 37, 25, 1, 2, 118, 0.666626
deduced-coef, 50, 38, 25, 1, 2, 116, 0.666626
deduced-coef, 53, 38, 25, 1, 2, 119, 0.666626
deduced-coef, 53, 38, 26, 1, 2, 120, 0.666626
deduced-coef, 52, 38, 25, 1, 2, 118, 0.666626
deduced-coef, 55, 38, 26, 1, 2, 122, 0.666626
deduced-coef, 52, 38, 25, 1, 2, 118, 0.666626
deduced-coef, 56, 37, 26, 1, 2, 122, 0.666626
deduced-coef, 53, 37, 25, 1, 2, 118, 0.666626
deduced-coef, 53, 38, 25, 1, 2, 119, 0.666626
deduced-coef, 52, 37, 25, 1, 2, 117, 0.666626
deduced-coef, 55, 38, 26, 1, 2, 122, 0.666626
deduced-coef, 52, 38, 25, 1, 2, 118, 0.666626
deduced-coef, 50, 37, 25, 1, 2, 115, 0.666626
deduced-coef, 57, 37, 26, 1, 2, 123, 0.666626
deduced-coef, 54, 37, 25, 1, 2, 119, 0.666626
deduced-coef, 54, 37, 25, 1, 2, 119, 0.666626
deduced-coef, 54, 38, 25, 1, 2, 120, 0.666626
deduced-coef, 57, 37, 26, 1, 2, 123, 0.666626
deduced-coef, 51, 38, 26, 1, 2, 118, 0.666626
deduced-coef, 59, 38, 25, 1, 2, 125, 0.666626
deduced-coef, 53, 38, 25, 1, 2, 119, 0.666626
deduced-coef, 56, 37, 26, 1, 2, 122, 0.666626
deduced-coef, 52, 37, 26, 1, 2, 118, 0.666626
deduced-coef, 53, 37, 25, 1, 2, 118, 0.666626
deduced-coef, 53, 37, 25, 1, 2, 118, 0.666626
deduced-coef, 54, 38, 25, 1, 2, 120, 0.666626
deduced-coef, 53, 38, 25, 1, 2, 119, 0.666626
deduced-coef, 53, 38, 26, 1, 2, 120, 0.666626
deduced-coef, 53, 37, 25, 1, 2, 118, 0.666626
deduced-coef, 52, 38, 25, 1, 2, 118, 0.666626
deduced-coef, 53, 38, 25, 1, 2, 119, 0.666626
deduced-coef, 52, 38, 25, 1, 2, 118, 0.666626
deduced-coef, 52, 38, 25, 1, 2, 118, 0.666626
deduced-coef, 51, 38, 26, 1, 2, 118, 0.666626
deduced-coef, 51, 38, 25, 1, 2, 117, 0.666626
deduced-coef, 52, 38, 26, 1, 2, 119, 0.666626
deduced-coef, 52, 38, 25, 1, 2, 118, 0.666626
deduced-coef, 53, 38, 25, 1, 2, 119, 0.666626
deduced-coef, 53, 37, 25, 1, 2, 118, 0.666626
deduced-coef, 53, 37, 25, 1, 2, 118, 0.666626
deduced-coef, 54, 38, 26, 1, 2, 121, 0.666626
deduced-coef, 53, 38, 25, 1, 2, 119, 0.666626
deduced-coef, 53, 38, 25, 1, 2, 119, 0.666626
deduced-coef, 53, 38, 25, 1, 2, 119, 0.666626
deduced-coef, 57, 38, 25, 1, 2, 123, 0.666626
deduced-coef, 53, 37, 26, 1, 2, 119, 0.666626
deduced-coef, 54, 38, 25, 1, 2, 120, 0.666626
deduced-coef, 54, 38, 25, 1, 2, 120, 0.666626
deduced-coef, 53, 37, 25, 1, 2, 118, 0.666626
deduced-coef, 54, 38, 25, 1, 2, 120, 0.666626
deduced-coef, 54, 38, 26, 1, 2, 121, 0.666626
deduced-coef, 52, 38, 25, 1, 2, 118, 0.666626
deduced-coef, 52, 38, 26, 1, 2, 119, 0.666626
deduced-coef, 60, 37, 26, 1, 2, 126, 0.666626
deduced-coef, 54, 38, 25, 1, 2, 120, 0.666626
deduced-coef, 52, 38, 26, 1, 2, 119, 0.666626
deduced-coef, 53, 38, 25, 1, 2, 119, 0.666626
deduced-coef, 53, 38, 26, 1, 2, 120, 0.666626
deduced-coef, 50, 37, 25, 1, 2, 115, 0.666626
deduced-coef, 50, 37, 25, 1, 2, 115, 0.666626
deduced-coef, 51, 38, 25, 1, 2, 117, 0.666626
deduced-coef, 52, 38, 25, 1, 2, 118, 0.666626
deduced-coef, 53, 38, 25, 1, 2, 119, 0.666626
deduced-coef, 53, 37, 26, 1, 2, 119, 0.666626
deduced-coef, 53, 38, 26, 1, 2, 120, 0.666626
deduced-coef, 51, 38, 26, 1, 2, 118, 0.666626
deduced-coef, 53, 38, 25, 1, 2, 119, 0.666626
deduced-coef, 52, 37, 25, 1, 2, 117, 0.666626
deduced-coef, 54, 37, 25, 1, 2, 119, 0.666626
deduced-coef, 54, 38, 26, 1, 2, 121, 0.666626
deduced-coef, 56, 37, 26, 1, 2, 122, 0.666626
deduced-coef, 53, 38, 25, 1, 2, 119, 0.666626
deduced-coef, 61, 38, 25, 1, 2, 127, 0.666626
deduced-coef, 54, 37, 25, 1, 2, 119, 0.666626
deduced-coef, 54, 37, 25, 1, 2, 119, 0.666626
deduced-coef, 54, 37, 25, 1, 2, 119, 0.666626
deduced-coef, 51, 41, 25, 1, 2, 120, 0.666626
deduced-coef, 54, 37, 25, 1, 2, 119, 0.666626
deduced-coef, 51, 38, 25, 1, 2, 117, 0.666626
deduced-coef, 52, 37, 25, 1, 2, 117, 0.666626
deduced-coef, 53, 37, 25, 1, 2, 118, 0.666626
deduced-coef, 53, 37, 25, 1, 2, 118, 0.666626
deduced-coef, 54, 38, 25, 1, 2, 120, 0.666626
deduced-coef, 51, 38, 25, 1, 2, 117, 0.666626
deduced-coef, 52, 38, 26, 1, 2, 119, 0.666626
deduced-coef, 52, 38, 25, 1, 2, 118, 0.666626
deduced-coef, 53, 37, 25, 1, 2, 118, 0.666626
deduced-coef, 52, 37, 25, 1, 2, 117, 0.666626
deduced-coef, 54, 37, 25, 1, 2, 119, 0.666626
deduced-coef, 54, 37, 25, 1, 2, 119, 0.666626
deduced-coef, 51, 38, 26, 1, 2, 118, 0.666626
deduced-coef, 52, 37, 25, 1, 2, 117, 0.666626
deduced-coef, 54, 37, 25, 1, 2, 119, 0.666626
deduced-coef, 54, 37, 25, 1, 2, 119, 0.666626
deduced-coef, 54, 37, 25, 1, 2, 119, 0.666626
deduced-coef, 50, 38, 25, 1, 2, 116, 0.666626
deduced-coef, 54, 38, 25, 1, 2, 120, 0.666626
deduced-coef, 53, 37, 25, 1, 2, 118, 0.666626
deduced-coef, 57, 38, 25, 1, 2, 123, 0.666626
deduced-coef, 53, 38, 25, 1, 2, 119, 0.666626
deduced-coef, 53, 37, 25, 1, 2, 118, 0.666626
deduced-coef, 62, 38, 25, 1, 2, 128, 0.666626
deduced-coef, 52, 37, 25, 1, 2, 117, 0.666626
deduced-coef, 52, 37, 25, 1, 2, 117, 0.666626
deduced-coef, 52, 37, 25, 1, 2, 117, 0.666626
deduced-coef, 54, 37, 25, 1, 2, 119, 0.666626
deduced-coef, 53, 39, 25, 1, 2, 120, 0.666626
deduced-coef, 52, 38, 25, 1, 2, 118, 0.666626
deduced-coef, 54, 37, 25, 1, 2, 119, 0.666626
deduced-coef, 54, 38, 25, 1, 2, 120, 0.666626
deduced-coef, 53, 37, 25, 1, 2, 118, 0.666626
deduced-coef, 58, 38, 26, 1, 2, 125, 0.666626
deduced-coef, 52, 38, 25, 1, 2, 118, 0.666626
deduced-coef, 53, 38, 25, 1, 2, 119, 0.666626
deduced-coef, 50, 37, 25, 1, 2, 115, 0.666626
deduced-coef, 51, 37, 25, 1, 2, 116, 0.666626
deduced-coef, 54, 38, 26, 1, 2, 121, 0.666626
deduced-coef, 52, 37, 25, 1, 2, 117, 0.666626
deduced-coef, 51, 38, 25, 1, 2, 117, 0.666626
deduced-coef, 52, 38, 25, 1, 2, 118, 0.666626
deduced-coef, 52, 37, 25, 1, 2, 117, 0.666626
deduced-coef, 54, 37, 25, 1, 2, 119, 0.666626
deduced-coef, 54, 38, 25, 1, 2, 120, 0.666626
deduced-coef, 54, 37, 25, 1, 2, 119, 0.666626
deduced-coef, 53, 37, 26, 1, 2, 119, 0.666626
deduced-coef, 53, 37, 25, 1, 2, 118, 0.666626
deduced-coef, 58, 37, 25, 1, 2, 123, 0.666626
deduced-coef, 50, 37, 25, 1, 2, 115, 0.666626
deduced-coef, 50, 37, 25, 1, 2, 115, 0.666626
deduced-coef, 57, 37, 25, 1, 2, 122, 0.666626
deduced-coef, 55, 37, 26, 1, 2, 121, 0.666626
deduced-coef, 52, 37, 26, 1, 2, 118, 0.666626
deduced-coef, 53, 39, 25, 1, 2, 120, 0.666626
deduced-coef, 52, 38, 25, 1, 2, 118, 0.666626
deduced-coef, 53, 37, 25, 1, 2, 118, 0.666626
deduced-coef, 54, 37, 25, 1, 2, 119, 0.666626
deduced-coef, 54, 37, 25, 1, 2, 119, 0.666626
deduced-coef, 53, 37, 26, 1, 2, 119, 0.666626
deduced-coef, 57, 38, 25, 1, 2, 123, 0.666626
deduced-coef, 53, 38, 26, 1, 2, 120, 0.666626
deduced-coef, 52, 38, 25, 1, 2, 118, 0.666626
deduced-coef, 57, 37, 26, 1, 2, 123, 0.666626
deduced-coef, 53, 37, 25, 1, 2, 118, 0.666626
deduced-coef, 53, 37, 26, 1, 2, 119, 0.666626
deduced-coef, 57, 38, 26, 1, 2, 124, 0.666626
deduced-coef, 52, 37, 25, 1, 2, 117, 0.666626
deduced-coef, 50, 37, 25, 1, 2, 115, 0.666626
deduced-coef, 57, 37, 25, 1, 2, 122, 0.666626
deduced-coef, 57, 41, 25, 1, 2, 126, 0.666626
deduced-coef, 55, 38, 25, 1, 2, 121, 0.666626
deduced-coef, 56, 38, 26, 1, 2, 123, 0.666626
deduced-coef, 52, 38, 25, 1, 2, 118, 0.666626
deduced-coef, 51, 38, 26, 1, 2, 118, 0.666626
deduced-coef, 51, 38, 25, 1, 2, 117, 0.666626
deduced-coef, 53, 38, 25, 1, 2, 119, 0.666626
deduced-coef, 53, 38, 26, 1, 2, 120, 0.666626
deduced-coef, 52, 37, 25, 1, 2, 117, 0.666626
deduced-coef, 52, 38, 25, 1, 2, 118, 0.666626
deduced-coef, 53, 37, 25, 1, 2, 118, 0.666626
deduced-coef, 54, 37, 25, 1, 2, 119, 0.666626
deduced-coef, 53, 38, 25, 1, 2, 119, 0.666626
deduced-coef, 53, 37, 25, 1, 2, 118, 0.666626
deduced-coef, 53, 38, 25, 1, 2, 119, 0.666626
deduced-coef, 53, 37, 25, 1, 2, 118, 0.666626
deduced-coef, 52, 37, 25, 1, 2, 117, 0.666626
deduced-coef, 54, 38, 25, 1, 2, 120, 0.666626
deduced-coef, 53, 37, 25, 1, 2, 118, 0.666626
deduced-coef, 50, 38, 25, 1, 2, 116, 0.666626
deduced-coef, 54, 37, 25, 1, 2, 119, 0.666626
deduced-coef, 54, 38, 25, 1, 2, 120, 0.666626
deduced-coef, 53, 37, 25, 1, 2, 118, 0.666626
deduced-coef, 54, 37, 25, 1, 2, 119, 0.666626
deduced-coef, 51, 37, 25, 1, 2, 116, 0.666626
deduced-coef, 53, 38, 26, 1, 2, 120, 0.666626
deduced-coef, 52, 38, 25, 1, 2, 118, 0.666626
deduced-coef, 51, 38, 25, 1, 2, 117, 0.666626
deduced-coef, 52, 37, 26, 1, 2, 118, 0.666626
deduced-coef, 53, 38, 26, 1, 2, 120, 0.666626
deduced-coef, 52, 38, 25, 1, 2, 118, 0.666626
deduced-coef, 53, 37, 26, 1, 2, 119, 0.666626
deduced-coef, 54, 38, 25, 1, 2, 120, 0.666626
deduced-coef, 55, 37, 25, 1, 2, 120, 0.666626
deduced-coef, 53, 38, 25, 1, 2, 119, 0.666626
deduced-coef, 53, 37, 25, 1, 2, 118, 0.666626
deduced-coef, 53, 38, 25, 1, 2, 119, 0.666626
deduced-coef, 56, 38, 26, 1, 2, 123, 0.666626
deduced-coef, 52, 38, 25, 1, 2, 118, 0.666626
deduced-coef, 53, 37, 25, 1, 2, 118, 0.666626
deduced-coef, 54, 37, 25, 1, 2, 119, 0.666626
deduced-coef, 53, 37, 25, 1, 2, 118, 0.666626
deduced-coef, 58, 38, 27, 1, 2, 126, 0.666626
deduced-coef, 51, 37, 25, 1, 2, 116, 0.666626
deduced-coef, 54, 39, 26, 1, 2, 122, 0.666626
deduced-coef, 51, 37, 26, 1, 2, 117, 0.666626
deduced-coef, 53, 37, 25, 1, 2, 118, 0.666626
deduced-coef, 50, 38, 26, 1, 2, 117, 0.666626
deduced-coef, 54, 38, 25, 1, 2, 120, 0.666626
deduced-coef, 53, 38, 25, 1, 2, 119, 0.666626
deduced-coef, 52, 38, 25, 1, 2, 118, 0.666626
deduced-coef, 53, 38, 25, 1, 2, 119, 0.666626
deduced-coef, 57, 38, 25, 1, 2, 123, 0.666626
deduced-coef, 50, 38, 25, 1, 2, 116, 0.666626
deduced-coef, 55, 37, 26, 1, 2, 121, 0.666626
deduced-coef, 53, 38, 25, 1, 2, 119, 0.666626
deduced-coef, 53, 38, 25, 1, 2, 119, 0.666626
deduced-coef, 53, 37, 26, 1, 2, 119, 0.666626
deduced-coef, 50, 37, 25, 1, 2, 115, 0.666626
deduced-coef, 53, 38, 26, 1, 2, 120, 0.666626
deduced-coef, 52, 37, 25, 1, 2, 117, 0.666626
deduced-coef, 54, 38, 25, 1, 2, 120, 0.666626
deduced-coef, 53, 37, 25, 1, 2, 118, 0.666626
deduced-coef, 53, 39, 26, 1, 2, 121, 0.666626
deduced-coef, 57, 37, 25, 1, 2, 122, 0.666626
deduced-coef, 52, 37, 25, 1, 2, 117, 0.666626
deduced-coef, 58, 37, 26, 1, 2, 124, 0.666626
deduced-coef, 53, 38, 25, 1, 2, 119, 0.666626
deduced-coef, 53, 38, 25, 1, 2, 119, 0.666626
deduced-coef, 53, 37, 25, 1, 2, 118, 0.666626
deduced-coef, 54, 38, 25, 1, 2, 120, 0.666626
deduced-coef, 54, 38, 25, 1, 2, 120, 0.666626
deduced-coef, 53, 38, 25, 1, 2, 119, 0.666626
deduced-coef, 54, 38, 25, 1, 2, 120, 0.666626
deduced-coef, 53, 37, 25, 1, 2, 118, 0.666626
deduced-coef, 51, 37, 25, 1, 2, 116, 0.666626
deduced-coef, 53, 37, 25, 1, 2, 118, 0.666626
deduced-coef, 54, 38, 25, 1, 2, 120, 0.666626
deduced-coef, 55, 37, 26, 1, 2, 121, 0.666626
deduced-coef, 52, 38, 25, 1, 2, 118, 0.666626
deduced-coef, 55, 37, 25, 1, 2, 120, 0.666626
deduced-coef, 53, 37, 25, 1, 2, 118, 0.666626
deduced-coef, 58, 38, 25, 1, 2, 124, 0.666626
deduced-coef, 52, 38, 25, 1, 2, 118, 0.666626
deduced-coef, 53, 37, 25, 1, 2, 118, 0.666626
deduced-coef, 51, 37, 25, 1, 2, 116, 0.666626
deduced-coef, 50, 38, 25, 1, 2, 116, 0.666626
deduced-coef, 52, 37, 26, 1, 2, 118, 0.666626
deduced-coef, 53, 37, 25, 1, 2, 118, 0.666626
deduced-coef, 50, 37, 25, 1, 2, 115, 0.666626
deduced-coef, 54, 38, 26, 1, 2, 121, 0.666626
deduced-coef, 56, 38, 26, 1, 2, 123, 0.666626
deduced-coef, 50, 37, 25, 1, 2, 115, 0.666626
deduced-coef, 51, 39, 25, 1, 2, 118, 0.666626
deduced-coef, 52, 37, 25, 1, 2, 117, 0.666626
deduced-coef, 54, 38, 25, 1, 2, 120, 0.666626
deduced-coef, 50, 41, 25, 1, 2, 119, 0.666626
deduced-coef, 53, 38, 25, 1, 2, 119, 0.666626
deduced-coef, 51, 38, 26, 1, 2, 118, 0.666626
deduced-coef, 54, 38, 25, 1, 2, 120, 0.666626
deduced-coef, 53, 38, 25, 1, 2, 119, 0.666626
deduced-coef, 54, 38, 39, 1, 2, 134, 0.666626
deduced-coef, 51, 38, 26, 1, 2, 118, 0.666626
deduced-coef, 56, 38, 27, 1, 2, 124, 0.666626
deduced-coef, 50, 38, 25, 1, 2, 116, 0.666626
deduced-coef, 52, 40, 25, 1, 2, 120, 0.666626
deduced-coef, 54, 38, 25, 1, 2, 120, 0.666626
deduced-coef, 53, 37, 26, 1, 2, 119, 0.666626
deduced-coef, 52, 38, 25, 1, 2, 118, 0.666626
deduced-coef, 53, 37, 25, 1, 2, 118, 0.666626
deduced-coef, 61, 37, 25, 1, 2, 126, 0.666626
deduced-coef, 54, 38, 25, 1, 2, 120, 0.666626
deduced-coef, 53, 37, 25, 1, 2, 118, 0.666626
deduced-coef, 54, 38, 25, 1, 2, 120, 0.666626
deduced-coef, 53, 38, 25, 1, 2, 119, 0.666626
deduced-coef, 57, 37, 25, 1, 2, 122, 0.666626
deduced-coef, 53, 38, 25, 1, 2, 119, 0.666626
deduced-coef, 53, 37, 26, 1, 2, 119, 0.666626
deduced-coef, 53, 37, 25, 1, 2, 118, 0.666626
deduced-coef, 52, 37, 26, 1, 2, 118, 0.666626
deduced-coef, 57, 38, 25, 1, 2, 123, 0.666626
deduced-coef, 53, 38, 25, 1, 2, 119, 0.666626
deduced-coef, 54, 38, 25, 1, 2, 120, 0.666626
deduced-coef, 56, 38, 25, 1, 2, 122, 0.666626
deduced-coef, 58, 38, 25, 1, 2, 124, 0.666626
deduced-coef, 56, 38, 26, 1, 2, 123, 0.666626
deduced-coef, 52, 38, 25, 1, 2, 118, 0.666626
deduced-coef, 54, 38, 26, 1, 2, 121, 0.666626
deduced-coef, 52, 38, 26, 1, 2, 119, 0.666626
deduced-coef, 52, 38, 25, 1, 2, 118, 0.666626
deduced-coef, 53, 38, 25, 1, 2, 119, 0.666626
deduced-coef, 53, 37, 25, 1, 2, 118, 0.666626
deduced-coef, 54, 37, 26, 1, 2, 120, 0.666626
deduced-coef, 52, 37, 25, 1, 2, 117, 0.666626
deduced-coef, 53, 37, 25, 1, 2, 118, 0.666626
deduced-coef, 54, 37, 25, 1, 2, 119, 0.666626
deduced-coef, 53, 38, 25, 1, 2, 119, 0.666626
deduced-coef, 56, 37, 25, 1, 2, 121, 0.666626
deduced-coef, 50, 38, 25, 1, 2, 116, 0.666626
deduced-coef, 56, 38, 27, 1, 2, 124, 0.666626
deduced-coef, 51, 38, 25, 1, 2, 117, 0.666626
deduced-coef, 54, 37, 25, 1, 2, 119, 0.666626
deduced-coef, 53, 38, 25, 1, 2, 119, 0.666626
deduced-coef, 53, 38, 25, 1, 2, 119, 0.666626
deduced-coef, 53, 38, 25, 1, 2, 119, 0.666626
deduced-coef, 53, 38, 25, 1, 2, 119, 0.666626
deduced-coef, 54, 38, 25, 1, 2, 120, 0.666626
deduced-coef, 51, 38, 25, 1, 2, 117, 0.666626
deduced-coef, 51, 38, 25, 1, 2, 117, 0.666626
deduced-coef, 54, 38, 26, 1, 2, 121, 0.666626
deduced-coef, 53, 38, 27, 1, 2, 121, 0.666626
deduced-coef, 55, 38, 25, 1, 2, 121, 0.666626
deduced-coef, 53, 37, 26, 1, 2, 119, 0.666626
deduced-coef, 57, 38, 25, 1, 2, 123, 0.666626
deduced-coef, 53, 37, 25, 1, 2, 118, 0.666626
deduced-coef, 51, 38, 25, 1, 2, 117, 0.666626
deduced-coef, 52, 37, 26, 1, 2, 118, 0.666626
deduced-coef, 55, 38, 26, 1, 2, 122, 0.666626
deduced-coef, 55, 38, 25, 1, 2, 121, 0.666626
deduced-coef, 51, 38, 25, 1, 2, 117, 0.666626
deduced-coef, 53, 38, 25, 1, 2, 119, 0.666626
deduced-coef, 56, 38, 25, 1, 2, 122, 0.666626
deduced-coef, 52, 38, 26, 1, 2, 119, 0.666626
deduced-coef, 53, 38, 25, 1, 2, 119, 0.666626
deduced-coef, 53, 37, 25, 1, 2, 118, 0.666626
deduced-coef, 54, 38, 26, 1, 2, 121, 0.666626
deduced-coef, 50, 38, 25, 1, 2, 116, 0.666626
deduced-coef, 51, 38, 25, 1, 2, 117, 0.666626
deduced-coef, 57, 37, 25, 1, 2, 122, 0.666626
deduced-coef, 50, 38, 25, 1, 2, 116, 0.666626
deduced-coef, 52, 38, 25, 1, 2, 118, 0.666626
deduced-coef, 59, 38, 25, 1, 2, 125, 0.666626
deduced-coef, 56, 38, 27, 1, 2, 124, 0.666626
deduced-coef, 54, 38, 25, 1, 2, 120, 0.666626
deduced-coef, 55, 37, 25, 1, 2, 120, 0.666626
deduced-coef, 52, 38, 25, 1, 2, 118, 0.666626
deduced-coef, 54, 38, 25, 1, 2, 120, 0.666626
deduced-coef, 56, 38, 25, 1, 2, 122, 0.666626
deduced-coef, 53, 38, 25, 1, 2, 119, 0.666626
deduced-coef, 52, 37, 26, 1, 2, 118, 0.666626
deduced-coef, 50, 37, 25, 1, 2, 115, 0.666626
deduced-coef, 52, 37, 26, 1, 2, 118, 0.666626
deduced-coef, 53, 38, 25, 1, 2, 119, 0.666626
deduced-coef, 54, 37, 25, 1, 2, 119, 0.666626
deduced-coef, 53, 37, 26, 1, 2, 119, 0.666626
deduced-coef, 52, 38, 28, 1, 2, 121, 0.666626
deduced-coef, 58, 37, 26, 1, 2, 124, 0.666626
deduced-coef, 53, 38, 25, 1, 2, 119, 0.666626
deduced-coef, 53, 38, 26, 1, 2, 120, 0.666626
deduced-coef, 52, 37, 25, 1, 2, 117, 0.666626
deduced-coef, 51, 37, 25, 1, 2, 116, 0.666626
deduced-coef, 51, 37, 25, 1, 2, 116, 0.666626
deduced-coef, 51, 38, 25, 1, 2, 117, 0.666626
deduced-coef, 54, 38, 25, 1, 2, 120, 0.666626
deduced-coef, 52, 38, 25, 1, 2, 118, 0.666626
deduced-coef, 54, 38, 25, 1, 2, 120, 0.666626
deduced-coef, 52, 38, 25, 1, 2, 118, 0.666626
deduced-coef, 52, 37, 25, 1, 2, 117, 0.666626
deduced-coef, 54, 38, 25, 1, 2, 120, 0.666626
deduced-coef, 53, 38, 25, 1, 2, 119, 0.666626
deduced-coef, 57, 38, 26, 1, 2, 124, 0.666626
deduced-coef, 56, 38, 26, 1, 2, 123, 0.666626
deduced-coef, 52, 38, 25, 1, 2, 118, 0.666626
deduced-coef, 53, 38, 25, 1, 2, 119, 0.666626
deduced-coef, 53, 38, 25, 1, 2, 119, 0.666626
deduced-coef, 54, 38, 25, 1, 2, 120, 0.666626
deduced-coef, 53, 38, 25, 1, 2, 119, 0.666626
deduced-coef, 52, 38, 25, 1, 2, 118, 0.666626
deduced-coef, 52, 38, 25, 1, 2, 118, 0.666626
deduced-coef, 53, 37, 25, 1, 2, 118, 0.666626
deduced-coef, 54, 38, 25, 1, 2, 120, 0.666626
deduced-coef, 53, 37, 25, 1, 2, 118, 0.666626
deduced-coef, 52, 38, 28, 1, 2, 121, 0.666626
deduced-coef, 54, 37, 25, 1, 2, 119, 0.666626
deduced-coef, 55, 38, 25, 1, 2, 121, 0.666626
deduced-coef, 53, 38, 25, 1, 2, 119, 0.666626
deduced-coef, 57, 37, 25, 1, 2, 122, 0.666626
deduced-coef, 53, 38, 25, 1, 2, 119, 0.666626
deduced-coef, 53, 37, 25, 1, 2, 118, 0.666626
deduced-coef, 53, 37, 25, 1, 2, 118, 0.666626
deduced-coef, 50, 37, 25, 1, 2, 115, 0.666626
deduced-coef, 54, 38, 25, 1, 2, 120, 0.666626
deduced-coef, 51, 38, 25, 1, 2, 117, 0.666626
deduced-coef, 51, 37, 25, 1, 2, 116, 0.666626
deduced-coef, 54, 38, 26, 1, 2, 121, 0.666626
deduced-coef, 53, 38, 26, 1, 2, 120, 0.666626
deduced-coef, 52, 38, 25, 1, 2, 118, 0.666626
deduced-coef, 53, 38, 25, 1, 2, 119, 0.666626
deduced-coef, 53, 38, 25, 1, 2, 119, 0.666626
deduced-coef, 52, 37, 25, 1, 2, 117, 0.666626
deduced-coef, 54, 37, 25, 1, 2, 119, 0.666626
deduced-coef, 58, 37, 25, 1, 2, 123, 0.666626
deduced-coef, 54, 37, 25, 1, 2, 119, 0.666626
deduced-coef, 54, 37, 25, 1, 2, 119, 0.666626
deduced-coef, 53, 38, 25, 1, 2, 119, 0.666626
deduced-coef, 56, 38, 25, 1, 2, 122, 0.666626
deduced-coef, 53, 37, 25, 1, 2, 118, 0.666626
deduced-coef, 54, 37, 25, 1, 2, 119, 0.666626
deduced-coef, 54, 38, 25, 1, 2, 120, 0.666626
deduced-coef, 55, 38, 26, 1, 2, 122, 0.666626
deduced-coef, 52, 38, 25, 1, 2, 118, 0.666626
deduced-coef, 52, 38, 25, 1, 2, 118, 0.666626
deduced-coef, 53, 38, 25, 1, 2, 119, 0.666626
deduced-coef, 52, 37, 25, 1, 2, 117, 0.666626
deduced-coef, 54, 37, 25, 1, 2, 119, 0.666626
deduced-coef, 54, 37, 26, 1, 2, 120, 0.666626
deduced-coef, 52, 37, 25, 1, 2, 117, 0.666626
deduced-coef, 54, 37, 25, 1, 2, 119, 0.666626
deduced-coef, 58, 38, 25, 1, 2, 124, 0.666626
deduced-coef, 50, 37, 25, 1, 2, 115, 0.666626
deduced-coef, 52, 38, 26, 1, 2, 119, 0.666626
deduced-coef, 52, 37, 26, 1, 2, 118, 0.666626
deduced-coef, 55, 38, 26, 1, 2, 122, 0.666626
deduced-coef, 51, 38, 25, 1, 2, 117, 0.666626
deduced-coef, 50, 37, 25, 1, 2, 115, 0.666626
deduced-coef, 52, 38, 25, 1, 2, 118, 0.666626
deduced-coef, 53, 37, 25, 1, 2, 118, 0.666626
deduced-coef, 53, 39, 25, 1, 2, 120, 0.666626
deduced-coef, 50, 37, 25, 1, 2, 115, 0.666626
deduced-coef, 52, 38, 25, 1, 2, 118, 0.666626
deduced-coef, 53, 37, 25, 1, 2, 118, 0.666626
deduced-coef, 54, 38, 25, 1, 2, 120, 0.666626
deduced-coef, 53, 38, 25, 1, 2, 119, 0.666626
deduced-coef, 51, 38, 25, 1, 2, 117, 0.666626
deduced-coef, 54, 38, 25, 1, 2, 120, 0.666626
deduced-coef, 53, 38, 25, 1, 2, 119, 0.666626
deduced-coef, 58, 38, 25, 1, 2, 124, 0.666626
deduced-coef, 52, 38, 26, 1, 2, 119, 0.666626
deduced-coef, 51, 37, 25, 1, 2, 116, 0.666626
deduced-coef, 58, 37, 26, 1, 2, 124, 0.666626
deduced-coef, 53, 37, 26, 1, 2, 119, 0.666626
deduced-coef, 53, 39, 25, 1, 2, 120, 0.666626
deduced-coef, 52, 38, 25, 1, 2, 118, 0.666626
deduced-coef, 52, 37, 26, 1, 2, 118, 0.666626
deduced-coef, 53, 38, 25, 1, 2, 119, 0.666626
deduced-coef, 51, 37, 25, 1, 2, 116, 0.666626
deduced-coef, 51, 38, 26, 1, 2, 118, 0.666626
deduced-coef, 51, 37, 25, 1, 2, 116, 0.666626
deduced-coef, 57, 38, 26, 1, 2, 124, 0.666626
deduced-coef, 52, 38, 26, 1, 2, 119, 0.666626
deduced-coef, 51, 38, 25, 1, 2, 117, 0.666626
deduced-coef, 50, 37, 25, 1, 2, 115, 0.666626
deduced-coef, 54, 38, 26, 1, 2, 121, 0.666626
deduced-coef, 56, 37, 25, 1, 2, 121, 0.666626
deduced-coef, 53, 38, 25, 1, 2, 119, 0.666626
deduced-coef, 54, 38, 25, 1, 2, 120, 0.666626
deduced-coef, 54, 38, 25, 1, 2, 120, 0.666626
deduced-coef, 52, 38, 25, 1, 2, 118, 0.666626
deduced-coef, 53, 38, 26, 1, 2, 120, 0.666626
deduced-coef, 53, 38, 26, 1, 2, 120, 0.666626
deduced-coef, 58, 37, 25, 1, 2, 123, 0.666626
deduced-coef, 52, 38, 25, 1, 2, 118, 0.666626
deduced-coef, 53, 37, 25, 1, 2, 118, 0.666626
deduced-coef, 54, 38, 26, 1, 2, 121, 0.666626
deduced-coef, 52, 40, 25, 1, 2, 120, 0.666626
deduced-coef, 55, 38, 26, 1, 2, 122, 0.666626
deduced-coef, 52, 38, 26, 1, 2, 119, 0.666626
deduced-coef, 52, 37, 28, 1, 2, 120, 0.666626
deduced-coef, 54, 37, 25, 1, 2, 119, 0.666626
deduced-coef, 51, 38, 25, 1, 2, 117, 0.666626
deduced-coef, 52, 37, 26, 1, 2, 118, 0.666626
deduced-coef, 53, 37, 25, 1, 2, 118, 0.666626
deduced-coef, 53, 38, 26, 1, 2, 120, 0.666626
deduced-coef, 57, 38, 26, 1, 2, 124, 0.666626
deduced-coef, 51, 37, 25, 1, 2, 116, 0.666626
deduced-coef, 54, 38, 25, 1, 2, 120, 0.666626
deduced-coef, 51, 37, 25, 1, 2, 116, 0.666626
deduced-coef, 53, 38, 25, 1, 2, 119, 0.666626
deduced-coef, 53, 38, 26, 1, 2, 120, 0.666626
deduced-coef, 54, 38, 25, 1, 2, 120, 0.666626
deduced-coef, 56, 37, 25, 1, 2, 121, 0.666626
deduced-coef, 53, 38, 25, 1, 2, 119, 0.666626
deduced-coef, 53, 38, 25, 1, 2, 119, 0.666626
deduced-coef, 52, 37, 25, 1, 2, 117, 0.666626
deduced-coef, 53, 38, 25, 1, 2, 119, 0.666626
deduced-coef, 53, 38, 26, 1, 2, 120, 0.666626
deduced-coef, 51, 38, 25, 1, 2, 117, 0.666626
deduced-coef, 63, 37, 25, 1, 2, 128, 0.666626
deduced-coef, 52, 38, 25, 1, 2, 118, 0.666626
deduced-coef, 53, 38, 26, 1, 2, 120, 0.666626
deduced-coef, 53, 38, 25, 1, 2, 119, 0.666626
deduced-coef, 54, 38, 26, 1, 2, 121, 0.666626
deduced-coef, 52, 37, 25, 1, 2, 117, 0.666626
deduced-coef, 53, 37, 25, 1, 2, 118, 0.666626
deduced-coef, 54, 38, 25, 1, 2, 120, 0.666626
deduced-coef, 55, 38, 26, 1, 2, 122, 0.666626
deduced-coef, 57, 37, 25, 1, 2, 122, 0.666626
deduced-coef, 52, 38, 26, 1, 2, 119, 0.666626
deduced-coef, 52, 38, 25, 1, 2, 118, 0.666626
deduced-coef, 53, 37, 25, 1, 2, 118, 0.666626
deduced-coef, 54, 38, 27, 1, 2, 122, 0.666626
deduced-coef, 53, 38, 25, 1, 2, 119, 0.666626
deduced-coef, 52, 37, 25, 1, 2, 117, 0.666626
deduced-coef, 53, 37, 25, 1, 2, 118, 0.666626
deduced-coef, 53, 37, 25, 1, 2, 118, 0.666626
deduced-coef, 54, 37, 25, 1, 2, 119, 0.666626
deduced-coef, 54, 38, 27, 1, 2, 122, 0.666626
deduced-coef, 52, 38, 25, 1, 2, 118, 0.666626
deduced-coef, 53, 38, 27, 1, 2, 121, 0.666626
deduced-coef, 51, 38, 26, 1, 2, 118, 0.666626
deduced-coef, 51, 38, 25, 1, 2, 117, 0.666626
deduced-coef, 50, 37, 25, 1, 2, 115, 0.666626
deduced-coef, 55, 38, 26, 1, 2, 122, 0.666626
deduced-coef, 52, 38, 25, 1, 2, 118, 0.666626
deduced-coef, 54, 38, 25, 1, 2, 120, 0.666626
deduced-coef, 52, 38, 26, 1, 2, 119, 0.666626
deduced-coef, 51, 37, 25, 1, 2, 116, 0.666626
deduced-coef, 53, 38, 25, 1, 2, 119, 0.666626
deduced-coef, 53, 38, 26, 1, 2, 120, 0.666626
deduced-coef, 53, 38, 25, 1, 2, 119, 0.666626
deduced-coef, 57, 38, 25, 1, 2, 123, 0.666626
deduced-coef, 51, 37, 25, 1, 2, 116, 0.666626
deduced-coef, 54, 37, 25, 1, 2, 119, 0.666626
deduced-coef, 54, 38, 25, 1, 2, 120, 0.666626
deduced-coef, 62, 38, 25, 1, 2, 128, 0.666626
deduced-coef, 57, 38, 25, 1, 2, 123, 0.666626
deduced-coef, 56, 38, 27, 1, 2, 124, 0.666626
deduced-coef, 51, 37, 25, 1, 2, 116, 0.666626
deduced-coef, 54, 37, 25, 1, 2, 119, 0.666626
deduced-coef, 54, 38, 26, 1, 2, 121, 0.666626
deduced-coef, 52, 38, 27, 1, 2, 120, 0.666626
deduced-coef, 53, 38, 26, 1, 2, 120, 0.666626
deduced-coef, 54, 37, 26, 1, 2, 120, 0.666626
deduced-coef, 50, 37, 25, 1, 2, 115, 0.666626
