type, ringDim, setup, encryption, homomorphic, decryption, plaintext, total, value

n8192-coef-sum, 8192, 41, 14, 0, 0, 0, 55, 1.00012
n8192-coef-sum, 8192, 35, 11, 0, 0, 0, 46, 1.00012
n8192-coef-sum, 8192, 35, 11, 0, 0, 0, 46, 1.00012
n8192-coef-sum, 8192, 35, 11, 0, 0, 0, 46, 1.00012
n8192-coef-sum, 8192, 35, 11, 0, 0, 0, 46, 1.00012
n8192-coef-sum, 8192, 35, 11, 0, 0, 0, 46, 1.00012
n8192-coef-sum, 8192, 35, 11, 0, 0, 0, 46, 1.00012
n8192-coef-sum, 8192, 35, 11, 0, 0, 0, 46, 1.00012
n8192-coef-sum, 8192, 35, 11, 0, 0, 0, 46, 1.00012
n8192-coef-sum, 8192, 35, 11, 0, 0, 0, 46, 1.00012
n8192-coef-sum, 8192, 36, 11, 0, 0, 0, 47, 1.00012
n8192-coef-sum, 8192, 35, 11, 0, 0, 0, 46, 1.00012
n8192-coef-sum, 8192, 34, 11, 0, 0, 0, 45, 1.00012
n8192-coef-sum, 8192, 35, 11, 0, 0, 0, 46, 1.00012
n8192-coef-sum, 8192, 35, 11, 0, 0, 0, 46, 1.00012
n8192-coef-sum, 8192, 36, 11, 0, 0, 0, 47, 1.00012
n8192-coef-sum, 8192, 35, 12, 0, 0, 0, 47, 1.00012
n8192-coef-sum, 8192, 35, 11, 0, 0, 0, 46, 1.00012
n8192-coef-sum, 8192, 35, 11, 0, 0, 0, 46, 1.00012
n8192-coef-sum, 8192, 36, 11, 0, 0, 0, 47, 1.00012
n8192-coef-sum, 8192, 35, 11, 0, 0, 0, 46, 1.00012
n8192-coef-sum, 8192, 37, 11, 0, 0, 0, 48, 1.00012
n8192-coef-sum, 8192, 35, 11, 0, 0, 0, 46, 1.00012
n8192-coef-sum, 8192, 35, 11, 0, 0, 0, 46, 1.00012
n8192-coef-sum, 8192, 35, 11, 0, 0, 0, 46, 1.00012
n8192-coef-sum, 8192, 35, 11, 0, 0, 0, 46, 1.00012
n8192-coef-sum, 8192, 34, 11, 0, 0, 0, 45, 1.00012
n8192-coef-sum, 8192, 35, 11, 0, 0, 0, 46, 1.00012
n8192-coef-sum, 8192, 35, 11, 0, 0, 0, 46, 1.00012
n8192-coef-sum, 8192, 35, 11, 0, 0, 0, 46, 1.00012
n8192-coef-sum, 8192, 35, 11, 0, 0, 0, 46, 1.00012
n8192-coef-sum, 8192, 35, 11, 0, 0, 0, 46, 1.00012
n8192-coef-sum, 8192, 37, 11, 0, 0, 0, 48, 1.00012
n8192-coef-sum, 8192, 35, 11, 0, 0, 0, 46, 1.00012
n8192-coef-sum, 8192, 35, 11, 0, 0, 0, 46, 1.00012
n8192-coef-sum, 8192, 35, 11, 0, 0, 0, 46, 1.00012
n8192-coef-sum, 8192, 35, 11, 0, 1, 0, 47, 1.00012
n8192-coef-sum, 8192, 35, 11, 0, 0, 0, 46, 1.00012
n8192-coef-sum, 8192, 47, 137, 32, 79, 0, 295, 1.00012
n8192-coef-sum, 8192, 72, 27, 0, 0, 0, 99, 1.00012
n8192-coef-sum, 8192, 35, 11, 0, 0, 0, 46, 1.00012
n8192-coef-sum, 8192, 35, 11, 0, 0, 0, 46, 1.00012
n8192-coef-sum, 8192, 34, 11, 0, 0, 0, 45, 1.00012
n8192-coef-sum, 8192, 35, 11, 0, 0, 0, 46, 1.00012
n8192-coef-sum, 8192, 35, 11, 0, 0, 0, 46, 1.00012
n8192-coef-sum, 8192, 35, 11, 0, 0, 0, 46, 1.00012
n8192-coef-sum, 8192, 35, 11, 0, 0, 0, 46, 1.00012
n8192-coef-sum, 8192, 35, 11, 0, 0, 0, 46, 1.00012
n8192-coef-sum, 8192, 56, 11, 0, 0, 0, 67, 1.00012
n8192-coef-sum, 8192, 34, 11, 0, 0, 0, 45, 1.00012
n8192-coef-sum, 8192, 35, 11, 0, 0, 0, 46, 1.00012
n8192-coef-sum, 8192, 35, 11, 0, 0, 0, 46, 1.00012
n8192-coef-sum, 8192, 35, 11, 0, 0, 0, 46, 1.00012
n8192-coef-sum, 8192, 35, 11, 0, 0, 0, 46, 1.00012
n8192-coef-sum, 8192, 35, 11, 0, 0, 0, 46, 1.00012
n8192-coef-sum, 8192, 35, 11, 0, 0, 0, 46, 1.00012
n8192-coef-sum, 8192, 35, 11, 0, 0, 0, 46, 1.00012
n8192-coef-sum, 8192, 35, 11, 0, 0, 0, 46, 1.00012
n8192-coef-sum, 8192, 35, 11, 0, 0, 0, 46, 1.00012
n8192-coef-sum, 8192, 35, 11, 0, 0, 0, 46, 1.00012
n8192-coef-sum, 8192, 35, 11, 0, 0, 0, 46, 1.00012
n8192-coef-sum, 8192, 35, 11, 0, 0, 0, 46, 1.00012
n8192-coef-sum, 8192, 35, 11, 0, 0, 0, 46, 1.00012
n8192-coef-sum, 8192, 35, 11, 0, 0, 0, 46, 1.00012
n8192-coef-sum, 8192, 35, 11, 0, 0, 0, 46, 1.00012
n8192-coef-sum, 8192, 35, 11, 0, 0, 0, 46, 1.00012
n8192-coef-sum, 8192, 35, 11, 0, 0, 0, 46, 1.00012
n8192-coef-sum, 8192, 35, 11, 0, 0, 0, 46, 1.00012
n8192-coef-sum, 8192, 35, 11, 0, 0, 0, 46, 1.00012
n8192-coef-sum, 8192, 35, 11, 0, 0, 0, 46, 1.00012
n8192-coef-sum, 8192, 35, 11, 0, 0, 0, 46, 1.00012
n8192-coef-sum, 8192, 35, 11, 0, 0, 0, 46, 1.00012
n8192-coef-sum, 8192, 35, 11, 0, 0, 0, 46, 1.00012
n8192-coef-sum, 8192, 34, 11, 0, 0, 0, 45, 1.00012
n8192-coef-sum, 8192, 35, 11, 0, 0, 0, 46, 1.00012
n8192-coef-sum, 8192, 34, 11, 0, 0, 0, 45, 1.00012
n8192-coef-sum, 8192, 34, 11, 0, 0, 0, 45, 1.00012
n8192-coef-sum, 8192, 34, 11, 0, 0, 0, 45, 1.00012
n8192-coef-sum, 8192, 34, 11, 0, 0, 0, 45, 1.00012
n8192-coef-sum, 8192, 34, 11, 0, 0, 0, 45, 1.00012
n8192-coef-sum, 8192, 35, 11, 0, 0, 0, 46, 1.00012
n8192-coef-sum, 8192, 37, 11, 0, 0, 0, 48, 1.00012
n8192-coef-sum, 8192, 35, 11, 0, 0, 0, 46, 1.00012
n8192-coef-sum, 8192, 34, 11, 0, 0, 0, 45, 1.00012
n8192-coef-sum, 8192, 35, 11, 0, 0, 0, 46, 1.00012
n8192-coef-sum, 8192, 34, 11, 0, 0, 0, 45, 1.00012
n8192-coef-sum, 8192, 34, 11, 0, 0, 0, 45, 1.00012
n8192-coef-sum, 8192, 35, 11, 0, 0, 0, 46, 1.00012
n8192-coef-sum, 8192, 35, 11, 0, 0, 0, 46, 1.00012
n8192-coef-sum, 8192, 34, 11, 0, 0, 0, 45, 1.00012
n8192-coef-sum, 8192, 34, 11, 0, 0, 0, 45, 1.00012
n8192-coef-sum, 8192, 35, 11, 0, 0, 0, 46, 1.00012
n8192-coef-sum, 8192, 36, 11, 0, 0, 0, 47, 1.00012
n8192-coef-sum, 8192, 35, 11, 0, 0, 0, 46, 1.00012
n8192-coef-sum, 8192, 34, 11, 0, 0, 0, 45, 1.00012
n8192-coef-sum, 8192, 34, 11, 0, 0, 0, 45, 1.00012
n8192-coef-sum, 8192, 34, 11, 0, 0, 0, 45, 1.00012
n8192-coef-sum, 8192, 35, 11, 0, 0, 0, 46, 1.00012
n8192-coef-sum, 8192, 34, 11, 0, 0, 0, 45, 1.00012
n8192-coef-sum, 8192, 35, 11, 0, 0, 0, 46, 1.00012
n8192-coef-sum, 4096, 19, 10, 0, 0, 0, 29, 1.00012
n8192-coef-sum, 4096, 19, 10, 0, 0, 0, 29, 1.00012
n8192-coef-sum, 4096, 19, 10, 0, 0, 0, 29, 1.00012
n8192-coef-sum, 4096, 19, 10, 0, 0, 0, 29, 1.00012
n8192-coef-sum, 4096, 19, 10, 0, 0, 0, 29, 1.00012
n8192-coef-sum, 4096, 21, 10, 0, 0, 0, 31, 1.00012
n8192-coef-sum, 4096, 19, 10, 0, 0, 0, 29, 1.00012
n8192-coef-sum, 4096, 19, 10, 0, 0, 0, 29, 1.00012
n8192-coef-sum, 4096, 18, 10, 0, 0, 0, 28, 1.00012
n8192-coef-sum, 4096, 19, 10, 0, 0, 0, 29, 1.00012
n8192-coef-sum, 4096, 19, 10, 0, 0, 0, 29, 1.00012
n8192-coef-sum, 4096, 19, 10, 0, 0, 0, 29, 1.00012
n8192-coef-sum, 4096, 19, 10, 0, 0, 0, 29, 1.00012
n8192-coef-sum, 4096, 19, 10, 0, 0, 0, 29, 1.00012
n8192-coef-sum, 4096, 19, 10, 0, 0, 0, 29, 1.00012
n8192-coef-sum, 4096, 19, 10, 0, 0, 0, 29, 1.00012
n8192-coef-sum, 4096, 19, 10, 0, 0, 0, 29, 1.00012
n8192-coef-sum, 4096, 19, 11, 0, 0, 0, 30, 1.00012
n8192-coef-sum, 4096, 19, 10, 0, 0, 0, 29, 1.00012
n8192-coef-sum, 4096, 19, 11, 0, 0, 0, 30, 1.00012
n8192-coef-sum, 4096, 19, 11, 0, 0, 0, 30, 1.00012
n8192-coef-sum, 4096, 19, 14, 0, 0, 0, 33, 1.00012
n8192-coef-sum, 4096, 19, 10, 0, 0, 0, 29, 1.00012
n8192-coef-sum, 4096, 19, 10, 0, 0, 0, 29, 1.00012
n8192-coef-sum, 4096, 19, 10, 0, 0, 0, 29, 1.00012
n8192-coef-sum, 4096, 19, 10, 0, 0, 0, 29, 1.00012
n8192-coef-sum, 4096, 19, 10, 0, 0, 0, 29, 1.00012
n8192-coef-sum, 4096, 19, 10, 0, 0, 0, 29, 1.00012
n8192-coef-sum, 4096, 19, 10, 0, 0, 0, 29, 1.00012
n8192-coef-sum, 4096, 19, 11, 0, 0, 0, 30, 1.00012
n8192-coef-sum, 4096, 19, 10, 0, 0, 0, 29, 1.00012
n8192-coef-sum, 4096, 19, 10, 0, 0, 0, 29, 1.00012
n8192-coef-sum, 4096, 19, 10, 0, 0, 0, 29, 1.00012
n8192-coef-sum, 4096, 19, 10, 0, 0, 0, 29, 1.00012
n8192-coef-sum, 4096, 19, 10, 0, 0, 0, 29, 1.00012
n8192-coef-sum, 4096, 19, 10, 0, 0, 0, 29, 1.00012
n8192-coef-sum, 4096, 19, 11, 0, 0, 0, 30, 1.00012
n8192-coef-sum, 4096, 19, 10, 0, 0, 0, 29, 1.00012
n8192-coef-sum, 4096, 19, 10, 0, 0, 0, 29, 1.00012
n8192-coef-sum, 4096, 18, 10, 0, 0, 0, 28, 1.00012
n8192-coef-sum, 4096, 19, 11, 0, 0, 0, 30, 1.00012
n8192-coef-sum, 4096, 19, 10, 0, 0, 0, 29, 1.00012
n8192-coef-sum, 4096, 19, 10, 0, 0, 0, 29, 1.00012
n8192-coef-sum, 4096, 19, 10, 0, 0, 0, 29, 1.00012
n8192-coef-sum, 4096, 19, 11, 0, 0, 0, 30, 1.00012
n8192-coef-sum, 4096, 19, 10, 0, 0, 0, 29, 1.00012
n8192-coef-sum, 4096, 19, 10, 0, 0, 0, 29, 1.00012
n8192-coef-sum, 4096, 18, 10, 0, 0, 0, 28, 1.00012
n8192-coef-sum, 4096, 19, 10, 0, 0, 0, 29, 1.00012
n8192-coef-sum, 4096, 18, 10, 0, 0, 0, 28, 1.00012
n8192-coef-sum, 4096, 19, 11, 0, 0, 0, 30, 1.00012
n8192-coef-sum, 4096, 18, 10, 0, 0, 0, 28, 1.00012
n8192-coef-sum, 4096, 19, 10, 0, 0, 0, 29, 1.00012
n8192-coef-sum, 4096, 19, 10, 0, 0, 0, 29, 1.00012
n8192-coef-sum, 4096, 21, 10, 0, 0, 0, 31, 1.00012
n8192-coef-sum, 4096, 19, 10, 0, 0, 0, 29, 1.00012
n8192-coef-sum, 4096, 19, 10, 0, 0, 0, 29, 1.00012
n8192-coef-sum, 4096, 19, 10, 0, 0, 0, 29, 1.00012
n8192-coef-sum, 4096, 18, 10, 0, 0, 0, 28, 1.00012
n8192-coef-sum, 4096, 19, 10, 0, 0, 0, 29, 1.00012
n8192-coef-sum, 4096, 19, 10, 0, 0, 0, 29, 1.00012
n8192-coef-sum, 4096, 18, 10, 0, 0, 0, 28, 1.00012
n8192-coef-sum, 4096, 19, 10, 0, 0, 0, 29, 1.00012
n8192-coef-sum, 4096, 19, 10, 0, 0, 0, 29, 1.00012
n8192-coef-sum, 4096, 32, 11, 0, 0, 0, 43, 1.00012
n8192-coef-sum, 4096, 19, 10, 0, 0, 0, 29, 1.00012
n8192-coef-sum, 4096, 19, 10, 0, 0, 0, 29, 1.00012
n8192-coef-sum, 4096, 19, 10, 0, 0, 0, 29, 1.00012
n8192-coef-sum, 4096, 19, 10, 0, 0, 0, 29, 1.00012
n8192-coef-sum, 4096, 18, 10, 0, 0, 0, 28, 1.00012
n8192-coef-sum, 4096, 21, 11, 0, 0, 0, 32, 1.00012
n8192-coef-sum, 4096, 19, 10, 0, 0, 0, 29, 1.00012
n8192-coef-sum, 4096, 18, 10, 0, 0, 0, 28, 1.00012
n8192-coef-sum, 4096, 19, 10, 0, 0, 0, 29, 1.00012
n8192-coef-sum, 4096, 19, 10, 0, 0, 0, 29, 1.00012
n8192-coef-sum, 4096, 19, 10, 0, 0, 0, 29, 1.00012
n8192-coef-sum, 4096, 19, 11, 0, 0, 0, 30, 1.00012
n8192-coef-sum, 4096, 18, 10, 0, 0, 0, 28, 1.00012
n8192-coef-sum, 4096, 19, 10, 0, 0, 0, 29, 1.00012
n8192-coef-sum, 4096, 19, 10, 0, 0, 0, 29, 1.00012
n8192-coef-sum, 4096, 18, 10, 0, 0, 0, 28, 1.00012
n8192-coef-sum, 4096, 19, 10, 0, 0, 0, 29, 1.00012
n8192-coef-sum, 4096, 19, 10, 0, 0, 0, 29, 1.00012
n8192-coef-sum, 4096, 19, 10, 0, 0, 0, 29, 1.00012
n8192-coef-sum, 4096, 18, 10, 0, 0, 0, 28, 1.00012
n8192-coef-sum, 4096, 19, 10, 0, 0, 0, 29, 1.00012
n8192-coef-sum, 4096, 19, 14, 0, 0, 0, 33, 1.00012
n8192-coef-sum, 4096, 19, 10, 0, 0, 0, 29, 1.00012
n8192-coef-sum, 4096, 19, 10, 0, 0, 0, 29, 1.00012
n8192-coef-sum, 4096, 18, 10, 0, 0, 0, 28, 1.00012
n8192-coef-sum, 4096, 19, 10, 0, 0, 0, 29, 1.00012
n8192-coef-sum, 4096, 19, 11, 0, 0, 0, 30, 1.00012
n8192-coef-sum, 4096, 19, 10, 0, 0, 0, 29, 1.00012
n8192-coef-sum, 4096, 19, 10, 0, 0, 0, 29, 1.00012
n8192-coef-sum, 4096, 18, 10, 0, 0, 0, 28, 1.00012
n8192-coef-sum, 4096, 19, 10, 0, 0, 0, 29, 1.00012
n8192-coef-sum, 4096, 19, 10, 0, 0, 0, 29, 1.00012
n8192-coef-sum, 4096, 19, 10, 0, 0, 0, 29, 1.00012
n8192-coef-sum, 4096, 19, 10, 0, 0, 0, 29, 1.00012
n8192-coef-sum, 4096, 19, 10, 0, 0, 0, 29, 1.00012
n8192-coef-sum, 2048, 11, 10, 0, 0, 0, 21, 1.00012
n8192-coef-sum, 2048, 11, 10, 0, 0, 0, 21, 1.00012
n8192-coef-sum, 2048, 11, 10, 0, 0, 0, 21, 1.00012
n8192-coef-sum, 2048, 11, 10, 0, 0, 0, 21, 1.00012
n8192-coef-sum, 2048, 11, 10, 0, 0, 0, 21, 1.00012
n8192-coef-sum, 2048, 11, 10, 0, 0, 0, 21, 1.00012
n8192-coef-sum, 2048, 11, 10, 0, 0, 0, 21, 1.00012
n8192-coef-sum, 2048, 11, 10, 0, 0, 0, 21, 1.00012
n8192-coef-sum, 2048, 11, 10, 0, 0, 0, 21, 1.00012
n8192-coef-sum, 2048, 11, 10, 0, 0, 0, 21, 1.00012
n8192-coef-sum, 2048, 11, 10, 0, 0, 0, 21, 1.00012
n8192-coef-sum, 2048, 11, 10, 0, 0, 0, 21, 1.00012
n8192-coef-sum, 2048, 11, 10, 0, 0, 0, 21, 1.00012
n8192-coef-sum, 2048, 11, 10, 0, 0, 0, 21, 1.00012
n8192-coef-sum, 2048, 11, 10, 0, 0, 0, 21, 1.00012
n8192-coef-sum, 2048, 11, 10, 0, 0, 0, 21, 1.00012
n8192-coef-sum, 2048, 11, 10, 0, 0, 0, 21, 1.00012
n8192-coef-sum, 2048, 11, 10, 0, 0, 0, 21, 1.00012
n8192-coef-sum, 2048, 11, 10, 0, 0, 0, 21, 1.00012
n8192-coef-sum, 2048, 11, 10, 0, 0, 0, 21, 1.00012
n8192-coef-sum, 2048, 11, 10, 0, 0, 0, 21, 1.00012
n8192-coef-sum, 2048, 11, 10, 0, 0, 0, 21, 1.00012
n8192-coef-sum, 2048, 11, 10, 0, 0, 0, 21, 1.00012
n8192-coef-sum, 2048, 11, 10, 0, 0, 0, 21, 1.00012
n8192-coef-sum, 2048, 11, 10, 0, 0, 0, 21, 1.00012
n8192-coef-sum, 2048, 14, 10, 0, 0, 0, 24, 1.00012
n8192-coef-sum, 2048, 11, 10, 0, 0, 0, 21, 1.00012
n8192-coef-sum, 2048, 11, 10, 0, 0, 0, 21, 1.00012
n8192-coef-sum, 2048, 11, 10, 0, 0, 0, 21, 1.00012
n8192-coef-sum, 2048, 11, 10, 0, 0, 0, 21, 1.00012
n8192-coef-sum, 2048, 11, 10, 0, 0, 0, 21, 1.00012
n8192-coef-sum, 2048, 11, 10, 0, 0, 0, 21, 1.00012
n8192-coef-sum, 2048, 11, 10, 0, 0, 0, 21, 1.00012
n8192-coef-sum, 2048, 11, 10, 0, 0, 0, 21, 1.00012
n8192-coef-sum, 2048, 11, 10, 0, 0, 0, 21, 1.00012
n8192-coef-sum, 2048, 11, 10, 0, 0, 0, 21, 1.00012
n8192-coef-sum, 2048, 11, 10, 0, 0, 0, 21, 1.00012
n8192-coef-sum, 2048, 11, 10, 0, 0, 0, 21, 1.00012
n8192-coef-sum, 2048, 11, 10, 0, 0, 0, 21, 1.00012
n8192-coef-sum, 2048, 11, 10, 0, 0, 0, 21, 1.00012
n8192-coef-sum, 2048, 11, 10, 0, 0, 0, 21, 1.00012
n8192-coef-sum, 2048, 11, 10, 0, 0, 0, 21, 1.00012
n8192-coef-sum, 2048, 11, 10, 0, 0, 0, 21, 1.00012
n8192-coef-sum, 2048, 11, 10, 0, 0, 0, 21, 1.00012
n8192-coef-sum, 2048, 11, 10, 0, 0, 0, 21, 1.00012
n8192-coef-sum, 2048, 11, 10, 0, 0, 0, 21, 1.00012
n8192-coef-sum, 2048, 11, 13, 0, 0, 0, 24, 1.00012
n8192-coef-sum, 2048, 11, 10, 0, 0, 0, 21, 1.00012
n8192-coef-sum, 2048, 11, 10, 0, 0, 0, 21, 1.00012
n8192-coef-sum, 2048, 11, 10, 0, 0, 0, 21, 1.00012
n8192-coef-sum, 2048, 11, 10, 0, 0, 0, 21, 1.00012
n8192-coef-sum, 2048, 11, 10, 0, 0, 0, 21, 1.00012
n8192-coef-sum, 2048, 11, 10, 0, 0, 0, 21, 1.00012
n8192-coef-sum, 2048, 11, 10, 0, 0, 0, 21, 1.00012
n8192-coef-sum, 2048, 11, 10, 0, 0, 0, 21, 1.00012
n8192-coef-sum, 2048, 11, 10, 0, 0, 0, 21, 1.00012
n8192-coef-sum, 2048, 11, 10, 0, 0, 0, 21, 1.00012
n8192-coef-sum, 2048, 11, 10, 0, 0, 0, 21, 1.00012
n8192-coef-sum, 2048, 11, 10, 0, 0, 0, 21, 1.00012
n8192-coef-sum, 2048, 11, 10, 0, 0, 0, 21, 1.00012
n8192-coef-sum, 2048, 11, 10, 0, 0, 0, 21, 1.00012
n8192-coef-sum, 2048, 11, 10, 0, 0, 0, 21, 1.00012
n8192-coef-sum, 2048, 11, 10, 0, 0, 0, 21, 1.00012
n8192-coef-sum, 2048, 11, 10, 0, 0, 0, 21, 1.00012
n8192-coef-sum, 2048, 11, 10, 0, 0, 0, 21, 1.00012
n8192-coef-sum, 2048, 11, 10, 0, 0, 0, 21, 1.00012
n8192-coef-sum, 2048, 11, 10, 0, 0, 0, 21, 1.00012
n8192-coef-sum, 2048, 11, 10, 3, 0, 0, 24, 1.00012
n8192-coef-sum, 2048, 11, 10, 0, 0, 0, 21, 1.00012
n8192-coef-sum, 2048, 11, 10, 0, 0, 0, 21, 1.00012
n8192-coef-sum, 2048, 11, 10, 0, 0, 0, 21, 1.00012
n8192-coef-sum, 2048, 11, 10, 0, 0, 0, 21, 1.00012
n8192-coef-sum, 2048, 11, 10, 0, 0, 0, 21, 1.00012
n8192-coef-sum, 2048, 11, 10, 0, 0, 0, 21, 1.00012
n8192-coef-sum, 2048, 11, 10, 0, 0, 0, 21, 1.00012
n8192-coef-sum, 2048, 11, 10, 0, 0, 0, 21, 1.00012
n8192-coef-sum, 2048, 11, 10, 0, 0, 0, 21, 1.00012
n8192-coef-sum, 2048, 11, 10, 0, 0, 0, 21, 1.00012
n8192-coef-sum, 2048, 11, 10, 0, 0, 0, 21, 1.00012
n8192-coef-sum, 2048, 11, 10, 0, 0, 0, 21, 1.00012
n8192-coef-sum, 2048, 11, 10, 0, 0, 0, 21, 1.00012
n8192-coef-sum, 2048, 11, 10, 0, 0, 0, 21, 1.00012
n8192-coef-sum, 2048, 11, 10, 0, 0, 0, 21, 1.00012
n8192-coef-sum, 2048, 11, 10, 0, 0, 0, 21, 1.00012
n8192-coef-sum, 2048, 11, 10, 0, 0, 0, 21, 1.00012
n8192-coef-sum, 2048, 11, 10, 0, 0, 0, 21, 1.00012
n8192-coef-sum, 2048, 11, 10, 0, 0, 0, 21, 1.00012
n8192-coef-sum, 2048, 11, 10, 0, 0, 0, 21, 1.00012
n8192-coef-sum, 2048, 11, 10, 0, 0, 0, 21, 1.00012
n8192-coef-sum, 2048, 11, 10, 0, 0, 0, 21, 1.00012
n8192-coef-sum, 2048, 11, 10, 0, 0, 0, 21, 1.00012
n8192-coef-sum, 2048, 11, 10, 0, 0, 0, 21, 1.00012
n8192-coef-sum, 2048, 11, 10, 0, 0, 0, 21, 1.00012
n8192-coef-sum, 2048, 11, 10, 0, 0, 0, 21, 1.00012
n8192-coef-sum, 2048, 11, 10, 0, 0, 0, 21, 1.00012
n8192-coef-sum, 2048, 11, 10, 0, 0, 0, 21, 1.00012
n8192-coef-sum, 2048, 11, 10, 0, 0, 0, 21, 1.00012
n8192-coef-sum, 2048, 11, 10, 0, 0, 0, 21, 1.00012
n8192-coef-sum, 2048, 11, 10, 0, 0, 0, 21, 1.00012
n8192-coef-sum, 2048, 12, 11, 0, 0, 0, 23, 1.00012
n8192-coef-sum, 1024, 8, 10, 0, 0, 0, 18, 1.00012
n8192-coef-sum, 1024, 8, 10, 0, 0, 0, 18, 1.00012
n8192-coef-sum, 1024, 7, 10, 0, 0, 0, 17, 1.00012
n8192-coef-sum, 1024, 8, 10, 0, 0, 0, 18, 1.00012
n8192-coef-sum, 1024, 8, 10, 0, 0, 0, 18, 1.00012
n8192-coef-sum, 1024, 7, 10, 0, 0, 0, 17, 1.00012
n8192-coef-sum, 1024, 8, 10, 0, 0, 0, 18, 1.00012
n8192-coef-sum, 1024, 8, 10, 0, 0, 0, 18, 1.00012
n8192-coef-sum, 1024, 8, 10, 0, 0, 0, 18, 1.00012
n8192-coef-sum, 1024, 7, 10, 0, 0, 0, 17, 1.00012
n8192-coef-sum, 1024, 8, 10, 0, 0, 0, 18, 1.00012
n8192-coef-sum, 1024, 7, 13, 0, 0, 0, 20, 1.00012
n8192-coef-sum, 1024, 8, 10, 0, 0, 0, 18, 1.00012
n8192-coef-sum, 1024, 8, 10, 0, 0, 0, 18, 1.00012
n8192-coef-sum, 1024, 7, 10, 0, 0, 0, 17, 1.00012
n8192-coef-sum, 1024, 8, 10, 0, 0, 0, 18, 1.00012
n8192-coef-sum, 1024, 7, 10, 0, 0, 0, 17, 1.00012
n8192-coef-sum, 1024, 8, 10, 0, 0, 0, 18, 1.00012
n8192-coef-sum, 1024, 7, 10, 0, 0, 0, 17, 1.00012
n8192-coef-sum, 1024, 7, 10, 0, 0, 0, 17, 1.00012
n8192-coef-sum, 1024, 7, 10, 0, 0, 0, 17, 1.00012
n8192-coef-sum, 1024, 7, 10, 0, 0, 0, 17, 1.00012
n8192-coef-sum, 1024, 7, 10, 0, 0, 0, 17, 1.00012
n8192-coef-sum, 1024, 7, 10, 0, 0, 0, 17, 1.00012
n8192-coef-sum, 1024, 8, 10, 0, 0, 0, 18, 1.00012
n8192-coef-sum, 1024, 7, 10, 0, 0, 0, 17, 1.00012
n8192-coef-sum, 1024, 7, 10, 0, 0, 0, 17, 1.00012
n8192-coef-sum, 1024, 7, 10, 0, 0, 0, 17, 1.00012
n8192-coef-sum, 1024, 7, 10, 0, 0, 0, 17, 1.00012
n8192-coef-sum, 1024, 7, 10, 0, 0, 0, 17, 1.00012
n8192-coef-sum, 1024, 7, 10, 0, 0, 0, 17, 1.00012
n8192-coef-sum, 1024, 7, 10, 0, 0, 0, 17, 1.00012
n8192-coef-sum, 1024, 8, 10, 0, 0, 0, 18, 1.00012
n8192-coef-sum, 1024, 8, 10, 0, 0, 0, 18, 1.00012
n8192-coef-sum, 1024, 7, 10, 0, 0, 0, 17, 1.00012
n8192-coef-sum, 1024, 7, 10, 0, 0, 0, 17, 1.00012
n8192-coef-sum, 1024, 11, 10, 0, 0, 0, 21, 1.00012
n8192-coef-sum, 1024, 7, 10, 0, 0, 0, 17, 1.00012
n8192-coef-sum, 1024, 7, 10, 0, 0, 0, 17, 1.00012
n8192-coef-sum, 1024, 7, 10, 0, 0, 0, 17, 1.00012
n8192-coef-sum, 1024, 7, 10, 0, 0, 0, 17, 1.00012
n8192-coef-sum, 1024, 7, 10, 0, 0, 0, 17, 1.00012
n8192-coef-sum, 1024, 8, 10, 0, 0, 0, 18, 1.00012
n8192-coef-sum, 1024, 8, 10, 0, 0, 0, 18, 1.00012
n8192-coef-sum, 1024, 8, 10, 0, 0, 0, 18, 1.00012
n8192-coef-sum, 1024, 8, 10, 0, 0, 0, 18, 1.00012
n8192-coef-sum, 1024, 8, 10, 0, 0, 0, 18, 1.00012
n8192-coef-sum, 1024, 8, 10, 0, 0, 0, 18, 1.00012
n8192-coef-sum, 1024, 7, 10, 0, 0, 0, 17, 1.00012
n8192-coef-sum, 1024, 8, 10, 0, 0, 0, 18, 1.00012
n8192-coef-sum, 1024, 8, 10, 0, 0, 0, 18, 1.00012
n8192-coef-sum, 1024, 7, 10, 0, 0, 0, 17, 1.00012
n8192-coef-sum, 1024, 7, 10, 0, 0, 0, 17, 1.00012
n8192-coef-sum, 1024, 7, 10, 0, 0, 0, 17, 1.00012
n8192-coef-sum, 1024, 7, 10, 0, 0, 0, 17, 1.00012
n8192-coef-sum, 1024, 7, 10, 0, 0, 0, 17, 1.00012
n8192-coef-sum, 1024, 7, 10, 0, 0, 0, 17, 1.00012
n8192-coef-sum, 1024, 7, 10, 0, 0, 0, 17, 1.00012
n8192-coef-sum, 1024, 7, 10, 0, 0, 0, 17, 1.00012
n8192-coef-sum, 1024, 7, 10, 0, 0, 0, 17, 1.00012
n8192-coef-sum, 1024, 7, 10, 0, 0, 0, 17, 1.00012
n8192-coef-sum, 1024, 8, 11, 0, 0, 0, 19, 1.00012
n8192-coef-sum, 1024, 8, 10, 0, 0, 0, 18, 1.00012
n8192-coef-sum, 1024, 7, 10, 0, 0, 0, 17, 1.00012
n8192-coef-sum, 1024, 7, 10, 0, 0, 0, 17, 1.00012
n8192-coef-sum, 1024, 7, 10, 0, 0, 0, 17, 1.00012
n8192-coef-sum, 1024, 8, 10, 0, 0, 0, 18, 1.00012
n8192-coef-sum, 1024, 8, 10, 0, 0, 0, 18, 1.00012
n8192-coef-sum, 1024, 8, 10, 0, 0, 0, 18, 1.00012
n8192-coef-sum, 1024, 7, 10, 0, 0, 0, 17, 1.00012
n8192-coef-sum, 1024, 7, 10, 0, 0, 0, 17, 1.00012
n8192-coef-sum, 1024, 7, 12, 0, 0, 0, 19, 1.00012
n8192-coef-sum, 1024, 7, 10, 0, 0, 0, 17, 1.00012
n8192-coef-sum, 1024, 8, 10, 0, 0, 0, 18, 1.00012
n8192-coef-sum, 1024, 7, 10, 0, 0, 0, 17, 1.00012
n8192-coef-sum, 1024, 8, 10, 0, 0, 0, 18, 1.00012
n8192-coef-sum, 1024, 8, 10, 0, 0, 0, 18, 1.00012
n8192-coef-sum, 1024, 7, 10, 0, 0, 0, 17, 1.00012
n8192-coef-sum, 1024, 7, 10, 0, 0, 0, 17, 1.00012
n8192-coef-sum, 1024, 7, 10, 0, 0, 0, 17, 1.00012
n8192-coef-sum, 1024, 8, 10, 0, 0, 0, 18, 1.00012
n8192-coef-sum, 1024, 7, 10, 0, 0, 0, 17, 1.00012
n8192-coef-sum, 1024, 7, 10, 0, 0, 0, 17, 1.00012
n8192-coef-sum, 1024, 8, 10, 0, 0, 0, 18, 1.00012
n8192-coef-sum, 1024, 8, 10, 0, 0, 0, 18, 1.00012
n8192-coef-sum, 1024, 10, 10, 0, 0, 0, 20, 1.00012
n8192-coef-sum, 1024, 7, 10, 0, 0, 0, 17, 1.00012
n8192-coef-sum, 1024, 7, 10, 0, 0, 0, 17, 1.00012
n8192-coef-sum, 1024, 8, 10, 0, 0, 0, 18, 1.00012
n8192-coef-sum, 1024, 7, 10, 0, 0, 0, 17, 1.00012
n8192-coef-sum, 1024, 7, 10, 0, 0, 0, 17, 1.00012
n8192-coef-sum, 1024, 8, 10, 0, 0, 0, 18, 1.00012
n8192-coef-sum, 1024, 7, 10, 0, 0, 0, 17, 1.00012
n8192-coef-sum, 1024, 8, 10, 0, 0, 0, 18, 1.00012
n8192-coef-sum, 1024, 8, 10, 0, 0, 0, 18, 1.00012
n8192-coef-sum, 1024, 7, 10, 0, 0, 0, 17, 1.00012
n8192-coef-sum, 1024, 8, 10, 0, 0, 0, 18, 1.00012
n8192-coef-sum, 1024, 8, 10, 0, 0, 0, 18, 1.00012
n8192-coef-sum, 1024, 8, 10, 0, 0, 0, 18, 1.00012
n8192-coef-sum, 1024, 7, 10, 0, 0, 0, 17, 1.00012
n8192-slot-sum, 8192, 126, 9, 35, 0, 0, 170, 1.00012
n8192-slot-sum, 8192, 129, 9, 35, 1, 0, 174, 1.00012
n8192-slot-sum, 8192, 127, 9, 35, 0, 0, 171, 1.00012
n8192-slot-sum, 8192, 126, 9, 35, 0, 0, 170, 1.00012
n8192-slot-sum, 8192, 128, 9, 35, 0, 0, 172, 1.00012
n8192-slot-sum, 8192, 125, 9, 35, 0, 0, 169, 1.00012
n8192-slot-sum, 8192, 126, 9, 35, 0, 0, 170, 1.00012
n8192-slot-sum, 8192, 126, 9, 35, 0, 0, 170, 1.00012
n8192-slot-sum, 8192, 125, 9, 35, 0, 0, 169, 1.00012
n8192-slot-sum, 8192, 126, 9, 36, 0, 0, 171, 1.00012
n8192-slot-sum, 8192, 126, 9, 36, 0, 0, 171, 1.00012
n8192-slot-sum, 8192, 128, 9, 35, 0, 0, 172, 1.00012
n8192-slot-sum, 8192, 126, 9, 35, 0, 0, 170, 1.00012
n8192-slot-sum, 8192, 125, 9, 35, 0, 0, 169, 1.00012
n8192-slot-sum, 8192, 125, 9, 35, 0, 0, 169, 1.00012
n8192-slot-sum, 8192, 125, 9, 35, 0, 0, 169, 1.00012
n8192-slot-sum, 8192, 127, 9, 35, 0, 0, 171, 1.00012
n8192-slot-sum, 8192, 126, 9, 36, 0, 0, 171, 1.00012
n8192-slot-sum, 8192, 126, 9, 36, 0, 0, 171, 1.00012
n8192-slot-sum, 8192, 126, 9, 35, 0, 0, 170, 1.00012
n8192-slot-sum, 8192, 125, 9, 35, 0, 0, 169, 1.00012
n8192-slot-sum, 8192, 126, 9, 35, 0, 0, 170, 1.00012
n8192-slot-sum, 8192, 126, 9, 35, 0, 0, 170, 1.00012
n8192-slot-sum, 8192, 126, 9, 35, 0, 0, 170, 1.00012
n8192-slot-sum, 8192, 126, 9, 38, 0, 0, 173, 1.00012
n8192-slot-sum, 8192, 125, 9, 35, 0, 0, 169, 1.00012
n8192-slot-sum, 8192, 126, 9, 35, 0, 0, 170, 1.00012
n8192-slot-sum, 8192, 126, 9, 35, 0, 0, 170, 1.00012
n8192-slot-sum, 8192, 129, 9, 35, 0, 0, 173, 1.00012
n8192-slot-sum, 8192, 126, 9, 35, 0, 0, 170, 1.00012
n8192-slot-sum, 8192, 126, 9, 35, 0, 0, 170, 1.00012
n8192-slot-sum, 8192, 129, 9, 35, 0, 0, 173, 1.00012
n8192-slot-sum, 8192, 126, 9, 35, 0, 0, 170, 1.00012
n8192-slot-sum, 8192, 126, 9, 35, 0, 0, 170, 1.00012
n8192-slot-sum, 8192, 126, 9, 39, 0, 0, 174, 1.00012
n8192-slot-sum, 8192, 126, 9, 35, 1, 0, 171, 1.00012
n8192-slot-sum, 8192, 125, 9, 35, 0, 0, 169, 1.00012
n8192-slot-sum, 8192, 127, 9, 35, 0, 0, 171, 1.00012
n8192-slot-sum, 8192, 126, 9, 35, 0, 0, 170, 1.00012
n8192-slot-sum, 8192, 125, 9, 35, 0, 0, 169, 1.00012
n8192-slot-sum, 8192, 124, 9, 35, 0, 0, 168, 1.00012
n8192-slot-sum, 8192, 126, 9, 35, 0, 0, 170, 1.00012
n8192-slot-sum, 8192, 125, 9, 35, 0, 0, 169, 1.00012
n8192-slot-sum, 8192, 126, 9, 36, 0, 0, 171, 1.00012
n8192-slot-sum, 8192, 126, 9, 38, 0, 0, 173, 1.00012
n8192-slot-sum, 8192, 125, 9, 35, 0, 0, 169, 1.00012
n8192-slot-sum, 8192, 126, 9, 35, 0, 0, 170, 1.00012
n8192-slot-sum, 8192, 125, 9, 35, 0, 0, 169, 1.00012
n8192-slot-sum, 8192, 127, 9, 37, 0, 0, 173, 1.00012
n8192-slot-sum, 8192, 126, 9, 35, 0, 0, 170, 1.00012
n8192-slot-sum, 8192, 126, 9, 36, 0, 0, 171, 1.00012
n8192-slot-sum, 8192, 128, 9, 42, 1, 0, 180, 1.00012
n8192-slot-sum, 8192, 126, 9, 35, 0, 0, 170, 1.00012
n8192-slot-sum, 8192, 126, 9, 35, 0, 0, 170, 1.00012
n8192-slot-sum, 8192, 127, 9, 38, 0, 0, 174, 1.00012
n8192-slot-sum, 8192, 126, 9, 35, 0, 0, 170, 1.00012
n8192-slot-sum, 8192, 125, 9, 35, 0, 0, 169, 1.00012
n8192-slot-sum, 8192, 126, 9, 35, 0, 0, 170, 1.00012
n8192-slot-sum, 8192, 126, 9, 35, 0, 0, 170, 1.00012
n8192-slot-sum, 8192, 126, 9, 36, 0, 0, 171, 1.00012
n8192-slot-sum, 8192, 126, 9, 35, 0, 0, 170, 1.00012
n8192-slot-sum, 8192, 128, 9, 42, 1, 0, 180, 1.00012
n8192-slot-sum, 8192, 126, 9, 35, 0, 0, 170, 1.00012
n8192-slot-sum, 8192, 125, 9, 35, 0, 0, 169, 1.00012
n8192-slot-sum, 8192, 125, 9, 35, 0, 0, 169, 1.00012
n8192-slot-sum, 8192, 125, 9, 35, 0, 0, 169, 1.00012
n8192-slot-sum, 8192, 126, 9, 35, 0, 0, 170, 1.00012
n8192-slot-sum, 8192, 125, 9, 35, 0, 0, 169, 1.00012
n8192-slot-sum, 8192, 125, 9, 35, 0, 0, 169, 1.00012
n8192-slot-sum, 8192, 126, 9, 35, 0, 0, 170, 1.00012
n8192-slot-sum, 8192, 125, 9, 36, 0, 0, 170, 1.00012
n8192-slot-sum, 8192, 128, 9, 35, 0, 0, 172, 1.00012
n8192-slot-sum, 8192, 125, 9, 35, 0, 0, 169, 1.00012
n8192-slot-sum, 8192, 125, 9, 35, 0, 0, 169, 1.00012
n8192-slot-sum, 8192, 125, 9, 35, 0, 0, 169, 1.00012
n8192-slot-sum, 8192, 125, 9, 35, 0, 0, 169, 1.00012
n8192-slot-sum, 8192, 126, 9, 35, 0, 0, 170, 1.00012
n8192-slot-sum, 8192, 125, 9, 35, 0, 0, 169, 1.00012
n8192-slot-sum, 8192, 126, 9, 35, 0, 0, 170, 1.00012
n8192-slot-sum, 8192, 125, 9, 35, 0, 0, 169, 1.00012
n8192-slot-sum, 8192, 126, 9, 35, 0, 0, 170, 1.00012
n8192-slot-sum, 8192, 126, 9, 39, 0, 0, 174, 1.00012
n8192-slot-sum, 8192, 125, 9, 35, 0, 0, 169, 1.00012
n8192-slot-sum, 8192, 127, 9, 35, 0, 0, 171, 1.00012
n8192-slot-sum, 8192, 125, 9, 35, 0, 0, 169, 1.00012
n8192-slot-sum, 8192, 128, 9, 35, 0, 0, 172, 1.00012
n8192-slot-sum, 8192, 125, 9, 35, 0, 0, 169, 1.00012
n8192-slot-sum, 8192, 127, 9, 35, 0, 0, 171, 1.00012
n8192-slot-sum, 8192, 126, 9, 35, 0, 0, 170, 1.00012
n8192-slot-sum, 8192, 126, 9, 36, 0, 0, 171, 1.00012
n8192-slot-sum, 8192, 126, 9, 35, 0, 0, 170, 1.00012
n8192-slot-sum, 8192, 126, 9, 38, 0, 0, 173, 1.00012
n8192-slot-sum, 8192, 125, 9, 35, 0, 0, 169, 1.00012
n8192-slot-sum, 8192, 125, 9, 35, 0, 0, 169, 1.00012
n8192-slot-sum, 8192, 125, 9, 35, 0, 0, 169, 1.00012
n8192-slot-sum, 8192, 132, 9, 42, 1, 0, 184, 1.00012
n8192-slot-sum, 8192, 126, 9, 36, 0, 0, 171, 1.00012
n8192-slot-sum, 8192, 127, 9, 35, 0, 0, 171, 1.00012
n8192-slot-sum, 8192, 128, 9, 35, 0, 0, 172, 1.00012
n8192-slot-sum, 8192, 126, 9, 35, 0, 0, 170, 1.00012
n8192-slot-sum, 4096, 60, 7, 16, 0, 0, 83, 1.00012
n8192-slot-sum, 4096, 60, 7, 16, 0, 0, 83, 1.00012
n8192-slot-sum, 4096, 60, 7, 16, 0, 0, 83, 1.00012
n8192-slot-sum, 4096, 63, 7, 16, 0, 0, 86, 1.00012
n8192-slot-sum, 4096, 60, 7, 16, 0, 0, 83, 1.00012
n8192-slot-sum, 4096, 60, 7, 16, 0, 0, 83, 1.00012
n8192-slot-sum, 4096, 60, 7, 16, 0, 0, 83, 1.00012
n8192-slot-sum, 4096, 60, 7, 16, 0, 0, 83, 1.00012
n8192-slot-sum, 4096, 60, 7, 16, 0, 0, 83, 1.00012
n8192-slot-sum, 4096, 60, 7, 16, 0, 0, 83, 1.00012
n8192-slot-sum, 4096, 63, 7, 16, 0, 0, 86, 1.00012
n8192-slot-sum, 4096, 59, 7, 15, 0, 0, 81, 1.00012
n8192-slot-sum, 4096, 59, 7, 16, 0, 0, 82, 1.00012
n8192-slot-sum, 4096, 59, 7, 15, 0, 0, 81, 1.00012
n8192-slot-sum, 4096, 60, 8, 18, 0, 0, 86, 1.00012
n8192-slot-sum, 4096, 60, 7, 16, 0, 0, 83, 1.00012
n8192-slot-sum, 4096, 60, 7, 19, 0, 0, 86, 1.00012
n8192-slot-sum, 4096, 60, 7, 16, 0, 0, 83, 1.00012
n8192-slot-sum, 4096, 60, 7, 15, 0, 0, 82, 1.00012
n8192-slot-sum, 4096, 60, 7, 16, 0, 0, 83, 1.00012
n8192-slot-sum, 4096, 60, 7, 16, 0, 0, 83, 1.00012
n8192-slot-sum, 4096, 60, 7, 15, 0, 0, 82, 1.00012
n8192-slot-sum, 4096, 60, 7, 16, 0, 0, 83, 1.00012
n8192-slot-sum, 4096, 62, 7, 16, 0, 0, 85, 1.00012
n8192-slot-sum, 4096, 60, 7, 16, 0, 0, 83, 1.00012
n8192-slot-sum, 4096, 60, 7, 16, 0, 0, 83, 1.00012
n8192-slot-sum, 4096, 60, 7, 16, 0, 0, 83, 1.00012
n8192-slot-sum, 4096, 72, 8, 18, 0, 0, 98, 1.00012
n8192-slot-sum, 4096, 60, 7, 16, 0, 0, 83, 1.00012
n8192-slot-sum, 4096, 60, 7, 19, 0, 0, 86, 1.00012
n8192-slot-sum, 4096, 59, 7, 16, 0, 0, 82, 1.00012
n8192-slot-sum, 4096, 60, 7, 16, 0, 0, 83, 1.00012
n8192-slot-sum, 4096, 59, 7, 15, 0, 0, 81, 1.00012
n8192-slot-sum, 4096, 59, 7, 16, 0, 0, 82, 1.00012
n8192-slot-sum, 4096, 59, 7, 15, 0, 0, 81, 1.00012
n8192-slot-sum, 4096, 59, 7, 16, 0, 0, 82, 1.00012
n8192-slot-sum, 4096, 61, 7, 15, 0, 0, 83, 1.00012
n8192-slot-sum, 4096, 59, 7, 16, 0, 0, 82, 1.00012
n8192-slot-sum, 4096, 60, 7, 16, 0, 0, 83, 1.00012
n8192-slot-sum, 4096, 59, 7, 15, 0, 0, 81, 1.00012
n8192-slot-sum, 4096, 61, 7, 16, 0, 0, 84, 1.00012
n8192-slot-sum, 4096, 60, 7, 16, 0, 0, 83, 1.00012
n8192-slot-sum, 4096, 60, 7, 16, 0, 0, 83, 1.00012
n8192-slot-sum, 4096, 60, 7, 15, 0, 0, 82, 1.00012
n8192-slot-sum, 4096, 60, 7, 16, 0, 0, 83, 1.00012
n8192-slot-sum, 4096, 65, 7, 16, 0, 0, 88, 1.00012
n8192-slot-sum, 4096, 59, 7, 16, 0, 0, 82, 1.00012
n8192-slot-sum, 4096, 59, 7, 16, 0, 0, 82, 1.00012
n8192-slot-sum, 4096, 59, 7, 16, 0, 0, 82, 1.00012
n8192-slot-sum, 4096, 63, 7, 16, 0, 0, 86, 1.00012
n8192-slot-sum, 4096, 59, 7, 16, 0, 0, 82, 1.00012
n8192-slot-sum, 4096, 61, 7, 16, 0, 0, 84, 1.00012
n8192-slot-sum, 4096, 59, 7, 16, 0, 0, 82, 1.00012
n8192-slot-sum, 4096, 60, 7, 16, 0, 0, 83, 1.00012
n8192-slot-sum, 4096, 59, 7, 15, 0, 0, 81, 1.00012
n8192-slot-sum, 4096, 60, 7, 16, 0, 0, 83, 1.00012
n8192-slot-sum, 4096, 63, 7, 15, 0, 0, 85, 1.00012
n8192-slot-sum, 4096, 60, 7, 16, 0, 0, 83, 1.00012
n8192-slot-sum, 4096, 59, 7, 16, 0, 0, 82, 1.00012
n8192-slot-sum, 4096, 60, 7, 16, 0, 0, 83, 1.00012
n8192-slot-sum, 4096, 60, 7, 16, 0, 0, 83, 1.00012
n8192-slot-sum, 4096, 60, 7, 16, 0, 0, 83, 1.00012
n8192-slot-sum, 4096, 60, 7, 19, 0, 0, 86, 1.00012
n8192-slot-sum, 4096, 59, 7, 16, 0, 0, 82, 1.00012
n8192-slot-sum, 4096, 59, 7, 16, 0, 0, 82, 1.00012
n8192-slot-sum, 4096, 60, 7, 16, 0, 0, 83, 1.00012
n8192-slot-sum, 4096, 59, 7, 15, 0, 0, 81, 1.00012
n8192-slot-sum, 4096, 60, 7, 16, 0, 0, 83, 1.00012
n8192-slot-sum, 4096, 60, 7, 16, 0, 0, 83, 1.00012
n8192-slot-sum, 4096, 61, 7, 15, 0, 0, 83, 1.00012
n8192-slot-sum, 4096, 60, 7, 16, 0, 0, 83, 1.00012
n8192-slot-sum, 4096, 60, 7, 15, 0, 0, 82, 1.00012
n8192-slot-sum, 4096, 59, 7, 15, 0, 0, 81, 1.00012
n8192-slot-sum, 4096, 60, 7, 16, 0, 0, 83, 1.00012
n8192-slot-sum, 4096, 59, 7, 16, 0, 0, 82, 1.00012
n8192-slot-sum, 4096, 60, 7, 16, 0, 0, 83, 1.00012
n8192-slot-sum, 4096, 60, 7, 15, 0, 0, 82, 1.00012
n8192-slot-sum, 4096, 60, 7, 16, 0, 0, 83, 1.00012
n8192-slot-sum, 4096, 60, 7, 15, 0, 0, 82, 1.00012
n8192-slot-sum, 4096, 59, 7, 16, 0, 0, 82, 1.00012
n8192-slot-sum, 4096, 59, 7, 15, 0, 0, 81, 1.00012
n8192-slot-sum, 4096, 59, 7, 16, 0, 0, 82, 1.00012
n8192-slot-sum, 4096, 60, 9, 15, 0, 0, 84, 1.00012
n8192-slot-sum, 4096, 59, 7, 16, 0, 0, 82, 1.00012
n8192-slot-sum, 4096, 60, 7, 16, 0, 0, 83, 1.00012
n8192-slot-sum, 4096, 60, 7, 16, 0, 0, 83, 1.00012
n8192-slot-sum, 4096, 60, 7, 16, 0, 0, 83, 1.00012
n8192-slot-sum, 4096, 59, 7, 16, 0, 0, 82, 1.00012
n8192-slot-sum, 4096, 60, 7, 16, 0, 0, 83, 1.00012
n8192-slot-sum, 4096, 63, 7, 16, 0, 0, 86, 1.00012
n8192-slot-sum, 4096, 60, 7, 16, 0, 0, 83, 1.00012
n8192-slot-sum, 4096, 60, 7, 15, 0, 0, 82, 1.00012
n8192-slot-sum, 4096, 60, 7, 16, 0, 0, 83, 1.00012
n8192-slot-sum, 4096, 59, 7, 16, 0, 0, 82, 1.00012
n8192-slot-sum, 4096, 60, 7, 16, 0, 0, 83, 1.00012
n8192-slot-sum, 4096, 60, 7, 19, 0, 0, 86, 1.00012
n8192-slot-sum, 4096, 59, 7, 16, 0, 0, 82, 1.00012
n8192-slot-sum, 4096, 59, 7, 16, 0, 0, 82, 1.00012
n8192-slot-sum, 4096, 59, 7, 15, 0, 0, 81, 1.00012
n8192-slot-sum, 4096, 59, 7, 16, 0, 0, 82, 1.00012
n8192-slot-sum, 2048, 29, 6, 7, 0, 0, 42, 1.00012
n8192-slot-sum, 2048, 30, 6, 7, 0, 0, 43, 1.00012
n8192-slot-sum, 2048, 29, 6, 7, 0, 0, 42, 1.00012
n8192-slot-sum, 2048, 30, 6, 7, 0, 0, 43, 1.00012
n8192-slot-sum, 2048, 32, 6, 7, 0, 0, 45, 1.00012
n8192-slot-sum, 2048, 29, 6, 7, 0, 0, 42, 1.00012
n8192-slot-sum, 2048, 30, 6, 7, 0, 0, 43, 1.00012
n8192-slot-sum, 2048, 29, 6, 7, 0, 0, 42, 1.00012
n8192-slot-sum, 2048, 29, 6, 7, 0, 0, 42, 1.00012
n8192-slot-sum, 2048, 29, 6, 7, 0, 0, 42, 1.00012
n8192-slot-sum, 2048, 30, 6, 7, 0, 0, 43, 1.00012
n8192-slot-sum, 2048, 30, 6, 7, 0, 0, 43, 1.00012
n8192-slot-sum, 2048, 30, 6, 7, 0, 0, 43, 1.00012
n8192-slot-sum, 2048, 29, 6, 7, 0, 0, 42, 1.00012
n8192-slot-sum, 2048, 29, 6, 7, 0, 0, 42, 1.00012
n8192-slot-sum, 2048, 30, 6, 7, 0, 0, 43, 1.00012
n8192-slot-sum, 2048, 33, 6, 7, 0, 0, 46, 1.00012
n8192-slot-sum, 2048, 30, 6, 7, 0, 0, 43, 1.00012
n8192-slot-sum, 2048, 30, 6, 7, 0, 0, 43, 1.00012
n8192-slot-sum, 2048, 29, 6, 7, 0, 0, 42, 1.00012
n8192-slot-sum, 2048, 29, 6, 7, 0, 0, 42, 1.00012
n8192-slot-sum, 2048, 30, 6, 7, 0, 0, 43, 1.00012
n8192-slot-sum, 2048, 29, 6, 7, 0, 0, 42, 1.00012
n8192-slot-sum, 2048, 30, 6, 7, 0, 0, 43, 1.00012
n8192-slot-sum, 2048, 30, 6, 7, 0, 0, 43, 1.00012
n8192-slot-sum, 2048, 29, 6, 7, 0, 0, 42, 1.00012
n8192-slot-sum, 2048, 29, 6, 7, 0, 0, 42, 1.00012
n8192-slot-sum, 2048, 30, 6, 7, 0, 0, 43, 1.00012
n8192-slot-sum, 2048, 32, 6, 7, 0, 0, 45, 1.00012
n8192-slot-sum, 2048, 30, 6, 7, 0, 0, 43, 1.00012
n8192-slot-sum, 2048, 29, 6, 7, 0, 0, 42, 1.00012
n8192-slot-sum, 2048, 30, 6, 7, 0, 0, 43, 1.00012
n8192-slot-sum, 2048, 30, 6, 7, 0, 0, 43, 1.00012
n8192-slot-sum, 2048, 29, 6, 7, 0, 0, 42, 1.00012
n8192-slot-sum, 2048, 29, 6, 7, 0, 0, 42, 1.00012
n8192-slot-sum, 2048, 30, 6, 7, 0, 0, 43, 1.00012
n8192-slot-sum, 2048, 30, 6, 7, 0, 0, 43, 1.00012
n8192-slot-sum, 2048, 30, 6, 7, 0, 0, 43, 1.00012
n8192-slot-sum, 2048, 30, 6, 7, 0, 0, 43, 1.00012
n8192-slot-sum, 2048, 29, 6, 7, 0, 0, 42, 1.00012
n8192-slot-sum, 2048, 32, 6, 7, 0, 0, 45, 1.00012
n8192-slot-sum, 2048, 30, 6, 7, 0, 0, 43, 1.00012
n8192-slot-sum, 2048, 29, 6, 7, 0, 0, 42, 1.00012
n8192-slot-sum, 2048, 29, 6, 7, 0, 0, 42, 1.00012
n8192-slot-sum, 2048, 29, 6, 7, 0, 0, 42, 1.00012
n8192-slot-sum, 2048, 29, 6, 7, 0, 0, 42, 1.00012
n8192-slot-sum, 2048, 29, 6, 7, 0, 0, 42, 1.00012
n8192-slot-sum, 2048, 29, 6, 7, 0, 0, 42, 1.00012
n8192-slot-sum, 2048, 29, 6, 7, 0, 0, 42, 1.00012
n8192-slot-sum, 2048, 29, 6, 7, 0, 0, 42, 1.00012
n8192-slot-sum, 2048, 29, 6, 7, 0, 0, 42, 1.00012
n8192-slot-sum, 2048, 30, 6, 7, 0, 0, 43, 1.00012
n8192-slot-sum, 2048, 32, 7, 8, 0, 0, 47, 1.00012
n8192-slot-sum, 2048, 29, 6, 7, 0, 0, 42, 1.00012
n8192-slot-sum, 2048, 30, 6, 7, 0, 0, 43, 1.00012
n8192-slot-sum, 2048, 30, 6, 7, 0, 0, 43, 1.00012
n8192-slot-sum, 2048, 29, 6, 7, 0, 0, 42, 1.00012
n8192-slot-sum, 2048, 29, 6, 7, 0, 0, 42, 1.00012
n8192-slot-sum, 2048, 29, 6, 7, 0, 0, 42, 1.00012
n8192-slot-sum, 2048, 30, 6, 7, 0, 0, 43, 1.00012
n8192-slot-sum, 2048, 30, 6, 7, 0, 0, 43, 1.00012
n8192-slot-sum, 2048, 29, 6, 7, 0, 0, 42, 1.00012
n8192-slot-sum, 2048, 29, 6, 7, 0, 0, 42, 1.00012
n8192-slot-sum, 2048, 30, 6, 7, 0, 0, 43, 1.00012
n8192-slot-sum, 2048, 30, 6, 7, 0, 0, 43, 1.00012
n8192-slot-sum, 2048, 30, 6, 7, 0, 0, 43, 1.00012
n8192-slot-sum, 2048, 30, 6, 7, 0, 0, 43, 1.00012
n8192-slot-sum, 2048, 30, 6, 7, 0, 0, 43, 1.00012
n8192-slot-sum, 2048, 30, 6, 7, 0, 0, 43, 1.00012
n8192-slot-sum, 2048, 29, 6, 7, 0, 0, 42, 1.00012
n8192-slot-sum, 2048, 29, 6, 7, 0, 0, 42, 1.00012
n8192-slot-sum, 2048, 29, 6, 7, 0, 0, 42, 1.00012
n8192-slot-sum, 2048, 30, 6, 7, 0, 0, 43, 1.00012
n8192-slot-sum, 2048, 30, 6, 7, 0, 0, 43, 1.00012
n8192-slot-sum, 2048, 30, 6, 7, 0, 0, 43, 1.00012
n8192-slot-sum, 2048, 30, 6, 7, 0, 0, 43, 1.00012
n8192-slot-sum, 2048, 29, 6, 7, 0, 0, 42, 1.00012
n8192-slot-sum, 2048, 31, 6, 7, 0, 0, 44, 1.00012
n8192-slot-sum, 2048, 29, 6, 7, 0, 0, 42, 1.00012
n8192-slot-sum, 2048, 29, 6, 7, 0, 0, 42, 1.00012
n8192-slot-sum, 2048, 30, 6, 7, 0, 0, 43, 1.00012
n8192-slot-sum, 2048, 29, 6, 7, 0, 0, 42, 1.00012
n8192-slot-sum, 2048, 30, 6, 7, 0, 0, 43, 1.00012
n8192-slot-sum, 2048, 29, 6, 7, 0, 0, 42, 1.00012
n8192-slot-sum, 2048, 30, 6, 7, 0, 0, 43, 1.00012
n8192-slot-sum, 2048, 30, 6, 7, 0, 0, 43, 1.00012
n8192-slot-sum, 2048, 30, 6, 7, 0, 0, 43, 1.00012
n8192-slot-sum, 2048, 29, 6, 10, 0, 0, 45, 1.00012
n8192-slot-sum, 2048, 29, 6, 7, 0, 0, 42, 1.00012
n8192-slot-sum, 2048, 29, 6, 7, 0, 0, 42, 1.00012
n8192-slot-sum, 2048, 30, 6, 7, 0, 0, 43, 1.00012
n8192-slot-sum, 2048, 30, 6, 7, 0, 0, 43, 1.00012
n8192-slot-sum, 2048, 30, 6, 7, 0, 0, 43, 1.00012
n8192-slot-sum, 2048, 30, 6, 7, 0, 0, 43, 1.00012
n8192-slot-sum, 2048, 30, 6, 7, 0, 0, 43, 1.00012
n8192-slot-sum, 2048, 30, 6, 7, 0, 0, 43, 1.00012
n8192-slot-sum, 2048, 29, 6, 7, 0, 0, 42, 1.00012
n8192-slot-sum, 2048, 30, 6, 7, 0, 0, 43, 1.00012
n8192-slot-sum, 2048, 29, 6, 7, 0, 0, 42, 1.00012
n8192-slot-sum, 2048, 29, 9, 7, 0, 0, 45, 1.00012
n8192-slot-sum, 1024, 16, 5, 3, 0, 0, 24, 1.00012
n8192-slot-sum, 1024, 16, 6, 3, 0, 0, 25, 1.00012
n8192-slot-sum, 1024, 16, 5, 3, 0, 0, 24, 1.00012
n8192-slot-sum, 1024, 16, 6, 3, 0, 0, 25, 1.00012
n8192-slot-sum, 1024, 16, 6, 3, 0, 0, 25, 1.00012
n8192-slot-sum, 1024, 16, 6, 3, 0, 0, 25, 1.00012
n8192-slot-sum, 1024, 16, 6, 3, 0, 0, 25, 1.00012
n8192-slot-sum, 1024, 16, 6, 3, 0, 0, 25, 1.00012
n8192-slot-sum, 1024, 16, 6, 3, 0, 0, 25, 1.00012
n8192-slot-sum, 1024, 16, 6, 3, 0, 0, 25, 1.00012
n8192-slot-sum, 1024, 16, 6, 3, 0, 0, 25, 1.00012
n8192-slot-sum, 1024, 16, 5, 3, 0, 0, 24, 1.00012
n8192-slot-sum, 1024, 16, 6, 3, 0, 0, 25, 1.00012
n8192-slot-sum, 1024, 16, 5, 3, 0, 0, 24, 1.00012
n8192-slot-sum, 1024, 16, 6, 3, 0, 0, 25, 1.00012
n8192-slot-sum, 1024, 16, 6, 3, 0, 0, 25, 1.00012
n8192-slot-sum, 1024, 17, 5, 3, 0, 0, 25, 1.00012
n8192-slot-sum, 1024, 16, 5, 3, 0, 0, 24, 1.00012
n8192-slot-sum, 1024, 19, 5, 3, 0, 0, 27, 1.00012
n8192-slot-sum, 1024, 16, 6, 3, 0, 0, 25, 1.00012
n8192-slot-sum, 1024, 16, 5, 3, 0, 0, 24, 1.00012
n8192-slot-sum, 1024, 16, 6, 3, 0, 0, 25, 1.00012
n8192-slot-sum, 1024, 16, 6, 3, 0, 0, 25, 1.00012
n8192-slot-sum, 1024, 16, 6, 3, 0, 0, 25, 1.00012
n8192-slot-sum, 1024, 16, 6, 3, 0, 0, 25, 1.00012
n8192-slot-sum, 1024, 16, 6, 3, 0, 0, 25, 1.00012
n8192-slot-sum, 1024, 16, 5, 3, 0, 0, 24, 1.00012
n8192-slot-sum, 1024, 16, 6, 3, 0, 0, 25, 1.00012
n8192-slot-sum, 1024, 16, 6, 3, 0, 0, 25, 1.00012
n8192-slot-sum, 1024, 16, 6, 3, 0, 0, 25, 1.00012
n8192-slot-sum, 1024, 16, 6, 3, 0, 0, 25, 1.00012
n8192-slot-sum, 1024, 16, 6, 3, 0, 0, 25, 1.00012
n8192-slot-sum, 1024, 16, 6, 3, 0, 0, 25, 1.00012
n8192-slot-sum, 1024, 16, 5, 3, 0, 0, 24, 1.00012
n8192-slot-sum, 1024, 16, 6, 3, 0, 0, 25, 1.00012
n8192-slot-sum, 1024, 16, 6, 3, 0, 0, 25, 1.00012
n8192-slot-sum, 1024, 16, 6, 3, 0, 0, 25, 1.00012
n8192-slot-sum, 1024, 16, 5, 3, 0, 0, 24, 1.00012
n8192-slot-sum, 1024, 16, 6, 3, 0, 0, 25, 1.00012
n8192-slot-sum, 1024, 16, 5, 3, 0, 0, 24, 1.00012
n8192-slot-sum, 1024, 16, 6, 3, 0, 0, 25, 1.00012
n8192-slot-sum, 1024, 16, 6, 3, 0, 0, 25, 1.00012
n8192-slot-sum, 1024, 16, 5, 3, 0, 0, 24, 1.00012
n8192-slot-sum, 1024, 16, 5, 3, 0, 0, 24, 1.00012
n8192-slot-sum, 1024, 16, 5, 3, 0, 0, 24, 1.00012
n8192-slot-sum, 1024, 16, 6, 3, 0, 0, 25, 1.00012
n8192-slot-sum, 1024, 16, 5, 3, 0, 0, 24, 1.00012
n8192-slot-sum, 1024, 16, 6, 3, 0, 0, 25, 1.00012
n8192-slot-sum, 1024, 16, 6, 3, 0, 0, 25, 1.00012
n8192-slot-sum, 1024, 16, 6, 3, 0, 0, 25, 1.00012
n8192-slot-sum, 1024, 16, 5, 3, 0, 0, 24, 1.00012
n8192-slot-sum, 1024, 16, 6, 3, 0, 0, 25, 1.00012
n8192-slot-sum, 1024, 16, 5, 3, 0, 0, 24, 1.00012
n8192-slot-sum, 1024, 16, 5, 3, 0, 0, 24, 1.00012
n8192-slot-sum, 1024, 16, 5, 3, 0, 0, 24, 1.00012
n8192-slot-sum, 1024, 16, 6, 3, 0, 0, 25, 1.00012
n8192-slot-sum, 1024, 16, 6, 3, 0, 0, 25, 1.00012
n8192-slot-sum, 1024, 16, 6, 3, 0, 0, 25, 1.00012
n8192-slot-sum, 1024, 16, 6, 3, 0, 0, 25, 1.00012
n8192-slot-sum, 1024, 16, 6, 3, 0, 0, 25, 1.00012
n8192-slot-sum, 1024, 16, 6, 3, 0, 0, 25, 1.00012
n8192-slot-sum, 1024, 16, 6, 3, 0, 0, 25, 1.00012
n8192-slot-sum, 1024, 16, 6, 3, 0, 0, 25, 1.00012
n8192-slot-sum, 1024, 16, 5, 3, 0, 0, 24, 1.00012
n8192-slot-sum, 1024, 16, 6, 3, 0, 0, 25, 1.00012
n8192-slot-sum, 1024, 16, 5, 3, 0, 0, 24, 1.00012
n8192-slot-sum, 1024, 16, 5, 3, 0, 0, 24, 1.00012
n8192-slot-sum, 1024, 16, 5, 3, 0, 0, 24, 1.00012
n8192-slot-sum, 1024, 16, 5, 3, 0, 0, 24, 1.00012
n8192-slot-sum, 1024, 16, 5, 3, 0, 0, 24, 1.00012
n8192-slot-sum, 1024, 16, 6, 3, 0, 0, 25, 1.00012
n8192-slot-sum, 1024, 16, 6, 3, 0, 0, 25, 1.00012
n8192-slot-sum, 1024, 16, 6, 3, 0, 0, 25, 1.00012
n8192-slot-sum, 1024, 16, 6, 3, 0, 0, 25, 1.00012
n8192-slot-sum, 1024, 16, 6, 6, 0, 0, 28, 1.00012
n8192-slot-sum, 1024, 16, 6, 3, 0, 0, 25, 1.00012
n8192-slot-sum, 1024, 16, 5, 3, 0, 0, 24, 1.00012
n8192-slot-sum, 1024, 16, 6, 3, 0, 0, 25, 1.00012
n8192-slot-sum, 1024, 16, 5, 3, 0, 0, 24, 1.00012
n8192-slot-sum, 1024, 16, 5, 3, 0, 0, 24, 1.00012
n8192-slot-sum, 1024, 16, 5, 3, 0, 0, 24, 1.00012
n8192-slot-sum, 1024, 16, 5, 3, 0, 0, 24, 1.00012
n8192-slot-sum, 1024, 16, 6, 3, 0, 0, 25, 1.00012
n8192-slot-sum, 1024, 16, 6, 3, 0, 0, 25, 1.00012
n8192-slot-sum, 1024, 16, 6, 3, 0, 0, 25, 1.00012
n8192-slot-sum, 1024, 16, 6, 3, 0, 0, 25, 1.00012
n8192-slot-sum, 1024, 16, 6, 3, 0, 0, 25, 1.00012
n8192-slot-sum, 1024, 16, 6, 3, 0, 0, 25, 1.00012
n8192-slot-sum, 1024, 16, 5, 3, 0, 0, 24, 1.00012
n8192-slot-sum, 1024, 16, 5, 3, 0, 0, 24, 1.00012
n8192-slot-sum, 1024, 15, 5, 3, 0, 0, 23, 1.00012
n8192-slot-sum, 1024, 16, 6, 3, 0, 0, 25, 1.00012
n8192-slot-sum, 1024, 16, 5, 3, 0, 0, 24, 1.00012
n8192-slot-sum, 1024, 16, 6, 6, 0, 0, 28, 1.00012
n8192-slot-sum, 1024, 16, 5, 3, 0, 0, 24, 1.00012
n8192-slot-sum, 1024, 16, 5, 3, 0, 0, 24, 1.00012
n8192-slot-sum, 1024, 16, 5, 3, 0, 0, 24, 1.00012
n8192-slot-sum, 1024, 16, 5, 3, 0, 0, 24, 1.00012
n8192-slot-sum, 1024, 16, 5, 3, 0, 0, 24, 1.00012
n8192-slot-sum, 1024, 16, 6, 3, 0, 0, 25, 1.00012
n8192-slot-inner, 8192, 133, 9, 44, 0, 0, 186, 13655
n8192-slot-inner, 8192, 134, 9, 44, 0, 0, 187, 13655
n8192-slot-inner, 8192, 135, 9, 44, 0, 0, 188, 13655
n8192-slot-inner, 8192, 134, 9, 44, 0, 0, 187, 13655
n8192-slot-inner, 8192, 133, 9, 44, 0, 0, 186, 13655
n8192-slot-inner, 8192, 134, 9, 44, 0, 0, 187, 13655
n8192-slot-inner, 8192, 133, 9, 44, 0, 0, 186, 13655
n8192-slot-inner, 8192, 133, 9, 45, 0, 0, 187, 13655
n8192-slot-inner, 8192, 135, 9, 44, 0, 0, 188, 13655
n8192-slot-inner, 8192, 133, 9, 44, 0, 0, 186, 13655
n8192-slot-inner, 8192, 134, 9, 45, 0, 0, 188, 13655
n8192-slot-inner, 8192, 133, 9, 45, 0, 0, 187, 13655
n8192-slot-inner, 8192, 134, 9, 44, 0, 0, 187, 13655
n8192-slot-inner, 8192, 134, 9, 45, 0, 0, 188, 13655
n8192-slot-inner, 8192, 134, 9, 44, 0, 0, 187, 13655
n8192-slot-inner, 8192, 134, 9, 44, 0, 0, 187, 13655
n8192-slot-inner, 8192, 134, 9, 44, 0, 0, 187, 13655
n8192-slot-inner, 8192, 133, 9, 45, 0, 0, 187, 13655
n8192-slot-inner, 8192, 133, 9, 44, 0, 0, 186, 13655
n8192-slot-inner, 8192, 134, 9, 44, 0, 0, 187, 13655
n8192-slot-inner, 8192, 133, 9, 44, 0, 0, 186, 13655
n8192-slot-inner, 8192, 132, 9, 44, 0, 0, 185, 13655
n8192-slot-inner, 8192, 134, 9, 44, 0, 0, 187, 13655
n8192-slot-inner, 8192, 134, 9, 44, 0, 0, 187, 13655
n8192-slot-inner, 8192, 134, 9, 44, 0, 0, 187, 13655
n8192-slot-inner, 8192, 133, 9, 45, 0, 0, 187, 13655
n8192-slot-inner, 8192, 134, 9, 45, 0, 0, 188, 13655
n8192-slot-inner, 8192, 135, 9, 44, 0, 0, 188, 13655
n8192-slot-inner, 8192, 134, 9, 44, 0, 0, 187, 13655
n8192-slot-inner, 8192, 133, 9, 44, 0, 0, 186, 13655
n8192-slot-inner, 8192, 134, 9, 44, 0, 0, 187, 13655
n8192-slot-inner, 8192, 133, 9, 44, 0, 0, 186, 13655
n8192-slot-inner, 8192, 137, 9, 44, 0, 0, 190, 13655
n8192-slot-inner, 8192, 134, 9, 44, 0, 0, 187, 13655
n8192-slot-inner, 8192, 133, 9, 45, 0, 0, 187, 13655
n8192-slot-inner, 8192, 133, 9, 44, 0, 0, 186, 13655
n8192-slot-inner, 8192, 134, 9, 44, 0, 0, 187, 13655
n8192-slot-inner, 8192, 133, 9, 44, 0, 0, 186, 13655
n8192-slot-inner, 8192, 135, 9, 45, 0, 0, 189, 13655
n8192-slot-inner, 8192, 134, 9, 45, 0, 0, 188, 13655
n8192-slot-inner, 8192, 135, 9, 44, 0, 0, 188, 13655
n8192-slot-inner, 8192, 134, 9, 44, 0, 0, 187, 13655
n8192-slot-inner, 8192, 133, 9, 45, 0, 0, 187, 13655
n8192-slot-inner, 8192, 134, 9, 45, 0, 0, 188, 13655
n8192-slot-inner, 8192, 134, 9, 44, 0, 0, 187, 13655
n8192-slot-inner, 8192, 134, 9, 44, 0, 0, 187, 13655
n8192-slot-inner, 8192, 133, 9, 44, 0, 0, 186, 13655
n8192-slot-inner, 8192, 133, 9, 44, 0, 0, 186, 13655
n8192-slot-inner, 8192, 134, 9, 45, 0, 0, 188, 13655
n8192-slot-inner, 8192, 134, 9, 44, 0, 0, 187, 13655
n8192-slot-inner, 8192, 133, 9, 44, 0, 0, 186, 13655
n8192-slot-inner, 8192, 134, 9, 44, 0, 0, 187, 13655
n8192-slot-inner, 8192, 134, 9, 44, 0, 0, 187, 13655
n8192-slot-inner, 8192, 133, 9, 45, 0, 0, 187, 13655
n8192-slot-inner, 8192, 133, 9, 44, 0, 0, 186, 13655
n8192-slot-inner, 8192, 134, 9, 44, 0, 0, 187, 13655
n8192-slot-inner, 8192, 133, 9, 44, 0, 0, 186, 13655
n8192-slot-inner, 8192, 133, 9, 45, 0, 0, 187, 13655
n8192-slot-inner, 8192, 134, 9, 44, 0, 0, 187, 13655
n8192-slot-inner, 8192, 133, 9, 44, 0, 0, 186, 13655
n8192-slot-inner, 8192, 134, 9, 45, 0, 0, 188, 13655
n8192-slot-inner, 8192, 135, 9, 45, 0, 0, 189, 13655
n8192-slot-inner, 8192, 133, 9, 44, 0, 0, 186, 13655
n8192-slot-inner, 8192, 135, 9, 45, 0, 0, 189, 13655
n8192-slot-inner, 8192, 134, 9, 45, 0, 0, 188, 13655
n8192-slot-inner, 8192, 135, 9, 44, 0, 0, 188, 13655
n8192-slot-inner, 8192, 133, 9, 45, 0, 0, 187, 13655
n8192-slot-inner, 8192, 134, 9, 44, 0, 0, 187, 13655
n8192-slot-inner, 8192, 135, 9, 44, 0, 0, 188, 13655
n8192-slot-inner, 8192, 134, 9, 44, 0, 0, 187, 13655
n8192-slot-inner, 8192, 133, 9, 44, 0, 0, 186, 13655
n8192-slot-inner, 8192, 134, 9, 45, 0, 0, 188, 13655
n8192-slot-inner, 8192, 134, 9, 44, 0, 0, 187, 13655
n8192-slot-inner, 8192, 135, 9, 45, 0, 0, 189, 13655
n8192-slot-inner, 8192, 134, 9, 45, 0, 0, 188, 13655
n8192-slot-inner, 8192, 134, 9, 44, 0, 0, 187, 13655
n8192-slot-inner, 8192, 132, 9, 45, 0, 0, 186, 13655
n8192-slot-inner, 8192, 134, 9, 44, 0, 0, 187, 13655
n8192-slot-inner, 8192, 134, 9, 44, 0, 0, 187, 13655
n8192-slot-inner, 8192, 134, 9, 44, 0, 0, 187, 13655
n8192-slot-inner, 8192, 132, 9, 44, 0, 0, 185, 13655
n8192-slot-inner, 8192, 133, 9, 44, 0, 0, 186, 13655
n8192-slot-inner, 8192, 133, 9, 44, 0, 0, 186, 13655
n8192-slot-inner, 8192, 134, 9, 44, 0, 0, 187, 13655
n8192-slot-inner, 8192, 133, 9, 44, 0, 0, 186, 13655
n8192-slot-inner, 8192, 133, 9, 45, 0, 0, 187, 13655
n8192-slot-inner, 8192, 133, 9, 44, 0, 0, 186, 13655
n8192-slot-inner, 8192, 134, 9, 44, 0, 0, 187, 13655
n8192-slot-inner, 8192, 134, 9, 45, 0, 0, 188, 13655
n8192-slot-inner, 8192, 135, 9, 44, 0, 0, 188, 13655
n8192-slot-inner, 8192, 134, 9, 44, 0, 0, 187, 13655
n8192-slot-inner, 8192, 132, 12, 44, 0, 0, 188, 13655
n8192-slot-inner, 8192, 133, 9, 44, 0, 0, 186, 13655
n8192-slot-inner, 8192, 133, 9, 44, 0, 0, 186, 13655
n8192-slot-inner, 8192, 134, 9, 44, 0, 0, 187, 13655
n8192-slot-inner, 8192, 134, 9, 45, 0, 0, 188, 13655
n8192-slot-inner, 8192, 134, 9, 44, 0, 0, 187, 13655
n8192-slot-inner, 8192, 135, 9, 44, 0, 0, 188, 13655
n8192-slot-inner, 8192, 133, 9, 44, 0, 0, 186, 13655
n8192-slot-inner, 8192, 135, 9, 45, 0, 0, 189, 13655
n8192-slot-inner, 4096, 64, 7, 24, 0, 0, 95, 13655
n8192-slot-inner, 4096, 64, 7, 24, 0, 0, 95, 13655
n8192-slot-inner, 4096, 64, 7, 24, 0, 0, 95, 13655
n8192-slot-inner, 4096, 64, 7, 25, 0, 0, 96, 13655
n8192-slot-inner, 4096, 64, 7, 24, 0, 0, 95, 13655
n8192-slot-inner, 4096, 63, 7, 23, 0, 0, 93, 13655
n8192-slot-inner, 4096, 63, 7, 24, 0, 0, 94, 13655
n8192-slot-inner, 4096, 64, 7, 24, 0, 0, 95, 13655
n8192-slot-inner, 4096, 64, 7, 24, 0, 0, 95, 13655
n8192-slot-inner, 4096, 63, 7, 24, 0, 0, 94, 13655
n8192-slot-inner, 4096, 64, 7, 24, 0, 0, 95, 13655
n8192-slot-inner, 4096, 63, 7, 24, 0, 0, 94, 13655
n8192-slot-inner, 4096, 63, 7, 24, 0, 0, 94, 13655
n8192-slot-inner, 4096, 64, 7, 24, 0, 0, 95, 13655
n8192-slot-inner, 4096, 64, 7, 24, 0, 0, 95, 13655
n8192-slot-inner, 4096, 64, 7, 24, 0, 0, 95, 13655
n8192-slot-inner, 4096, 64, 7, 24, 0, 0, 95, 13655
n8192-slot-inner, 4096, 65, 7, 24, 0, 0, 96, 13655
n8192-slot-inner, 4096, 63, 7, 24, 0, 0, 94, 13655
n8192-slot-inner, 4096, 64, 7, 24, 0, 0, 95, 13655
n8192-slot-inner, 4096, 63, 7, 24, 0, 0, 94, 13655
n8192-slot-inner, 4096, 63, 7, 24, 0, 0, 94, 13655
n8192-slot-inner, 4096, 64, 7, 24, 0, 0, 95, 13655
n8192-slot-inner, 4096, 63, 7, 24, 0, 0, 94, 13655
n8192-slot-inner, 4096, 63, 7, 24, 0, 0, 94, 13655
n8192-slot-inner, 4096, 63, 7, 24, 0, 0, 94, 13655
n8192-slot-inner, 4096, 63, 8, 24, 0, 0, 95, 13655
n8192-slot-inner, 4096, 63, 7, 24, 0, 0, 94, 13655
n8192-slot-inner, 4096, 65, 7, 24, 0, 0, 96, 13655
n8192-slot-inner, 4096, 63, 7, 24, 0, 0, 94, 13655
n8192-slot-inner, 4096, 63, 7, 24, 0, 0, 94, 13655
n8192-slot-inner, 4096, 64, 7, 24, 0, 0, 95, 13655
n8192-slot-inner, 4096, 63, 7, 24, 0, 0, 94, 13655
n8192-slot-inner, 4096, 64, 7, 24, 0, 0, 95, 13655
n8192-slot-inner, 4096, 63, 7, 24, 0, 0, 94, 13655
n8192-slot-inner, 4096, 63, 7, 24, 0, 0, 94, 13655
n8192-slot-inner, 4096, 63, 7, 24, 0, 0, 94, 13655
n8192-slot-inner, 4096, 64, 7, 24, 0, 0, 95, 13655
n8192-slot-inner, 4096, 64, 7, 24, 0, 0, 95, 13655
n8192-slot-inner, 4096, 63, 7, 24, 0, 0, 94, 13655
n8192-slot-inner, 4096, 63, 7, 24, 0, 0, 94, 13655
n8192-slot-inner, 4096, 64, 7, 24, 0, 0, 95, 13655
n8192-slot-inner, 4096, 63, 7, 24, 0, 0, 94, 13655
n8192-slot-inner, 4096, 64, 7, 24, 0, 0, 95, 13655
n8192-slot-inner, 4096, 64, 7, 24, 0, 0, 95, 13655
n8192-slot-inner, 4096, 63, 7, 24, 0, 0, 94, 13655
n8192-slot-inner, 4096, 63, 7, 24, 0, 0, 94, 13655
n8192-slot-inner, 4096, 65, 7, 24, 0, 0, 96, 13655
n8192-slot-inner, 4096, 64, 7, 24, 0, 0, 95, 13655
n8192-slot-inner, 4096, 64, 7, 24, 0, 0, 95, 13655
n8192-slot-inner, 4096, 64, 7, 24, 0, 0, 95, 13655
n8192-slot-inner, 4096, 63, 7, 24, 0, 0, 94, 13655
n8192-slot-inner, 4096, 63, 7, 24, 0, 0, 94, 13655
n8192-slot-inner, 4096, 64, 7, 24, 0, 0, 95, 13655
n8192-slot-inner, 4096, 63, 7, 24, 0, 0, 94, 13655
n8192-slot-inner, 4096, 63, 7, 24, 0, 0, 94, 13655
n8192-slot-inner, 4096, 64, 7, 24, 0, 0, 95, 13655
n8192-slot-inner, 4096, 64, 7, 24, 0, 0, 95, 13655
n8192-slot-inner, 4096, 63, 7, 24, 0, 0, 94, 13655
n8192-slot-inner, 4096, 63, 7, 24, 0, 0, 94, 13655
n8192-slot-inner, 4096, 63, 7, 24, 0, 0, 94, 13655
n8192-slot-inner, 4096, 64, 7, 24, 0, 0, 95, 13655
n8192-slot-inner, 4096, 64, 7, 24, 0, 0, 95, 13655
n8192-slot-inner, 4096, 63, 7, 24, 0, 0, 94, 13655
n8192-slot-inner, 4096, 64, 7, 24, 0, 0, 95, 13655
n8192-slot-inner, 4096, 66, 7, 24, 0, 0, 97, 13655
n8192-slot-inner, 4096, 64, 7, 24, 0, 0, 95, 13655
n8192-slot-inner, 4096, 64, 7, 24, 0, 0, 95, 13655
n8192-slot-inner, 4096, 64, 7, 24, 0, 0, 95, 13655
n8192-slot-inner, 4096, 63, 7, 24, 0, 0, 94, 13655
n8192-slot-inner, 4096, 64, 7, 24, 0, 0, 95, 13655
n8192-slot-inner, 4096, 63, 7, 24, 0, 0, 94, 13655
n8192-slot-inner, 4096, 64, 7, 24, 0, 0, 95, 13655
n8192-slot-inner, 4096, 64, 7, 24, 0, 0, 95, 13655
n8192-slot-inner, 4096, 63, 7, 24, 0, 0, 94, 13655
n8192-slot-inner, 4096, 64, 7, 24, 0, 0, 95, 13655
n8192-slot-inner, 4096, 63, 7, 24, 0, 0, 94, 13655
n8192-slot-inner, 4096, 64, 7, 24, 0, 0, 95, 13655
n8192-slot-inner, 4096, 63, 7, 24, 0, 0, 94, 13655
n8192-slot-inner, 4096, 64, 7, 24, 0, 0, 95, 13655
n8192-slot-inner, 4096, 64, 7, 24, 0, 0, 95, 13655
n8192-slot-inner, 4096, 64, 7, 24, 0, 0, 95, 13655
n8192-slot-inner, 4096, 64, 7, 24, 0, 0, 95, 13655
n8192-slot-inner, 4096, 64, 7, 24, 0, 0, 95, 13655
n8192-slot-inner, 4096, 63, 7, 24, 0, 0, 94, 13655
n8192-slot-inner, 4096, 63, 7, 24, 0, 0, 94, 13655
n8192-slot-inner, 4096, 64, 7, 24, 0, 0, 95, 13655
n8192-slot-inner, 4096, 64, 7, 24, 0, 0, 95, 13655
n8192-slot-inner, 4096, 64, 7, 24, 0, 0, 95, 13655
n8192-slot-inner, 4096, 63, 7, 24, 0, 0, 94, 13655
n8192-slot-inner, 4096, 63, 7, 24, 0, 0, 94, 13655
n8192-slot-inner, 4096, 63, 7, 24, 0, 0, 94, 13655
n8192-slot-inner, 4096, 64, 7, 24, 0, 0, 95, 13655
n8192-slot-inner, 4096, 63, 7, 24, 0, 0, 94, 13655
n8192-slot-inner, 4096, 64, 7, 24, 0, 0, 95, 13655
n8192-slot-inner, 4096, 63, 7, 24, 0, 0, 94, 13655
n8192-slot-inner, 4096, 64, 7, 24, 0, 0, 95, 13655
n8192-slot-inner, 4096, 64, 7, 24, 0, 0, 95, 13655
n8192-slot-inner, 4096, 63, 7, 24, 0, 0, 94, 13655
n8192-slot-inner, 4096, 64, 7, 24, 0, 0, 95, 13655
n8192-slot-inner, 2048, 31, 6, 15, 0, 0, 52, 13655
n8192-slot-inner, 2048, 31, 6, 15, 0, 0, 52, 13655
n8192-slot-inner, 2048, 32, 6, 15, 0, 0, 53, 13655
n8192-slot-inner, 2048, 31, 6, 15, 0, 0, 52, 13655
n8192-slot-inner, 2048, 32, 6, 15, 0, 0, 53, 13655
n8192-slot-inner, 2048, 31, 6, 15, 0, 0, 52, 13655
n8192-slot-inner, 2048, 31, 6, 15, 0, 0, 52, 13655
n8192-slot-inner, 2048, 31, 6, 15, 0, 0, 52, 13655
n8192-slot-inner, 2048, 32, 6, 15, 0, 0, 53, 13655
n8192-slot-inner, 2048, 32, 6, 15, 0, 0, 53, 13655
n8192-slot-inner, 2048, 31, 6, 15, 0, 0, 52, 13655
n8192-slot-inner, 2048, 31, 6, 15, 0, 0, 52, 13655
n8192-slot-inner, 2048, 31, 6, 15, 0, 0, 52, 13655
n8192-slot-inner, 2048, 31, 6, 15, 0, 0, 52, 13655
n8192-slot-inner, 2048, 31, 6, 15, 0, 0, 52, 13655
n8192-slot-inner, 2048, 32, 6, 15, 0, 0, 53, 13655
n8192-slot-inner, 2048, 31, 6, 15, 0, 0, 52, 13655
n8192-slot-inner, 2048, 31, 6, 15, 0, 0, 52, 13655
n8192-slot-inner, 2048, 31, 6, 15, 0, 0, 52, 13655
n8192-slot-inner, 2048, 31, 6, 16, 0, 0, 53, 13655
n8192-slot-inner, 2048, 32, 6, 15, 0, 0, 53, 13655
n8192-slot-inner, 2048, 32, 6, 15, 0, 0, 53, 13655
n8192-slot-inner, 2048, 32, 6, 16, 0, 0, 54, 13655
n8192-slot-inner, 2048, 32, 6, 15, 0, 0, 53, 13655
n8192-slot-inner, 2048, 32, 6, 15, 0, 0, 53, 13655
n8192-slot-inner, 2048, 31, 6, 15, 0, 0, 52, 13655
n8192-slot-inner, 2048, 34, 6, 15, 0, 0, 55, 13655
n8192-slot-inner, 2048, 32, 6, 15, 0, 0, 53, 13655
n8192-slot-inner, 2048, 32, 6, 15, 0, 0, 53, 13655
n8192-slot-inner, 2048, 32, 6, 16, 0, 0, 54, 13655
n8192-slot-inner, 2048, 32, 6, 16, 0, 0, 54, 13655
n8192-slot-inner, 2048, 32, 6, 15, 0, 0, 53, 13655
n8192-slot-inner, 2048, 32, 6, 15, 0, 0, 53, 13655
n8192-slot-inner, 2048, 31, 6, 15, 0, 0, 52, 13655
n8192-slot-inner, 2048, 31, 6, 15, 0, 0, 52, 13655
n8192-slot-inner, 2048, 32, 6, 15, 0, 0, 53, 13655
n8192-slot-inner, 2048, 31, 6, 15, 0, 0, 52, 13655
n8192-slot-inner, 2048, 31, 6, 15, 0, 0, 52, 13655
n8192-slot-inner, 2048, 31, 6, 15, 0, 0, 52, 13655
n8192-slot-inner, 2048, 31, 6, 15, 0, 0, 52, 13655
n8192-slot-inner, 2048, 32, 6, 16, 0, 0, 54, 13655
n8192-slot-inner, 2048, 32, 6, 15, 0, 0, 53, 13655
n8192-slot-inner, 2048, 31, 6, 15, 0, 0, 52, 13655
n8192-slot-inner, 2048, 32, 6, 15, 0, 0, 53, 13655
n8192-slot-inner, 2048, 32, 6, 15, 0, 0, 53, 13655
n8192-slot-inner, 2048, 31, 6, 15, 0, 0, 52, 13655
n8192-slot-inner, 2048, 32, 6, 15, 0, 0, 53, 13655
n8192-slot-inner, 2048, 31, 6, 15, 0, 0, 52, 13655
n8192-slot-inner, 2048, 31, 6, 15, 0, 0, 52, 13655
n8192-slot-inner, 2048, 31, 6, 15, 0, 0, 52, 13655
n8192-slot-inner, 2048, 31, 6, 15, 0, 0, 52, 13655
n8192-slot-inner, 2048, 31, 6, 15, 0, 0, 52, 13655
n8192-slot-inner, 2048, 31, 6, 15, 0, 0, 52, 13655
n8192-slot-inner, 2048, 31, 6, 15, 0, 0, 52, 13655
n8192-slot-inner, 2048, 32, 6, 15, 0, 0, 53, 13655
n8192-slot-inner, 2048, 31, 6, 15, 0, 0, 52, 13655
n8192-slot-inner, 2048, 31, 6, 15, 0, 0, 52, 13655
n8192-slot-inner, 2048, 31, 6, 16, 0, 0, 53, 13655
n8192-slot-inner, 2048, 32, 6, 15, 0, 0, 53, 13655
n8192-slot-inner, 2048, 32, 6, 15, 0, 0, 53, 13655
n8192-slot-inner, 2048, 32, 6, 15, 0, 0, 53, 13655
n8192-slot-inner, 2048, 31, 6, 15, 0, 0, 52, 13655
n8192-slot-inner, 2048, 31, 6, 15, 0, 0, 52, 13655
n8192-slot-inner, 2048, 32, 6, 15, 0, 0, 53, 13655
n8192-slot-inner, 2048, 31, 6, 15, 0, 0, 52, 13655
n8192-slot-inner, 2048, 32, 6, 15, 0, 0, 53, 13655
n8192-slot-inner, 2048, 31, 6, 15, 0, 0, 52, 13655
n8192-slot-inner, 2048, 31, 6, 15, 0, 0, 52, 13655
n8192-slot-inner, 2048, 32, 6, 15, 0, 0, 53, 13655
n8192-slot-inner, 2048, 31, 6, 16, 0, 0, 53, 13655
n8192-slot-inner, 2048, 32, 6, 15, 0, 0, 53, 13655
n8192-slot-inner, 2048, 31, 6, 15, 0, 0, 52, 13655
n8192-slot-inner, 2048, 31, 6, 15, 0, 0, 52, 13655
n8192-slot-inner, 2048, 31, 6, 15, 0, 0, 52, 13655
n8192-slot-inner, 2048, 31, 6, 15, 0, 0, 52, 13655
n8192-slot-inner, 2048, 31, 6, 15, 0, 0, 52, 13655
n8192-slot-inner, 2048, 31, 6, 16, 0, 0, 53, 13655
n8192-slot-inner, 2048, 32, 6, 15, 0, 0, 53, 13655
n8192-slot-inner, 2048, 32, 6, 15, 0, 0, 53, 13655
n8192-slot-inner, 2048, 31, 6, 15, 0, 0, 52, 13655
n8192-slot-inner, 2048, 31, 6, 15, 0, 0, 52, 13655
n8192-slot-inner, 2048, 31, 6, 15, 0, 0, 52, 13655
n8192-slot-inner, 2048, 32, 6, 15, 0, 0, 53, 13655
n8192-slot-inner, 2048, 32, 6, 15, 0, 0, 53, 13655
n8192-slot-inner, 2048, 31, 6, 15, 0, 0, 52, 13655
n8192-slot-inner, 2048, 31, 6, 15, 0, 0, 52, 13655
n8192-slot-inner, 2048, 32, 6, 15, 0, 0, 53, 13655
n8192-slot-inner, 2048, 31, 6, 15, 0, 0, 52, 13655
n8192-slot-inner, 2048, 31, 6, 15, 0, 0, 52, 13655
n8192-slot-inner, 2048, 31, 6, 15, 0, 0, 52, 13655
n8192-slot-inner, 2048, 31, 6, 15, 0, 0, 52, 13655
n8192-slot-inner, 2048, 32, 6, 15, 0, 0, 53, 13655
n8192-slot-inner, 2048, 31, 6, 15, 0, 0, 52, 13655
n8192-slot-inner, 2048, 31, 6, 15, 0, 0, 52, 13655
n8192-slot-inner, 2048, 31, 6, 15, 0, 0, 52, 13655
n8192-slot-inner, 2048, 32, 6, 15, 0, 0, 53, 13655
n8192-slot-inner, 2048, 32, 6, 15, 0, 0, 53, 13655
n8192-slot-inner, 2048, 32, 6, 15, 0, 0, 53, 13655
n8192-slot-inner, 2048, 31, 6, 15, 0, 0, 52, 13655
n8192-slot-inner, 2048, 31, 6, 15, 0, 0, 52, 13655
n8192-slot-inner, 1024, 17, 6, 12, 0, 0, 35, 13655
n8192-slot-inner, 1024, 17, 6, 12, 0, 0, 35, 13655
n8192-slot-inner, 1024, 17, 5, 12, 0, 0, 34, 13655
n8192-slot-inner, 1024, 17, 6, 12, 0, 0, 35, 13655
n8192-slot-inner, 1024, 17, 6, 13, 0, 0, 36, 13655
n8192-slot-inner, 1024, 17, 6, 11, 0, 0, 34, 13655
n8192-slot-inner, 1024, 17, 6, 12, 0, 0, 35, 13655
n8192-slot-inner, 1024, 17, 5, 12, 0, 0, 34, 13655
n8192-slot-inner, 1024, 17, 5, 11, 0, 0, 33, 13655
n8192-slot-inner, 1024, 17, 6, 12, 0, 0, 35, 13655
n8192-slot-inner, 1024, 17, 6, 13, 0, 0, 36, 13655
n8192-slot-inner, 1024, 17, 5, 11, 0, 0, 33, 13655
n8192-slot-inner, 1024, 17, 6, 12, 0, 0, 35, 13655
n8192-slot-inner, 1024, 17, 6, 12, 0, 0, 35, 13655
n8192-slot-inner, 1024, 18, 6, 12, 0, 0, 36, 13655
n8192-slot-inner, 1024, 17, 6, 12, 0, 0, 35, 13655
n8192-slot-inner, 1024, 17, 5, 11, 0, 0, 33, 13655
n8192-slot-inner, 1024, 17, 6, 12, 0, 0, 35, 13655
n8192-slot-inner, 1024, 17, 6, 11, 0, 0, 34, 13655
n8192-slot-inner, 1024, 17, 6, 11, 0, 0, 34, 13655
n8192-slot-inner, 1024, 17, 5, 11, 0, 0, 33, 13655
n8192-slot-inner, 1024, 17, 6, 12, 0, 0, 35, 13655
n8192-slot-inner, 1024, 17, 6, 11, 0, 0, 34, 13655
n8192-slot-inner, 1024, 17, 5, 12, 0, 0, 34, 13655
n8192-slot-inner, 1024, 17, 5, 12, 0, 0, 34, 13655
n8192-slot-inner, 1024, 17, 6, 11, 0, 0, 34, 13655
n8192-slot-inner, 1024, 17, 5, 12, 0, 0, 34, 13655
n8192-slot-inner, 1024, 17, 6, 11, 0, 0, 34, 13655
n8192-slot-inner, 1024, 17, 5, 11, 0, 0, 33, 13655
n8192-slot-inner, 1024, 17, 5, 12, 0, 0, 34, 13655
n8192-slot-inner, 1024, 17, 6, 12, 0, 0, 35, 13655
n8192-slot-inner, 1024, 17, 5, 11, 0, 0, 33, 13655
n8192-slot-inner, 1024, 17, 5, 12, 0, 0, 34, 13655
n8192-slot-inner, 1024, 17, 6, 12, 0, 0, 35, 13655
n8192-slot-inner, 1024, 17, 5, 12, 0, 0, 34, 13655
n8192-slot-inner, 1024, 17, 5, 12, 0, 0, 34, 13655
n8192-slot-inner, 1024, 17, 6, 11, 0, 0, 34, 13655
n8192-slot-inner, 1024, 17, 5, 12, 0, 0, 34, 13655
n8192-slot-inner, 1024, 17, 6, 14, 0, 0, 37, 13655
n8192-slot-inner, 1024, 17, 6, 11, 0, 0, 34, 13655
n8192-slot-inner, 1024, 17, 5, 11, 0, 0, 33, 13655
n8192-slot-inner, 1024, 17, 6, 12, 0, 0, 35, 13655
n8192-slot-inner, 1024, 17, 5, 11, 0, 0, 33, 13655
n8192-slot-inner, 1024, 17, 5, 11, 0, 0, 33, 13655
n8192-slot-inner, 1024, 17, 5, 11, 0, 0, 33, 13655
n8192-slot-inner, 1024, 17, 6, 12, 0, 0, 35, 13655
n8192-slot-inner, 1024, 17, 6, 12, 0, 0, 35, 13655
n8192-slot-inner, 1024, 17, 5, 11, 0, 0, 33, 13655
n8192-slot-inner, 1024, 17, 5, 11, 0, 0, 33, 13655
n8192-slot-inner, 1024, 17, 6, 11, 0, 0, 34, 13655
n8192-slot-inner, 1024, 17, 6, 12, 0, 0, 35, 13655
n8192-slot-inner, 1024, 17, 6, 12, 0, 0, 35, 13655
n8192-slot-inner, 1024, 17, 6, 12, 0, 0, 35, 13655
n8192-slot-inner, 1024, 17, 6, 12, 0, 0, 35, 13655
n8192-slot-inner, 1024, 17, 5, 12, 0, 0, 34, 13655
n8192-slot-inner, 1024, 17, 5, 11, 0, 0, 33, 13655
n8192-slot-inner, 1024, 17, 5, 11, 0, 0, 33, 13655
n8192-slot-inner, 1024, 17, 5, 11, 0, 0, 33, 13655
n8192-slot-inner, 1024, 17, 5, 12, 0, 0, 34, 13655
n8192-slot-inner, 1024, 17, 6, 12, 0, 0, 35, 13655
n8192-slot-inner, 1024, 17, 6, 11, 0, 0, 34, 13655
n8192-slot-inner, 1024, 17, 5, 11, 0, 0, 33, 13655
n8192-slot-inner, 1024, 17, 6, 12, 0, 0, 35, 13655
n8192-slot-inner, 1024, 17, 6, 12, 0, 0, 35, 13655
n8192-slot-inner, 1024, 18, 6, 12, 0, 0, 36, 13655
n8192-slot-inner, 1024, 17, 5, 11, 0, 0, 33, 13655
n8192-slot-inner, 1024, 17, 5, 11, 0, 0, 33, 13655
n8192-slot-inner, 1024, 17, 6, 11, 0, 0, 34, 13655
n8192-slot-inner, 1024, 17, 5, 11, 0, 0, 33, 13655
n8192-slot-inner, 1024, 17, 5, 12, 0, 0, 34, 13655
n8192-slot-inner, 1024, 17, 6, 12, 0, 0, 35, 13655
n8192-slot-inner, 1024, 17, 5, 11, 0, 0, 33, 13655
n8192-slot-inner, 1024, 17, 6, 11, 0, 0, 34, 13655
n8192-slot-inner, 1024, 17, 6, 11, 0, 0, 34, 13655
n8192-slot-inner, 1024, 17, 6, 12, 0, 0, 35, 13655
n8192-slot-inner, 1024, 17, 6, 12, 0, 0, 35, 13655
n8192-slot-inner, 1024, 17, 6, 12, 0, 0, 35, 13655
n8192-slot-inner, 1024, 17, 6, 12, 0, 0, 35, 13655
n8192-slot-inner, 1024, 17, 6, 11, 0, 0, 34, 13655
n8192-slot-inner, 1024, 17, 5, 11, 0, 0, 33, 13655
n8192-slot-inner, 1024, 17, 5, 12, 0, 0, 34, 13655
n8192-slot-inner, 1024, 17, 5, 12, 0, 0, 34, 13655
n8192-slot-inner, 1024, 17, 6, 11, 0, 0, 34, 13655
n8192-slot-inner, 1024, 17, 5, 12, 0, 0, 34, 13655
n8192-slot-inner, 1024, 17, 6, 12, 0, 0, 35, 13655
n8192-slot-inner, 1024, 17, 6, 11, 0, 0, 34, 13655
n8192-slot-inner, 1024, 17, 6, 12, 0, 0, 35, 13655
n8192-slot-inner, 1024, 17, 5, 11, 0, 0, 33, 13655
n8192-slot-inner, 1024, 17, 6, 14, 0, 0, 37, 13655
n8192-slot-inner, 1024, 17, 5, 11, 0, 0, 33, 13655
n8192-slot-inner, 1024, 17, 5, 11, 0, 0, 33, 13655
n8192-slot-inner, 1024, 17, 6, 11, 0, 0, 34, 13655
n8192-slot-inner, 1024, 17, 5, 11, 0, 0, 33, 13655
n8192-slot-inner, 1024, 17, 5, 11, 0, 0, 33, 13655
n8192-slot-inner, 1024, 17, 5, 12, 0, 0, 34, 13655
n8192-slot-inner, 1024, 17, 6, 11, 0, 0, 34, 13655
n8192-slot-inner, 1024, 17, 5, 11, 0, 0, 33, 13655
n8192-slot-inner, 1024, 17, 5, 11, 0, 0, 33, 13655
n8192-slot-inner, 1024, 17, 5, 12, 0, 0, 34, 13655
n8192-slot-inner, 1024, 17, 6, 12, 0, 0, 35, 13655
n8192-coef-inner, 8192, 30, 22, 8, 0, 0, 60, 13655
n8192-coef-inner, 8192, 30, 22, 8, 0, 0, 60, 13655
n8192-coef-inner, 8192, 29, 22, 8, 0, 0, 59, 13655
n8192-coef-inner, 8192, 29, 22, 8, 0, 0, 59, 13655
n8192-coef-inner, 8192, 30, 22, 8, 0, 0, 60, 13655
n8192-coef-inner, 8192, 30, 22, 8, 0, 0, 60, 13655
n8192-coef-inner, 8192, 29, 22, 8, 0, 0, 59, 13655
n8192-coef-inner, 8192, 30, 22, 8, 0, 0, 60, 13655
n8192-coef-inner, 8192, 29, 22, 8, 0, 0, 59, 13655
n8192-coef-inner, 8192, 29, 22, 8, 0, 0, 59, 13655
n8192-coef-inner, 8192, 29, 22, 8, 0, 0, 59, 13655
n8192-coef-inner, 8192, 30, 22, 8, 0, 0, 60, 13655
n8192-coef-inner, 8192, 29, 22, 8, 0, 0, 59, 13655
n8192-coef-inner, 8192, 30, 22, 8, 0, 0, 60, 13655
n8192-coef-inner, 8192, 29, 22, 8, 0, 0, 59, 13655
n8192-coef-inner, 8192, 29, 22, 8, 0, 0, 59, 13655
n8192-coef-inner, 8192, 30, 22, 8, 0, 0, 60, 13655
n8192-coef-inner, 8192, 29, 22, 8, 0, 0, 59, 13655
n8192-coef-inner, 8192, 29, 22, 8, 0, 0, 59, 13655
n8192-coef-inner, 8192, 29, 22, 8, 0, 0, 59, 13655
n8192-coef-inner, 8192, 29, 22, 8, 0, 0, 59, 13655
n8192-coef-inner, 8192, 30, 22, 8, 0, 0, 60, 13655
n8192-coef-inner, 8192, 29, 22, 8, 0, 0, 59, 13655
n8192-coef-inner, 8192, 30, 22, 8, 0, 0, 60, 13655
n8192-coef-inner, 8192, 30, 22, 8, 0, 0, 60, 13655
n8192-coef-inner, 8192, 29, 22, 8, 0, 0, 59, 13655
n8192-coef-inner, 8192, 30, 22, 8, 0, 0, 60, 13655
n8192-coef-inner, 8192, 29, 22, 8, 0, 0, 59, 13655
n8192-coef-inner, 8192, 29, 22, 8, 0, 0, 59, 13655
n8192-coef-inner, 8192, 30, 22, 8, 0, 0, 60, 13655
n8192-coef-inner, 8192, 42, 22, 8, 0, 0, 72, 13655
n8192-coef-inner, 8192, 29, 22, 8, 0, 0, 59, 13655
n8192-coef-inner, 8192, 29, 22, 8, 0, 0, 59, 13655
n8192-coef-inner, 8192, 30, 22, 8, 0, 0, 60, 13655
n8192-coef-inner, 8192, 30, 22, 8, 0, 0, 60, 13655
n8192-coef-inner, 8192, 30, 22, 9, 0, 0, 61, 13655
n8192-coef-inner, 8192, 29, 22, 8, 0, 0, 59, 13655
n8192-coef-inner, 8192, 30, 22, 8, 0, 0, 60, 13655
n8192-coef-inner, 8192, 29, 23, 8, 0, 0, 60, 13655
n8192-coef-inner, 8192, 29, 22, 8, 0, 0, 59, 13655
n8192-coef-inner, 8192, 29, 22, 8, 0, 0, 59, 13655
n8192-coef-inner, 8192, 30, 22, 8, 0, 0, 60, 13655
n8192-coef-inner, 8192, 30, 22, 8, 0, 0, 60, 13655
n8192-coef-inner, 8192, 30, 22, 8, 0, 0, 60, 13655
n8192-coef-inner, 8192, 30, 22, 8, 0, 0, 60, 13655
n8192-coef-inner, 8192, 29, 22, 8, 0, 0, 59, 13655
n8192-coef-inner, 8192, 29, 22, 8, 0, 0, 59, 13655
n8192-coef-inner, 8192, 30, 22, 8, 0, 0, 60, 13655
n8192-coef-inner, 8192, 30, 22, 8, 0, 0, 60, 13655
n8192-coef-inner, 8192, 29, 22, 8, 0, 0, 59, 13655
n8192-coef-inner, 8192, 29, 22, 8, 0, 0, 59, 13655
n8192-coef-inner, 8192, 29, 22, 8, 0, 0, 59, 13655
n8192-coef-inner, 8192, 29, 22, 8, 0, 0, 59, 13655
n8192-coef-inner, 8192, 30, 22, 8, 0, 0, 60, 13655
n8192-coef-inner, 8192, 30, 22, 8, 0, 0, 60, 13655
n8192-coef-inner, 8192, 29, 22, 8, 0, 0, 59, 13655
n8192-coef-inner, 8192, 29, 22, 8, 0, 0, 59, 13655
n8192-coef-inner, 8192, 29, 22, 8, 0, 0, 59, 13655
n8192-coef-inner, 8192, 29, 22, 8, 0, 0, 59, 13655
n8192-coef-inner, 8192, 29, 22, 8, 0, 0, 59, 13655
n8192-coef-inner, 8192, 30, 22, 8, 0, 0, 60, 13655
n8192-coef-inner, 8192, 29, 22, 8, 0, 0, 59, 13655
n8192-coef-inner, 8192, 30, 22, 8, 0, 0, 60, 13655
n8192-coef-inner, 8192, 29, 22, 8, 0, 0, 59, 13655
n8192-coef-inner, 8192, 29, 22, 8, 0, 0, 59, 13655
n8192-coef-inner, 8192, 30, 22, 8, 0, 0, 60, 13655
n8192-coef-inner, 8192, 29, 22, 8, 0, 0, 59, 13655
n8192-coef-inner, 8192, 30, 23, 10, 0, 0, 63, 13655
n8192-coef-inner, 8192, 29, 22, 8, 0, 0, 59, 13655
n8192-coef-inner, 8192, 29, 22, 8, 0, 0, 59, 13655
n8192-coef-inner, 8192, 30, 22, 8, 0, 0, 60, 13655
n8192-coef-inner, 8192, 29, 22, 8, 0, 0, 59, 13655
n8192-coef-inner, 8192, 29, 22, 8, 0, 0, 59, 13655
n8192-coef-inner, 8192, 30, 22, 8, 0, 0, 60, 13655
n8192-coef-inner, 8192, 29, 22, 8, 0, 0, 59, 13655
n8192-coef-inner, 8192, 29, 22, 8, 0, 0, 59, 13655
n8192-coef-inner, 8192, 29, 22, 8, 0, 0, 59, 13655
n8192-coef-inner, 8192, 30, 22, 8, 0, 0, 60, 13655
n8192-coef-inner, 8192, 30, 22, 8, 0, 0, 60, 13655
n8192-coef-inner, 8192, 30, 22, 8, 0, 0, 60, 13655
n8192-coef-inner, 8192, 29, 22, 8, 0, 0, 59, 13655
n8192-coef-inner, 8192, 29, 22, 8, 0, 0, 59, 13655
n8192-coef-inner, 8192, 29, 22, 8, 0, 0, 59, 13655
n8192-coef-inner, 8192, 29, 22, 8, 0, 0, 59, 13655
n8192-coef-inner, 8192, 29, 22, 8, 0, 0, 59, 13655
n8192-coef-inner, 8192, 29, 22, 8, 0, 0, 59, 13655
n8192-coef-inner, 8192, 30, 22, 8, 0, 0, 60, 13655
n8192-coef-inner, 8192, 30, 22, 8, 0, 0, 60, 13655
n8192-coef-inner, 8192, 30, 22, 8, 0, 0, 60, 13655
n8192-coef-inner, 8192, 29, 22, 8, 0, 0, 59, 13655
n8192-coef-inner, 8192, 29, 22, 8, 0, 0, 59, 13655
n8192-coef-inner, 8192, 29, 22, 8, 0, 0, 59, 13655
n8192-coef-inner, 8192, 30, 22, 8, 0, 0, 60, 13655
n8192-coef-inner, 8192, 29, 22, 8, 0, 0, 59, 13655
n8192-coef-inner, 8192, 30, 22, 8, 0, 0, 60, 13655
n8192-coef-inner, 8192, 29, 22, 8, 0, 0, 59, 13655
n8192-coef-inner, 8192, 30, 22, 8, 0, 0, 60, 13655
n8192-coef-inner, 8192, 29, 22, 8, 0, 0, 59, 13655
n8192-coef-inner, 8192, 29, 22, 8, 0, 0, 59, 13655
n8192-coef-inner, 8192, 30, 22, 8, 0, 0, 60, 13655
n8192-coef-inner, 4096, 16, 21, 8, 0, 0, 45, 13655
n8192-coef-inner, 4096, 16, 21, 8, 0, 0, 45, 13655
n8192-coef-inner, 4096, 16, 22, 9, 0, 0, 47, 13655
n8192-coef-inner, 4096, 16, 21, 8, 0, 0, 45, 13655
n8192-coef-inner, 4096, 16, 21, 8, 0, 0, 45, 13655
n8192-coef-inner, 4096, 16, 21, 8, 0, 0, 45, 13655
n8192-coef-inner, 4096, 16, 21, 8, 0, 0, 45, 13655
n8192-coef-inner, 4096, 16, 21, 8, 0, 0, 45, 13655
n8192-coef-inner, 4096, 16, 21, 8, 0, 0, 45, 13655
n8192-coef-inner, 4096, 16, 21, 8, 0, 0, 45, 13655
n8192-coef-inner, 4096, 16, 21, 8, 0, 0, 45, 13655
n8192-coef-inner, 4096, 16, 21, 8, 0, 0, 45, 13655
n8192-coef-inner, 4096, 16, 21, 8, 0, 0, 45, 13655
n8192-coef-inner, 4096, 16, 21, 8, 0, 0, 45, 13655
n8192-coef-inner, 4096, 16, 21, 8, 0, 0, 45, 13655
n8192-coef-inner, 4096, 16, 21, 8, 0, 0, 45, 13655
n8192-coef-inner, 4096, 16, 21, 8, 0, 0, 45, 13655
n8192-coef-inner, 4096, 16, 21, 8, 0, 0, 45, 13655
n8192-coef-inner, 4096, 16, 21, 8, 0, 0, 45, 13655
n8192-coef-inner, 4096, 16, 21, 8, 0, 0, 45, 13655
n8192-coef-inner, 4096, 16, 21, 8, 0, 0, 45, 13655
n8192-coef-inner, 4096, 16, 21, 8, 0, 0, 45, 13655
n8192-coef-inner, 4096, 16, 21, 8, 0, 0, 45, 13655
n8192-coef-inner, 4096, 16, 21, 8, 0, 0, 45, 13655
n8192-coef-inner, 4096, 16, 21, 8, 0, 0, 45, 13655
n8192-coef-inner, 4096, 16, 21, 8, 0, 0, 45, 13655
n8192-coef-inner, 4096, 16, 21, 8, 0, 0, 45, 13655
n8192-coef-inner, 4096, 16, 22, 8, 0, 0, 46, 13655
n8192-coef-inner, 4096, 16, 21, 8, 0, 0, 45, 13655
n8192-coef-inner, 4096, 16, 21, 8, 0, 0, 45, 13655
n8192-coef-inner, 4096, 16, 21, 8, 0, 0, 45, 13655
n8192-coef-inner, 4096, 16, 21, 8, 0, 0, 45, 13655
n8192-coef-inner, 4096, 16, 21, 8, 0, 0, 45, 13655
n8192-coef-inner, 4096, 16, 22, 8, 0, 0, 46, 13655
n8192-coef-inner, 4096, 16, 21, 8, 0, 0, 45, 13655
n8192-coef-inner, 4096, 16, 21, 8, 0, 0, 45, 13655
n8192-coef-inner, 4096, 16, 21, 8, 0, 0, 45, 13655
n8192-coef-inner, 4096, 16, 21, 8, 0, 0, 45, 13655
n8192-coef-inner, 4096, 16, 21, 8, 0, 0, 45, 13655
n8192-coef-inner, 4096, 16, 21, 8, 0, 0, 45, 13655
n8192-coef-inner, 4096, 16, 21, 8, 0, 0, 45, 13655
n8192-coef-inner, 4096, 16, 21, 8, 0, 0, 45, 13655
n8192-coef-inner, 4096, 16, 21, 8, 0, 0, 45, 13655
n8192-coef-inner, 4096, 16, 21, 8, 0, 0, 45, 13655
n8192-coef-inner, 4096, 16, 21, 8, 0, 0, 45, 13655
n8192-coef-inner, 4096, 16, 21, 8, 0, 0, 45, 13655
n8192-coef-inner, 4096, 16, 21, 8, 0, 0, 45, 13655
n8192-coef-inner, 4096, 16, 21, 8, 0, 0, 45, 13655
n8192-coef-inner, 4096, 17, 21, 8, 0, 0, 46, 13655
n8192-coef-inner, 4096, 16, 21, 8, 0, 0, 45, 13655
n8192-coef-inner, 4096, 16, 21, 8, 0, 0, 45, 13655
n8192-coef-inner, 4096, 16, 21, 8, 0, 0, 45, 13655
n8192-coef-inner, 4096, 16, 21, 8, 0, 0, 45, 13655
n8192-coef-inner, 4096, 17, 21, 8, 0, 0, 46, 13655
n8192-coef-inner, 4096, 16, 21, 8, 0, 0, 45, 13655
n8192-coef-inner, 4096, 16, 21, 8, 0, 0, 45, 13655
n8192-coef-inner, 4096, 16, 21, 8, 0, 0, 45, 13655
n8192-coef-inner, 4096, 16, 21, 8, 0, 0, 45, 13655
n8192-coef-inner, 4096, 16, 21, 8, 0, 0, 45, 13655
n8192-coef-inner, 4096, 16, 22, 8, 0, 0, 46, 13655
n8192-coef-inner, 4096, 16, 21, 8, 0, 0, 45, 13655
n8192-coef-inner, 4096, 16, 21, 8, 0, 0, 45, 13655
n8192-coef-inner, 4096, 16, 22, 8, 0, 0, 46, 13655
n8192-coef-inner, 4096, 16, 21, 8, 0, 0, 45, 13655
n8192-coef-inner, 4096, 16, 21, 8, 0, 0, 45, 13655
n8192-coef-inner, 4096, 16, 22, 8, 0, 0, 46, 13655
n8192-coef-inner, 4096, 16, 21, 8, 0, 0, 45, 13655
n8192-coef-inner, 4096, 16, 21, 8, 0, 0, 45, 13655
n8192-coef-inner, 4096, 16, 21, 8, 0, 0, 45, 13655
n8192-coef-inner, 4096, 16, 21, 8, 0, 0, 45, 13655
n8192-coef-inner, 4096, 16, 21, 8, 0, 0, 45, 13655
n8192-coef-inner, 4096, 16, 21, 8, 0, 0, 45, 13655
n8192-coef-inner, 4096, 16, 21, 8, 0, 0, 45, 13655
n8192-coef-inner, 4096, 16, 21, 8, 0, 0, 45, 13655
n8192-coef-inner, 4096, 16, 21, 8, 0, 0, 45, 13655
n8192-coef-inner, 4096, 16, 21, 8, 0, 0, 45, 13655
n8192-coef-inner, 4096, 16, 21, 8, 0, 0, 45, 13655
n8192-coef-inner, 4096, 16, 21, 8, 0, 0, 45, 13655
n8192-coef-inner, 4096, 16, 21, 8, 0, 0, 45, 13655
n8192-coef-inner, 4096, 16, 21, 8, 0, 0, 45, 13655
n8192-coef-inner, 4096, 16, 22, 8, 0, 0, 46, 13655
n8192-coef-inner, 4096, 16, 21, 8, 0, 0, 45, 13655
n8192-coef-inner, 4096, 17, 21, 8, 0, 0, 46, 13655
n8192-coef-inner, 4096, 16, 21, 8, 0, 0, 45, 13655
n8192-coef-inner, 4096, 17, 21, 8, 0, 0, 46, 13655
n8192-coef-inner, 4096, 16, 21, 8, 0, 0, 45, 13655
n8192-coef-inner, 4096, 16, 21, 8, 0, 0, 45, 13655
n8192-coef-inner, 4096, 16, 21, 8, 0, 0, 45, 13655
n8192-coef-inner, 4096, 16, 22, 8, 0, 0, 46, 13655
n8192-coef-inner, 4096, 16, 21, 8, 0, 0, 45, 13655
n8192-coef-inner, 4096, 16, 21, 8, 0, 0, 45, 13655
n8192-coef-inner, 4096, 16, 21, 8, 0, 0, 45, 13655
n8192-coef-inner, 4096, 16, 21, 8, 0, 0, 45, 13655
n8192-coef-inner, 4096, 16, 21, 8, 0, 0, 45, 13655
n8192-coef-inner, 4096, 16, 21, 8, 0, 0, 45, 13655
n8192-coef-inner, 4096, 16, 21, 8, 0, 0, 45, 13655
n8192-coef-inner, 4096, 16, 21, 8, 0, 0, 45, 13655
n8192-coef-inner, 4096, 16, 21, 8, 0, 0, 45, 13655
n8192-coef-inner, 4096, 16, 21, 8, 0, 0, 45, 13655
n8192-coef-inner, 4096, 16, 21, 8, 0, 0, 45, 13655
n8192-coef-inner, 2048, 10, 20, 8, 0, 0, 38, 13655
n8192-coef-inner, 2048, 10, 20, 8, 0, 0, 38, 13655
n8192-coef-inner, 2048, 10, 20, 8, 0, 0, 38, 13655
n8192-coef-inner, 2048, 10, 20, 8, 0, 0, 38, 13655
n8192-coef-inner, 2048, 10, 21, 8, 0, 0, 39, 13655
n8192-coef-inner, 2048, 10, 20, 8, 0, 0, 38, 13655
n8192-coef-inner, 2048, 10, 20, 8, 0, 0, 38, 13655
n8192-coef-inner, 2048, 10, 20, 8, 0, 0, 38, 13655
n8192-coef-inner, 2048, 10, 20, 8, 0, 0, 38, 13655
n8192-coef-inner, 2048, 10, 21, 8, 0, 0, 39, 13655
n8192-coef-inner, 2048, 10, 21, 8, 0, 0, 39, 13655
n8192-coef-inner, 2048, 10, 20, 8, 0, 0, 38, 13655
n8192-coef-inner, 2048, 10, 20, 8, 0, 0, 38, 13655
n8192-coef-inner, 2048, 10, 20, 8, 0, 0, 38, 13655
n8192-coef-inner, 2048, 10, 20, 8, 0, 0, 38, 13655
n8192-coef-inner, 2048, 10, 20, 8, 0, 0, 38, 13655
n8192-coef-inner, 2048, 10, 20, 8, 0, 0, 38, 13655
n8192-coef-inner, 2048, 10, 20, 8, 0, 0, 38, 13655
n8192-coef-inner, 2048, 10, 20, 8, 0, 0, 38, 13655
n8192-coef-inner, 2048, 10, 20, 8, 0, 0, 38, 13655
n8192-coef-inner, 2048, 10, 20, 8, 0, 0, 38, 13655
n8192-coef-inner, 2048, 10, 20, 8, 0, 0, 38, 13655
n8192-coef-inner, 2048, 10, 20, 8, 0, 0, 38, 13655
n8192-coef-inner, 2048, 10, 20, 8, 0, 0, 38, 13655
n8192-coef-inner, 2048, 10, 20, 8, 0, 0, 38, 13655
n8192-coef-inner, 2048, 10, 20, 8, 0, 0, 38, 13655
n8192-coef-inner, 2048, 10, 20, 8, 0, 0, 38, 13655
n8192-coef-inner, 2048, 10, 20, 8, 0, 0, 38, 13655
n8192-coef-inner, 2048, 10, 20, 8, 0, 0, 38, 13655
n8192-coef-inner, 2048, 9, 20, 8, 0, 0, 37, 13655
n8192-coef-inner, 2048, 10, 20, 8, 0, 0, 38, 13655
n8192-coef-inner, 2048, 10, 20, 8, 0, 0, 38, 13655
n8192-coef-inner, 2048, 10, 20, 8, 0, 0, 38, 13655
n8192-coef-inner, 2048, 10, 20, 8, 0, 0, 38, 13655
n8192-coef-inner, 2048, 10, 20, 8, 0, 0, 38, 13655
n8192-coef-inner, 2048, 10, 20, 8, 0, 0, 38, 13655
n8192-coef-inner, 2048, 10, 20, 8, 0, 0, 38, 13655
n8192-coef-inner, 2048, 10, 20, 8, 0, 0, 38, 13655
n8192-coef-inner, 2048, 10, 20, 8, 0, 0, 38, 13655
n8192-coef-inner, 2048, 10, 20, 8, 0, 0, 38, 13655
n8192-coef-inner, 2048, 10, 20, 8, 0, 0, 38, 13655
n8192-coef-inner, 2048, 10, 20, 8, 0, 0, 38, 13655
n8192-coef-inner, 2048, 10, 20, 8, 0, 0, 38, 13655
n8192-coef-inner, 2048, 10, 20, 8, 0, 0, 38, 13655
n8192-coef-inner, 2048, 10, 20, 8, 0, 0, 38, 13655
n8192-coef-inner, 2048, 10, 24, 8, 0, 0, 42, 13655
n8192-coef-inner, 2048, 10, 20, 8, 0, 0, 38, 13655
n8192-coef-inner, 2048, 10, 20, 8, 0, 0, 38, 13655
n8192-coef-inner, 2048, 10, 20, 8, 0, 0, 38, 13655
n8192-coef-inner, 2048, 10, 20, 8, 0, 0, 38, 13655
n8192-coef-inner, 2048, 10, 20, 8, 0, 0, 38, 13655
n8192-coef-inner, 2048, 10, 20, 8, 0, 0, 38, 13655
n8192-coef-inner, 2048, 10, 20, 8, 0, 0, 38, 13655
n8192-coef-inner, 2048, 10, 20, 8, 0, 0, 38, 13655
n8192-coef-inner, 2048, 10, 20, 8, 0, 0, 38, 13655
n8192-coef-inner, 2048, 10, 20, 8, 0, 0, 38, 13655
n8192-coef-inner, 2048, 10, 20, 8, 0, 0, 38, 13655
n8192-coef-inner, 2048, 10, 20, 8, 0, 0, 38, 13655
n8192-coef-inner, 2048, 10, 20, 8, 0, 0, 38, 13655
n8192-coef-inner, 2048, 10, 20, 8, 0, 0, 38, 13655
n8192-coef-inner, 2048, 9, 20, 8, 0, 0, 37, 13655
n8192-coef-inner, 2048, 10, 20, 8, 0, 0, 38, 13655
n8192-coef-inner, 2048, 10, 20, 8, 0, 0, 38, 13655
n8192-coef-inner, 2048, 10, 20, 8, 0, 0, 38, 13655
n8192-coef-inner, 2048, 10, 21, 8, 0, 0, 39, 13655
n8192-coef-inner, 2048, 10, 20, 8, 0, 0, 38, 13655
n8192-coef-inner, 2048, 10, 20, 8, 0, 0, 38, 13655
n8192-coef-inner, 2048, 10, 20, 8, 0, 0, 38, 13655
n8192-coef-inner, 2048, 10, 20, 8, 0, 0, 38, 13655
n8192-coef-inner, 2048, 10, 20, 8, 0, 0, 38, 13655
n8192-coef-inner, 2048, 10, 20, 8, 0, 0, 38, 13655
n8192-coef-inner, 2048, 10, 20, 8, 0, 0, 38, 13655
n8192-coef-inner, 2048, 10, 20, 8, 0, 0, 38, 13655
n8192-coef-inner, 2048, 10, 20, 8, 0, 0, 38, 13655
n8192-coef-inner, 2048, 10, 20, 10, 0, 0, 40, 13655
n8192-coef-inner, 2048, 10, 20, 8, 0, 0, 38, 13655
n8192-coef-inner, 2048, 10, 20, 8, 0, 0, 38, 13655
n8192-coef-inner, 2048, 10, 20, 8, 0, 0, 38, 13655
n8192-coef-inner, 2048, 10, 20, 8, 0, 0, 38, 13655
n8192-coef-inner, 2048, 10, 20, 8, 0, 0, 38, 13655
n8192-coef-inner, 2048, 10, 21, 8, 0, 0, 39, 13655
n8192-coef-inner, 2048, 10, 20, 8, 0, 0, 38, 13655
n8192-coef-inner, 2048, 10, 21, 8, 0, 0, 39, 13655
n8192-coef-inner, 2048, 10, 20, 8, 0, 0, 38, 13655
n8192-coef-inner, 2048, 10, 20, 8, 0, 0, 38, 13655
n8192-coef-inner, 2048, 10, 20, 8, 0, 0, 38, 13655
n8192-coef-inner, 2048, 10, 21, 8, 0, 0, 39, 13655
n8192-coef-inner, 2048, 10, 20, 8, 0, 0, 38, 13655
n8192-coef-inner, 2048, 10, 21, 8, 0, 0, 39, 13655
n8192-coef-inner, 2048, 10, 20, 8, 0, 0, 38, 13655
n8192-coef-inner, 2048, 10, 20, 8, 0, 0, 38, 13655
n8192-coef-inner, 2048, 10, 20, 9, 0, 0, 39, 13655
n8192-coef-inner, 2048, 10, 20, 8, 0, 0, 38, 13655
n8192-coef-inner, 2048, 10, 20, 8, 0, 0, 38, 13655
n8192-coef-inner, 2048, 10, 20, 8, 0, 0, 38, 13655
n8192-coef-inner, 2048, 10, 20, 8, 0, 0, 38, 13655
n8192-coef-inner, 2048, 10, 20, 8, 0, 0, 38, 13655
n8192-coef-inner, 2048, 10, 20, 8, 0, 0, 38, 13655
n8192-coef-inner, 2048, 10, 20, 8, 0, 0, 38, 13655
n8192-coef-inner, 2048, 10, 20, 8, 0, 0, 38, 13655
n8192-coef-inner, 1024, 7, 20, 8, 0, 0, 35, 13655
n8192-coef-inner, 1024, 7, 20, 8, 0, 0, 35, 13655
n8192-coef-inner, 1024, 7, 20, 8, 0, 0, 35, 13655
n8192-coef-inner, 1024, 7, 20, 8, 0, 0, 35, 13655
n8192-coef-inner, 1024, 7, 20, 8, 0, 0, 35, 13655
n8192-coef-inner, 1024, 7, 20, 8, 0, 0, 35, 13655
n8192-coef-inner, 1024, 7, 20, 8, 0, 0, 35, 13655
n8192-coef-inner, 1024, 7, 20, 8, 0, 0, 35, 13655
n8192-coef-inner, 1024, 7, 20, 8, 0, 0, 35, 13655
n8192-coef-inner, 1024, 7, 21, 8, 0, 0, 36, 13655
n8192-coef-inner, 1024, 7, 21, 8, 0, 0, 36, 13655
n8192-coef-inner, 1024, 7, 20, 8, 0, 0, 35, 13655
n8192-coef-inner, 1024, 7, 20, 8, 0, 0, 35, 13655
n8192-coef-inner, 1024, 7, 20, 8, 0, 0, 35, 13655
n8192-coef-inner, 1024, 7, 20, 8, 0, 0, 35, 13655
n8192-coef-inner, 1024, 7, 21, 8, 0, 0, 36, 13655
n8192-coef-inner, 1024, 7, 20, 8, 0, 0, 35, 13655
n8192-coef-inner, 1024, 7, 20, 8, 0, 0, 35, 13655
n8192-coef-inner, 1024, 7, 20, 8, 0, 0, 35, 13655
n8192-coef-inner, 1024, 7, 20, 8, 0, 0, 35, 13655
n8192-coef-inner, 1024, 7, 21, 8, 0, 0, 36, 13655
n8192-coef-inner, 1024, 7, 20, 8, 0, 0, 35, 13655
n8192-coef-inner, 1024, 7, 20, 8, 0, 0, 35, 13655
n8192-coef-inner, 1024, 7, 20, 8, 0, 0, 35, 13655
n8192-coef-inner, 1024, 7, 20, 8, 0, 0, 35, 13655
n8192-coef-inner, 1024, 7, 20, 8, 0, 0, 35, 13655
n8192-coef-inner, 1024, 7, 20, 8, 0, 0, 35, 13655
n8192-coef-inner, 1024, 7, 20, 8, 0, 0, 35, 13655
n8192-coef-inner, 1024, 7, 20, 8, 0, 0, 35, 13655
n8192-coef-inner, 1024, 7, 20, 8, 0, 0, 35, 13655
n8192-coef-inner, 1024, 7, 20, 8, 0, 0, 35, 13655
n8192-coef-inner, 1024, 7, 20, 8, 0, 0, 35, 13655
n8192-coef-inner, 1024, 7, 20, 8, 0, 0, 35, 13655
n8192-coef-inner, 1024, 7, 20, 8, 0, 0, 35, 13655
n8192-coef-inner, 1024, 7, 20, 8, 0, 0, 35, 13655
n8192-coef-inner, 1024, 7, 20, 8, 0, 0, 35, 13655
n8192-coef-inner, 1024, 7, 20, 8, 0, 0, 35, 13655
n8192-coef-inner, 1024, 7, 20, 8, 0, 0, 35, 13655
n8192-coef-inner, 1024, 7, 20, 8, 0, 0, 35, 13655
n8192-coef-inner, 1024, 7, 20, 8, 0, 0, 35, 13655
n8192-coef-inner, 1024, 7, 20, 8, 0, 0, 35, 13655
n8192-coef-inner, 1024, 7, 20, 8, 0, 0, 35, 13655
n8192-coef-inner, 1024, 7, 20, 8, 0, 0, 35, 13655
n8192-coef-inner, 1024, 7, 20, 9, 0, 0, 36, 13655
n8192-coef-inner, 1024, 7, 20, 8, 0, 0, 35, 13655
n8192-coef-inner, 1024, 7, 20, 8, 0, 0, 35, 13655
n8192-coef-inner, 1024, 7, 20, 8, 0, 0, 35, 13655
n8192-coef-inner, 1024, 7, 21, 8, 0, 0, 36, 13655
n8192-coef-inner, 1024, 7, 20, 8, 0, 0, 35, 13655
n8192-coef-inner, 1024, 7, 20, 8, 0, 0, 35, 13655
n8192-coef-inner, 1024, 7, 20, 8, 0, 0, 35, 13655
n8192-coef-inner, 1024, 7, 20, 8, 0, 0, 35, 13655
n8192-coef-inner, 1024, 7, 20, 8, 0, 0, 35, 13655
n8192-coef-inner, 1024, 7, 20, 8, 0, 0, 35, 13655
n8192-coef-inner, 1024, 7, 20, 8, 0, 0, 35, 13655
n8192-coef-inner, 1024, 7, 20, 8, 0, 0, 35, 13655
n8192-coef-inner, 1024, 7, 20, 8, 0, 0, 35, 13655
n8192-coef-inner, 1024, 7, 20, 8, 0, 0, 35, 13655
n8192-coef-inner, 1024, 7, 20, 8, 0, 0, 35, 13655
n8192-coef-inner, 1024, 7, 20, 8, 0, 0, 35, 13655
n8192-coef-inner, 1024, 7, 20, 8, 0, 0, 35, 13655
n8192-coef-inner, 1024, 7, 20, 8, 0, 0, 35, 13655
n8192-coef-inner, 1024, 7, 20, 8, 0, 0, 35, 13655
n8192-coef-inner, 1024, 7, 20, 8, 0, 0, 35, 13655
n8192-coef-inner, 1024, 7, 20, 8, 0, 0, 35, 13655
n8192-coef-inner, 1024, 7, 20, 8, 0, 0, 35, 13655
n8192-coef-inner, 1024, 7, 20, 8, 0, 0, 35, 13655
n8192-coef-inner, 1024, 7, 20, 8, 0, 0, 35, 13655
n8192-coef-inner, 1024, 7, 20, 8, 0, 0, 35, 13655
n8192-coef-inner, 1024, 7, 20, 8, 0, 0, 35, 13655
n8192-coef-inner, 1024, 7, 20, 8, 0, 0, 35, 13655
n8192-coef-inner, 1024, 7, 20, 8, 0, 0, 35, 13655
n8192-coef-inner, 1024, 7, 20, 8, 0, 0, 35, 13655
n8192-coef-inner, 1024, 7, 20, 8, 0, 0, 35, 13655
n8192-coef-inner, 1024, 7, 20, 8, 0, 0, 35, 13655
n8192-coef-inner, 1024, 7, 20, 8, 0, 0, 35, 13655
n8192-coef-inner, 1024, 7, 20, 8, 0, 0, 35, 13655
n8192-coef-inner, 1024, 7, 20, 8, 0, 0, 35, 13655
n8192-coef-inner, 1024, 7, 20, 8, 0, 0, 35, 13655
n8192-coef-inner, 1024, 7, 20, 8, 0, 0, 35, 13655
n8192-coef-inner, 1024, 7, 20, 8, 0, 0, 35, 13655
n8192-coef-inner, 1024, 7, 20, 8, 0, 0, 35, 13655
n8192-coef-inner, 1024, 7, 20, 8, 0, 0, 35, 13655
n8192-coef-inner, 1024, 7, 20, 8, 0, 0, 35, 13655
n8192-coef-inner, 1024, 7, 20, 8, 0, 0, 35, 13655
n8192-coef-inner, 1024, 7, 20, 8, 0, 0, 35, 13655
n8192-coef-inner, 1024, 7, 20, 8, 0, 0, 35, 13655
n8192-coef-inner, 1024, 7, 20, 8, 0, 0, 35, 13655
n8192-coef-inner, 1024, 7, 20, 9, 0, 0, 36, 13655
n8192-coef-inner, 1024, 7, 20, 8, 0, 0, 35, 13655
n8192-coef-inner, 1024, 7, 20, 8, 0, 0, 35, 13655
n8192-coef-inner, 1024, 7, 20, 8, 0, 0, 35, 13655
n8192-coef-inner, 1024, 7, 20, 8, 0, 0, 35, 13655
n8192-coef-inner, 1024, 7, 20, 8, 0, 0, 35, 13655
n8192-coef-inner, 1024, 7, 20, 8, 0, 0, 35, 13655
n8192-coef-inner, 1024, 7, 20, 8, 0, 0, 35, 13655
n8192-coef-inner, 1024, 7, 20, 9, 0, 0, 36, 13655
n8192-coef-inner, 1024, 7, 20, 8, 0, 0, 35, 13655
n8192-coef-inner, 1024, 7, 20, 8, 0, 0, 35, 13655
n8192-coef-inner, 1024, 7, 20, 8, 0, 0, 35, 13655
n50x8192-coef-sum, 8192, 34, 511, 12, 0, 0, 557, 1
n50x8192-coef-sum, 8192, 35, 512, 12, 0, 0, 559, 1
n50x8192-coef-sum, 8192, 35, 511, 12, 0, 0, 558, 1
n50x8192-coef-sum, 8192, 34, 507, 12, 0, 0, 553, 1
n50x8192-coef-sum, 8192, 35, 510, 12, 0, 0, 557, 1
n50x8192-coef-sum, 8192, 34, 511, 12, 0, 0, 557, 1
n50x8192-coef-sum, 8192, 37, 511, 12, 0, 0, 560, 1
n50x8192-coef-sum, 8192, 34, 508, 12, 0, 0, 554, 1
n50x8192-coef-sum, 8192, 36, 511, 12, 0, 0, 559, 1
n50x8192-coef-sum, 8192, 35, 513, 12, 0, 0, 560, 1
n50x8192-coef-sum, 8192, 34, 509, 11, 0, 0, 554, 1
n50x8192-coef-sum, 8192, 34, 512, 12, 0, 0, 558, 1
n50x8192-coef-sum, 8192, 35, 513, 11, 0, 0, 559, 1
n50x8192-coef-sum, 8192, 35, 512, 12, 0, 0, 559, 1
n50x8192-coef-sum, 8192, 37, 510, 12, 0, 0, 559, 1
n50x8192-coef-sum, 8192, 35, 547, 13, 0, 0, 595, 1
n50x8192-coef-sum, 8192, 34, 513, 12, 0, 0, 559, 1
n50x8192-coef-sum, 8192, 34, 513, 12, 0, 0, 559, 1
n50x8192-coef-sum, 8192, 35, 514, 12, 0, 0, 561, 1
n50x8192-coef-sum, 8192, 34, 510, 12, 0, 0, 556, 1
n50x8192-coef-sum, 8192, 35, 516, 12, 0, 0, 563, 1
n50x8192-coef-sum, 8192, 35, 514, 12, 0, 0, 561, 1
n50x8192-coef-sum, 8192, 35, 512, 12, 0, 0, 559, 1
n50x8192-coef-sum, 8192, 34, 510, 12, 0, 0, 556, 1
n50x8192-coef-sum, 8192, 35, 512, 12, 0, 0, 559, 1
n50x8192-coef-sum, 8192, 34, 509, 12, 0, 0, 555, 1
n50x8192-coef-sum, 8192, 35, 516, 12, 0, 0, 563, 1
n50x8192-coef-sum, 8192, 34, 513, 12, 0, 0, 559, 1
n50x8192-coef-sum, 8192, 34, 510, 12, 0, 0, 556, 1
n50x8192-coef-sum, 8192, 34, 510, 12, 0, 0, 556, 1
n50x8192-coef-sum, 8192, 35, 511, 11, 0, 0, 557, 1
n50x8192-coef-sum, 8192, 34, 508, 12, 0, 0, 554, 1
n50x8192-coef-sum, 8192, 34, 511, 12, 0, 0, 557, 1
n50x8192-coef-sum, 8192, 34, 509, 12, 0, 0, 555, 1
n50x8192-coef-sum, 8192, 34, 513, 12, 0, 0, 559, 1
n50x8192-coef-sum, 8192, 34, 511, 11, 0, 0, 556, 1
n50x8192-coef-sum, 8192, 34, 511, 12, 0, 0, 557, 1
n50x8192-coef-sum, 8192, 34, 512, 12, 0, 0, 558, 1
n50x8192-coef-sum, 8192, 34, 514, 12, 0, 0, 560, 1
n50x8192-coef-sum, 8192, 34, 513, 12, 0, 0, 559, 1
n50x8192-coef-sum, 8192, 34, 514, 12, 0, 0, 560, 1
n50x8192-coef-sum, 8192, 35, 538, 13, 0, 0, 586, 1
n50x8192-coef-sum, 8192, 34, 515, 12, 0, 0, 561, 1
n50x8192-coef-sum, 8192, 34, 514, 12, 0, 0, 560, 1
n50x8192-coef-sum, 8192, 34, 514, 12, 0, 0, 560, 1
n50x8192-coef-sum, 8192, 35, 512, 12, 0, 0, 559, 1
n50x8192-coef-sum, 8192, 34, 510, 12, 0, 0, 556, 1
n50x8192-coef-sum, 8192, 34, 510, 11, 0, 0, 555, 1
n50x8192-coef-sum, 8192, 34, 511, 11, 0, 0, 556, 1
n50x8192-coef-sum, 8192, 34, 509, 11, 0, 0, 554, 1
n50x8192-coef-sum, 8192, 34, 519, 12, 0, 0, 565, 1
n50x8192-coef-sum, 8192, 35, 513, 12, 0, 0, 560, 1
n50x8192-coef-sum, 8192, 34, 515, 12, 0, 0, 561, 1
n50x8192-coef-sum, 8192, 34, 508, 12, 0, 0, 554, 1
n50x8192-coef-sum, 8192, 35, 514, 11, 0, 0, 560, 1
n50x8192-coef-sum, 8192, 34, 514, 11, 0, 0, 559, 1
n50x8192-coef-sum, 8192, 34, 508, 11, 0, 0, 553, 1
n50x8192-coef-sum, 8192, 34, 511, 12, 0, 0, 557, 1
n50x8192-coef-sum, 8192, 34, 514, 12, 0, 0, 560, 1
n50x8192-coef-sum, 8192, 35, 514, 12, 0, 0, 561, 1
n50x8192-coef-sum, 8192, 34, 516, 12, 0, 0, 562, 1
n50x8192-coef-sum, 8192, 35, 511, 12, 0, 0, 558, 1
n50x8192-coef-sum, 8192, 34, 509, 12, 0, 0, 555, 1
n50x8192-coef-sum, 8192, 35, 515, 12, 0, 0, 562, 1
n50x8192-coef-sum, 8192, 35, 514, 12, 0, 0, 561, 1
n50x8192-coef-sum, 8192, 35, 513, 12, 0, 0, 560, 1
n50x8192-coef-sum, 8192, 35, 518, 12, 0, 0, 565, 1
n50x8192-coef-sum, 8192, 34, 511, 12, 0, 0, 557, 1
n50x8192-coef-sum, 8192, 35, 523, 11, 0, 0, 569, 1
n50x8192-coef-sum, 8192, 34, 517, 12, 0, 0, 563, 1
n50x8192-coef-sum, 8192, 34, 513, 12, 0, 0, 559, 1
n50x8192-coef-sum, 8192, 34, 512, 11, 0, 0, 557, 1
n50x8192-coef-sum, 8192, 34, 511, 12, 0, 0, 557, 1
n50x8192-coef-sum, 8192, 34, 513, 11, 0, 0, 558, 1
n50x8192-coef-sum, 8192, 35, 510, 12, 0, 0, 557, 1
n50x8192-coef-sum, 8192, 34, 514, 12, 0, 0, 560, 1
n50x8192-coef-sum, 8192, 34, 510, 11, 0, 0, 555, 1
n50x8192-coef-sum, 8192, 35, 524, 12, 0, 0, 571, 1
n50x8192-coef-sum, 8192, 34, 509, 12, 0, 0, 555, 1
n50x8192-coef-sum, 8192, 35, 517, 12, 0, 0, 564, 1
n50x8192-coef-sum, 8192, 35, 516, 12, 0, 0, 563, 1
n50x8192-coef-sum, 8192, 34, 510, 11, 0, 0, 555, 1
n50x8192-coef-sum, 8192, 34, 509, 12, 0, 0, 555, 1
n50x8192-coef-sum, 8192, 34, 515, 12, 0, 0, 561, 1
n50x8192-coef-sum, 8192, 34, 511, 12, 0, 0, 557, 1
n50x8192-coef-sum, 8192, 35, 509, 12, 0, 0, 556, 1
n50x8192-coef-sum, 8192, 34, 511, 12, 0, 0, 557, 1
n50x8192-coef-sum, 8192, 34, 510, 12, 1, 0, 557, 1
n50x8192-coef-sum, 8192, 35, 510, 12, 0, 0, 557, 1
n50x8192-coef-sum, 8192, 35, 510, 12, 0, 0, 557, 1
n50x8192-coef-sum, 8192, 35, 511, 12, 0, 0, 558, 1
n50x8192-coef-sum, 8192, 34, 508, 12, 0, 0, 554, 1
n50x8192-coef-sum, 8192, 34, 512, 12, 0, 0, 558, 1
n50x8192-coef-sum, 8192, 34, 515, 12, 0, 0, 561, 1
n50x8192-coef-sum, 8192, 34, 511, 12, 0, 0, 557, 1
n50x8192-coef-sum, 8192, 34, 513, 12, 0, 0, 559, 1
n50x8192-coef-sum, 8192, 35, 509, 12, 0, 0, 556, 1
n50x8192-coef-sum, 8192, 34, 510, 12, 0, 0, 556, 1
n50x8192-coef-sum, 8192, 35, 510, 12, 0, 0, 557, 1
n50x8192-coef-sum, 8192, 35, 508, 11, 0, 0, 554, 1
n50x8192-coef-sum, 4096, 19, 501, 13, 0, 0, 533, 1
n50x8192-coef-sum, 4096, 19, 503, 13, 0, 0, 535, 1
n50x8192-coef-sum, 4096, 18, 499, 12, 0, 0, 529, 1
n50x8192-coef-sum, 4096, 19, 504, 12, 0, 0, 535, 1
n50x8192-coef-sum, 4096, 18, 504, 13, 0, 0, 535, 1
n50x8192-coef-sum, 4096, 19, 501, 13, 0, 0, 533, 1
n50x8192-coef-sum, 4096, 19, 503, 12, 0, 0, 534, 1
n50x8192-coef-sum, 4096, 19, 502, 13, 0, 0, 534, 1
n50x8192-coef-sum, 4096, 19, 502, 13, 0, 0, 534, 1
n50x8192-coef-sum, 4096, 19, 500, 13, 0, 0, 532, 1
n50x8192-coef-sum, 4096, 18, 503, 12, 0, 0, 533, 1
n50x8192-coef-sum, 4096, 19, 501, 13, 0, 0, 533, 1
n50x8192-coef-sum, 4096, 18, 501, 12, 0, 0, 531, 1
n50x8192-coef-sum, 4096, 19, 505, 13, 0, 0, 537, 1
n50x8192-coef-sum, 4096, 18, 504, 13, 0, 0, 535, 1
n50x8192-coef-sum, 4096, 19, 503, 13, 0, 0, 535, 1
n50x8192-coef-sum, 4096, 19, 502, 13, 0, 0, 534, 1
n50x8192-coef-sum, 4096, 19, 503, 13, 0, 0, 535, 1
n50x8192-coef-sum, 4096, 18, 506, 12, 0, 0, 536, 1
n50x8192-coef-sum, 4096, 19, 505, 13, 0, 0, 537, 1
n50x8192-coef-sum, 4096, 19, 506, 12, 0, 0, 537, 1
n50x8192-coef-sum, 4096, 19, 504, 13, 0, 0, 536, 1
n50x8192-coef-sum, 4096, 19, 504, 12, 0, 0, 535, 1
n50x8192-coef-sum, 4096, 19, 503, 13, 0, 0, 535, 1
n50x8192-coef-sum, 4096, 19, 509, 12, 0, 0, 540, 1
n50x8192-coef-sum, 4096, 19, 504, 12, 0, 0, 535, 1
n50x8192-coef-sum, 4096, 19, 503, 13, 0, 0, 535, 1
n50x8192-coef-sum, 4096, 18, 502, 13, 0, 0, 533, 1
n50x8192-coef-sum, 4096, 19, 501, 12, 0, 0, 532, 1
n50x8192-coef-sum, 4096, 19, 502, 13, 0, 0, 534, 1
n50x8192-coef-sum, 4096, 19, 505, 13, 0, 0, 537, 1
n50x8192-coef-sum, 4096, 19, 505, 13, 0, 0, 537, 1
n50x8192-coef-sum, 4096, 19, 504, 13, 0, 0, 536, 1
n50x8192-coef-sum, 4096, 19, 504, 13, 0, 0, 536, 1
n50x8192-coef-sum, 4096, 19, 503, 13, 0, 0, 535, 1
n50x8192-coef-sum, 4096, 19, 502, 12, 0, 0, 533, 1
n50x8192-coef-sum, 4096, 18, 503, 12, 0, 0, 533, 1
n50x8192-coef-sum, 4096, 18, 499, 12, 0, 0, 529, 1
n50x8192-coef-sum, 4096, 19, 505, 13, 0, 0, 537, 1
n50x8192-coef-sum, 4096, 19, 503, 13, 0, 0, 535, 1
n50x8192-coef-sum, 4096, 19, 504, 12, 0, 0, 535, 1
n50x8192-coef-sum, 4096, 19, 502, 13, 0, 0, 534, 1
n50x8192-coef-sum, 4096, 19, 503, 13, 0, 0, 535, 1
n50x8192-coef-sum, 4096, 19, 503, 12, 0, 0, 534, 1
n50x8192-coef-sum, 4096, 19, 504, 12, 0, 0, 535, 1
n50x8192-coef-sum, 4096, 18, 504, 12, 0, 0, 534, 1
n50x8192-coef-sum, 4096, 19, 505, 12, 0, 0, 536, 1
n50x8192-coef-sum, 4096, 18, 504, 13, 0, 0, 535, 1
n50x8192-coef-sum, 4096, 19, 507, 13, 0, 0, 539, 1
n50x8192-coef-sum, 4096, 19, 504, 13, 2, 0, 538, 1
n50x8192-coef-sum, 4096, 19, 506, 13, 0, 0, 538, 1
n50x8192-coef-sum, 4096, 19, 500, 12, 0, 0, 531, 1
n50x8192-coef-sum, 4096, 19, 503, 12, 0, 0, 534, 1
n50x8192-coef-sum, 4096, 19, 504, 12, 0, 0, 535, 1
n50x8192-coef-sum, 4096, 19, 504, 12, 0, 0, 535, 1
n50x8192-coef-sum, 4096, 18, 505, 12, 0, 0, 535, 1
n50x8192-coef-sum, 4096, 18, 500, 12, 0, 0, 530, 1
n50x8192-coef-sum, 4096, 19, 504, 13, 0, 0, 536, 1
n50x8192-coef-sum, 4096, 18, 501, 13, 0, 0, 532, 1
n50x8192-coef-sum, 4096, 19, 502, 13, 0, 0, 534, 1
n50x8192-coef-sum, 4096, 19, 502, 13, 0, 0, 534, 1
n50x8192-coef-sum, 4096, 18, 503, 13, 0, 0, 534, 1
n50x8192-coef-sum, 4096, 18, 504, 13, 0, 0, 535, 1
n50x8192-coef-sum, 4096, 19, 502, 13, 0, 0, 534, 1
n50x8192-coef-sum, 4096, 18, 505, 12, 0, 0, 535, 1
n50x8192-coef-sum, 4096, 19, 499, 12, 0, 0, 530, 1
n50x8192-coef-sum, 4096, 19, 503, 12, 0, 0, 534, 1
n50x8192-coef-sum, 4096, 18, 504, 13, 0, 0, 535, 1
n50x8192-coef-sum, 4096, 19, 503, 13, 0, 0, 535, 1
n50x8192-coef-sum, 4096, 19, 505, 13, 0, 0, 537, 1
n50x8192-coef-sum, 4096, 18, 501, 12, 0, 0, 531, 1
n50x8192-coef-sum, 4096, 19, 504, 12, 0, 0, 535, 1
n50x8192-coef-sum, 4096, 19, 522, 12, 0, 0, 553, 1
n50x8192-coef-sum, 4096, 19, 504, 13, 0, 0, 536, 1
n50x8192-coef-sum, 4096, 19, 508, 13, 0, 0, 540, 1
n50x8192-coef-sum, 4096, 18, 505, 13, 0, 0, 536, 1
n50x8192-coef-sum, 4096, 19, 503, 12, 0, 0, 534, 1
n50x8192-coef-sum, 4096, 18, 507, 13, 0, 0, 538, 1
n50x8192-coef-sum, 4096, 19, 504, 13, 0, 0, 536, 1
n50x8192-coef-sum, 4096, 19, 508, 13, 0, 0, 540, 1
n50x8192-coef-sum, 4096, 19, 506, 13, 0, 0, 538, 1
n50x8192-coef-sum, 4096, 18, 503, 13, 0, 0, 534, 1
n50x8192-coef-sum, 4096, 19, 503, 13, 0, 0, 535, 1
n50x8192-coef-sum, 4096, 19, 503, 13, 0, 0, 535, 1
n50x8192-coef-sum, 4096, 19, 502, 13, 0, 0, 534, 1
n50x8192-coef-sum, 4096, 18, 501, 12, 0, 0, 531, 1
n50x8192-coef-sum, 4096, 19, 501, 12, 0, 0, 532, 1
n50x8192-coef-sum, 4096, 18, 501, 12, 0, 0, 531, 1
n50x8192-coef-sum, 4096, 18, 503, 12, 0, 0, 533, 1
n50x8192-coef-sum, 4096, 18, 503, 12, 0, 0, 533, 1
n50x8192-coef-sum, 4096, 18, 503, 12, 0, 0, 533, 1
n50x8192-coef-sum, 4096, 19, 505, 12, 0, 0, 536, 1
n50x8192-coef-sum, 4096, 19, 503, 13, 0, 0, 535, 1
n50x8192-coef-sum, 4096, 19, 501, 12, 0, 0, 532, 1
n50x8192-coef-sum, 4096, 19, 503, 12, 0, 0, 534, 1
n50x8192-coef-sum, 4096, 19, 502, 13, 0, 0, 534, 1
n50x8192-coef-sum, 4096, 18, 503, 13, 0, 0, 534, 1
n50x8192-coef-sum, 4096, 18, 503, 13, 0, 0, 534, 1
n50x8192-coef-sum, 4096, 19, 504, 13, 0, 0, 536, 1
n50x8192-coef-sum, 4096, 19, 504, 12, 0, 0, 535, 1
n50x8192-coef-sum, 2048, 11, 500, 14, 0, 0, 525, 1
n50x8192-coef-sum, 2048, 11, 504, 14, 0, 0, 529, 1
n50x8192-coef-sum, 2048, 11, 500, 14, 0, 0, 525, 1
n50x8192-coef-sum, 2048, 11, 502, 14, 0, 0, 527, 1
n50x8192-coef-sum, 2048, 11, 503, 14, 0, 0, 528, 1
n50x8192-coef-sum, 2048, 11, 504, 14, 0, 0, 529, 1
n50x8192-coef-sum, 2048, 11, 502, 14, 0, 0, 527, 1
n50x8192-coef-sum, 2048, 11, 503, 14, 0, 0, 528, 1
n50x8192-coef-sum, 2048, 11, 504, 14, 0, 0, 529, 1
n50x8192-coef-sum, 2048, 11, 504, 14, 0, 0, 529, 1
n50x8192-coef-sum, 2048, 11, 502, 14, 0, 0, 527, 1
n50x8192-coef-sum, 2048, 11, 500, 14, 0, 0, 525, 1
n50x8192-coef-sum, 2048, 11, 503, 14, 0, 0, 528, 1
n50x8192-coef-sum, 2048, 11, 502, 14, 0, 0, 527, 1
n50x8192-coef-sum, 2048, 11, 503, 14, 0, 0, 528, 1
n50x8192-coef-sum, 2048, 11, 503, 14, 0, 0, 528, 1
n50x8192-coef-sum, 2048, 11, 505, 14, 0, 0, 530, 1
n50x8192-coef-sum, 2048, 12, 503, 15, 0, 0, 530, 1
n50x8192-coef-sum, 2048, 11, 499, 14, 0, 0, 524, 1
n50x8192-coef-sum, 2048, 11, 501, 14, 0, 0, 526, 1
n50x8192-coef-sum, 2048, 11, 501, 14, 0, 0, 526, 1
n50x8192-coef-sum, 2048, 11, 500, 14, 0, 0, 525, 1
n50x8192-coef-sum, 2048, 11, 502, 14, 0, 0, 527, 1
n50x8192-coef-sum, 2048, 11, 502, 14, 0, 0, 527, 1
n50x8192-coef-sum, 2048, 12, 501, 15, 0, 0, 528, 1
n50x8192-coef-sum, 2048, 11, 502, 14, 0, 0, 527, 1
n50x8192-coef-sum, 2048, 11, 503, 14, 0, 0, 528, 1
n50x8192-coef-sum, 2048, 11, 503, 14, 0, 0, 528, 1
n50x8192-coef-sum, 2048, 11, 501, 14, 0, 0, 526, 1
n50x8192-coef-sum, 2048, 11, 504, 14, 0, 0, 529, 1
n50x8192-coef-sum, 2048, 11, 503, 14, 0, 0, 528, 1
n50x8192-coef-sum, 2048, 11, 503, 14, 0, 0, 528, 1
n50x8192-coef-sum, 2048, 11, 500, 14, 0, 0, 525, 1
n50x8192-coef-sum, 2048, 11, 499, 14, 0, 0, 524, 1
n50x8192-coef-sum, 2048, 11, 500, 14, 0, 0, 525, 1
n50x8192-coef-sum, 2048, 11, 505, 14, 0, 0, 530, 1
n50x8192-coef-sum, 2048, 11, 502, 14, 0, 0, 527, 1
n50x8192-coef-sum, 2048, 11, 501, 14, 0, 0, 526, 1
n50x8192-coef-sum, 2048, 11, 503, 14, 0, 0, 528, 1
n50x8192-coef-sum, 2048, 11, 499, 14, 0, 0, 524, 1
n50x8192-coef-sum, 2048, 11, 501, 14, 0, 0, 526, 1
n50x8192-coef-sum, 2048, 11, 503, 15, 0, 0, 529, 1
n50x8192-coef-sum, 2048, 12, 504, 14, 0, 0, 530, 1
n50x8192-coef-sum, 2048, 11, 500, 14, 0, 0, 525, 1
n50x8192-coef-sum, 2048, 11, 505, 15, 0, 0, 531, 1
n50x8192-coef-sum, 2048, 11, 502, 14, 0, 0, 527, 1
n50x8192-coef-sum, 2048, 11, 503, 14, 0, 0, 528, 1
n50x8192-coef-sum, 2048, 11, 501, 14, 0, 0, 526, 1
n50x8192-coef-sum, 2048, 11, 502, 14, 0, 0, 527, 1
n50x8192-coef-sum, 2048, 11, 501, 14, 0, 0, 526, 1
n50x8192-coef-sum, 2048, 11, 504, 14, 0, 0, 529, 1
n50x8192-coef-sum, 2048, 11, 502, 14, 0, 0, 527, 1
n50x8192-coef-sum, 2048, 11, 502, 14, 0, 0, 527, 1
n50x8192-coef-sum, 2048, 11, 503, 14, 0, 0, 528, 1
n50x8192-coef-sum, 2048, 11, 503, 14, 0, 0, 528, 1
n50x8192-coef-sum, 2048, 11, 501, 14, 0, 0, 526, 1
n50x8192-coef-sum, 2048, 12, 503, 15, 0, 0, 530, 1
n50x8192-coef-sum, 2048, 11, 502, 14, 0, 0, 527, 1
n50x8192-coef-sum, 2048, 11, 503, 14, 0, 0, 528, 1
n50x8192-coef-sum, 2048, 11, 502, 14, 0, 0, 527, 1
n50x8192-coef-sum, 2048, 11, 504, 14, 0, 0, 529, 1
n50x8192-coef-sum, 2048, 11, 504, 14, 0, 0, 529, 1
n50x8192-coef-sum, 2048, 11, 502, 14, 0, 0, 527, 1
n50x8192-coef-sum, 2048, 11, 501, 14, 0, 0, 526, 1
n50x8192-coef-sum, 2048, 11, 499, 14, 0, 0, 524, 1
n50x8192-coef-sum, 2048, 11, 505, 14, 0, 0, 530, 1
n50x8192-coef-sum, 2048, 11, 504, 15, 0, 0, 530, 1
n50x8192-coef-sum, 2048, 11, 505, 14, 0, 0, 530, 1
n50x8192-coef-sum, 2048, 11, 503, 14, 0, 0, 528, 1
n50x8192-coef-sum, 2048, 11, 506, 15, 0, 0, 532, 1
n50x8192-coef-sum, 2048, 11, 503, 14, 0, 0, 528, 1
n50x8192-coef-sum, 2048, 11, 503, 14, 0, 0, 528, 1
n50x8192-coef-sum, 2048, 11, 500, 14, 0, 0, 525, 1
n50x8192-coef-sum, 2048, 11, 500, 14, 0, 0, 525, 1
n50x8192-coef-sum, 2048, 11, 501, 14, 0, 0, 526, 1
n50x8192-coef-sum, 2048, 11, 501, 14, 0, 0, 526, 1
n50x8192-coef-sum, 2048, 11, 505, 14, 0, 0, 530, 1
n50x8192-coef-sum, 2048, 11, 500, 14, 0, 0, 525, 1
n50x8192-coef-sum, 2048, 11, 518, 14, 0, 0, 543, 1
n50x8192-coef-sum, 2048, 11, 504, 15, 0, 0, 530, 1
n50x8192-coef-sum, 2048, 11, 503, 14, 0, 0, 528, 1
n50x8192-coef-sum, 2048, 11, 503, 14, 0, 0, 528, 1
n50x8192-coef-sum, 2048, 11, 499, 14, 0, 0, 524, 1
n50x8192-coef-sum, 2048, 11, 503, 14, 0, 0, 528, 1
n50x8192-coef-sum, 2048, 11, 529, 15, 0, 0, 555, 1
n50x8192-coef-sum, 2048, 11, 501, 14, 0, 0, 526, 1
n50x8192-coef-sum, 2048, 11, 501, 14, 0, 0, 526, 1
n50x8192-coef-sum, 2048, 11, 502, 14, 0, 0, 527, 1
n50x8192-coef-sum, 2048, 12, 502, 14, 0, 0, 528, 1
n50x8192-coef-sum, 2048, 11, 500, 14, 0, 0, 525, 1
n50x8192-coef-sum, 2048, 11, 501, 14, 0, 0, 526, 1
n50x8192-coef-sum, 2048, 11, 499, 14, 0, 0, 524, 1
n50x8192-coef-sum, 2048, 11, 502, 14, 0, 0, 527, 1
n50x8192-coef-sum, 2048, 11, 504, 14, 0, 0, 529, 1
n50x8192-coef-sum, 2048, 11, 502, 14, 0, 0, 527, 1
n50x8192-coef-sum, 2048, 11, 504, 14, 0, 0, 529, 1
n50x8192-coef-sum, 2048, 11, 504, 14, 0, 0, 529, 1
n50x8192-coef-sum, 2048, 11, 503, 14, 0, 0, 528, 1
n50x8192-coef-sum, 2048, 11, 503, 14, 0, 0, 528, 1
n50x8192-coef-sum, 2048, 12, 503, 14, 0, 0, 529, 1
n50x8192-coef-sum, 1024, 13, 633, 21, 0, 0, 667, 1
n50x8192-coef-sum, 1024, 14, 635, 22, 0, 0, 671, 1
n50x8192-coef-sum, 1024, 12, 636, 22, 0, 0, 670, 1
n50x8192-coef-sum, 1024, 13, 637, 22, 0, 0, 672, 1
n50x8192-coef-sum, 1024, 13, 643, 24, 0, 0, 680, 1
n50x8192-coef-sum, 1024, 12, 636, 21, 0, 0, 669, 1
n50x8192-coef-sum, 1024, 12, 638, 22, 0, 0, 672, 1
n50x8192-coef-sum, 1024, 13, 638, 22, 0, 0, 673, 1
n50x8192-coef-sum, 1024, 12, 638, 22, 0, 0, 672, 1
n50x8192-coef-sum, 1024, 13, 636, 22, 0, 0, 671, 1
n50x8192-coef-sum, 1024, 13, 641, 22, 0, 0, 676, 1
n50x8192-coef-sum, 1024, 15, 635, 21, 0, 0, 671, 1
n50x8192-coef-sum, 1024, 13, 638, 21, 0, 0, 672, 1
n50x8192-coef-sum, 1024, 13, 633, 22, 0, 0, 668, 1
n50x8192-coef-sum, 1024, 12, 638, 22, 0, 0, 672, 1
n50x8192-coef-sum, 1024, 12, 639, 22, 0, 0, 673, 1
n50x8192-coef-sum, 1024, 13, 636, 22, 0, 0, 671, 1
n50x8192-coef-sum, 1024, 13, 636, 22, 0, 0, 671, 1
n50x8192-coef-sum, 1024, 14, 638, 22, 0, 0, 674, 1
n50x8192-coef-sum, 1024, 14, 634, 21, 0, 0, 669, 1
n50x8192-coef-sum, 1024, 12, 639, 22, 0, 0, 673, 1
n50x8192-coef-sum, 1024, 12, 634, 22, 0, 0, 668, 1
n50x8192-coef-sum, 1024, 12, 636, 22, 0, 0, 670, 1
n50x8192-coef-sum, 1024, 13, 635, 22, 0, 0, 670, 1
n50x8192-coef-sum, 1024, 14, 644, 23, 0, 0, 681, 1
n50x8192-coef-sum, 1024, 15, 635, 22, 0, 0, 672, 1
n50x8192-coef-sum, 1024, 12, 646, 22, 0, 0, 680, 1
n50x8192-coef-sum, 1024, 12, 640, 22, 0, 0, 674, 1
n50x8192-coef-sum, 1024, 13, 635, 22, 0, 0, 670, 1
n50x8192-coef-sum, 1024, 13, 637, 22, 0, 0, 672, 1
n50x8192-coef-sum, 1024, 12, 640, 21, 0, 0, 673, 1
n50x8192-coef-sum, 1024, 12, 636, 21, 0, 0, 669, 1
n50x8192-coef-sum, 1024, 13, 634, 22, 0, 0, 669, 1
n50x8192-coef-sum, 1024, 14, 636, 22, 0, 0, 672, 1
n50x8192-coef-sum, 1024, 13, 636, 22, 0, 0, 671, 1
n50x8192-coef-sum, 1024, 13, 634, 21, 0, 0, 668, 1
n50x8192-coef-sum, 1024, 12, 637, 21, 0, 0, 670, 1
n50x8192-coef-sum, 1024, 12, 635, 22, 0, 0, 669, 1
n50x8192-coef-sum, 1024, 12, 647, 22, 0, 0, 681, 1
n50x8192-coef-sum, 1024, 12, 634, 22, 0, 0, 668, 1
n50x8192-coef-sum, 1024, 12, 641, 22, 0, 0, 675, 1
n50x8192-coef-sum, 1024, 13, 640, 22, 0, 0, 675, 1
n50x8192-coef-sum, 1024, 12, 635, 23, 0, 0, 670, 1
n50x8192-coef-sum, 1024, 14, 636, 22, 0, 0, 672, 1
n50x8192-coef-sum, 1024, 12, 641, 22, 0, 0, 675, 1
n50x8192-coef-sum, 1024, 13, 638, 22, 0, 0, 673, 1
n50x8192-coef-sum, 1024, 13, 635, 22, 0, 0, 670, 1
n50x8192-coef-sum, 1024, 13, 642, 22, 0, 0, 677, 1
n50x8192-coef-sum, 1024, 13, 635, 22, 0, 0, 670, 1
n50x8192-coef-sum, 1024, 13, 635, 22, 0, 0, 670, 1
n50x8192-coef-sum, 1024, 15, 638, 21, 0, 0, 674, 1
n50x8192-coef-sum, 1024, 13, 639, 22, 0, 0, 674, 1
n50x8192-coef-sum, 1024, 12, 640, 23, 0, 0, 675, 1
n50x8192-coef-sum, 1024, 13, 635, 21, 0, 0, 669, 1
n50x8192-coef-sum, 1024, 13, 646, 22, 0, 0, 681, 1
n50x8192-coef-sum, 1024, 13, 637, 22, 0, 0, 672, 1
n50x8192-coef-sum, 1024, 13, 639, 22, 0, 0, 674, 1
n50x8192-coef-sum, 1024, 13, 635, 22, 0, 0, 670, 1
n50x8192-coef-sum, 1024, 13, 637, 22, 0, 0, 672, 1
n50x8192-coef-sum, 1024, 13, 635, 22, 0, 0, 670, 1
n50x8192-coef-sum, 1024, 12, 638, 22, 0, 0, 672, 1
n50x8192-coef-sum, 1024, 12, 644, 22, 0, 0, 678, 1
n50x8192-coef-sum, 1024, 13, 638, 21, 0, 0, 672, 1
n50x8192-coef-sum, 1024, 13, 632, 22, 0, 0, 667, 1
n50x8192-coef-sum, 1024, 13, 635, 22, 0, 0, 670, 1
n50x8192-coef-sum, 1024, 12, 634, 22, 0, 0, 668, 1
n50x8192-coef-sum, 1024, 15, 639, 22, 0, 0, 676, 1
n50x8192-coef-sum, 1024, 13, 656, 21, 0, 0, 690, 1
n50x8192-coef-sum, 1024, 12, 641, 22, 0, 0, 675, 1
n50x8192-coef-sum, 1024, 13, 639, 22, 0, 0, 674, 1
n50x8192-coef-sum, 1024, 12, 633, 22, 0, 0, 667, 1
n50x8192-coef-sum, 1024, 12, 635, 21, 0, 0, 668, 1
n50x8192-coef-sum, 1024, 12, 636, 22, 0, 0, 670, 1
n50x8192-coef-sum, 1024, 14, 638, 22, 0, 0, 674, 1
n50x8192-coef-sum, 1024, 12, 640, 22, 0, 0, 674, 1
n50x8192-coef-sum, 1024, 13, 638, 22, 0, 0, 673, 1
n50x8192-coef-sum, 1024, 13, 634, 22, 0, 0, 669, 1
n50x8192-coef-sum, 1024, 13, 637, 22, 0, 0, 672, 1
n50x8192-coef-sum, 1024, 13, 635, 22, 0, 0, 670, 1
n50x8192-coef-sum, 1024, 13, 639, 21, 0, 0, 673, 1
n50x8192-coef-sum, 1024, 12, 640, 21, 0, 0, 673, 1
n50x8192-coef-sum, 1024, 13, 641, 22, 0, 0, 676, 1
n50x8192-coef-sum, 1024, 13, 641, 22, 0, 0, 676, 1
n50x8192-coef-sum, 1024, 13, 636, 21, 0, 0, 670, 1
n50x8192-coef-sum, 1024, 12, 640, 22, 0, 0, 674, 1
n50x8192-coef-sum, 1024, 13, 642, 22, 0, 0, 677, 1
n50x8192-coef-sum, 1024, 12, 637, 22, 0, 0, 671, 1
n50x8192-coef-sum, 1024, 12, 638, 22, 0, 0, 672, 1
n50x8192-coef-sum, 1024, 13, 639, 22, 0, 0, 674, 1
n50x8192-coef-sum, 1024, 13, 645, 23, 0, 0, 681, 1
n50x8192-coef-sum, 1024, 12, 638, 21, 0, 0, 671, 1
n50x8192-coef-sum, 1024, 12, 633, 22, 0, 0, 667, 1
n50x8192-coef-sum, 1024, 13, 637, 22, 0, 0, 672, 1
n50x8192-coef-sum, 1024, 12, 636, 22, 0, 0, 670, 1
n50x8192-coef-sum, 1024, 12, 632, 21, 0, 0, 665, 1
n50x8192-coef-sum, 1024, 12, 634, 23, 0, 0, 669, 1
n50x8192-coef-sum, 1024, 13, 639, 21, 0, 0, 673, 1
n50x8192-coef-sum, 1024, 12, 638, 23, 0, 0, 673, 1
n50x8192-coef-sum, 1024, 13, 640, 21, 0, 0, 674, 1
n50x8192-coef-sum, 1024, 12, 639, 21, 0, 0, 672, 1
n50x8192-slot-sum, 8192, 126, 287, 35, 0, 0, 448, 1
n50x8192-slot-sum, 8192, 125, 284, 34, 0, 0, 443, 1
n50x8192-slot-sum, 8192, 126, 284, 34, 0, 0, 444, 1
n50x8192-slot-sum, 8192, 125, 285, 35, 0, 0, 445, 1
n50x8192-slot-sum, 8192, 126, 284, 34, 0, 0, 444, 1
n50x8192-slot-sum, 8192, 126, 285, 34, 0, 0, 445, 1
n50x8192-slot-sum, 8192, 125, 283, 34, 0, 0, 442, 1
n50x8192-slot-sum, 8192, 125, 285, 34, 0, 0, 444, 1
n50x8192-slot-sum, 8192, 125, 283, 34, 0, 0, 442, 1
n50x8192-slot-sum, 8192, 125, 284, 34, 0, 0, 443, 1
n50x8192-slot-sum, 8192, 125, 284, 34, 0, 0, 443, 1
n50x8192-slot-sum, 8192, 125, 284, 34, 0, 0, 443, 1
n50x8192-slot-sum, 8192, 125, 286, 34, 0, 0, 445, 1
n50x8192-slot-sum, 8192, 125, 284, 34, 0, 0, 443, 1
n50x8192-slot-sum, 8192, 125, 285, 34, 0, 0, 444, 1
n50x8192-slot-sum, 8192, 125, 287, 34, 0, 0, 446, 1
n50x8192-slot-sum, 8192, 127, 285, 34, 0, 0, 446, 1
n50x8192-slot-sum, 8192, 124, 283, 34, 0, 0, 441, 1
n50x8192-slot-sum, 8192, 126, 284, 36, 0, 0, 446, 1
n50x8192-slot-sum, 8192, 125, 286, 34, 0, 0, 445, 1
n50x8192-slot-sum, 8192, 126, 282, 34, 0, 0, 442, 1
n50x8192-slot-sum, 8192, 125, 283, 34, 0, 0, 442, 1
n50x8192-slot-sum, 8192, 127, 283, 34, 0, 0, 444, 1
n50x8192-slot-sum, 8192, 125, 283, 34, 0, 0, 442, 1
n50x8192-slot-sum, 8192, 126, 282, 34, 0, 0, 442, 1
n50x8192-slot-sum, 8192, 125, 282, 34, 0, 0, 441, 1
n50x8192-slot-sum, 8192, 126, 286, 34, 0, 0, 446, 1
n50x8192-slot-sum, 8192, 125, 282, 34, 0, 0, 441, 1
n50x8192-slot-sum, 8192, 126, 283, 34, 0, 0, 443, 1
n50x8192-slot-sum, 8192, 125, 283, 34, 0, 0, 442, 1
n50x8192-slot-sum, 8192, 126, 284, 34, 0, 0, 444, 1
n50x8192-slot-sum, 8192, 124, 282, 34, 0, 0, 440, 1
n50x8192-slot-sum, 8192, 126, 286, 34, 0, 0, 446, 1
n50x8192-slot-sum, 8192, 125, 285, 34, 0, 0, 444, 1
n50x8192-slot-sum, 8192, 125, 282, 34, 0, 0, 441, 1
n50x8192-slot-sum, 8192, 126, 284, 33, 0, 0, 443, 1
n50x8192-slot-sum, 8192, 126, 287, 34, 0, 0, 447, 1
n50x8192-slot-sum, 8192, 125, 281, 34, 0, 0, 440, 1
n50x8192-slot-sum, 8192, 125, 283, 34, 0, 0, 442, 1
n50x8192-slot-sum, 8192, 126, 282, 34, 0, 0, 442, 1
n50x8192-slot-sum, 8192, 128, 288, 34, 0, 0, 450, 1
n50x8192-slot-sum, 8192, 126, 283, 34, 0, 0, 443, 1
n50x8192-slot-sum, 8192, 125, 282, 34, 0, 0, 441, 1
n50x8192-slot-sum, 8192, 125, 285, 34, 0, 0, 444, 1
n50x8192-slot-sum, 8192, 128, 285, 34, 0, 0, 447, 1
n50x8192-slot-sum, 8192, 125, 283, 35, 0, 0, 443, 1
n50x8192-slot-sum, 8192, 125, 285, 34, 0, 0, 444, 1
n50x8192-slot-sum, 8192, 126, 284, 34, 0, 0, 444, 1
n50x8192-slot-sum, 8192, 126, 284, 34, 0, 0, 444, 1
n50x8192-slot-sum, 8192, 125, 281, 34, 0, 0, 440, 1
n50x8192-slot-sum, 8192, 125, 282, 34, 0, 0, 441, 1
n50x8192-slot-sum, 8192, 125, 283, 34, 0, 0, 442, 1
n50x8192-slot-sum, 8192, 125, 283, 34, 0, 0, 442, 1
n50x8192-slot-sum, 8192, 125, 284, 35, 0, 0, 444, 1
n50x8192-slot-sum, 8192, 126, 283, 34, 0, 0, 443, 1
n50x8192-slot-sum, 8192, 127, 293, 34, 0, 0, 454, 1
n50x8192-slot-sum, 8192, 125, 284, 34, 0, 0, 443, 1
n50x8192-slot-sum, 8192, 126, 284, 34, 0, 0, 444, 1
n50x8192-slot-sum, 8192, 126, 284, 34, 0, 0, 444, 1
n50x8192-slot-sum, 8192, 128, 288, 34, 0, 0, 450, 1
n50x8192-slot-sum, 8192, 125, 283, 34, 0, 0, 442, 1
n50x8192-slot-sum, 8192, 126, 284, 34, 0, 0, 444, 1
n50x8192-slot-sum, 8192, 126, 283, 35, 0, 0, 444, 1
n50x8192-slot-sum, 8192, 125, 283, 34, 0, 0, 442, 1
n50x8192-slot-sum, 8192, 125, 283, 34, 0, 0, 442, 1
n50x8192-slot-sum, 8192, 126, 285, 34, 0, 0, 445, 1
n50x8192-slot-sum, 8192, 126, 283, 35, 0, 0, 444, 1
n50x8192-slot-sum, 8192, 125, 284, 34, 0, 0, 443, 1
n50x8192-slot-sum, 8192, 126, 284, 34, 0, 0, 444, 1
n50x8192-slot-sum, 8192, 126, 284, 34, 0, 0, 444, 1
n50x8192-slot-sum, 8192, 125, 282, 34, 0, 0, 441, 1
n50x8192-slot-sum, 8192, 125, 284, 34, 0, 0, 443, 1
n50x8192-slot-sum, 8192, 126, 283, 34, 0, 0, 443, 1
n50x8192-slot-sum, 8192, 126, 284, 34, 0, 0, 444, 1
n50x8192-slot-sum, 8192, 126, 283, 35, 0, 0, 444, 1
n50x8192-slot-sum, 8192, 125, 282, 34, 0, 0, 441, 1
n50x8192-slot-sum, 8192, 126, 283, 33, 0, 0, 442, 1
n50x8192-slot-sum, 8192, 126, 320, 41, 1, 0, 488, 1
n50x8192-slot-sum, 8192, 126, 283, 34, 0, 0, 443, 1
n50x8192-slot-sum, 8192, 126, 284, 34, 0, 0, 444, 1
n50x8192-slot-sum, 8192, 126, 284, 35, 0, 0, 445, 1
n50x8192-slot-sum, 8192, 125, 283, 34, 0, 0, 442, 1
n50x8192-slot-sum, 8192, 126, 284, 34, 0, 0, 444, 1
n50x8192-slot-sum, 8192, 125, 285, 37, 0, 0, 447, 1
n50x8192-slot-sum, 8192, 126, 285, 34, 0, 0, 445, 1
n50x8192-slot-sum, 8192, 125, 283, 34, 0, 0, 442, 1
n50x8192-slot-sum, 8192, 126, 284, 34, 0, 0, 444, 1
n50x8192-slot-sum, 8192, 126, 284, 34, 0, 0, 444, 1
n50x8192-slot-sum, 8192, 125, 284, 34, 0, 0, 443, 1
n50x8192-slot-sum, 8192, 126, 283, 34, 0, 0, 443, 1
n50x8192-slot-sum, 8192, 125, 283, 34, 0, 0, 442, 1
n50x8192-slot-sum, 8192, 125, 282, 34, 0, 0, 441, 1
n50x8192-slot-sum, 8192, 124, 284, 34, 0, 0, 442, 1
n50x8192-slot-sum, 8192, 125, 284, 34, 0, 0, 443, 1
n50x8192-slot-sum, 8192, 125, 284, 34, 0, 0, 443, 1
n50x8192-slot-sum, 8192, 125, 284, 35, 0, 0, 444, 1
n50x8192-slot-sum, 8192, 126, 284, 34, 0, 0, 444, 1
n50x8192-slot-sum, 8192, 126, 283, 34, 0, 0, 443, 1
n50x8192-slot-sum, 8192, 126, 285, 34, 0, 0, 445, 1
n50x8192-slot-sum, 8192, 126, 284, 33, 0, 0, 443, 1
n50x8192-slot-sum, 4096, 60, 273, 23, 0, 0, 356, 1
n50x8192-slot-sum, 4096, 60, 274, 23, 0, 0, 357, 1
n50x8192-slot-sum, 4096, 59, 274, 23, 0, 0, 356, 1
n50x8192-slot-sum, 4096, 60, 274, 23, 0, 0, 357, 1
n50x8192-slot-sum, 4096, 60, 273, 23, 0, 0, 356, 1
n50x8192-slot-sum, 4096, 59, 273, 23, 0, 0, 355, 1
n50x8192-slot-sum, 4096, 59, 277, 23, 0, 0, 359, 1
n50x8192-slot-sum, 4096, 60, 274, 23, 0, 0, 357, 1
n50x8192-slot-sum, 4096, 59, 278, 24, 0, 0, 361, 1
n50x8192-slot-sum, 4096, 60, 274, 23, 0, 0, 357, 1
n50x8192-slot-sum, 4096, 59, 276, 23, 0, 0, 358, 1
n50x8192-slot-sum, 4096, 60, 275, 23, 0, 0, 358, 1
n50x8192-slot-sum, 4096, 60, 276, 23, 0, 0, 359, 1
n50x8192-slot-sum, 4096, 60, 274, 23, 0, 0, 357, 1
n50x8192-slot-sum, 4096, 59, 273, 22, 0, 0, 354, 1
n50x8192-slot-sum, 4096, 59, 274, 23, 0, 0, 356, 1
n50x8192-slot-sum, 4096, 60, 276, 23, 0, 0, 359, 1
n50x8192-slot-sum, 4096, 59, 274, 23, 0, 0, 356, 1
n50x8192-slot-sum, 4096, 60, 275, 24, 0, 0, 359, 1
n50x8192-slot-sum, 4096, 60, 273, 23, 0, 0, 356, 1
n50x8192-slot-sum, 4096, 59, 274, 23, 0, 0, 356, 1
n50x8192-slot-sum, 4096, 59, 276, 23, 0, 0, 358, 1
n50x8192-slot-sum, 4096, 60, 276, 24, 0, 0, 360, 1
n50x8192-slot-sum, 4096, 59, 275, 23, 0, 0, 357, 1
n50x8192-slot-sum, 4096, 60, 274, 23, 0, 0, 357, 1
n50x8192-slot-sum, 4096, 59, 274, 23, 0, 0, 356, 1
n50x8192-slot-sum, 4096, 59, 275, 23, 0, 0, 357, 1
n50x8192-slot-sum, 4096, 59, 274, 23, 0, 0, 356, 1
n50x8192-slot-sum, 4096, 60, 273, 23, 0, 0, 356, 1
n50x8192-slot-sum, 4096, 60, 276, 23, 0, 0, 359, 1
n50x8192-slot-sum, 4096, 60, 276, 23, 0, 0, 359, 1
n50x8192-slot-sum, 4096, 60, 275, 23, 0, 0, 358, 1
n50x8192-slot-sum, 4096, 60, 273, 23, 0, 0, 356, 1
n50x8192-slot-sum, 4096, 60, 274, 23, 0, 0, 357, 1
n50x8192-slot-sum, 4096, 60, 275, 23, 0, 0, 358, 1
n50x8192-slot-sum, 4096, 60, 274, 23, 0, 0, 357, 1
n50x8192-slot-sum, 4096, 59, 275, 23, 0, 0, 357, 1
n50x8192-slot-sum, 4096, 60, 275, 23, 0, 0, 358, 1
n50x8192-slot-sum, 4096, 60, 274, 23, 0, 0, 357, 1
n50x8192-slot-sum, 4096, 60, 276, 23, 0, 0, 359, 1
n50x8192-slot-sum, 4096, 60, 276, 24, 0, 0, 360, 1
n50x8192-slot-sum, 4096, 60, 275, 23, 0, 0, 358, 1
n50x8192-slot-sum, 4096, 59, 274, 23, 0, 0, 356, 1
n50x8192-slot-sum, 4096, 59, 273, 23, 0, 0, 355, 1
n50x8192-slot-sum, 4096, 59, 275, 23, 0, 0, 357, 1
n50x8192-slot-sum, 4096, 60, 278, 23, 0, 0, 361, 1
n50x8192-slot-sum, 4096, 60, 275, 23, 0, 0, 358, 1
n50x8192-slot-sum, 4096, 60, 274, 23, 0, 0, 357, 1
n50x8192-slot-sum, 4096, 60, 275, 23, 0, 0, 358, 1
n50x8192-slot-sum, 4096, 60, 276, 23, 0, 0, 359, 1
n50x8192-slot-sum, 4096, 60, 275, 23, 0, 0, 358, 1
n50x8192-slot-sum, 4096, 60, 274, 23, 0, 0, 357, 1
n50x8192-slot-sum, 4096, 59, 274, 24, 0, 0, 357, 1
n50x8192-slot-sum, 4096, 59, 274, 23, 0, 0, 356, 1
n50x8192-slot-sum, 4096, 60, 275, 23, 0, 0, 358, 1
n50x8192-slot-sum, 4096, 59, 274, 23, 0, 0, 356, 1
n50x8192-slot-sum, 4096, 61, 275, 23, 0, 0, 359, 1
n50x8192-slot-sum, 4096, 60, 274, 23, 0, 0, 357, 1
n50x8192-slot-sum, 4096, 59, 274, 23, 0, 0, 356, 1
n50x8192-slot-sum, 4096, 60, 276, 23, 0, 0, 359, 1
n50x8192-slot-sum, 4096, 60, 275, 23, 0, 0, 358, 1
n50x8192-slot-sum, 4096, 59, 273, 24, 0, 0, 356, 1
n50x8192-slot-sum, 4096, 60, 276, 23, 0, 0, 359, 1
n50x8192-slot-sum, 4096, 59, 273, 23, 0, 0, 355, 1
n50x8192-slot-sum, 4096, 59, 273, 23, 0, 0, 355, 1
n50x8192-slot-sum, 4096, 60, 275, 23, 0, 0, 358, 1
n50x8192-slot-sum, 4096, 60, 273, 23, 0, 0, 356, 1
n50x8192-slot-sum, 4096, 60, 275, 23, 0, 0, 358, 1
n50x8192-slot-sum, 4096, 60, 273, 23, 0, 0, 356, 1
n50x8192-slot-sum, 4096, 59, 273, 23, 0, 0, 355, 1
n50x8192-slot-sum, 4096, 60, 274, 23, 0, 0, 357, 1
n50x8192-slot-sum, 4096, 60, 275, 23, 0, 0, 358, 1
n50x8192-slot-sum, 4096, 60, 276, 23, 0, 0, 359, 1
n50x8192-slot-sum, 4096, 59, 274, 23, 0, 0, 356, 1
n50x8192-slot-sum, 4096, 60, 274, 23, 0, 0, 357, 1
n50x8192-slot-sum, 4096, 60, 274, 23, 0, 0, 357, 1
n50x8192-slot-sum, 4096, 60, 275, 23, 0, 0, 358, 1
n50x8192-slot-sum, 4096, 60, 274, 23, 0, 0, 357, 1
n50x8192-slot-sum, 4096, 60, 275, 23, 0, 0, 358, 1
n50x8192-slot-sum, 4096, 59, 276, 23, 0, 0, 358, 1
n50x8192-slot-sum, 4096, 60, 274, 23, 0, 0, 357, 1
n50x8192-slot-sum, 4096, 60, 275, 23, 0, 0, 358, 1
n50x8192-slot-sum, 4096, 59, 276, 23, 0, 0, 358, 1
n50x8192-slot-sum, 4096, 60, 276, 23, 0, 0, 359, 1
n50x8192-slot-sum, 4096, 60, 274, 23, 0, 0, 357, 1
n50x8192-slot-sum, 4096, 60, 274, 23, 0, 0, 357, 1
n50x8192-slot-sum, 4096, 59, 274, 23, 0, 0, 356, 1
n50x8192-slot-sum, 4096, 60, 277, 23, 0, 0, 360, 1
n50x8192-slot-sum, 4096, 60, 276, 23, 0, 0, 359, 1
n50x8192-slot-sum, 4096, 60, 275, 24, 0, 0, 359, 1
n50x8192-slot-sum, 4096, 59, 274, 23, 0, 0, 356, 1
n50x8192-slot-sum, 4096, 59, 276, 23, 0, 0, 358, 1
n50x8192-slot-sum, 4096, 61, 275, 23, 0, 0, 359, 1
n50x8192-slot-sum, 4096, 60, 275, 23, 0, 0, 358, 1
n50x8192-slot-sum, 4096, 59, 275, 23, 0, 0, 357, 1
n50x8192-slot-sum, 4096, 59, 277, 23, 0, 0, 359, 1
n50x8192-slot-sum, 4096, 59, 276, 23, 0, 0, 358, 1
n50x8192-slot-sum, 4096, 59, 278, 23, 0, 0, 360, 1
n50x8192-slot-sum, 4096, 60, 277, 23, 0, 0, 360, 1
n50x8192-slot-sum, 4096, 60, 275, 23, 0, 0, 358, 1
n50x8192-slot-sum, 2048, 30, 271, 19, 0, 0, 320, 1
n50x8192-slot-sum, 2048, 29, 270, 19, 0, 0, 318, 1
n50x8192-slot-sum, 2048, 30, 269, 19, 0, 0, 318, 1
n50x8192-slot-sum, 2048, 29, 271, 19, 0, 0, 319, 1
n50x8192-slot-sum, 2048, 30, 271, 19, 0, 0, 320, 1
n50x8192-slot-sum, 2048, 29, 270, 19, 0, 0, 318, 1
n50x8192-slot-sum, 2048, 30, 270, 19, 0, 0, 319, 1
n50x8192-slot-sum, 2048, 29, 271, 19, 0, 0, 319, 1
n50x8192-slot-sum, 2048, 29, 274, 19, 0, 0, 322, 1
n50x8192-slot-sum, 2048, 30, 270, 19, 0, 0, 319, 1
n50x8192-slot-sum, 2048, 29, 270, 18, 0, 0, 317, 1
n50x8192-slot-sum, 2048, 29, 270, 19, 0, 0, 318, 1
n50x8192-slot-sum, 2048, 30, 269, 19, 0, 0, 318, 1
n50x8192-slot-sum, 2048, 31, 269, 19, 0, 0, 319, 1
n50x8192-slot-sum, 2048, 31, 270, 18, 0, 0, 319, 1
n50x8192-slot-sum, 2048, 29, 268, 19, 0, 0, 316, 1
n50x8192-slot-sum, 2048, 29, 268, 19, 0, 0, 316, 1
n50x8192-slot-sum, 2048, 30, 272, 19, 0, 0, 321, 1
n50x8192-slot-sum, 2048, 30, 270, 19, 0, 0, 319, 1
n50x8192-slot-sum, 2048, 30, 270, 19, 0, 0, 319, 1
n50x8192-slot-sum, 2048, 30, 269, 19, 0, 0, 318, 1
n50x8192-slot-sum, 2048, 30, 268, 18, 0, 0, 316, 1
n50x8192-slot-sum, 2048, 29, 270, 19, 0, 0, 318, 1
n50x8192-slot-sum, 2048, 30, 269, 19, 0, 0, 318, 1
n50x8192-slot-sum, 2048, 29, 268, 19, 0, 0, 316, 1
n50x8192-slot-sum, 2048, 29, 269, 18, 0, 0, 316, 1
n50x8192-slot-sum, 2048, 29, 268, 19, 0, 0, 316, 1
n50x8192-slot-sum, 2048, 30, 282, 19, 0, 0, 331, 1
n50x8192-slot-sum, 2048, 29, 272, 19, 0, 0, 320, 1
n50x8192-slot-sum, 2048, 29, 271, 19, 0, 0, 319, 1
n50x8192-slot-sum, 2048, 29, 268, 19, 0, 0, 316, 1
n50x8192-slot-sum, 2048, 30, 271, 19, 0, 0, 320, 1
n50x8192-slot-sum, 2048, 29, 268, 18, 0, 0, 315, 1
n50x8192-slot-sum, 2048, 29, 267, 18, 0, 0, 314, 1
n50x8192-slot-sum, 2048, 29, 269, 19, 0, 0, 317, 1
n50x8192-slot-sum, 2048, 29, 269, 19, 0, 0, 317, 1
n50x8192-slot-sum, 2048, 30, 274, 19, 0, 0, 323, 1
n50x8192-slot-sum, 2048, 29, 269, 18, 0, 0, 316, 1
n50x8192-slot-sum, 2048, 29, 268, 19, 0, 0, 316, 1
n50x8192-slot-sum, 2048, 30, 271, 18, 0, 0, 319, 1
n50x8192-slot-sum, 2048, 29, 269, 19, 0, 0, 317, 1
n50x8192-slot-sum, 2048, 29, 268, 19, 0, 0, 316, 1
n50x8192-slot-sum, 2048, 29, 272, 19, 0, 0, 320, 1
n50x8192-slot-sum, 2048, 29, 269, 18, 0, 0, 316, 1
n50x8192-slot-sum, 2048, 29, 268, 19, 0, 0, 316, 1
n50x8192-slot-sum, 2048, 29, 268, 18, 0, 0, 315, 1
n50x8192-slot-sum, 2048, 30, 269, 19, 0, 0, 318, 1
n50x8192-slot-sum, 2048, 29, 268, 18, 0, 0, 315, 1
n50x8192-slot-sum, 2048, 29, 270, 18, 0, 0, 317, 1
n50x8192-slot-sum, 2048, 29, 268, 18, 0, 0, 315, 1
n50x8192-slot-sum, 2048, 29, 270, 19, 0, 0, 318, 1
n50x8192-slot-sum, 2048, 29, 269, 19, 0, 0, 317, 1
n50x8192-slot-sum, 2048, 30, 268, 19, 0, 0, 317, 1
n50x8192-slot-sum, 2048, 29, 270, 19, 0, 0, 318, 1
n50x8192-slot-sum, 2048, 30, 268, 18, 0, 0, 316, 1
n50x8192-slot-sum, 2048, 30, 270, 19, 0, 0, 319, 1
n50x8192-slot-sum, 2048, 29, 270, 19, 0, 0, 318, 1
n50x8192-slot-sum, 2048, 30, 270, 19, 0, 0, 319, 1
n50x8192-slot-sum, 2048, 29, 271, 19, 0, 0, 319, 1
n50x8192-slot-sum, 2048, 30, 270, 19, 0, 0, 319, 1
n50x8192-slot-sum, 2048, 29, 270, 18, 0, 0, 317, 1
n50x8192-slot-sum, 2048, 30, 268, 19, 0, 0, 317, 1
n50x8192-slot-sum, 2048, 29, 270, 19, 0, 0, 318, 1
n50x8192-slot-sum, 2048, 29, 269, 19, 0, 0, 317, 1
n50x8192-slot-sum, 2048, 29, 269, 18, 0, 0, 316, 1
n50x8192-slot-sum, 2048, 29, 270, 19, 0, 0, 318, 1
n50x8192-slot-sum, 2048, 29, 268, 18, 0, 0, 315, 1
n50x8192-slot-sum, 2048, 30, 269, 18, 0, 0, 317, 1
n50x8192-slot-sum, 2048, 30, 271, 19, 0, 0, 320, 1
n50x8192-slot-sum, 2048, 29, 271, 19, 0, 0, 319, 1
n50x8192-slot-sum, 2048, 30, 270, 19, 0, 0, 319, 1
n50x8192-slot-sum, 2048, 30, 271, 19, 0, 0, 320, 1
n50x8192-slot-sum, 2048, 29, 269, 19, 0, 0, 317, 1
n50x8192-slot-sum, 2048, 30, 270, 19, 0, 0, 319, 1
n50x8192-slot-sum, 2048, 30, 269, 19, 0, 0, 318, 1
n50x8192-slot-sum, 2048, 29, 268, 19, 0, 0, 316, 1
n50x8192-slot-sum, 2048, 29, 269, 19, 0, 0, 317, 1
n50x8192-slot-sum, 2048, 30, 270, 18, 0, 0, 318, 1
n50x8192-slot-sum, 2048, 30, 268, 19, 0, 0, 317, 1
n50x8192-slot-sum, 2048, 29, 271, 19, 0, 0, 319, 1
n50x8192-slot-sum, 2048, 29, 268, 19, 0, 0, 316, 1
n50x8192-slot-sum, 2048, 30, 270, 19, 0, 0, 319, 1
n50x8192-slot-sum, 2048, 29, 271, 18, 0, 0, 318, 1
n50x8192-slot-sum, 2048, 29, 268, 19, 0, 0, 316, 1
n50x8192-slot-sum, 2048, 29, 268, 18, 0, 0, 315, 1
n50x8192-slot-sum, 2048, 29, 271, 19, 0, 0, 319, 1
n50x8192-slot-sum, 2048, 30, 270, 19, 0, 0, 319, 1
n50x8192-slot-sum, 2048, 29, 269, 18, 0, 0, 316, 1
n50x8192-slot-sum, 2048, 30, 270, 19, 0, 0, 319, 1
n50x8192-slot-sum, 2048, 30, 270, 18, 0, 0, 318, 1
n50x8192-slot-sum, 2048, 30, 270, 19, 0, 0, 319, 1
n50x8192-slot-sum, 2048, 30, 269, 19, 0, 0, 318, 1
n50x8192-slot-sum, 2048, 29, 269, 19, 0, 0, 317, 1
n50x8192-slot-sum, 2048, 30, 270, 18, 0, 0, 318, 1
n50x8192-slot-sum, 2048, 30, 269, 19, 0, 0, 318, 1
n50x8192-slot-sum, 2048, 30, 272, 19, 0, 0, 321, 1
n50x8192-slot-sum, 2048, 29, 269, 19, 0, 0, 317, 1
n50x8192-slot-sum, 2048, 29, 269, 19, 0, 0, 317, 1
n50x8192-slot-sum, 2048, 29, 270, 19, 0, 0, 318, 1
n50x8192-slot-sum, 2048, 30, 270, 19, 0, 0, 319, 1
n50x8192-slot-sum, 1024, 30, 343, 26, 0, 0, 399, 1
n50x8192-slot-sum, 1024, 30, 343, 26, 0, 0, 399, 1
n50x8192-slot-sum, 1024, 31, 345, 26, 0, 0, 402, 1
n50x8192-slot-sum, 1024, 30, 345, 27, 0, 0, 402, 1
n50x8192-slot-sum, 1024, 30, 348, 27, 0, 0, 405, 1
n50x8192-slot-sum, 1024, 30, 345, 26, 0, 0, 401, 1
n50x8192-slot-sum, 1024, 30, 347, 26, 0, 0, 403, 1
n50x8192-slot-sum, 1024, 30, 347, 26, 0, 0, 403, 1
n50x8192-slot-sum, 1024, 30, 346, 27, 0, 0, 403, 1
n50x8192-slot-sum, 1024, 30, 345, 27, 0, 0, 402, 1
n50x8192-slot-sum, 1024, 30, 345, 26, 0, 0, 401, 1
n50x8192-slot-sum, 1024, 42, 670, 26, 0, 0, 738, 1
n50x8192-slot-sum, 1024, 30, 346, 25, 0, 0, 401, 1
n50x8192-slot-sum, 1024, 30, 346, 26, 0, 0, 402, 1
n50x8192-slot-sum, 1024, 29, 346, 26, 0, 0, 401, 1
n50x8192-slot-sum, 1024, 31, 348, 25, 0, 0, 404, 1
n50x8192-slot-sum, 1024, 30, 345, 26, 0, 0, 401, 1
n50x8192-slot-sum, 1024, 31, 348, 26, 0, 0, 405, 1
n50x8192-slot-sum, 1024, 31, 350, 27, 0, 0, 408, 1
n50x8192-slot-sum, 1024, 31, 348, 27, 0, 0, 406, 1
n50x8192-slot-sum, 1024, 31, 348, 26, 0, 0, 405, 1
n50x8192-slot-sum, 1024, 31, 348, 25, 0, 0, 404, 1
n50x8192-slot-sum, 1024, 32, 345, 26, 0, 0, 403, 1
n50x8192-slot-sum, 1024, 30, 343, 27, 0, 0, 400, 1
n50x8192-slot-sum, 1024, 31, 344, 26, 0, 0, 401, 1
n50x8192-slot-sum, 1024, 29, 344, 26, 0, 0, 399, 1
n50x8192-slot-sum, 1024, 30, 344, 26, 0, 0, 400, 1
n50x8192-slot-sum, 1024, 30, 345, 26, 0, 0, 401, 1
n50x8192-slot-sum, 1024, 30, 345, 26, 0, 0, 401, 1
n50x8192-slot-sum, 1024, 29, 347, 26, 0, 0, 402, 1
n50x8192-slot-sum, 1024, 31, 346, 26, 0, 0, 403, 1
n50x8192-slot-sum, 1024, 30, 346, 26, 0, 0, 402, 1
n50x8192-slot-sum, 1024, 30, 346, 27, 0, 0, 403, 1
n50x8192-slot-sum, 1024, 30, 345, 26, 0, 0, 401, 1
n50x8192-slot-sum, 1024, 30, 344, 27, 0, 0, 401, 1
n50x8192-slot-sum, 1024, 31, 345, 26, 0, 0, 402, 1
n50x8192-slot-sum, 1024, 34, 342, 26, 0, 0, 402, 1
n50x8192-slot-sum, 1024, 31, 345, 26, 0, 0, 402, 1
n50x8192-slot-sum, 1024, 30, 346, 27, 0, 0, 403, 1
n50x8192-slot-sum, 1024, 30, 348, 27, 0, 0, 405, 1
n50x8192-slot-sum, 1024, 30, 345, 27, 0, 0, 402, 1
n50x8192-slot-sum, 1024, 30, 345, 26, 0, 0, 401, 1
n50x8192-slot-sum, 1024, 31, 346, 26, 0, 0, 403, 1
n50x8192-slot-sum, 1024, 30, 347, 26, 0, 0, 403, 1
n50x8192-slot-sum, 1024, 31, 347, 27, 0, 0, 405, 1
n50x8192-slot-sum, 1024, 30, 344, 25, 0, 0, 399, 1
n50x8192-slot-sum, 1024, 30, 344, 26, 0, 0, 400, 1
n50x8192-slot-sum, 1024, 30, 347, 27, 0, 0, 404, 1
n50x8192-slot-sum, 1024, 31, 346, 27, 0, 0, 404, 1
n50x8192-slot-sum, 1024, 31, 343, 26, 0, 0, 400, 1
n50x8192-slot-sum, 1024, 30, 344, 27, 0, 0, 401, 1
n50x8192-slot-sum, 1024, 31, 347, 26, 0, 0, 404, 1
n50x8192-slot-sum, 1024, 30, 343, 26, 0, 0, 399, 1
n50x8192-slot-sum, 1024, 30, 349, 26, 0, 0, 405, 1
n50x8192-slot-sum, 1024, 30, 346, 27, 0, 0, 403, 1
n50x8192-slot-sum, 1024, 30, 345, 26, 0, 0, 401, 1
n50x8192-slot-sum, 1024, 31, 346, 26, 0, 0, 403, 1
n50x8192-slot-sum, 1024, 32, 348, 26, 0, 0, 406, 1
n50x8192-slot-sum, 1024, 31, 346, 26, 0, 0, 403, 1
n50x8192-slot-sum, 1024, 30, 345, 27, 0, 0, 402, 1
n50x8192-slot-sum, 1024, 30, 346, 26, 0, 0, 402, 1
n50x8192-slot-sum, 1024, 30, 344, 26, 0, 0, 400, 1
n50x8192-slot-sum, 1024, 30, 346, 26, 0, 0, 402, 1
n50x8192-slot-sum, 1024, 30, 343, 26, 0, 0, 399, 1
n50x8192-slot-sum, 1024, 31, 347, 26, 0, 0, 404, 1
n50x8192-slot-sum, 1024, 31, 344, 26, 0, 0, 401, 1
n50x8192-slot-sum, 1024, 29, 345, 26, 0, 0, 400, 1
n50x8192-slot-sum, 1024, 30, 347, 27, 0, 0, 404, 1
n50x8192-slot-sum, 1024, 29, 344, 27, 0, 0, 400, 1
n50x8192-slot-sum, 1024, 34, 345, 26, 0, 0, 405, 1
n50x8192-slot-sum, 1024, 31, 346, 27, 0, 0, 404, 1
n50x8192-slot-sum, 1024, 30, 346, 26, 0, 0, 402, 1
n50x8192-slot-sum, 1024, 30, 343, 27, 0, 0, 400, 1
n50x8192-slot-sum, 1024, 30, 344, 26, 0, 0, 400, 1
n50x8192-slot-sum, 1024, 31, 345, 26, 0, 0, 402, 1
n50x8192-slot-sum, 1024, 30, 347, 26, 0, 0, 403, 1
n50x8192-slot-sum, 1024, 38, 345, 27, 0, 0, 410, 1
n50x8192-slot-sum, 1024, 30, 358, 26, 0, 0, 414, 1
n50x8192-slot-sum, 1024, 30, 345, 27, 0, 0, 402, 1
n50x8192-slot-sum, 1024, 31, 347, 27, 0, 0, 405, 1
n50x8192-slot-sum, 1024, 30, 347, 27, 0, 0, 404, 1
n50x8192-slot-sum, 1024, 31, 343, 26, 0, 0, 400, 1
n50x8192-slot-sum, 1024, 30, 345, 27, 0, 0, 402, 1
n50x8192-slot-sum, 1024, 32, 345, 26, 0, 0, 403, 1
n50x8192-slot-sum, 1024, 31, 347, 26, 0, 0, 404, 1
n50x8192-slot-sum, 1024, 31, 346, 26, 0, 0, 403, 1
n50x8192-slot-sum, 1024, 30, 344, 27, 0, 0, 401, 1
n50x8192-slot-sum, 1024, 30, 345, 26, 0, 0, 401, 1
n50x8192-slot-sum, 1024, 31, 344, 27, 0, 0, 402, 1
n50x8192-slot-sum, 1024, 30, 345, 27, 0, 0, 402, 1
n50x8192-slot-sum, 1024, 31, 343, 25, 0, 0, 399, 1
n50x8192-slot-sum, 1024, 34, 348, 27, 0, 0, 409, 1
n50x8192-slot-sum, 1024, 30, 346, 26, 0, 0, 402, 1
n50x8192-slot-sum, 1024, 30, 344, 26, 0, 0, 400, 1
n50x8192-slot-sum, 1024, 30, 344, 26, 0, 0, 400, 1
n50x8192-slot-sum, 1024, 30, 345, 27, 0, 0, 402, 1
n50x8192-slot-sum, 1024, 30, 347, 26, 0, 0, 403, 1
n50x8192-slot-sum, 1024, 30, 346, 26, 0, 0, 402, 1
n50x8192-slot-sum, 1024, 30, 346, 26, 0, 0, 402, 1
n50x8192-slot-sum, 1024, 30, 346, 27, 0, 0, 403, 1
n50x8192-slot-inner, 8192, 133, 283, 442, 0, 0, 858, 682666
n50x8192-slot-inner, 8192, 133, 284, 445, 0, 0, 862, 682666
n50x8192-slot-inner, 8192, 133, 283, 438, 0, 0, 854, 682666
n50x8192-slot-inner, 8192, 134, 284, 440, 0, 0, 858, 682666
n50x8192-slot-inner, 8192, 133, 284, 440, 0, 0, 857, 682666
n50x8192-slot-inner, 8192, 134, 286, 440, 0, 0, 860, 682666
n50x8192-slot-inner, 8192, 134, 283, 445, 0, 0, 862, 682666
n50x8192-slot-inner, 8192, 134, 284, 437, 0, 0, 855, 682666
n50x8192-slot-inner, 8192, 133, 284, 440, 0, 0, 857, 682666
n50x8192-slot-inner, 8192, 133, 282, 440, 0, 0, 855, 682666
n50x8192-slot-inner, 8192, 134, 286, 443, 0, 0, 863, 682666
n50x8192-slot-inner, 8192, 133, 283, 442, 0, 0, 858, 682666
n50x8192-slot-inner, 8192, 134, 285, 441, 0, 0, 860, 682666
n50x8192-slot-inner, 8192, 133, 283, 441, 0, 0, 857, 682666
n50x8192-slot-inner, 8192, 135, 284, 440, 0, 0, 859, 682666
n50x8192-slot-inner, 8192, 135, 283, 441, 0, 0, 859, 682666
n50x8192-slot-inner, 8192, 135, 284, 441, 0, 0, 860, 682666
n50x8192-slot-inner, 8192, 133, 285, 439, 0, 0, 857, 682666
n50x8192-slot-inner, 8192, 134, 284, 438, 0, 0, 856, 682666
n50x8192-slot-inner, 8192, 133, 284, 439, 0, 0, 856, 682666
n50x8192-slot-inner, 8192, 133, 284, 441, 0, 0, 858, 682666
n50x8192-slot-inner, 8192, 135, 287, 441, 0, 0, 863, 682666
n50x8192-slot-inner, 8192, 134, 289, 438, 0, 0, 861, 682666
n50x8192-slot-inner, 8192, 134, 285, 440, 0, 0, 859, 682666
n50x8192-slot-inner, 8192, 134, 283, 438, 0, 0, 855, 682666
n50x8192-slot-inner, 8192, 134, 284, 442, 0, 0, 860, 682666
n50x8192-slot-inner, 8192, 134, 286, 437, 0, 0, 857, 682666
n50x8192-slot-inner, 8192, 133, 285, 442, 0, 0, 860, 682666
n50x8192-slot-inner, 8192, 135, 286, 442, 0, 0, 863, 682666
n50x8192-slot-inner, 8192, 133, 283, 441, 0, 0, 857, 682666
n50x8192-slot-inner, 8192, 133, 282, 439, 0, 0, 854, 682666
n50x8192-slot-inner, 8192, 133, 282, 444, 0, 0, 859, 682666
n50x8192-slot-inner, 8192, 134, 287, 438, 0, 0, 859, 682666
n50x8192-slot-inner, 8192, 133, 283, 442, 0, 0, 858, 682666
n50x8192-slot-inner, 8192, 136, 284, 441, 0, 0, 861, 682666
n50x8192-slot-inner, 8192, 134, 284, 441, 0, 0, 859, 682666
n50x8192-slot-inner, 8192, 133, 283, 439, 0, 0, 855, 682666
n50x8192-slot-inner, 8192, 135, 286, 439, 0, 0, 860, 682666
n50x8192-slot-inner, 8192, 133, 283, 437, 0, 0, 853, 682666
n50x8192-slot-inner, 8192, 135, 285, 441, 0, 0, 861, 682666
n50x8192-slot-inner, 8192, 135, 285, 440, 0, 0, 860, 682666
n50x8192-slot-inner, 8192, 134, 283, 437, 0, 0, 854, 682666
n50x8192-slot-inner, 8192, 134, 283, 439, 0, 0, 856, 682666
n50x8192-slot-inner, 8192, 135, 283, 440, 0, 0, 858, 682666
n50x8192-slot-inner, 8192, 135, 285, 442, 0, 0, 862, 682666
n50x8192-slot-inner, 8192, 134, 284, 439, 0, 0, 857, 682666
n50x8192-slot-inner, 8192, 135, 285, 440, 0, 0, 860, 682666
n50x8192-slot-inner, 8192, 133, 283, 438, 0, 0, 854, 682666
n50x8192-slot-inner, 8192, 134, 285, 442, 0, 0, 861, 682666
n50x8192-slot-inner, 8192, 133, 283, 439, 0, 0, 855, 682666
n50x8192-slot-inner, 8192, 135, 283, 440, 0, 0, 858, 682666
n50x8192-slot-inner, 8192, 134, 285, 441, 0, 0, 860, 682666
n50x8192-slot-inner, 8192, 134, 283, 439, 0, 0, 856, 682666
n50x8192-slot-inner, 8192, 135, 283, 440, 0, 0, 858, 682666
n50x8192-slot-inner, 8192, 133, 282, 442, 0, 0, 857, 682666
n50x8192-slot-inner, 8192, 134, 284, 444, 0, 0, 862, 682666
n50x8192-slot-inner, 8192, 147, 285, 444, 0, 0, 876, 682666
n50x8192-slot-inner, 8192, 134, 284, 440, 0, 0, 858, 682666
n50x8192-slot-inner, 8192, 134, 284, 441, 0, 0, 859, 682666
n50x8192-slot-inner, 8192, 134, 284, 441, 0, 0, 859, 682666
n50x8192-slot-inner, 8192, 134, 284, 445, 0, 0, 863, 682666
n50x8192-slot-inner, 8192, 134, 285, 444, 0, 0, 863, 682666
n50x8192-slot-inner, 8192, 135, 284, 440, 0, 0, 859, 682666
n50x8192-slot-inner, 8192, 134, 284, 442, 0, 0, 860, 682666
n50x8192-slot-inner, 8192, 133, 284, 443, 0, 0, 860, 682666
n50x8192-slot-inner, 8192, 133, 284, 438, 0, 0, 855, 682666
n50x8192-slot-inner, 8192, 134, 283, 439, 0, 0, 856, 682666
n50x8192-slot-inner, 8192, 134, 283, 443, 0, 0, 860, 682666
n50x8192-slot-inner, 8192, 134, 286, 442, 0, 0, 862, 682666
n50x8192-slot-inner, 8192, 134, 284, 443, 0, 0, 861, 682666
n50x8192-slot-inner, 8192, 134, 283, 440, 0, 0, 857, 682666
n50x8192-slot-inner, 8192, 133, 286, 442, 0, 0, 861, 682666
n50x8192-slot-inner, 8192, 133, 285, 442, 0, 0, 860, 682666
n50x8192-slot-inner, 8192, 134, 287, 445, 0, 0, 866, 682666
n50x8192-slot-inner, 8192, 133, 284, 438, 0, 0, 855, 682666
n50x8192-slot-inner, 8192, 135, 285, 438, 0, 0, 858, 682666
n50x8192-slot-inner, 8192, 133, 283, 440, 0, 0, 856, 682666
n50x8192-slot-inner, 8192, 133, 283, 441, 0, 0, 857, 682666
n50x8192-slot-inner, 8192, 133, 283, 443, 0, 0, 859, 682666
n50x8192-slot-inner, 8192, 134, 283, 442, 0, 0, 859, 682666
n50x8192-slot-inner, 8192, 134, 283, 441, 0, 0, 858, 682666
n50x8192-slot-inner, 8192, 134, 284, 438, 0, 0, 856, 682666
n50x8192-slot-inner, 8192, 134, 283, 439, 0, 0, 856, 682666
n50x8192-slot-inner, 8192, 134, 284, 441, 0, 0, 859, 682666
n50x8192-slot-inner, 8192, 133, 287, 435, 0, 0, 855, 682666
n50x8192-slot-inner, 8192, 136, 283, 440, 0, 0, 859, 682666
n50x8192-slot-inner, 8192, 134, 284, 441, 0, 0, 859, 682666
n50x8192-slot-inner, 8192, 134, 284, 442, 0, 0, 860, 682666
n50x8192-slot-inner, 8192, 135, 286, 442, 0, 0, 863, 682666
n50x8192-slot-inner, 8192, 133, 286, 440, 0, 0, 859, 682666
n50x8192-slot-inner, 8192, 134, 284, 439, 0, 0, 857, 682666
n50x8192-slot-inner, 8192, 134, 284, 438, 0, 0, 856, 682666
n50x8192-slot-inner, 8192, 134, 284, 439, 0, 0, 857, 682666
n50x8192-slot-inner, 8192, 134, 284, 439, 0, 0, 857, 682666
n50x8192-slot-inner, 8192, 133, 284, 439, 0, 0, 856, 682666
n50x8192-slot-inner, 8192, 134, 284, 438, 0, 0, 856, 682666
n50x8192-slot-inner, 8192, 134, 284, 444, 0, 0, 862, 682666
n50x8192-slot-inner, 8192, 134, 283, 441, 0, 0, 858, 682666
n50x8192-slot-inner, 8192, 134, 285, 438, 0, 0, 857, 682666
n50x8192-slot-inner, 8192, 134, 282, 439, 0, 0, 855, 682666
n50x8192-slot-inner, 4096, 64, 275, 414, 0, 0, 753, 682666
n50x8192-slot-inner, 4096, 63, 277, 417, 0, 0, 757, 682666
n50x8192-slot-inner, 4096, 64, 275, 416, 0, 0, 755, 682666
n50x8192-slot-inner, 4096, 63, 273, 418, 0, 0, 754, 682666
n50x8192-slot-inner, 4096, 64, 276, 416, 0, 0, 756, 682666
n50x8192-slot-inner, 4096, 64, 274, 418, 0, 0, 756, 682666
n50x8192-slot-inner, 4096, 63, 276, 417, 0, 0, 756, 682666
n50x8192-slot-inner, 4096, 65, 278, 422, 0, 0, 765, 682666
n50x8192-slot-inner, 4096, 64, 274, 418, 0, 0, 756, 682666
n50x8192-slot-inner, 4096, 63, 273, 414, 0, 0, 750, 682666
n50x8192-slot-inner, 4096, 63, 275, 416, 0, 0, 754, 682666
n50x8192-slot-inner, 4096, 64, 275, 416, 0, 0, 755, 682666
n50x8192-slot-inner, 4096, 63, 272, 423, 0, 0, 758, 682666
n50x8192-slot-inner, 4096, 64, 280, 423, 0, 0, 767, 682666
n50x8192-slot-inner, 4096, 63, 275, 425, 0, 0, 763, 682666
n50x8192-slot-inner, 4096, 63, 274, 417, 0, 0, 754, 682666
n50x8192-slot-inner, 4096, 63, 275, 419, 0, 0, 757, 682666
n50x8192-slot-inner, 4096, 63, 274, 422, 0, 0, 759, 682666
n50x8192-slot-inner, 4096, 63, 274, 417, 0, 0, 754, 682666
n50x8192-slot-inner, 4096, 64, 276, 419, 0, 0, 759, 682666
n50x8192-slot-inner, 4096, 64, 274, 418, 0, 0, 756, 682666
n50x8192-slot-inner, 4096, 64, 275, 418, 0, 0, 757, 682666
n50x8192-slot-inner, 4096, 63, 276, 416, 0, 0, 755, 682666
n50x8192-slot-inner, 4096, 64, 274, 420, 0, 0, 758, 682666
n50x8192-slot-inner, 4096, 64, 275, 423, 0, 0, 762, 682666
n50x8192-slot-inner, 4096, 64, 275, 419, 0, 0, 758, 682666
n50x8192-slot-inner, 4096, 76, 303, 499, 0, 0, 878, 682666
n50x8192-slot-inner, 4096, 66, 276, 421, 0, 0, 763, 682666
n50x8192-slot-inner, 4096, 64, 275, 417, 0, 0, 756, 682666
n50x8192-slot-inner, 4096, 63, 272, 430, 0, 0, 765, 682666
n50x8192-slot-inner, 4096, 64, 274, 416, 0, 0, 754, 682666
n50x8192-slot-inner, 4096, 64, 274, 419, 0, 0, 757, 682666
n50x8192-slot-inner, 4096, 64, 272, 420, 0, 0, 756, 682666
n50x8192-slot-inner, 4096, 63, 275, 418, 0, 0, 756, 682666
n50x8192-slot-inner, 4096, 64, 274, 417, 0, 0, 755, 682666
n50x8192-slot-inner, 4096, 63, 274, 414, 0, 0, 751, 682666
n50x8192-slot-inner, 4096, 65, 275, 417, 0, 0, 757, 682666
n50x8192-slot-inner, 4096, 63, 274, 418, 0, 0, 755, 682666
n50x8192-slot-inner, 4096, 64, 272, 417, 0, 0, 753, 682666
n50x8192-slot-inner, 4096, 65, 273, 417, 0, 0, 755, 682666
n50x8192-slot-inner, 4096, 64, 275, 417, 0, 0, 756, 682666
n50x8192-slot-inner, 4096, 64, 274, 419, 0, 0, 757, 682666
n50x8192-slot-inner, 4096, 64, 276, 420, 0, 0, 760, 682666
n50x8192-slot-inner, 4096, 64, 274, 414, 0, 0, 752, 682666
n50x8192-slot-inner, 4096, 64, 274, 421, 0, 0, 759, 682666
n50x8192-slot-inner, 4096, 63, 276, 419, 0, 0, 758, 682666
n50x8192-slot-inner, 4096, 64, 274, 418, 0, 0, 756, 682666
n50x8192-slot-inner, 4096, 64, 274, 420, 0, 0, 758, 682666
n50x8192-slot-inner, 4096, 64, 274, 419, 0, 0, 757, 682666
n50x8192-slot-inner, 4096, 63, 276, 416, 0, 0, 755, 682666
n50x8192-slot-inner, 4096, 63, 276, 416, 0, 0, 755, 682666
n50x8192-slot-inner, 4096, 63, 273, 419, 0, 0, 755, 682666
n50x8192-slot-inner, 4096, 64, 275, 420, 0, 0, 759, 682666
n50x8192-slot-inner, 4096, 64, 274, 414, 0, 0, 752, 682666
n50x8192-slot-inner, 4096, 63, 277, 418, 0, 0, 758, 682666
n50x8192-slot-inner, 4096, 63, 276, 418, 0, 0, 757, 682666
n50x8192-slot-inner, 4096, 63, 274, 420, 0, 0, 757, 682666
n50x8192-slot-inner, 4096, 64, 272, 418, 1, 0, 755, 682666
n50x8192-slot-inner, 4096, 63, 275, 416, 0, 0, 754, 682666
n50x8192-slot-inner, 4096, 64, 273, 413, 0, 0, 750, 682666
n50x8192-slot-inner, 4096, 64, 274, 419, 0, 0, 757, 682666
n50x8192-slot-inner, 4096, 63, 275, 419, 0, 0, 757, 682666
n50x8192-slot-inner, 4096, 64, 274, 416, 0, 0, 754, 682666
n50x8192-slot-inner, 4096, 65, 274, 420, 0, 0, 759, 682666
n50x8192-slot-inner, 4096, 64, 274, 421, 0, 0, 759, 682666
n50x8192-slot-inner, 4096, 64, 274, 420, 0, 0, 758, 682666
n50x8192-slot-inner, 4096, 63, 274, 421, 0, 0, 758, 682666
n50x8192-slot-inner, 4096, 63, 275, 419, 0, 0, 757, 682666
n50x8192-slot-inner, 4096, 63, 276, 414, 0, 0, 753, 682666
n50x8192-slot-inner, 4096, 63, 277, 418, 0, 0, 758, 682666
n50x8192-slot-inner, 4096, 64, 274, 418, 0, 0, 756, 682666
n50x8192-slot-inner, 4096, 64, 275, 419, 0, 0, 758, 682666
n50x8192-slot-inner, 4096, 63, 273, 417, 0, 0, 753, 682666
n50x8192-slot-inner, 4096, 63, 277, 415, 0, 0, 755, 682666
n50x8192-slot-inner, 4096, 63, 275, 416, 0, 0, 754, 682666
n50x8192-slot-inner, 4096, 64, 273, 419, 0, 0, 756, 682666
n50x8192-slot-inner, 4096, 63, 274, 417, 0, 0, 754, 682666
n50x8192-slot-inner, 4096, 63, 272, 416, 0, 0, 751, 682666
n50x8192-slot-inner, 4096, 64, 275, 414, 0, 0, 753, 682666
n50x8192-slot-inner, 4096, 63, 274, 416, 0, 0, 753, 682666
n50x8192-slot-inner, 4096, 64, 275, 420, 0, 0, 759, 682666
n50x8192-slot-inner, 4096, 64, 274, 416, 0, 0, 754, 682666
n50x8192-slot-inner, 4096, 63, 274, 419, 0, 0, 756, 682666
n50x8192-slot-inner, 4096, 64, 274, 417, 0, 0, 755, 682666
n50x8192-slot-inner, 4096, 64, 276, 419, 0, 0, 759, 682666
n50x8192-slot-inner, 4096, 63, 275, 421, 0, 0, 759, 682666
n50x8192-slot-inner, 4096, 63, 275, 430, 0, 0, 768, 682666
n50x8192-slot-inner, 4096, 63, 274, 420, 0, 0, 757, 682666
n50x8192-slot-inner, 4096, 64, 279, 434, 0, 0, 777, 682666
n50x8192-slot-inner, 4096, 63, 273, 428, 0, 0, 764, 682666
n50x8192-slot-inner, 4096, 63, 392, 567, 0, 0, 1022, 682666
n50x8192-slot-inner, 4096, 64, 275, 419, 0, 0, 758, 682666
n50x8192-slot-inner, 4096, 64, 274, 415, 0, 0, 753, 682666
n50x8192-slot-inner, 4096, 64, 275, 418, 0, 0, 757, 682666
n50x8192-slot-inner, 4096, 64, 274, 418, 0, 0, 756, 682666
n50x8192-slot-inner, 4096, 63, 274, 417, 0, 0, 754, 682666
n50x8192-slot-inner, 4096, 63, 273, 419, 0, 0, 755, 682666
n50x8192-slot-inner, 4096, 64, 273, 419, 0, 0, 756, 682666
n50x8192-slot-inner, 4096, 64, 273, 416, 0, 0, 753, 682666
n50x8192-slot-inner, 4096, 64, 277, 422, 0, 0, 763, 682666
n50x8192-slot-inner, 2048, 31, 269, 415, 0, 0, 715, 682666
n50x8192-slot-inner, 2048, 32, 283, 417, 0, 0, 732, 682666
n50x8192-slot-inner, 2048, 31, 270, 413, 0, 0, 714, 682666
n50x8192-slot-inner, 2048, 31, 271, 414, 0, 0, 716, 682666
n50x8192-slot-inner, 2048, 31, 270, 415, 0, 0, 716, 682666
n50x8192-slot-inner, 2048, 31, 276, 414, 0, 0, 721, 682666
n50x8192-slot-inner, 2048, 31, 268, 412, 0, 0, 711, 682666
n50x8192-slot-inner, 2048, 31, 268, 412, 0, 0, 711, 682666
n50x8192-slot-inner, 2048, 32, 269, 417, 0, 0, 718, 682666
n50x8192-slot-inner, 2048, 31, 268, 413, 0, 0, 712, 682666
n50x8192-slot-inner, 2048, 31, 268, 412, 0, 0, 711, 682666
n50x8192-slot-inner, 2048, 31, 268, 412, 0, 0, 711, 682666
n50x8192-slot-inner, 2048, 32, 270, 415, 0, 0, 717, 682666
n50x8192-slot-inner, 2048, 31, 268, 413, 0, 0, 712, 682666
n50x8192-slot-inner, 2048, 31, 269, 411, 0, 0, 711, 682666
n50x8192-slot-inner, 2048, 32, 271, 413, 0, 0, 716, 682666
n50x8192-slot-inner, 2048, 32, 270, 416, 0, 0, 718, 682666
n50x8192-slot-inner, 2048, 31, 268, 414, 0, 0, 713, 682666
n50x8192-slot-inner, 2048, 31, 268, 412, 0, 0, 711, 682666
n50x8192-slot-inner, 2048, 32, 269, 414, 0, 0, 715, 682666
n50x8192-slot-inner, 2048, 31, 269, 414, 0, 0, 714, 682666
n50x8192-slot-inner, 2048, 32, 271, 417, 0, 0, 720, 682666
n50x8192-slot-inner, 2048, 31, 273, 416, 0, 0, 720, 682666
n50x8192-slot-inner, 2048, 31, 269, 412, 0, 0, 712, 682666
n50x8192-slot-inner, 2048, 32, 269, 414, 0, 0, 715, 682666
n50x8192-slot-inner, 2048, 31, 270, 414, 0, 0, 715, 682666
n50x8192-slot-inner, 2048, 31, 270, 410, 0, 0, 711, 682666
n50x8192-slot-inner, 2048, 32, 270, 414, 0, 0, 716, 682666
n50x8192-slot-inner, 2048, 31, 269, 413, 0, 0, 713, 682666
n50x8192-slot-inner, 2048, 31, 268, 414, 0, 0, 713, 682666
n50x8192-slot-inner, 2048, 32, 268, 412, 0, 0, 712, 682666
n50x8192-slot-inner, 2048, 32, 270, 412, 0, 0, 714, 682666
n50x8192-slot-inner, 2048, 31, 269, 415, 0, 0, 715, 682666
n50x8192-slot-inner, 2048, 31, 269, 414, 0, 0, 714, 682666
n50x8192-slot-inner, 2048, 31, 268, 410, 0, 0, 709, 682666
n50x8192-slot-inner, 2048, 31, 270, 417, 0, 0, 718, 682666
n50x8192-slot-inner, 2048, 32, 269, 413, 0, 0, 714, 682666
n50x8192-slot-inner, 2048, 31, 268, 414, 0, 0, 713, 682666
n50x8192-slot-inner, 2048, 31, 269, 415, 0, 0, 715, 682666
n50x8192-slot-inner, 2048, 32, 269, 418, 0, 0, 719, 682666
n50x8192-slot-inner, 2048, 32, 269, 415, 0, 0, 716, 682666
n50x8192-slot-inner, 2048, 32, 270, 413, 0, 0, 715, 682666
n50x8192-slot-inner, 2048, 31, 270, 411, 0, 0, 712, 682666
n50x8192-slot-inner, 2048, 32, 271, 412, 0, 0, 715, 682666
n50x8192-slot-inner, 2048, 32, 270, 414, 0, 0, 716, 682666
n50x8192-slot-inner, 2048, 31, 269, 412, 0, 0, 712, 682666
n50x8192-slot-inner, 2048, 31, 269, 414, 0, 0, 714, 682666
n50x8192-slot-inner, 2048, 31, 270, 415, 0, 0, 716, 682666
n50x8192-slot-inner, 2048, 31, 270, 416, 0, 0, 717, 682666
n50x8192-slot-inner, 2048, 32, 270, 414, 0, 0, 716, 682666
n50x8192-slot-inner, 2048, 31, 267, 409, 0, 0, 707, 682666
n50x8192-slot-inner, 2048, 31, 269, 412, 0, 0, 712, 682666
n50x8192-slot-inner, 2048, 31, 269, 412, 0, 0, 712, 682666
n50x8192-slot-inner, 2048, 31, 271, 413, 0, 0, 715, 682666
n50x8192-slot-inner, 2048, 32, 272, 413, 0, 0, 717, 682666
n50x8192-slot-inner, 2048, 31, 269, 412, 0, 0, 712, 682666
n50x8192-slot-inner, 2048, 31, 271, 413, 0, 0, 715, 682666
n50x8192-slot-inner, 2048, 32, 269, 413, 0, 0, 714, 682666
n50x8192-slot-inner, 2048, 31, 270, 417, 0, 0, 718, 682666
n50x8192-slot-inner, 2048, 32, 269, 416, 0, 0, 717, 682666
n50x8192-slot-inner, 2048, 31, 270, 418, 0, 0, 719, 682666
n50x8192-slot-inner, 2048, 32, 271, 412, 0, 0, 715, 682666
n50x8192-slot-inner, 2048, 31, 269, 412, 0, 0, 712, 682666
n50x8192-slot-inner, 2048, 31, 270, 413, 0, 0, 714, 682666
n50x8192-slot-inner, 2048, 31, 269, 410, 0, 0, 710, 682666
n50x8192-slot-inner, 2048, 31, 268, 411, 0, 0, 710, 682666
n50x8192-slot-inner, 2048, 31, 268, 412, 0, 0, 711, 682666
n50x8192-slot-inner, 2048, 31, 271, 414, 0, 0, 716, 682666
n50x8192-slot-inner, 2048, 32, 272, 413, 0, 0, 717, 682666
n50x8192-slot-inner, 2048, 31, 271, 415, 0, 0, 717, 682666
n50x8192-slot-inner, 2048, 31, 268, 410, 0, 0, 709, 682666
n50x8192-slot-inner, 2048, 31, 268, 413, 0, 0, 712, 682666
n50x8192-slot-inner, 2048, 31, 269, 416, 0, 0, 716, 682666
n50x8192-slot-inner, 2048, 31, 267, 413, 0, 0, 711, 682666
n50x8192-slot-inner, 2048, 31, 268, 413, 0, 0, 712, 682666
n50x8192-slot-inner, 2048, 32, 270, 417, 0, 0, 719, 682666
n50x8192-slot-inner, 2048, 31, 268, 415, 0, 0, 714, 682666
n50x8192-slot-inner, 2048, 31, 268, 412, 0, 0, 711, 682666
n50x8192-slot-inner, 2048, 32, 268, 411, 0, 0, 711, 682666
n50x8192-slot-inner, 2048, 32, 270, 416, 0, 0, 718, 682666
n50x8192-slot-inner, 2048, 31, 270, 415, 0, 0, 716, 682666
n50x8192-slot-inner, 2048, 31, 283, 421, 0, 0, 735, 682666
n50x8192-slot-inner, 2048, 32, 270, 413, 0, 0, 715, 682666
n50x8192-slot-inner, 2048, 31, 270, 414, 0, 0, 715, 682666
n50x8192-slot-inner, 2048, 31, 270, 414, 0, 0, 715, 682666
n50x8192-slot-inner, 2048, 31, 270, 419, 0, 0, 720, 682666
n50x8192-slot-inner, 2048, 31, 270, 412, 0, 0, 713, 682666
n50x8192-slot-inner, 2048, 32, 270, 414, 0, 0, 716, 682666
n50x8192-slot-inner, 2048, 31, 269, 416, 0, 0, 716, 682666
n50x8192-slot-inner, 2048, 31, 270, 414, 0, 0, 715, 682666
n50x8192-slot-inner, 2048, 31, 268, 415, 0, 0, 714, 682666
n50x8192-slot-inner, 2048, 32, 271, 414, 0, 0, 717, 682666
n50x8192-slot-inner, 2048, 33, 269, 410, 0, 0, 712, 682666
n50x8192-slot-inner, 2048, 32, 270, 415, 0, 0, 717, 682666
n50x8192-slot-inner, 2048, 32, 270, 414, 0, 0, 716, 682666
n50x8192-slot-inner, 2048, 31, 270, 415, 0, 0, 716, 682666
n50x8192-slot-inner, 2048, 32, 273, 412, 0, 0, 717, 682666
n50x8192-slot-inner, 2048, 32, 269, 411, 0, 0, 712, 682666
n50x8192-slot-inner, 2048, 31, 273, 417, 0, 0, 721, 682666
n50x8192-slot-inner, 2048, 31, 269, 415, 0, 0, 715, 682666
n50x8192-slot-inner, 1024, 32, 344, 658, 0, 0, 1034, 682666
n50x8192-slot-inner, 1024, 33, 347, 662, 0, 0, 1042, 682666
n50x8192-slot-inner, 1024, 32, 345, 657, 0, 0, 1034, 682666
n50x8192-slot-inner, 1024, 34, 346, 660, 0, 0, 1040, 682666
n50x8192-slot-inner, 1024, 33, 345, 660, 0, 0, 1038, 682666
n50x8192-slot-inner, 1024, 33, 344, 665, 0, 0, 1042, 682666
n50x8192-slot-inner, 1024, 33, 345, 664, 0, 0, 1042, 682666
n50x8192-slot-inner, 1024, 32, 346, 665, 0, 0, 1043, 682666
n50x8192-slot-inner, 1024, 33, 345, 665, 0, 0, 1043, 682666
n50x8192-slot-inner, 1024, 32, 348, 664, 0, 0, 1044, 682666
n50x8192-slot-inner, 1024, 32, 347, 663, 0, 0, 1042, 682666
n50x8192-slot-inner, 1024, 34, 347, 662, 0, 0, 1043, 682666
n50x8192-slot-inner, 1024, 32, 345, 665, 0, 0, 1042, 682666
n50x8192-slot-inner, 1024, 33, 348, 663, 0, 0, 1044, 682666
n50x8192-slot-inner, 1024, 32, 346, 663, 0, 0, 1041, 682666
n50x8192-slot-inner, 1024, 33, 347, 665, 0, 0, 1045, 682666
n50x8192-slot-inner, 1024, 33, 346, 663, 0, 0, 1042, 682666
n50x8192-slot-inner, 1024, 32, 345, 663, 0, 0, 1040, 682666
n50x8192-slot-inner, 1024, 40, 346, 684, 0, 0, 1070, 682666
n50x8192-slot-inner, 1024, 32, 346, 667, 0, 0, 1045, 682666
n50x8192-slot-inner, 1024, 32, 348, 666, 0, 0, 1046, 682666
n50x8192-slot-inner, 1024, 32, 345, 660, 0, 0, 1037, 682666
n50x8192-slot-inner, 1024, 32, 345, 660, 0, 0, 1037, 682666
n50x8192-slot-inner, 1024, 31, 342, 661, 0, 0, 1034, 682666
n50x8192-slot-inner, 1024, 33, 344, 664, 0, 0, 1041, 682666
n50x8192-slot-inner, 1024, 34, 346, 658, 0, 0, 1038, 682666
n50x8192-slot-inner, 1024, 37, 346, 686, 0, 0, 1069, 682666
n50x8192-slot-inner, 1024, 32, 346, 660, 0, 0, 1038, 682666
n50x8192-slot-inner, 1024, 33, 349, 660, 0, 0, 1042, 682666
n50x8192-slot-inner, 1024, 32, 345, 659, 0, 0, 1036, 682666
n50x8192-slot-inner, 1024, 33, 345, 660, 0, 0, 1038, 682666
n50x8192-slot-inner, 1024, 32, 345, 660, 0, 0, 1037, 682666
n50x8192-slot-inner, 1024, 33, 347, 665, 0, 0, 1045, 682666
n50x8192-slot-inner, 1024, 32, 345, 661, 0, 0, 1038, 682666
n50x8192-slot-inner, 1024, 33, 346, 661, 0, 0, 1040, 682666
n50x8192-slot-inner, 1024, 33, 345, 662, 0, 0, 1040, 682666
n50x8192-slot-inner, 1024, 33, 346, 660, 0, 0, 1039, 682666
n50x8192-slot-inner, 1024, 36, 345, 664, 0, 0, 1045, 682666
n50x8192-slot-inner, 1024, 32, 347, 666, 0, 0, 1045, 682666
n50x8192-slot-inner, 1024, 32, 348, 663, 0, 0, 1043, 682666
n50x8192-slot-inner, 1024, 31, 345, 658, 0, 0, 1034, 682666
n50x8192-slot-inner, 1024, 32, 344, 660, 0, 0, 1036, 682666
n50x8192-slot-inner, 1024, 32, 344, 679, 0, 0, 1055, 682666
n50x8192-slot-inner, 1024, 33, 347, 669, 0, 0, 1049, 682666
n50x8192-slot-inner, 1024, 32, 347, 660, 0, 0, 1039, 682666
n50x8192-slot-inner, 1024, 33, 345, 662, 0, 0, 1040, 682666
n50x8192-slot-inner, 1024, 32, 344, 667, 0, 0, 1043, 682666
n50x8192-slot-inner, 1024, 34, 343, 660, 0, 0, 1037, 682666
n50x8192-slot-inner, 1024, 35, 343, 683, 0, 0, 1061, 682666
n50x8192-slot-inner, 1024, 32, 344, 661, 0, 0, 1037, 682666
n50x8192-slot-inner, 1024, 32, 349, 666, 0, 0, 1047, 682666
n50x8192-slot-inner, 1024, 32, 346, 663, 0, 0, 1041, 682666
n50x8192-slot-inner, 1024, 34, 349, 665, 0, 0, 1048, 682666
n50x8192-slot-inner, 1024, 33, 346, 664, 0, 0, 1043, 682666
n50x8192-slot-inner, 1024, 33, 345, 660, 0, 0, 1038, 682666
n50x8192-slot-inner, 1024, 33, 344, 660, 0, 0, 1037, 682666
n50x8192-slot-inner, 1024, 32, 344, 663, 0, 0, 1039, 682666
n50x8192-slot-inner, 1024, 32, 347, 660, 0, 0, 1039, 682666
n50x8192-slot-inner, 1024, 32, 344, 660, 0, 0, 1036, 682666
n50x8192-slot-inner, 1024, 32, 344, 662, 0, 0, 1038, 682666
n50x8192-slot-inner, 1024, 33, 344, 665, 0, 0, 1042, 682666
n50x8192-slot-inner, 1024, 32, 348, 660, 0, 0, 1040, 682666
n50x8192-slot-inner, 1024, 33, 344, 662, 0, 0, 1039, 682666
n50x8192-slot-inner, 1024, 33, 345, 661, 0, 0, 1039, 682666
n50x8192-slot-inner, 1024, 32, 346, 661, 0, 0, 1039, 682666
n50x8192-slot-inner, 1024, 32, 347, 658, 0, 0, 1037, 682666
n50x8192-slot-inner, 1024, 33, 347, 666, 0, 0, 1046, 682666
n50x8192-slot-inner, 1024, 33, 347, 666, 0, 0, 1046, 682666
n50x8192-slot-inner, 1024, 32, 342, 661, 0, 0, 1035, 682666
n50x8192-slot-inner, 1024, 33, 347, 661, 0, 0, 1041, 682666
n50x8192-slot-inner, 1024, 32, 345, 663, 0, 0, 1040, 682666
n50x8192-slot-inner, 1024, 32, 345, 661, 0, 0, 1038, 682666
n50x8192-slot-inner, 1024, 32, 345, 663, 0, 0, 1040, 682666
n50x8192-slot-inner, 1024, 32, 344, 658, 0, 0, 1034, 682666
n50x8192-slot-inner, 1024, 32, 345, 657, 0, 0, 1034, 682666
n50x8192-slot-inner, 1024, 33, 347, 664, 0, 0, 1044, 682666
n50x8192-slot-inner, 1024, 32, 347, 661, 0, 0, 1040, 682666
n50x8192-slot-inner, 1024, 32, 347, 662, 0, 0, 1041, 682666
n50x8192-slot-inner, 1024, 32, 347, 665, 0, 0, 1044, 682666
n50x8192-slot-inner, 1024, 33, 347, 664, 0, 0, 1044, 682666
n50x8192-slot-inner, 1024, 33, 346, 666, 0, 0, 1045, 682666
n50x8192-slot-inner, 1024, 32, 346, 663, 0, 0, 1041, 682666
n50x8192-slot-inner, 1024, 33, 343, 662, 0, 0, 1038, 682666
n50x8192-slot-inner, 1024, 32, 348, 666, 0, 0, 1046, 682666
n50x8192-slot-inner, 1024, 33, 348, 667, 0, 0, 1048, 682666
n50x8192-slot-inner, 1024, 33, 344, 662, 0, 0, 1039, 682666
n50x8192-slot-inner, 1024, 32, 347, 660, 0, 0, 1039, 682666
n50x8192-slot-inner, 1024, 32, 345, 665, 0, 0, 1042, 682666
n50x8192-slot-inner, 1024, 33, 349, 664, 0, 0, 1046, 682666
n50x8192-slot-inner, 1024, 32, 347, 663, 0, 0, 1042, 682666
n50x8192-slot-inner, 1024, 33, 347, 659, 0, 0, 1039, 682666
n50x8192-slot-inner, 1024, 40, 350, 684, 0, 0, 1074, 682666
n50x8192-slot-inner, 1024, 33, 347, 658, 0, 0, 1038, 682666
n50x8192-slot-inner, 1024, 33, 348, 666, 0, 0, 1047, 682666
n50x8192-slot-inner, 1024, 32, 344, 665, 0, 0, 1041, 682666
n50x8192-slot-inner, 1024, 32, 344, 664, 0, 0, 1040, 682666
n50x8192-slot-inner, 1024, 33, 344, 660, 0, 0, 1037, 682666
n50x8192-slot-inner, 1024, 34, 347, 665, 0, 0, 1046, 682666
n50x8192-slot-inner, 1024, 32, 362, 667, 0, 0, 1061, 682666
n50x8192-slot-inner, 1024, 32, 347, 660, 0, 0, 1039, 682666
n50x8192-coef-inner, 8192, 29, 1025, 418, 0, 0, 1472, 682666
n50x8192-coef-inner, 8192, 29, 1023, 416, 0, 0, 1468, 682666
n50x8192-coef-inner, 8192, 30, 1030, 416, 0, 0, 1476, 682666
n50x8192-coef-inner, 8192, 30, 1026, 416, 0, 0, 1472, 682666
n50x8192-coef-inner, 8192, 29, 1028, 420, 0, 0, 1477, 682666
n50x8192-coef-inner, 8192, 29, 1033, 417, 0, 0, 1479, 682666
n50x8192-coef-inner, 8192, 29, 1024, 418, 0, 0, 1471, 682666
n50x8192-coef-inner, 8192, 30, 1030, 419, 0, 0, 1479, 682666
n50x8192-coef-inner, 8192, 30, 1027, 419, 0, 0, 1476, 682666
n50x8192-coef-inner, 8192, 29, 1027, 420, 0, 0, 1476, 682666
n50x8192-coef-inner, 8192, 30, 1027, 417, 0, 0, 1474, 682666
n50x8192-coef-inner, 8192, 29, 1027, 417, 0, 0, 1473, 682666
n50x8192-coef-inner, 8192, 30, 1031, 419, 0, 0, 1480, 682666
n50x8192-coef-inner, 8192, 30, 1027, 416, 0, 0, 1473, 682666
n50x8192-coef-inner, 8192, 29, 1031, 416, 0, 0, 1476, 682666
n50x8192-coef-inner, 8192, 29, 1024, 415, 0, 0, 1468, 682666
n50x8192-coef-inner, 8192, 30, 1026, 421, 0, 0, 1477, 682666
n50x8192-coef-inner, 8192, 30, 1027, 419, 0, 0, 1476, 682666
n50x8192-coef-inner, 8192, 30, 1027, 421, 0, 0, 1478, 682666
n50x8192-coef-inner, 8192, 29, 1028, 416, 0, 0, 1473, 682666
n50x8192-coef-inner, 8192, 30, 1028, 415, 0, 0, 1473, 682666
n50x8192-coef-inner, 8192, 30, 1029, 420, 0, 0, 1479, 682666
n50x8192-coef-inner, 8192, 30, 1033, 421, 0, 0, 1484, 682666
n50x8192-coef-inner, 8192, 29, 1026, 419, 0, 0, 1474, 682666
n50x8192-coef-inner, 8192, 29, 1026, 416, 0, 0, 1471, 682666
n50x8192-coef-inner, 8192, 29, 1026, 418, 0, 0, 1473, 682666
n50x8192-coef-inner, 8192, 29, 1019, 414, 0, 0, 1462, 682666
n50x8192-coef-inner, 8192, 29, 1029, 418, 0, 0, 1476, 682666
n50x8192-coef-inner, 8192, 29, 1023, 417, 0, 0, 1469, 682666
n50x8192-coef-inner, 8192, 30, 1028, 418, 0, 0, 1476, 682666
n50x8192-coef-inner, 8192, 30, 1026, 420, 0, 0, 1476, 682666
n50x8192-coef-inner, 8192, 29, 1030, 418, 0, 0, 1477, 682666
n50x8192-coef-inner, 8192, 29, 1027, 417, 0, 0, 1473, 682666
n50x8192-coef-inner, 8192, 30, 1028, 417, 0, 0, 1475, 682666
n50x8192-coef-inner, 8192, 29, 1026, 417, 0, 0, 1472, 682666
n50x8192-coef-inner, 8192, 30, 1025, 416, 0, 0, 1471, 682666
n50x8192-coef-inner, 8192, 29, 1027, 419, 0, 0, 1475, 682666
n50x8192-coef-inner, 8192, 29, 1035, 417, 0, 0, 1481, 682666
n50x8192-coef-inner, 8192, 30, 1041, 418, 0, 0, 1489, 682666
n50x8192-coef-inner, 8192, 30, 1035, 417, 0, 0, 1482, 682666
n50x8192-coef-inner, 8192, 30, 1035, 417, 0, 0, 1482, 682666
n50x8192-coef-inner, 8192, 30, 1035, 419, 0, 0, 1484, 682666
n50x8192-coef-inner, 8192, 29, 1029, 419, 0, 0, 1477, 682666
n50x8192-coef-inner, 8192, 30, 1029, 421, 0, 0, 1480, 682666
n50x8192-coef-inner, 8192, 30, 1025, 417, 0, 0, 1472, 682666
n50x8192-coef-inner, 8192, 30, 1027, 421, 0, 0, 1478, 682666
n50x8192-coef-inner, 8192, 29, 1028, 418, 0, 0, 1475, 682666
n50x8192-coef-inner, 8192, 29, 1028, 420, 0, 0, 1477, 682666
n50x8192-coef-inner, 8192, 29, 1029, 417, 0, 0, 1475, 682666
n50x8192-coef-inner, 8192, 30, 1030, 416, 0, 0, 1476, 682666
n50x8192-coef-inner, 8192, 29, 1024, 418, 0, 0, 1471, 682666
n50x8192-coef-inner, 8192, 29, 1025, 418, 0, 0, 1472, 682666
n50x8192-coef-inner, 8192, 29, 1031, 416, 0, 0, 1476, 682666
n50x8192-coef-inner, 8192, 29, 1021, 420, 0, 0, 1470, 682666
n50x8192-coef-inner, 8192, 29, 1026, 415, 0, 0, 1470, 682666
n50x8192-coef-inner, 8192, 30, 1028, 419, 0, 0, 1477, 682666
n50x8192-coef-inner, 8192, 30, 1029, 419, 0, 0, 1478, 682666
n50x8192-coef-inner, 8192, 29, 1034, 420, 0, 0, 1483, 682666
n50x8192-coef-inner, 8192, 30, 1030, 420, 0, 0, 1480, 682666
n50x8192-coef-inner, 8192, 30, 1026, 421, 0, 0, 1477, 682666
n50x8192-coef-inner, 8192, 29, 1026, 417, 0, 0, 1472, 682666
n50x8192-coef-inner, 8192, 30, 1024, 421, 0, 0, 1475, 682666
n50x8192-coef-inner, 8192, 30, 1025, 421, 0, 0, 1476, 682666
n50x8192-coef-inner, 8192, 29, 1029, 417, 0, 0, 1475, 682666
n50x8192-coef-inner, 8192, 29, 1027, 419, 0, 0, 1475, 682666
n50x8192-coef-inner, 8192, 30, 1030, 417, 0, 0, 1477, 682666
n50x8192-coef-inner, 8192, 30, 1029, 418, 0, 0, 1477, 682666
n50x8192-coef-inner, 8192, 30, 1024, 419, 0, 0, 1473, 682666
n50x8192-coef-inner, 8192, 30, 1029, 417, 0, 0, 1476, 682666
n50x8192-coef-inner, 8192, 30, 1022, 418, 0, 0, 1470, 682666
n50x8192-coef-inner, 8192, 29, 1026, 418, 0, 0, 1473, 682666
n50x8192-coef-inner, 8192, 29, 1024, 421, 0, 0, 1474, 682666
n50x8192-coef-inner, 8192, 29, 1028, 420, 0, 0, 1477, 682666
n50x8192-coef-inner, 8192, 30, 1029, 416, 0, 0, 1475, 682666
n50x8192-coef-inner, 8192, 29, 1023, 422, 0, 0, 1474, 682666
n50x8192-coef-inner, 8192, 30, 1032, 418, 0, 0, 1480, 682666
n50x8192-coef-inner, 8192, 29, 1025, 416, 0, 0, 1470, 682666
n50x8192-coef-inner, 8192, 29, 1029, 421, 0, 0, 1479, 682666
n50x8192-coef-inner, 8192, 29, 1098, 500, 0, 0, 1627, 682666
n50x8192-coef-inner, 8192, 29, 1025, 420, 0, 0, 1474, 682666
n50x8192-coef-inner, 8192, 29, 1030, 422, 0, 0, 1481, 682666
n50x8192-coef-inner, 8192, 29, 1029, 420, 0, 0, 1478, 682666
n50x8192-coef-inner, 8192, 29, 1023, 417, 0, 0, 1469, 682666
n50x8192-coef-inner, 8192, 30, 1029, 417, 0, 0, 1476, 682666
n50x8192-coef-inner, 8192, 30, 1027, 417, 0, 0, 1474, 682666
n50x8192-coef-inner, 8192, 30, 1028, 415, 0, 0, 1473, 682666
n50x8192-coef-inner, 8192, 29, 1025, 419, 0, 0, 1473, 682666
n50x8192-coef-inner, 8192, 29, 1028, 420, 0, 0, 1477, 682666
n50x8192-coef-inner, 8192, 29, 1030, 419, 0, 0, 1478, 682666
n50x8192-coef-inner, 8192, 29, 1028, 417, 0, 0, 1474, 682666
n50x8192-coef-inner, 8192, 29, 1023, 420, 0, 0, 1472, 682666
n50x8192-coef-inner, 8192, 29, 1020, 416, 0, 0, 1465, 682666
n50x8192-coef-inner, 8192, 30, 1029, 418, 0, 0, 1477, 682666
n50x8192-coef-inner, 8192, 29, 1027, 416, 0, 0, 1472, 682666
n50x8192-coef-inner, 8192, 29, 1023, 422, 0, 0, 1474, 682666
n50x8192-coef-inner, 8192, 29, 1028, 416, 0, 0, 1473, 682666
n50x8192-coef-inner, 8192, 30, 1023, 420, 0, 0, 1473, 682666
n50x8192-coef-inner, 8192, 30, 1023, 418, 0, 0, 1471, 682666
n50x8192-coef-inner, 8192, 29, 1032, 420, 0, 0, 1481, 682666
n50x8192-coef-inner, 8192, 29, 1025, 418, 0, 0, 1472, 682666
n50x8192-coef-inner, 4096, 16, 1010, 408, 0, 0, 1434, 682666
n50x8192-coef-inner, 4096, 16, 1012, 408, 0, 0, 1436, 682666
n50x8192-coef-inner, 4096, 16, 1013, 411, 0, 0, 1440, 682666
n50x8192-coef-inner, 4096, 16, 1013, 408, 0, 0, 1437, 682666
n50x8192-coef-inner, 4096, 16, 1015, 408, 0, 0, 1439, 682666
n50x8192-coef-inner, 4096, 16, 1011, 407, 0, 0, 1434, 682666
n50x8192-coef-inner, 4096, 16, 1013, 407, 0, 0, 1436, 682666
n50x8192-coef-inner, 4096, 16, 1009, 408, 0, 0, 1433, 682666
n50x8192-coef-inner, 4096, 16, 1012, 406, 0, 0, 1434, 682666
n50x8192-coef-inner, 4096, 16, 1008, 409, 0, 0, 1433, 682666
n50x8192-coef-inner, 4096, 16, 1016, 412, 0, 0, 1444, 682666
n50x8192-coef-inner, 4096, 17, 1012, 411, 0, 0, 1440, 682666
n50x8192-coef-inner, 4096, 17, 1012, 407, 0, 0, 1436, 682666
n50x8192-coef-inner, 4096, 16, 1006, 407, 0, 0, 1429, 682666
n50x8192-coef-inner, 4096, 17, 1005, 408, 0, 0, 1430, 682666
n50x8192-coef-inner, 4096, 16, 1012, 404, 0, 0, 1432, 682666
n50x8192-coef-inner, 4096, 16, 1008, 408, 0, 0, 1432, 682666
n50x8192-coef-inner, 4096, 16, 1010, 409, 0, 0, 1435, 682666
n50x8192-coef-inner, 4096, 16, 1075, 479, 0, 0, 1570, 682666
n50x8192-coef-inner, 4096, 16, 1010, 406, 0, 0, 1432, 682666
n50x8192-coef-inner, 4096, 16, 1016, 410, 0, 0, 1442, 682666
n50x8192-coef-inner, 4096, 16, 1022, 409, 0, 0, 1447, 682666
n50x8192-coef-inner, 4096, 16, 1010, 409, 0, 0, 1435, 682666
n50x8192-coef-inner, 4096, 16, 1011, 408, 0, 0, 1435, 682666
n50x8192-coef-inner, 4096, 16, 1009, 407, 0, 0, 1432, 682666
n50x8192-coef-inner, 4096, 17, 1018, 404, 0, 0, 1439, 682666
n50x8192-coef-inner, 4096, 16, 1005, 405, 0, 0, 1426, 682666
n50x8192-coef-inner, 4096, 16, 1012, 406, 0, 0, 1434, 682666
n50x8192-coef-inner, 4096, 16, 1014, 406, 0, 0, 1436, 682666
n50x8192-coef-inner, 4096, 16, 1008, 406, 0, 0, 1430, 682666
n50x8192-coef-inner, 4096, 16, 1009, 406, 0, 0, 1431, 682666
n50x8192-coef-inner, 4096, 16, 1007, 407, 0, 0, 1430, 682666
n50x8192-coef-inner, 4096, 16, 1004, 404, 0, 0, 1424, 682666
n50x8192-coef-inner, 4096, 16, 1009, 408, 0, 0, 1433, 682666
n50x8192-coef-inner, 4096, 16, 1007, 406, 0, 0, 1429, 682666
n50x8192-coef-inner, 4096, 16, 1012, 403, 0, 0, 1431, 682666
n50x8192-coef-inner, 4096, 16, 1004, 408, 0, 0, 1428, 682666
n50x8192-coef-inner, 4096, 16, 1014, 408, 0, 0, 1438, 682666
n50x8192-coef-inner, 4096, 16, 1009, 406, 0, 0, 1431, 682666
n50x8192-coef-inner, 4096, 16, 1009, 404, 0, 0, 1429, 682666
n50x8192-coef-inner, 4096, 16, 1015, 406, 0, 0, 1437, 682666
n50x8192-coef-inner, 4096, 16, 1005, 407, 0, 0, 1428, 682666
n50x8192-coef-inner, 4096, 16, 1017, 410, 0, 0, 1443, 682666
n50x8192-coef-inner, 4096, 16, 1011, 407, 0, 0, 1434, 682666
n50x8192-coef-inner, 4096, 16, 1005, 406, 0, 0, 1427, 682666
n50x8192-coef-inner, 4096, 16, 1004, 404, 0, 0, 1424, 682666
n50x8192-coef-inner, 4096, 16, 1006, 409, 0, 0, 1431, 682666
n50x8192-coef-inner, 4096, 16, 1008, 410, 0, 0, 1434, 682666
n50x8192-coef-inner, 4096, 16, 1011, 407, 0, 0, 1434, 682666
n50x8192-coef-inner, 4096, 16, 1017, 406, 0, 0, 1439, 682666
n50x8192-coef-inner, 4096, 16, 1014, 409, 0, 0, 1439, 682666
n50x8192-coef-inner, 4096, 16, 1011, 409, 0, 0, 1436, 682666
n50x8192-coef-inner, 4096, 16, 1015, 408, 0, 0, 1439, 682666
n50x8192-coef-inner, 4096, 16, 1009, 409, 0, 0, 1434, 682666
n50x8192-coef-inner, 4096, 16, 1013, 408, 0, 0, 1437, 682666
n50x8192-coef-inner, 4096, 16, 1008, 408, 0, 0, 1432, 682666
n50x8192-coef-inner, 4096, 16, 1008, 404, 0, 0, 1428, 682666
n50x8192-coef-inner, 4096, 16, 1012, 412, 0, 0, 1440, 682666
n50x8192-coef-inner, 4096, 16, 1010, 462, 0, 0, 1488, 682666
n50x8192-coef-inner, 4096, 16, 1013, 408, 0, 0, 1437, 682666
n50x8192-coef-inner, 4096, 16, 1014, 406, 0, 0, 1436, 682666
n50x8192-coef-inner, 4096, 16, 1014, 403, 0, 0, 1433, 682666
n50x8192-coef-inner, 4096, 16, 1011, 407, 0, 0, 1434, 682666
n50x8192-coef-inner, 4096, 16, 1009, 408, 0, 0, 1433, 682666
n50x8192-coef-inner, 4096, 17, 1017, 408, 0, 0, 1442, 682666
n50x8192-coef-inner, 4096, 16, 1015, 406, 0, 0, 1437, 682666
n50x8192-coef-inner, 4096, 16, 1007, 407, 0, 0, 1430, 682666
n50x8192-coef-inner, 4096, 16, 1006, 408, 0, 0, 1430, 682666
n50x8192-coef-inner, 4096, 17, 1009, 411, 0, 0, 1437, 682666
n50x8192-coef-inner, 4096, 16, 1011, 406, 0, 0, 1433, 682666
n50x8192-coef-inner, 4096, 16, 1006, 407, 0, 0, 1429, 682666
n50x8192-coef-inner, 4096, 16, 1003, 403, 0, 0, 1422, 682666
n50x8192-coef-inner, 4096, 16, 1010, 405, 0, 0, 1431, 682666
n50x8192-coef-inner, 4096, 16, 1015, 407, 0, 0, 1438, 682666
n50x8192-coef-inner, 4096, 16, 1013, 405, 0, 0, 1434, 682666
n50x8192-coef-inner, 4096, 16, 1011, 403, 0, 0, 1430, 682666
n50x8192-coef-inner, 4096, 16, 1014, 407, 0, 0, 1437, 682666
n50x8192-coef-inner, 4096, 16, 1012, 409, 0, 0, 1437, 682666
n50x8192-coef-inner, 4096, 16, 1013, 411, 0, 0, 1440, 682666
n50x8192-coef-inner, 4096, 16, 1010, 406, 0, 0, 1432, 682666
n50x8192-coef-inner, 4096, 16, 1009, 406, 0, 0, 1431, 682666
n50x8192-coef-inner, 4096, 16, 1010, 407, 0, 0, 1433, 682666
n50x8192-coef-inner, 4096, 16, 1008, 411, 0, 0, 1435, 682666
n50x8192-coef-inner, 4096, 16, 1012, 408, 0, 0, 1436, 682666
n50x8192-coef-inner, 4096, 16, 1011, 407, 0, 0, 1434, 682666
n50x8192-coef-inner, 4096, 17, 1008, 407, 0, 0, 1432, 682666
n50x8192-coef-inner, 4096, 16, 1013, 406, 0, 0, 1435, 682666
n50x8192-coef-inner, 4096, 16, 1014, 407, 0, 0, 1437, 682666
n50x8192-coef-inner, 4096, 16, 1013, 408, 0, 0, 1437, 682666
n50x8192-coef-inner, 4096, 16, 1011, 409, 0, 0, 1436, 682666
n50x8192-coef-inner, 4096, 17, 1016, 407, 0, 0, 1440, 682666
n50x8192-coef-inner, 4096, 16, 1009, 409, 0, 0, 1434, 682666
n50x8192-coef-inner, 4096, 16, 1016, 408, 0, 0, 1440, 682666
n50x8192-coef-inner, 4096, 16, 1013, 408, 0, 0, 1437, 682666
n50x8192-coef-inner, 4096, 16, 1014, 405, 0, 0, 1435, 682666
n50x8192-coef-inner, 4096, 17, 1007, 405, 0, 0, 1429, 682666
n50x8192-coef-inner, 4096, 16, 1008, 405, 0, 0, 1429, 682666
n50x8192-coef-inner, 4096, 16, 1012, 407, 0, 0, 1435, 682666
n50x8192-coef-inner, 4096, 16, 1008, 408, 0, 0, 1432, 682666
n50x8192-coef-inner, 4096, 16, 1031, 480, 0, 0, 1527, 682666
n50x8192-coef-inner, 2048, 10, 1004, 406, 0, 0, 1420, 682666
n50x8192-coef-inner, 2048, 10, 1015, 413, 0, 0, 1438, 682666
n50x8192-coef-inner, 2048, 10, 1010, 409, 0, 0, 1429, 682666
n50x8192-coef-inner, 2048, 10, 1012, 411, 0, 0, 1433, 682666
n50x8192-coef-inner, 2048, 10, 1005, 407, 0, 0, 1422, 682666
n50x8192-coef-inner, 2048, 10, 1007, 411, 0, 0, 1428, 682666
n50x8192-coef-inner, 2048, 10, 1008, 412, 0, 0, 1430, 682666
n50x8192-coef-inner, 2048, 10, 1005, 411, 0, 0, 1426, 682666
n50x8192-coef-inner, 2048, 10, 1007, 408, 0, 0, 1425, 682666
n50x8192-coef-inner, 2048, 10, 1009, 414, 0, 0, 1433, 682666
n50x8192-coef-inner, 2048, 10, 1010, 411, 0, 0, 1431, 682666
n50x8192-coef-inner, 2048, 10, 1005, 406, 0, 0, 1421, 682666
n50x8192-coef-inner, 2048, 10, 1008, 412, 0, 0, 1430, 682666
n50x8192-coef-inner, 2048, 10, 1008, 408, 0, 0, 1426, 682666
n50x8192-coef-inner, 2048, 10, 1005, 413, 0, 0, 1428, 682666
n50x8192-coef-inner, 2048, 10, 1006, 408, 0, 0, 1424, 682666
n50x8192-coef-inner, 2048, 10, 1003, 414, 0, 0, 1427, 682666
n50x8192-coef-inner, 2048, 10, 1006, 410, 0, 0, 1426, 682666
n50x8192-coef-inner, 2048, 10, 1008, 414, 0, 0, 1432, 682666
n50x8192-coef-inner, 2048, 10, 1010, 412, 0, 0, 1432, 682666
n50x8192-coef-inner, 2048, 10, 1012, 412, 0, 0, 1434, 682666
n50x8192-coef-inner, 2048, 10, 1009, 407, 0, 0, 1426, 682666
n50x8192-coef-inner, 2048, 10, 1005, 409, 0, 0, 1424, 682666
n50x8192-coef-inner, 2048, 10, 1013, 411, 0, 0, 1434, 682666
n50x8192-coef-inner, 2048, 10, 1006, 409, 0, 0, 1425, 682666
n50x8192-coef-inner, 2048, 10, 1010, 413, 0, 0, 1433, 682666
n50x8192-coef-inner, 2048, 10, 1009, 410, 0, 0, 1429, 682666
n50x8192-coef-inner, 2048, 10, 1011, 409, 0, 0, 1430, 682666
n50x8192-coef-inner, 2048, 10, 1011, 409, 0, 0, 1430, 682666
n50x8192-coef-inner, 2048, 10, 1009, 409, 0, 0, 1428, 682666
n50x8192-coef-inner, 2048, 10, 1009, 410, 0, 0, 1429, 682666
n50x8192-coef-inner, 2048, 10, 1008, 414, 0, 0, 1432, 682666
n50x8192-coef-inner, 2048, 10, 1004, 409, 0, 0, 1423, 682666
n50x8192-coef-inner, 2048, 10, 1009, 413, 0, 0, 1432, 682666
n50x8192-coef-inner, 2048, 10, 1011, 414, 0, 0, 1435, 682666
n50x8192-coef-inner, 2048, 10, 1009, 410, 0, 0, 1429, 682666
n50x8192-coef-inner, 2048, 9, 1008, 406, 0, 0, 1423, 682666
n50x8192-coef-inner, 2048, 10, 1010, 410, 0, 0, 1430, 682666
n50x8192-coef-inner, 2048, 10, 1008, 409, 0, 0, 1427, 682666
n50x8192-coef-inner, 2048, 10, 1010, 410, 0, 0, 1430, 682666
n50x8192-coef-inner, 2048, 10, 1019, 413, 0, 0, 1442, 682666
n50x8192-coef-inner, 2048, 10, 1007, 410, 0, 0, 1427, 682666
n50x8192-coef-inner, 2048, 10, 1006, 416, 0, 0, 1432, 682666
n50x8192-coef-inner, 2048, 10, 1007, 408, 0, 0, 1425, 682666
n50x8192-coef-inner, 2048, 10, 1009, 407, 0, 0, 1426, 682666
n50x8192-coef-inner, 2048, 10, 1004, 408, 0, 0, 1422, 682666
n50x8192-coef-inner, 2048, 10, 1011, 409, 0, 0, 1430, 682666
n50x8192-coef-inner, 2048, 10, 1009, 412, 0, 0, 1431, 682666
n50x8192-coef-inner, 2048, 10, 1010, 411, 0, 0, 1431, 682666
n50x8192-coef-inner, 2048, 10, 1008, 412, 0, 0, 1430, 682666
n50x8192-coef-inner, 2048, 10, 1009, 413, 0, 0, 1432, 682666
n50x8192-coef-inner, 2048, 10, 1009, 409, 0, 0, 1428, 682666
n50x8192-coef-inner, 2048, 10, 1004, 411, 0, 0, 1425, 682666
n50x8192-coef-inner, 2048, 10, 1006, 411, 0, 0, 1427, 682666
n50x8192-coef-inner, 2048, 10, 1007, 409, 0, 0, 1426, 682666
n50x8192-coef-inner, 2048, 10, 1017, 412, 0, 0, 1439, 682666
n50x8192-coef-inner, 2048, 10, 1010, 410, 0, 0, 1430, 682666
n50x8192-coef-inner, 2048, 10, 1003, 412, 0, 0, 1425, 682666
n50x8192-coef-inner, 2048, 10, 1005, 409, 0, 0, 1424, 682666
n50x8192-coef-inner, 2048, 10, 1005, 413, 0, 0, 1428, 682666
n50x8192-coef-inner, 2048, 10, 1009, 409, 0, 0, 1428, 682666
n50x8192-coef-inner, 2048, 10, 1011, 408, 0, 0, 1429, 682666
n50x8192-coef-inner, 2048, 10, 1007, 408, 0, 0, 1425, 682666
n50x8192-coef-inner, 2048, 10, 1009, 411, 0, 0, 1430, 682666
n50x8192-coef-inner, 2048, 10, 1007, 409, 0, 0, 1426, 682666
n50x8192-coef-inner, 2048, 10, 1006, 408, 0, 0, 1424, 682666
n50x8192-coef-inner, 2048, 10, 1017, 409, 0, 0, 1436, 682666
n50x8192-coef-inner, 2048, 10, 1009, 411, 0, 0, 1430, 682666
n50x8192-coef-inner, 2048, 10, 1006, 412, 0, 0, 1428, 682666
n50x8192-coef-inner, 2048, 10, 1004, 413, 0, 0, 1427, 682666
n50x8192-coef-inner, 2048, 10, 1009, 412, 0, 0, 1431, 682666
n50x8192-coef-inner, 2048, 10, 1011, 408, 0, 0, 1429, 682666
n50x8192-coef-inner, 2048, 10, 1003, 410, 0, 0, 1423, 682666
n50x8192-coef-inner, 2048, 10, 1006, 409, 0, 0, 1425, 682666
n50x8192-coef-inner, 2048, 10, 1011, 410, 0, 0, 1431, 682666
n50x8192-coef-inner, 2048, 10, 1007, 407, 0, 0, 1424, 682666
n50x8192-coef-inner, 2048, 10, 1006, 410, 0, 0, 1426, 682666
n50x8192-coef-inner, 2048, 10, 1008, 410, 0, 0, 1428, 682666
n50x8192-coef-inner, 2048, 10, 1011, 412, 0, 0, 1433, 682666
n50x8192-coef-inner, 2048, 10, 1008, 408, 0, 0, 1426, 682666
n50x8192-coef-inner, 2048, 10, 1012, 411, 0, 0, 1433, 682666
n50x8192-coef-inner, 2048, 10, 1027, 411, 0, 0, 1448, 682666
n50x8192-coef-inner, 2048, 10, 1006, 412, 0, 0, 1428, 682666
n50x8192-coef-inner, 2048, 10, 1005, 410, 0, 0, 1425, 682666
n50x8192-coef-inner, 2048, 10, 1014, 408, 0, 0, 1432, 682666
n50x8192-coef-inner, 2048, 10, 1008, 411, 0, 0, 1429, 682666
n50x8192-coef-inner, 2048, 10, 1012, 409, 0, 0, 1431, 682666
n50x8192-coef-inner, 2048, 10, 1008, 411, 0, 0, 1429, 682666
n50x8192-coef-inner, 2048, 10, 1014, 407, 0, 0, 1431, 682666
n50x8192-coef-inner, 2048, 10, 1005, 412, 0, 0, 1427, 682666
n50x8192-coef-inner, 2048, 10, 1010, 409, 0, 0, 1429, 682666
n50x8192-coef-inner, 2048, 10, 1013, 411, 0, 0, 1434, 682666
n50x8192-coef-inner, 2048, 10, 1013, 411, 0, 0, 1434, 682666
n50x8192-coef-inner, 2048, 10, 1009, 407, 0, 0, 1426, 682666
n50x8192-coef-inner, 2048, 10, 1005, 408, 0, 0, 1423, 682666
n50x8192-coef-inner, 2048, 10, 1009, 408, 0, 0, 1427, 682666
n50x8192-coef-inner, 2048, 10, 1011, 412, 0, 0, 1433, 682666
n50x8192-coef-inner, 2048, 10, 1009, 410, 0, 0, 1429, 682666
n50x8192-coef-inner, 2048, 10, 1003, 409, 0, 0, 1422, 682666
n50x8192-coef-inner, 2048, 10, 1010, 412, 0, 0, 1432, 682666
n50x8192-coef-inner, 1024, 13, 1289, 664, 0, 0, 1966, 682666
n50x8192-coef-inner, 1024, 11, 1285, 655, 0, 0, 1951, 682666
n50x8192-coef-inner, 1024, 12, 1277, 659, 0, 0, 1948, 682666
n50x8192-coef-inner, 1024, 13, 1282, 660, 0, 0, 1955, 682666
n50x8192-coef-inner, 1024, 12, 1284, 661, 0, 0, 1957, 682666
n50x8192-coef-inner, 1024, 12, 1285, 667, 0, 0, 1964, 682666
n50x8192-coef-inner, 1024, 12, 1280, 659, 0, 0, 1951, 682666
n50x8192-coef-inner, 1024, 12, 1283, 663, 0, 0, 1958, 682666
n50x8192-coef-inner, 1024, 13, 1285, 665, 0, 0, 1963, 682666
n50x8192-coef-inner, 1024, 12, 1287, 656, 0, 0, 1955, 682666
n50x8192-coef-inner, 1024, 12, 1279, 659, 0, 0, 1950, 682666
n50x8192-coef-inner, 1024, 11, 1285, 668, 0, 0, 1964, 682666
n50x8192-coef-inner, 1024, 13, 1287, 661, 0, 0, 1961, 682666
n50x8192-coef-inner, 1024, 11, 1290, 665, 0, 0, 1966, 682666
n50x8192-coef-inner, 1024, 12, 1282, 660, 0, 0, 1954, 682666
n50x8192-coef-inner, 1024, 12, 1282, 661, 0, 0, 1955, 682666
n50x8192-coef-inner, 1024, 12, 1302, 668, 0, 0, 1982, 682666
n50x8192-coef-inner, 1024, 13, 1283, 657, 0, 0, 1953, 682666
n50x8192-coef-inner, 1024, 12, 1293, 661, 0, 0, 1966, 682666
n50x8192-coef-inner, 1024, 12, 1283, 661, 0, 0, 1956, 682666
n50x8192-coef-inner, 1024, 13, 1279, 664, 0, 0, 1956, 682666
n50x8192-coef-inner, 1024, 12, 1282, 657, 0, 0, 1951, 682666
n50x8192-coef-inner, 1024, 12, 1287, 656, 0, 0, 1955, 682666
n50x8192-coef-inner, 1024, 12, 1278, 666, 0, 0, 1956, 682666
n50x8192-coef-inner, 1024, 12, 1277, 655, 0, 0, 1944, 682666
n50x8192-coef-inner, 1024, 12, 1278, 657, 0, 0, 1947, 682666
n50x8192-coef-inner, 1024, 11, 1276, 655, 0, 0, 1942, 682666
n50x8192-coef-inner, 1024, 12, 1277, 664, 0, 0, 1953, 682666
n50x8192-coef-inner, 1024, 12, 1276, 659, 0, 0, 1947, 682666
n50x8192-coef-inner, 1024, 12, 1275, 658, 0, 0, 1945, 682666
n50x8192-coef-inner, 1024, 12, 1279, 663, 0, 0, 1954, 682666
n50x8192-coef-inner, 1024, 12, 1277, 657, 0, 0, 1946, 682666
n50x8192-coef-inner, 1024, 13, 1278, 680, 0, 0, 1971, 682666
n50x8192-coef-inner, 1024, 12, 1277, 661, 0, 0, 1950, 682666
n50x8192-coef-inner, 1024, 12, 1282, 658, 0, 0, 1952, 682666
n50x8192-coef-inner, 1024, 11, 1284, 657, 0, 0, 1952, 682666
n50x8192-coef-inner, 1024, 12, 1284, 659, 0, 0, 1955, 682666
n50x8192-coef-inner, 1024, 12, 1279, 659, 0, 0, 1950, 682666
n50x8192-coef-inner, 1024, 11, 1282, 659, 0, 0, 1952, 682666
n50x8192-coef-inner, 1024, 12, 1286, 659, 0, 0, 1957, 682666
n50x8192-coef-inner, 1024, 12, 1274, 658, 0, 0, 1944, 682666
n50x8192-coef-inner, 1024, 12, 1284, 671, 0, 0, 1967, 682666
n50x8192-coef-inner, 1024, 12, 1287, 657, 0, 0, 1956, 682666
n50x8192-coef-inner, 1024, 11, 1279, 659, 0, 0, 1949, 682666
n50x8192-coef-inner, 1024, 11, 1280, 662, 0, 0, 1953, 682666
n50x8192-coef-inner, 1024, 11, 1277, 664, 0, 0, 1952, 682666
n50x8192-coef-inner, 1024, 13, 1296, 690, 0, 0, 1999, 682666
n50x8192-coef-inner, 1024, 11, 1277, 662, 0, 0, 1950, 682666
n50x8192-coef-inner, 1024, 11, 1294, 659, 0, 0, 1964, 682666
n50x8192-coef-inner, 1024, 12, 1280, 661, 0, 0, 1953, 682666
n50x8192-coef-inner, 1024, 12, 1288, 659, 0, 0, 1959, 682666
n50x8192-coef-inner, 1024, 12, 1284, 656, 0, 0, 1952, 682666
n50x8192-coef-inner, 1024, 11, 1279, 657, 0, 0, 1947, 682666
n50x8192-coef-inner, 1024, 12, 1277, 663, 0, 0, 1952, 682666
n50x8192-coef-inner, 1024, 12, 1280, 661, 0, 0, 1953, 682666
n50x8192-coef-inner, 1024, 12, 1282, 659, 0, 0, 1953, 682666
n50x8192-coef-inner, 1024, 11, 1273, 659, 0, 0, 1943, 682666
n50x8192-coef-inner, 1024, 12, 1280, 661, 0, 0, 1953, 682666
n50x8192-coef-inner, 1024, 12, 1286, 659, 0, 0, 1957, 682666
n50x8192-coef-inner, 1024, 12, 1280, 660, 0, 0, 1952, 682666
n50x8192-coef-inner, 1024, 13, 1280, 661, 0, 0, 1954, 682666
n50x8192-coef-inner, 1024, 11, 1286, 659, 0, 0, 1956, 682666
n50x8192-coef-inner, 1024, 12, 1284, 667, 0, 0, 1963, 682666
n50x8192-coef-inner, 1024, 12, 1275, 660, 0, 0, 1947, 682666
n50x8192-coef-inner, 1024, 12, 1278, 658, 0, 0, 1948, 682666
n50x8192-coef-inner, 1024, 12, 1278, 658, 0, 0, 1948, 682666
n50x8192-coef-inner, 1024, 12, 1284, 662, 0, 0, 1958, 682666
n50x8192-coef-inner, 1024, 12, 1278, 659, 0, 0, 1949, 682666
n50x8192-coef-inner, 1024, 12, 1280, 658, 0, 0, 1950, 682666
n50x8192-coef-inner, 1024, 12, 1278, 658, 0, 0, 1948, 682666
n50x8192-coef-inner, 1024, 12, 1277, 657, 0, 0, 1946, 682666
n50x8192-coef-inner, 1024, 12, 1281, 659, 0, 0, 1952, 682666
n50x8192-coef-inner, 1024, 12, 1281, 655, 0, 0, 1948, 682666
n50x8192-coef-inner, 1024, 11, 1283, 661, 0, 0, 1955, 682666
n50x8192-coef-inner, 1024, 12, 1285, 660, 0, 0, 1957, 682666
n50x8192-coef-inner, 1024, 12, 1280, 663, 0, 0, 1955, 682666
n50x8192-coef-inner, 1024, 11, 1289, 660, 0, 0, 1960, 682666
n50x8192-coef-inner, 1024, 11, 1279, 656, 0, 0, 1946, 682666
n50x8192-coef-inner, 1024, 12, 1296, 660, 0, 0, 1968, 682666
n50x8192-coef-inner, 1024, 19, 1273, 685, 0, 0, 1977, 682666
n50x8192-coef-inner, 1024, 12, 1274, 662, 0, 0, 1948, 682666
n50x8192-coef-inner, 1024, 12, 1287, 656, 0, 0, 1955, 682666
n50x8192-coef-inner, 1024, 12, 1276, 658, 0, 0, 1946, 682666
n50x8192-coef-inner, 1024, 11, 1278, 658, 0, 0, 1947, 682666
n50x8192-coef-inner, 1024, 12, 1293, 686, 0, 0, 1991, 682666
n50x8192-coef-inner, 1024, 12, 1282, 661, 0, 0, 1955, 682666
n50x8192-coef-inner, 1024, 11, 1285, 664, 0, 0, 1960, 682666
n50x8192-coef-inner, 1024, 11, 1275, 657, 0, 0, 1943, 682666
n50x8192-coef-inner, 1024, 12, 1276, 660, 0, 0, 1948, 682666
n50x8192-coef-inner, 1024, 11, 1280, 652, 0, 0, 1943, 682666
n50x8192-coef-inner, 1024, 11, 1277, 659, 0, 0, 1947, 682666
n50x8192-coef-inner, 1024, 12, 1279, 660, 0, 0, 1951, 682666
n50x8192-coef-inner, 1024, 12, 1279, 659, 0, 0, 1950, 682666
n50x8192-coef-inner, 1024, 11, 1282, 659, 0, 0, 1952, 682666
n50x8192-coef-inner, 1024, 11, 1278, 658, 0, 0, 1947, 682666
n50x8192-coef-inner, 1024, 12, 1278, 660, 0, 0, 1950, 682666
n50x8192-coef-inner, 1024, 12, 1283, 659, 0, 0, 1954, 682666
n50x8192-coef-inner, 1024, 12, 1277, 656, 0, 0, 1945, 682666
n50x8192-coef-inner, 1024, 11, 1279, 660, 0, 0, 1950, 682666
n50x8192-coef-inner, 1024, 12, 1278, 655, 0, 0, 1945, 682666
n100x8192-coef-sum, 8192, 34, 1019, 25, 0, 0, 1078, 1
n100x8192-coef-sum, 8192, 35, 1021, 25, 0, 0, 1081, 1
n100x8192-coef-sum, 8192, 35, 1027, 25, 0, 0, 1087, 1
n100x8192-coef-sum, 8192, 34, 1022, 24, 0, 0, 1080, 1
n100x8192-coef-sum, 8192, 35, 1022, 24, 0, 0, 1081, 1
n100x8192-coef-sum, 8192, 34, 1037, 26, 1, 0, 1098, 1
n100x8192-coef-sum, 8192, 35, 1028, 24, 0, 0, 1087, 1
n100x8192-coef-sum, 8192, 34, 1021, 25, 0, 0, 1080, 1
n100x8192-coef-sum, 8192, 34, 1026, 24, 0, 0, 1084, 1
n100x8192-coef-sum, 8192, 35, 1022, 25, 0, 0, 1082, 1
n100x8192-coef-sum, 8192, 35, 1024, 28, 0, 0, 1087, 1
n100x8192-coef-sum, 8192, 34, 1029, 25, 0, 0, 1088, 1
n100x8192-coef-sum, 8192, 34, 1025, 24, 0, 0, 1083, 1
n100x8192-coef-sum, 8192, 35, 1026, 24, 0, 0, 1085, 1
n100x8192-coef-sum, 8192, 35, 1019, 25, 0, 0, 1079, 1
n100x8192-coef-sum, 8192, 35, 1080, 25, 1, 0, 1141, 1
n100x8192-coef-sum, 8192, 35, 1048, 26, 1, 0, 1110, 1
n100x8192-coef-sum, 8192, 35, 1024, 25, 0, 0, 1084, 1
n100x8192-coef-sum, 8192, 34, 1023, 25, 0, 0, 1082, 1
n100x8192-coef-sum, 8192, 35, 1024, 25, 0, 0, 1084, 1
n100x8192-coef-sum, 8192, 34, 1066, 25, 1, 0, 1126, 1
n100x8192-coef-sum, 8192, 34, 1026, 25, 0, 0, 1085, 1
n100x8192-coef-sum, 8192, 34, 1022, 24, 0, 0, 1080, 1
n100x8192-coef-sum, 8192, 35, 1019, 28, 0, 0, 1082, 1
n100x8192-coef-sum, 8192, 35, 1025, 25, 0, 0, 1085, 1
n100x8192-coef-sum, 8192, 35, 1022, 25, 0, 0, 1082, 1
n100x8192-coef-sum, 8192, 36, 1022, 25, 0, 0, 1083, 1
n100x8192-coef-sum, 8192, 34, 1059, 25, 1, 0, 1119, 1
n100x8192-coef-sum, 8192, 34, 1020, 24, 0, 0, 1078, 1
n100x8192-coef-sum, 8192, 35, 1025, 24, 0, 0, 1084, 1
n100x8192-coef-sum, 8192, 34, 1028, 24, 0, 0, 1086, 1
n100x8192-coef-sum, 8192, 34, 1028, 25, 0, 0, 1087, 1
n100x8192-coef-sum, 8192, 34, 1021, 24, 0, 0, 1079, 1
n100x8192-coef-sum, 8192, 34, 1019, 24, 0, 0, 1077, 1
n100x8192-coef-sum, 8192, 34, 1026, 25, 0, 0, 1085, 1
n100x8192-coef-sum, 8192, 34, 1027, 24, 0, 0, 1085, 1
n100x8192-coef-sum, 8192, 34, 1025, 25, 0, 0, 1084, 1
n100x8192-coef-sum, 8192, 34, 1021, 24, 0, 0, 1079, 1
n100x8192-coef-sum, 8192, 35, 1028, 25, 0, 0, 1088, 1
n100x8192-coef-sum, 8192, 34, 1023, 24, 0, 0, 1081, 1
n100x8192-coef-sum, 8192, 34, 1022, 24, 0, 0, 1080, 1
n100x8192-coef-sum, 8192, 34, 1041, 26, 1, 0, 1102, 1
n100x8192-coef-sum, 8192, 35, 1025, 25, 0, 0, 1085, 1
n100x8192-coef-sum, 8192, 35, 1022, 25, 0, 0, 1082, 1
n100x8192-coef-sum, 8192, 34, 1016, 24, 0, 0, 1074, 1
n100x8192-coef-sum, 8192, 35, 1019, 24, 0, 0, 1078, 1
n100x8192-coef-sum, 8192, 34, 1021, 24, 0, 0, 1079, 1
n100x8192-coef-sum, 8192, 34, 1017, 24, 0, 0, 1075, 1
n100x8192-coef-sum, 8192, 35, 1021, 25, 0, 0, 1081, 1
n100x8192-coef-sum, 8192, 34, 1019, 25, 0, 0, 1078, 1
n100x8192-coef-sum, 8192, 34, 1018, 25, 0, 0, 1077, 1
n100x8192-coef-sum, 8192, 35, 1026, 25, 0, 0, 1086, 1
n100x8192-coef-sum, 8192, 34, 1020, 25, 0, 0, 1079, 1
n100x8192-coef-sum, 8192, 34, 1017, 24, 0, 0, 1075, 1
n100x8192-coef-sum, 8192, 34, 1025, 24, 0, 0, 1083, 1
n100x8192-coef-sum, 8192, 34, 1018, 25, 0, 0, 1077, 1
n100x8192-coef-sum, 8192, 34, 1019, 25, 0, 0, 1078, 1
n100x8192-coef-sum, 8192, 35, 1022, 25, 0, 0, 1082, 1
n100x8192-coef-sum, 8192, 34, 1017, 25, 0, 0, 1076, 1
n100x8192-coef-sum, 8192, 34, 1024, 25, 0, 0, 1083, 1
n100x8192-coef-sum, 8192, 34, 1017, 24, 0, 0, 1075, 1
n100x8192-coef-sum, 8192, 34, 1014, 24, 0, 0, 1072, 1
n100x8192-coef-sum, 8192, 34, 1016, 24, 0, 0, 1074, 1
n100x8192-coef-sum, 8192, 34, 1027, 24, 0, 0, 1085, 1
n100x8192-coef-sum, 8192, 34, 1017, 24, 0, 0, 1075, 1
n100x8192-coef-sum, 8192, 34, 1020, 24, 0, 0, 1078, 1
n100x8192-coef-sum, 8192, 34, 1050, 26, 1, 0, 1111, 1
n100x8192-coef-sum, 8192, 34, 1020, 25, 0, 0, 1079, 1
n100x8192-coef-sum, 8192, 35, 1017, 25, 0, 0, 1077, 1
n100x8192-coef-sum, 8192, 34, 1018, 25, 0, 0, 1077, 1
n100x8192-coef-sum, 8192, 35, 1017, 24, 0, 0, 1076, 1
n100x8192-coef-sum, 8192, 34, 1019, 24, 0, 0, 1077, 1
n100x8192-coef-sum, 8192, 34, 1019, 24, 0, 0, 1077, 1
n100x8192-coef-sum, 8192, 34, 1018, 24, 0, 0, 1076, 1
n100x8192-coef-sum, 8192, 35, 1020, 24, 0, 0, 1079, 1
n100x8192-coef-sum, 8192, 34, 1019, 24, 0, 0, 1077, 1
n100x8192-coef-sum, 8192, 34, 1020, 24, 0, 0, 1078, 1
n100x8192-coef-sum, 8192, 34, 1018, 24, 0, 0, 1076, 1
n100x8192-coef-sum, 8192, 34, 1019, 24, 0, 0, 1077, 1
n100x8192-coef-sum, 8192, 35, 1017, 24, 0, 0, 1076, 1
n100x8192-coef-sum, 8192, 35, 1019, 24, 0, 0, 1078, 1
n100x8192-coef-sum, 8192, 34, 1021, 24, 0, 0, 1079, 1
n100x8192-coef-sum, 8192, 34, 1021, 24, 0, 0, 1079, 1
n100x8192-coef-sum, 8192, 34, 1021, 25, 0, 0, 1080, 1
n100x8192-coef-sum, 8192, 34, 1013, 24, 0, 0, 1071, 1
n100x8192-coef-sum, 8192, 34, 1020, 24, 0, 0, 1078, 1
n100x8192-coef-sum, 8192, 34, 1018, 25, 0, 0, 1077, 1
n100x8192-coef-sum, 8192, 34, 1020, 25, 0, 0, 1079, 1
n100x8192-coef-sum, 8192, 34, 1019, 25, 0, 0, 1078, 1
n100x8192-coef-sum, 8192, 34, 1019, 24, 0, 0, 1077, 1
n100x8192-coef-sum, 8192, 35, 1024, 25, 0, 0, 1084, 1
n100x8192-coef-sum, 8192, 35, 1028, 25, 0, 0, 1088, 1
n100x8192-coef-sum, 8192, 34, 1016, 24, 0, 0, 1074, 1
n100x8192-coef-sum, 8192, 34, 1024, 25, 0, 0, 1083, 1
n100x8192-coef-sum, 8192, 34, 1024, 26, 0, 0, 1084, 1
n100x8192-coef-sum, 8192, 35, 1021, 25, 0, 0, 1081, 1
n100x8192-coef-sum, 8192, 34, 1014, 24, 0, 0, 1072, 1
n100x8192-coef-sum, 8192, 34, 1019, 24, 0, 0, 1077, 1
n100x8192-coef-sum, 8192, 34, 1021, 25, 0, 0, 1080, 1
n100x8192-coef-sum, 8192, 34, 1020, 24, 0, 0, 1078, 1
n100x8192-coef-sum, 4096, 19, 1002, 26, 0, 0, 1047, 1
n100x8192-coef-sum, 4096, 19, 1006, 27, 0, 0, 1052, 1
n100x8192-coef-sum, 4096, 19, 1006, 27, 0, 0, 1052, 1
n100x8192-coef-sum, 4096, 19, 1004, 27, 0, 0, 1050, 1
n100x8192-coef-sum, 4096, 19, 1007, 27, 0, 0, 1053, 1
n100x8192-coef-sum, 4096, 19, 1005, 27, 0, 0, 1051, 1
n100x8192-coef-sum, 4096, 19, 1008, 28, 0, 0, 1055, 1
n100x8192-coef-sum, 4096, 19, 1005, 27, 0, 0, 1051, 1
n100x8192-coef-sum, 4096, 19, 1005, 27, 0, 0, 1051, 1
n100x8192-coef-sum, 4096, 19, 1006, 27, 0, 0, 1052, 1
n100x8192-coef-sum, 4096, 19, 1009, 27, 0, 0, 1055, 1
n100x8192-coef-sum, 4096, 19, 1009, 27, 0, 0, 1055, 1
n100x8192-coef-sum, 4096, 19, 1007, 26, 0, 0, 1052, 1
n100x8192-coef-sum, 4096, 19, 1003, 27, 0, 0, 1049, 1
n100x8192-coef-sum, 4096, 19, 1002, 27, 0, 0, 1048, 1
n100x8192-coef-sum, 4096, 19, 1004, 27, 0, 0, 1050, 1
n100x8192-coef-sum, 4096, 19, 1024, 27, 0, 0, 1070, 1
n100x8192-coef-sum, 4096, 19, 1010, 27, 0, 0, 1056, 1
n100x8192-coef-sum, 4096, 18, 1005, 27, 0, 0, 1050, 1
n100x8192-coef-sum, 4096, 19, 1009, 27, 0, 0, 1055, 1
n100x8192-coef-sum, 4096, 19, 1013, 27, 0, 0, 1059, 1
n100x8192-coef-sum, 4096, 19, 1008, 27, 0, 0, 1054, 1
n100x8192-coef-sum, 4096, 19, 1006, 27, 0, 0, 1052, 1
n100x8192-coef-sum, 4096, 19, 1005, 27, 0, 0, 1051, 1
n100x8192-coef-sum, 4096, 19, 1008, 27, 0, 0, 1054, 1
n100x8192-coef-sum, 4096, 19, 1008, 27, 0, 0, 1054, 1
n100x8192-coef-sum, 4096, 19, 1008, 27, 0, 0, 1054, 1
n100x8192-coef-sum, 4096, 19, 1004, 27, 0, 0, 1050, 1
n100x8192-coef-sum, 4096, 19, 1007, 27, 0, 0, 1053, 1
n100x8192-coef-sum, 4096, 19, 1006, 27, 0, 0, 1052, 1
n100x8192-coef-sum, 4096, 19, 1010, 26, 0, 0, 1055, 1
n100x8192-coef-sum, 4096, 19, 1007, 27, 0, 0, 1053, 1
n100x8192-coef-sum, 4096, 19, 1002, 26, 0, 0, 1047, 1
n100x8192-coef-sum, 4096, 18, 1001, 27, 0, 0, 1046, 1
n100x8192-coef-sum, 4096, 19, 1006, 27, 0, 0, 1052, 1
n100x8192-coef-sum, 4096, 19, 1010, 27, 0, 0, 1056, 1
n100x8192-coef-sum, 4096, 19, 1004, 27, 0, 0, 1050, 1
n100x8192-coef-sum, 4096, 19, 1004, 27, 0, 0, 1050, 1
n100x8192-coef-sum, 4096, 19, 1008, 27, 0, 0, 1054, 1
n100x8192-coef-sum, 4096, 19, 1005, 27, 0, 0, 1051, 1
n100x8192-coef-sum, 4096, 19, 1012, 27, 0, 0, 1058, 1
n100x8192-coef-sum, 4096, 19, 1008, 26, 0, 0, 1053, 1
n100x8192-coef-sum, 4096, 19, 1006, 27, 0, 0, 1052, 1
n100x8192-coef-sum, 4096, 19, 1012, 27, 0, 0, 1058, 1
n100x8192-coef-sum, 4096, 19, 1012, 28, 0, 0, 1059, 1
n100x8192-coef-sum, 4096, 19, 1007, 27, 0, 0, 1053, 1
n100x8192-coef-sum, 4096, 19, 1005, 27, 0, 0, 1051, 1
n100x8192-coef-sum, 4096, 19, 1007, 27, 0, 0, 1053, 1
n100x8192-coef-sum, 4096, 19, 1003, 27, 0, 0, 1049, 1
n100x8192-coef-sum, 4096, 19, 1006, 29, 0, 0, 1054, 1
n100x8192-coef-sum, 4096, 19, 1007, 27, 0, 0, 1053, 1
n100x8192-coef-sum, 4096, 19, 1004, 27, 0, 0, 1050, 1
n100x8192-coef-sum, 4096, 19, 1008, 27, 0, 0, 1054, 1
n100x8192-coef-sum, 4096, 19, 1006, 26, 0, 0, 1051, 1
n100x8192-coef-sum, 4096, 19, 1008, 28, 0, 0, 1055, 1
n100x8192-coef-sum, 4096, 19, 1007, 27, 0, 0, 1053, 1
n100x8192-coef-sum, 4096, 19, 1006, 27, 0, 0, 1052, 1
n100x8192-coef-sum, 4096, 19, 1007, 26, 0, 0, 1052, 1
n100x8192-coef-sum, 4096, 19, 1008, 26, 0, 0, 1053, 1
n100x8192-coef-sum, 4096, 18, 1005, 26, 0, 0, 1049, 1
n100x8192-coef-sum, 4096, 19, 1003, 26, 0, 0, 1048, 1
n100x8192-coef-sum, 4096, 19, 1005, 26, 0, 0, 1050, 1
n100x8192-coef-sum, 4096, 19, 1008, 26, 0, 0, 1053, 1
n100x8192-coef-sum, 4096, 19, 1009, 26, 0, 0, 1054, 1
n100x8192-coef-sum, 4096, 19, 1007, 26, 0, 0, 1052, 1
n100x8192-coef-sum, 4096, 19, 1006, 27, 0, 0, 1052, 1
n100x8192-coef-sum, 4096, 19, 1007, 27, 0, 0, 1053, 1
n100x8192-coef-sum, 4096, 19, 1010, 27, 0, 0, 1056, 1
n100x8192-coef-sum, 4096, 19, 1008, 27, 0, 0, 1054, 1
n100x8192-coef-sum, 4096, 19, 1003, 27, 0, 0, 1049, 1
n100x8192-coef-sum, 4096, 19, 1017, 27, 0, 0, 1063, 1
n100x8192-coef-sum, 4096, 19, 1007, 27, 0, 0, 1053, 1
n100x8192-coef-sum, 4096, 19, 1004, 27, 0, 0, 1050, 1
n100x8192-coef-sum, 4096, 19, 1018, 27, 0, 0, 1064, 1
n100x8192-coef-sum, 4096, 19, 1008, 27, 0, 0, 1054, 1
n100x8192-coef-sum, 4096, 19, 1005, 28, 0, 0, 1052, 1
n100x8192-coef-sum, 4096, 19, 1006, 27, 0, 0, 1052, 1
n100x8192-coef-sum, 4096, 19, 1006, 27, 0, 0, 1052, 1
n100x8192-coef-sum, 4096, 18, 1006, 27, 0, 0, 1051, 1
n100x8192-coef-sum, 4096, 19, 1002, 27, 0, 0, 1048, 1
n100x8192-coef-sum, 4096, 19, 1018, 27, 0, 0, 1064, 1
n100x8192-coef-sum, 4096, 19, 1005, 27, 0, 0, 1051, 1
n100x8192-coef-sum, 4096, 19, 1014, 27, 0, 0, 1060, 1
n100x8192-coef-sum, 4096, 19, 1016, 27, 0, 0, 1062, 1
n100x8192-coef-sum, 4096, 19, 1013, 27, 0, 0, 1059, 1
n100x8192-coef-sum, 4096, 19, 1003, 27, 0, 0, 1049, 1
n100x8192-coef-sum, 4096, 19, 1008, 27, 0, 0, 1054, 1
n100x8192-coef-sum, 4096, 18, 1005, 27, 0, 0, 1050, 1
n100x8192-coef-sum, 4096, 19, 1004, 27, 0, 0, 1050, 1
n100x8192-coef-sum, 4096, 19, 1008, 27, 0, 0, 1054, 1
n100x8192-coef-sum, 4096, 19, 1005, 27, 0, 0, 1051, 1
n100x8192-coef-sum, 4096, 19, 1004, 27, 0, 0, 1050, 1
n100x8192-coef-sum, 4096, 19, 1011, 27, 0, 0, 1057, 1
n100x8192-coef-sum, 4096, 19, 1006, 27, 0, 0, 1052, 1
n100x8192-coef-sum, 4096, 19, 1004, 27, 0, 0, 1050, 1
n100x8192-coef-sum, 4096, 19, 1009, 27, 0, 0, 1055, 1
n100x8192-coef-sum, 4096, 19, 1004, 27, 0, 0, 1050, 1
n100x8192-coef-sum, 4096, 19, 1004, 27, 0, 0, 1050, 1
n100x8192-coef-sum, 4096, 18, 1007, 27, 0, 0, 1052, 1
n100x8192-coef-sum, 4096, 19, 1005, 27, 0, 0, 1051, 1
n100x8192-coef-sum, 2048, 11, 1000, 29, 0, 0, 1040, 1
n100x8192-coef-sum, 2048, 11, 1006, 30, 0, 0, 1047, 1
n100x8192-coef-sum, 2048, 11, 1001, 29, 0, 0, 1041, 1
n100x8192-coef-sum, 2048, 11, 1001, 28, 0, 0, 1040, 1
n100x8192-coef-sum, 2048, 11, 1005, 29, 0, 0, 1045, 1
n100x8192-coef-sum, 2048, 11, 1009, 29, 0, 0, 1049, 1
n100x8192-coef-sum, 2048, 11, 1015, 29, 0, 0, 1055, 1
n100x8192-coef-sum, 2048, 11, 1009, 28, 0, 0, 1048, 1
n100x8192-coef-sum, 2048, 11, 1002, 28, 0, 0, 1041, 1
n100x8192-coef-sum, 2048, 11, 1002, 28, 0, 0, 1041, 1
n100x8192-coef-sum, 2048, 11, 1007, 28, 0, 0, 1046, 1
n100x8192-coef-sum, 2048, 11, 1004, 29, 0, 0, 1044, 1
n100x8192-coef-sum, 2048, 11, 1005, 28, 0, 0, 1044, 1
n100x8192-coef-sum, 2048, 11, 1012, 29, 0, 0, 1052, 1
n100x8192-coef-sum, 2048, 11, 1011, 29, 0, 0, 1051, 1
n100x8192-coef-sum, 2048, 11, 1002, 29, 0, 0, 1042, 1
n100x8192-coef-sum, 2048, 11, 1010, 29, 0, 0, 1050, 1
n100x8192-coef-sum, 2048, 11, 1007, 29, 0, 0, 1047, 1
n100x8192-coef-sum, 2048, 11, 1014, 29, 0, 0, 1054, 1
n100x8192-coef-sum, 2048, 11, 1005, 28, 0, 0, 1044, 1
n100x8192-coef-sum, 2048, 11, 1006, 29, 0, 0, 1046, 1
n100x8192-coef-sum, 2048, 12, 1007, 29, 0, 0, 1048, 1
n100x8192-coef-sum, 2048, 12, 1012, 29, 0, 0, 1053, 1
n100x8192-coef-sum, 2048, 12, 1009, 29, 0, 0, 1050, 1
n100x8192-coef-sum, 2048, 11, 1026, 30, 0, 0, 1067, 1
n100x8192-coef-sum, 2048, 12, 1011, 30, 0, 0, 1053, 1
n100x8192-coef-sum, 2048, 11, 1016, 29, 0, 0, 1056, 1
n100x8192-coef-sum, 2048, 11, 1007, 29, 0, 0, 1047, 1
n100x8192-coef-sum, 2048, 12, 1005, 29, 0, 0, 1046, 1
n100x8192-coef-sum, 2048, 12, 1008, 29, 0, 0, 1049, 1
n100x8192-coef-sum, 2048, 11, 1008, 28, 0, 0, 1047, 1
n100x8192-coef-sum, 2048, 11, 1003, 29, 0, 0, 1043, 1
n100x8192-coef-sum, 2048, 11, 1008, 30, 0, 0, 1049, 1
n100x8192-coef-sum, 2048, 11, 1015, 29, 0, 0, 1055, 1
n100x8192-coef-sum, 2048, 12, 1006, 29, 0, 0, 1047, 1
n100x8192-coef-sum, 2048, 11, 1007, 29, 0, 0, 1047, 1
n100x8192-coef-sum, 2048, 11, 1004, 29, 0, 0, 1044, 1
n100x8192-coef-sum, 2048, 11, 1010, 29, 0, 0, 1050, 1
n100x8192-coef-sum, 2048, 11, 1011, 29, 0, 0, 1051, 1
n100x8192-coef-sum, 2048, 11, 1009, 30, 0, 0, 1050, 1
n100x8192-coef-sum, 2048, 11, 1006, 28, 0, 0, 1045, 1
n100x8192-coef-sum, 2048, 12, 1009, 29, 0, 0, 1050, 1
n100x8192-coef-sum, 2048, 11, 1011, 29, 0, 0, 1051, 1
n100x8192-coef-sum, 2048, 11, 1007, 29, 0, 0, 1047, 1
n100x8192-coef-sum, 2048, 11, 1005, 29, 0, 0, 1045, 1
n100x8192-coef-sum, 2048, 12, 1008, 29, 0, 0, 1049, 1
n100x8192-coef-sum, 2048, 11, 1013, 29, 0, 0, 1053, 1
n100x8192-coef-sum, 2048, 11, 1009, 29, 0, 0, 1049, 1
n100x8192-coef-sum, 2048, 12, 1009, 29, 0, 0, 1050, 1
n100x8192-coef-sum, 2048, 11, 1010, 29, 0, 0, 1050, 1
n100x8192-coef-sum, 2048, 12, 1011, 29, 0, 0, 1052, 1
n100x8192-coef-sum, 2048, 11, 1014, 28, 0, 0, 1053, 1
n100x8192-coef-sum, 2048, 11, 1009, 29, 0, 0, 1049, 1
n100x8192-coef-sum, 2048, 11, 1005, 28, 0, 0, 1044, 1
n100x8192-coef-sum, 2048, 11, 1009, 29, 0, 0, 1049, 1
n100x8192-coef-sum, 2048, 11, 1009, 29, 0, 0, 1049, 1
n100x8192-coef-sum, 2048, 11, 1010, 29, 0, 0, 1050, 1
n100x8192-coef-sum, 2048, 11, 1008, 28, 0, 0, 1047, 1
n100x8192-coef-sum, 2048, 11, 1008, 29, 0, 0, 1048, 1
n100x8192-coef-sum, 2048, 11, 1005, 28, 0, 0, 1044, 1
n100x8192-coef-sum, 2048, 11, 1010, 28, 0, 0, 1049, 1
n100x8192-coef-sum, 2048, 11, 1010, 29, 0, 0, 1050, 1
n100x8192-coef-sum, 2048, 11, 1016, 29, 0, 0, 1056, 1
n100x8192-coef-sum, 2048, 11, 1003, 29, 0, 0, 1043, 1
n100x8192-coef-sum, 2048, 11, 1012, 29, 0, 0, 1052, 1
n100x8192-coef-sum, 2048, 11, 1009, 29, 0, 0, 1049, 1
n100x8192-coef-sum, 2048, 11, 1009, 29, 0, 0, 1049, 1
n100x8192-coef-sum, 2048, 11, 1008, 29, 0, 0, 1048, 1
n100x8192-coef-sum, 2048, 11, 1013, 29, 0, 0, 1053, 1
n100x8192-coef-sum, 2048, 11, 1009, 28, 0, 0, 1048, 1
n100x8192-coef-sum, 2048, 11, 1008, 29, 0, 0, 1048, 1
n100x8192-coef-sum, 2048, 11, 1011, 29, 0, 0, 1051, 1
n100x8192-coef-sum, 2048, 11, 1008, 29, 0, 0, 1048, 1
n100x8192-coef-sum, 2048, 11, 1010, 29, 0, 0, 1050, 1
n100x8192-coef-sum, 2048, 11, 1008, 28, 0, 0, 1047, 1
n100x8192-coef-sum, 2048, 11, 1003, 28, 0, 0, 1042, 1
n100x8192-coef-sum, 2048, 12, 1013, 29, 0, 0, 1054, 1
n100x8192-coef-sum, 2048, 11, 1007, 29, 0, 0, 1047, 1
n100x8192-coef-sum, 2048, 11, 1007, 29, 0, 0, 1047, 1
n100x8192-coef-sum, 2048, 11, 1004, 28, 0, 0, 1043, 1
n100x8192-coef-sum, 2048, 11, 1003, 29, 0, 0, 1043, 1
n100x8192-coef-sum, 2048, 11, 1017, 30, 0, 0, 1058, 1
n100x8192-coef-sum, 2048, 11, 1006, 29, 0, 0, 1046, 1
n100x8192-coef-sum, 2048, 11, 1007, 28, 0, 0, 1046, 1
n100x8192-coef-sum, 2048, 12, 1005, 30, 0, 0, 1047, 1
n100x8192-coef-sum, 2048, 11, 1009, 29, 0, 0, 1049, 1
n100x8192-coef-sum, 2048, 11, 1019, 29, 0, 0, 1059, 1
n100x8192-coef-sum, 2048, 11, 1006, 28, 0, 0, 1045, 1
n100x8192-coef-sum, 2048, 11, 1010, 29, 0, 0, 1050, 1
n100x8192-coef-sum, 2048, 11, 1009, 29, 0, 0, 1049, 1
n100x8192-coef-sum, 2048, 11, 1012, 29, 0, 0, 1052, 1
n100x8192-coef-sum, 2048, 11, 1014, 29, 0, 0, 1054, 1
n100x8192-coef-sum, 2048, 11, 1008, 29, 0, 0, 1048, 1
n100x8192-coef-sum, 2048, 11, 1002, 29, 0, 0, 1042, 1
n100x8192-coef-sum, 2048, 12, 1004, 29, 0, 0, 1045, 1
n100x8192-coef-sum, 2048, 11, 1005, 29, 0, 0, 1045, 1
n100x8192-coef-sum, 2048, 11, 1007, 29, 0, 0, 1047, 1
n100x8192-coef-sum, 2048, 11, 1009, 29, 0, 0, 1049, 1
n100x8192-coef-sum, 2048, 12, 1009, 29, 0, 0, 1050, 1
n100x8192-coef-sum, 2048, 12, 1006, 30, 0, 0, 1048, 1
n100x8192-coef-sum, 1024, 12, 1274, 43, 0, 0, 1329, 1
n100x8192-coef-sum, 1024, 13, 1275, 43, 0, 0, 1331, 1
n100x8192-coef-sum, 1024, 12, 1285, 43, 0, 0, 1340, 1
n100x8192-coef-sum, 1024, 12, 1280, 43, 0, 0, 1335, 1
n100x8192-coef-sum, 1024, 13, 1275, 44, 0, 0, 1332, 1
n100x8192-coef-sum, 1024, 13, 1281, 43, 0, 0, 1337, 1
n100x8192-coef-sum, 1024, 13, 1278, 44, 0, 0, 1335, 1
n100x8192-coef-sum, 1024, 13, 1278, 43, 0, 0, 1334, 1
n100x8192-coef-sum, 1024, 13, 1269, 43, 0, 0, 1325, 1
n100x8192-coef-sum, 1024, 13, 1279, 44, 0, 0, 1336, 1
n100x8192-coef-sum, 1024, 13, 1279, 43, 0, 0, 1335, 1
n100x8192-coef-sum, 1024, 14, 1280, 44, 0, 0, 1338, 1
n100x8192-coef-sum, 1024, 13, 1295, 43, 0, 0, 1351, 1
n100x8192-coef-sum, 1024, 12, 1275, 43, 0, 0, 1330, 1
n100x8192-coef-sum, 1024, 12, 1278, 44, 0, 0, 1334, 1
n100x8192-coef-sum, 1024, 12, 1273, 43, 0, 0, 1328, 1
n100x8192-coef-sum, 1024, 13, 1275, 44, 0, 0, 1332, 1
n100x8192-coef-sum, 1024, 13, 1286, 44, 0, 0, 1343, 1
n100x8192-coef-sum, 1024, 12, 1276, 43, 0, 0, 1331, 1
n100x8192-coef-sum, 1024, 12, 1280, 44, 0, 0, 1336, 1
n100x8192-coef-sum, 1024, 13, 1282, 44, 0, 0, 1339, 1
n100x8192-coef-sum, 1024, 13, 1278, 44, 0, 0, 1335, 1
n100x8192-coef-sum, 1024, 12, 1273, 43, 0, 0, 1328, 1
n100x8192-coef-sum, 1024, 13, 1276, 44, 0, 0, 1333, 1
n100x8192-coef-sum, 1024, 12, 1276, 44, 0, 0, 1332, 1
n100x8192-coef-sum, 1024, 12, 1290, 44, 0, 0, 1346, 1
n100x8192-coef-sum, 1024, 12, 1275, 43, 0, 0, 1330, 1
n100x8192-coef-sum, 1024, 13, 1281, 43, 0, 0, 1337, 1
n100x8192-coef-sum, 1024, 12, 1281, 42, 0, 0, 1335, 1
n100x8192-coef-sum, 1024, 12, 1276, 43, 0, 0, 1331, 1
n100x8192-coef-sum, 1024, 12, 1275, 43, 0, 0, 1330, 1
n100x8192-coef-sum, 1024, 12, 1279, 43, 0, 0, 1334, 1
n100x8192-coef-sum, 1024, 12, 1271, 43, 0, 0, 1326, 1
n100x8192-coef-sum, 1024, 13, 1272, 43, 0, 0, 1328, 1
n100x8192-coef-sum, 1024, 16, 1274, 45, 0, 0, 1335, 1
n100x8192-coef-sum, 1024, 13, 1276, 44, 0, 0, 1333, 1
n100x8192-coef-sum, 1024, 12, 1281, 44, 0, 0, 1337, 1
n100x8192-coef-sum, 1024, 12, 1274, 43, 0, 0, 1329, 1
n100x8192-coef-sum, 1024, 13, 1277, 43, 0, 0, 1333, 1
n100x8192-coef-sum, 1024, 12, 1279, 43, 0, 0, 1334, 1
n100x8192-coef-sum, 1024, 12, 1272, 43, 0, 0, 1327, 1
n100x8192-coef-sum, 1024, 12, 1277, 44, 0, 0, 1333, 1
n100x8192-coef-sum, 1024, 12, 1278, 43, 0, 0, 1333, 1
n100x8192-coef-sum, 1024, 12, 1275, 44, 0, 0, 1331, 1
n100x8192-coef-sum, 1024, 13, 1279, 43, 0, 0, 1335, 1
n100x8192-coef-sum, 1024, 13, 1279, 44, 0, 0, 1336, 1
n100x8192-coef-sum, 1024, 13, 1283, 43, 0, 0, 1339, 1
n100x8192-coef-sum, 1024, 13, 1278, 44, 0, 0, 1335, 1
n100x8192-coef-sum, 1024, 13, 1280, 43, 0, 0, 1336, 1
n100x8192-coef-sum, 1024, 13, 1273, 44, 0, 0, 1330, 1
n100x8192-coef-sum, 1024, 12, 1282, 43, 0, 0, 1337, 1
n100x8192-coef-sum, 1024, 12, 1267, 44, 0, 0, 1323, 1
n100x8192-coef-sum, 1024, 12, 1278, 43, 0, 0, 1333, 1
n100x8192-coef-sum, 1024, 12, 1267, 43, 0, 0, 1322, 1
n100x8192-coef-sum, 1024, 12, 1278, 43, 0, 0, 1333, 1
n100x8192-coef-sum, 1024, 12, 1273, 44, 0, 0, 1329, 1
n100x8192-coef-sum, 1024, 13, 1279, 44, 0, 0, 1336, 1
n100x8192-coef-sum, 1024, 13, 1279, 42, 0, 0, 1334, 1
n100x8192-coef-sum, 1024, 13, 1276, 43, 0, 0, 1332, 1
n100x8192-coef-sum, 1024, 13, 1271, 44, 0, 0, 1328, 1
n100x8192-coef-sum, 1024, 16, 1282, 43, 0, 0, 1341, 1
n100x8192-coef-sum, 1024, 13, 1277, 43, 0, 0, 1333, 1
n100x8192-coef-sum, 1024, 12, 1282, 44, 0, 0, 1338, 1
n100x8192-coef-sum, 1024, 12, 1278, 44, 0, 0, 1334, 1
n100x8192-coef-sum, 1024, 12, 1276, 43, 0, 0, 1331, 1
n100x8192-coef-sum, 1024, 13, 1275, 44, 0, 0, 1332, 1
n100x8192-coef-sum, 1024, 19, 1277, 44, 0, 0, 1340, 1
n100x8192-coef-sum, 1024, 14, 1276, 43, 0, 0, 1333, 1
n100x8192-coef-sum, 1024, 13, 1301, 43, 0, 0, 1357, 1
n100x8192-coef-sum, 1024, 12, 1273, 43, 0, 0, 1328, 1
n100x8192-coef-sum, 1024, 12, 1279, 43, 0, 0, 1334, 1
n100x8192-coef-sum, 1024, 13, 1271, 43, 0, 0, 1327, 1
n100x8192-coef-sum, 1024, 12, 1270, 43, 0, 0, 1325, 1
n100x8192-coef-sum, 1024, 12, 1275, 43, 0, 0, 1330, 1
n100x8192-coef-sum, 1024, 12, 1279, 43, 0, 0, 1334, 1
n100x8192-coef-sum, 1024, 12, 1273, 44, 0, 0, 1329, 1
n100x8192-coef-sum, 1024, 13, 1276, 44, 0, 0, 1333, 1
n100x8192-coef-sum, 1024, 12, 1271, 43, 0, 0, 1326, 1
n100x8192-coef-sum, 1024, 12, 1273, 44, 0, 0, 1329, 1
n100x8192-coef-sum, 1024, 14, 1278, 43, 0, 0, 1335, 1
n100x8192-coef-sum, 1024, 12, 1271, 43, 0, 0, 1326, 1
n100x8192-coef-sum, 1024, 12, 1271, 43, 0, 0, 1326, 1
n100x8192-coef-sum, 1024, 13, 1276, 43, 0, 0, 1332, 1
n100x8192-coef-sum, 1024, 13, 1280, 43, 0, 0, 1336, 1
n100x8192-coef-sum, 1024, 12, 1272, 43, 0, 0, 1327, 1
n100x8192-coef-sum, 1024, 13, 1272, 43, 0, 0, 1328, 1
n100x8192-coef-sum, 1024, 12, 1270, 43, 0, 0, 1325, 1
n100x8192-coef-sum, 1024, 13, 1275, 43, 0, 0, 1331, 1
n100x8192-coef-sum, 1024, 12, 1282, 44, 0, 0, 1338, 1
n100x8192-coef-sum, 1024, 12, 1278, 44, 0, 0, 1334, 1
n100x8192-coef-sum, 1024, 13, 1275, 44, 0, 0, 1332, 1
n100x8192-coef-sum, 1024, 12, 1277, 44, 0, 0, 1333, 1
n100x8192-coef-sum, 1024, 13, 1277, 43, 0, 0, 1333, 1
n100x8192-coef-sum, 1024, 13, 1273, 43, 0, 0, 1329, 1
n100x8192-coef-sum, 1024, 12, 1274, 44, 0, 0, 1330, 1
n100x8192-coef-sum, 1024, 13, 1278, 44, 0, 0, 1335, 1
n100x8192-coef-sum, 1024, 13, 1269, 43, 0, 0, 1325, 1
n100x8192-coef-sum, 1024, 12, 1276, 43, 0, 0, 1331, 1
n100x8192-coef-sum, 1024, 13, 1276, 44, 0, 0, 1333, 1
n100x8192-coef-sum, 1024, 12, 1280, 44, 0, 0, 1336, 1
n100x8192-slot-sum, 8192, 126, 563, 47, 0, 0, 736, 1
n100x8192-slot-sum, 8192, 126, 565, 47, 0, 0, 738, 1
n100x8192-slot-sum, 8192, 125, 564, 46, 0, 0, 735, 1
n100x8192-slot-sum, 8192, 127, 565, 47, 0, 0, 739, 1
n100x8192-slot-sum, 8192, 126, 567, 48, 0, 0, 741, 1
n100x8192-slot-sum, 8192, 127, 567, 47, 0, 0, 741, 1
n100x8192-slot-sum, 8192, 127, 567, 46, 0, 0, 740, 1
n100x8192-slot-sum, 8192, 126, 565, 47, 0, 0, 738, 1
n100x8192-slot-sum, 8192, 125, 565, 47, 0, 0, 737, 1
n100x8192-slot-sum, 8192, 125, 564, 47, 0, 0, 736, 1
n100x8192-slot-sum, 8192, 126, 563, 48, 0, 0, 737, 1
n100x8192-slot-sum, 8192, 127, 564, 47, 0, 0, 738, 1
n100x8192-slot-sum, 8192, 127, 566, 47, 0, 0, 740, 1
n100x8192-slot-sum, 8192, 125, 562, 47, 0, 0, 734, 1
n100x8192-slot-sum, 8192, 125, 563, 48, 0, 0, 736, 1
n100x8192-slot-sum, 8192, 127, 566, 47, 0, 0, 740, 1
n100x8192-slot-sum, 8192, 126, 565, 47, 0, 0, 738, 1
n100x8192-slot-sum, 8192, 126, 570, 48, 0, 0, 744, 1
n100x8192-slot-sum, 8192, 127, 567, 47, 0, 0, 741, 1
n100x8192-slot-sum, 8192, 126, 629, 54, 1, 0, 810, 1
n100x8192-slot-sum, 8192, 126, 567, 47, 0, 0, 740, 1
n100x8192-slot-sum, 8192, 126, 566, 47, 0, 0, 739, 1
n100x8192-slot-sum, 8192, 126, 565, 47, 0, 0, 738, 1
n100x8192-slot-sum, 8192, 126, 565, 47, 0, 0, 738, 1
n100x8192-slot-sum, 8192, 126, 567, 47, 0, 0, 740, 1
n100x8192-slot-sum, 8192, 125, 566, 47, 0, 0, 738, 1
n100x8192-slot-sum, 8192, 126, 565, 47, 0, 0, 738, 1
n100x8192-slot-sum, 8192, 127, 566, 47, 0, 0, 740, 1
n100x8192-slot-sum, 8192, 126, 566, 47, 0, 0, 739, 1
n100x8192-slot-sum, 8192, 125, 568, 47, 0, 0, 740, 1
n100x8192-slot-sum, 8192, 127, 567, 47, 0, 0, 741, 1
n100x8192-slot-sum, 8192, 125, 563, 48, 1, 0, 737, 1
n100x8192-slot-sum, 8192, 126, 571, 48, 0, 0, 745, 1
n100x8192-slot-sum, 8192, 126, 563, 47, 0, 0, 736, 1
n100x8192-slot-sum, 8192, 126, 566, 47, 0, 0, 739, 1
n100x8192-slot-sum, 8192, 126, 568, 48, 0, 0, 742, 1
n100x8192-slot-sum, 8192, 126, 565, 47, 0, 0, 738, 1
n100x8192-slot-sum, 8192, 126, 569, 47, 0, 0, 742, 1
n100x8192-slot-sum, 8192, 127, 568, 47, 0, 0, 742, 1
n100x8192-slot-sum, 8192, 126, 565, 47, 0, 0, 738, 1
n100x8192-slot-sum, 8192, 126, 566, 46, 0, 0, 738, 1
n100x8192-slot-sum, 8192, 126, 571, 47, 0, 0, 744, 1
n100x8192-slot-sum, 8192, 126, 567, 47, 0, 0, 740, 1
n100x8192-slot-sum, 8192, 126, 567, 46, 0, 0, 739, 1
n100x8192-slot-sum, 8192, 125, 568, 47, 0, 0, 740, 1
n100x8192-slot-sum, 8192, 126, 564, 47, 0, 0, 737, 1
n100x8192-slot-sum, 8192, 127, 563, 47, 0, 0, 737, 1
n100x8192-slot-sum, 8192, 126, 565, 47, 1, 0, 739, 1
n100x8192-slot-sum, 8192, 126, 563, 47, 0, 0, 736, 1
n100x8192-slot-sum, 8192, 125, 566, 48, 0, 0, 739, 1
n100x8192-slot-sum, 8192, 126, 566, 47, 0, 0, 739, 1
n100x8192-slot-sum, 8192, 127, 566, 47, 0, 0, 740, 1
n100x8192-slot-sum, 8192, 127, 564, 47, 0, 0, 738, 1
n100x8192-slot-sum, 8192, 126, 562, 47, 0, 0, 735, 1
n100x8192-slot-sum, 8192, 125, 567, 47, 0, 0, 739, 1
n100x8192-slot-sum, 8192, 125, 565, 47, 0, 0, 737, 1
n100x8192-slot-sum, 8192, 127, 575, 47, 0, 0, 749, 1
n100x8192-slot-sum, 8192, 126, 568, 47, 0, 0, 741, 1
n100x8192-slot-sum, 8192, 126, 566, 46, 0, 0, 738, 1
n100x8192-slot-sum, 8192, 125, 565, 47, 0, 0, 737, 1
n100x8192-slot-sum, 8192, 125, 565, 47, 0, 0, 737, 1
n100x8192-slot-sum, 8192, 127, 567, 47, 0, 0, 741, 1
n100x8192-slot-sum, 8192, 126, 564, 47, 0, 0, 737, 1
n100x8192-slot-sum, 8192, 125, 565, 47, 0, 0, 737, 1
n100x8192-slot-sum, 8192, 125, 563, 46, 0, 0, 734, 1
n100x8192-slot-sum, 8192, 126, 564, 46, 0, 0, 736, 1
n100x8192-slot-sum, 8192, 125, 562, 47, 0, 0, 734, 1
n100x8192-slot-sum, 8192, 125, 561, 46, 0, 0, 732, 1
n100x8192-slot-sum, 8192, 127, 563, 47, 0, 0, 737, 1
n100x8192-slot-sum, 8192, 126, 564, 47, 0, 0, 737, 1
n100x8192-slot-sum, 8192, 126, 567, 47, 0, 0, 740, 1
n100x8192-slot-sum, 8192, 125, 564, 47, 0, 0, 736, 1
n100x8192-slot-sum, 8192, 126, 564, 47, 0, 0, 737, 1
n100x8192-slot-sum, 8192, 126, 569, 48, 0, 0, 743, 1
n100x8192-slot-sum, 8192, 126, 565, 47, 0, 0, 738, 1
n100x8192-slot-sum, 8192, 126, 568, 48, 0, 0, 742, 1
n100x8192-slot-sum, 8192, 126, 564, 48, 0, 0, 738, 1
n100x8192-slot-sum, 8192, 126, 565, 47, 0, 0, 738, 1
n100x8192-slot-sum, 8192, 126, 563, 47, 0, 0, 736, 1
n100x8192-slot-sum, 8192, 126, 566, 47, 0, 0, 739, 1
n100x8192-slot-sum, 8192, 126, 564, 47, 0, 0, 737, 1
n100x8192-slot-sum, 8192, 126, 564, 47, 0, 0, 737, 1
n100x8192-slot-sum, 8192, 125, 566, 47, 0, 0, 738, 1
n100x8192-slot-sum, 8192, 126, 568, 48, 0, 0, 742, 1
n100x8192-slot-sum, 8192, 125, 563, 46, 0, 0, 734, 1
n100x8192-slot-sum, 8192, 125, 566, 46, 0, 0, 737, 1
n100x8192-slot-sum, 8192, 126, 564, 47, 0, 0, 737, 1
n100x8192-slot-sum, 8192, 125, 564, 47, 0, 0, 736, 1
n100x8192-slot-sum, 8192, 127, 563, 47, 0, 0, 737, 1
n100x8192-slot-sum, 8192, 126, 566, 47, 0, 0, 739, 1
n100x8192-slot-sum, 8192, 126, 566, 46, 0, 0, 738, 1
n100x8192-slot-sum, 8192, 126, 567, 47, 0, 0, 740, 1
n100x8192-slot-sum, 8192, 127, 565, 47, 0, 0, 739, 1
n100x8192-slot-sum, 8192, 127, 575, 47, 0, 0, 749, 1
n100x8192-slot-sum, 8192, 127, 564, 46, 0, 0, 737, 1
n100x8192-slot-sum, 8192, 127, 564, 46, 0, 0, 737, 1
n100x8192-slot-sum, 8192, 125, 564, 48, 0, 0, 737, 1
n100x8192-slot-sum, 8192, 126, 563, 47, 0, 0, 736, 1
n100x8192-slot-sum, 8192, 126, 567, 47, 0, 0, 740, 1
n100x8192-slot-sum, 8192, 125, 564, 46, 0, 0, 735, 1
n100x8192-slot-sum, 4096, 60, 548, 36, 0, 0, 644, 1
n100x8192-slot-sum, 4096, 60, 547, 36, 0, 0, 643, 1
n100x8192-slot-sum, 4096, 61, 547, 36, 0, 0, 644, 1
n100x8192-slot-sum, 4096, 59, 546, 36, 0, 0, 641, 1
n100x8192-slot-sum, 4096, 59, 547, 36, 0, 0, 642, 1
n100x8192-slot-sum, 4096, 60, 553, 36, 0, 0, 649, 1
n100x8192-slot-sum, 4096, 60, 548, 36, 0, 0, 644, 1
n100x8192-slot-sum, 4096, 60, 550, 36, 0, 0, 646, 1
n100x8192-slot-sum, 4096, 60, 546, 36, 0, 0, 642, 1
n100x8192-slot-sum, 4096, 60, 551, 36, 0, 0, 647, 1
n100x8192-slot-sum, 4096, 60, 551, 36, 0, 0, 647, 1
n100x8192-slot-sum, 4096, 59, 548, 37, 0, 0, 644, 1
n100x8192-slot-sum, 4096, 59, 545, 35, 0, 0, 639, 1
n100x8192-slot-sum, 4096, 59, 549, 36, 0, 0, 644, 1
n100x8192-slot-sum, 4096, 60, 547, 36, 0, 0, 643, 1
n100x8192-slot-sum, 4096, 60, 549, 36, 0, 0, 645, 1
n100x8192-slot-sum, 4096, 60, 547, 36, 0, 0, 643, 1
n100x8192-slot-sum, 4096, 60, 548, 36, 0, 0, 644, 1
n100x8192-slot-sum, 4096, 60, 546, 36, 0, 0, 642, 1
n100x8192-slot-sum, 4096, 60, 547, 36, 0, 0, 643, 1
n100x8192-slot-sum, 4096, 59, 549, 36, 0, 0, 644, 1
n100x8192-slot-sum, 4096, 59, 550, 36, 0, 0, 645, 1
n100x8192-slot-sum, 4096, 60, 546, 36, 0, 0, 642, 1
n100x8192-slot-sum, 4096, 60, 549, 36, 0, 0, 645, 1
n100x8192-slot-sum, 4096, 60, 547, 37, 0, 0, 644, 1
n100x8192-slot-sum, 4096, 60, 545, 36, 0, 0, 641, 1
n100x8192-slot-sum, 4096, 60, 547, 37, 0, 0, 644, 1
n100x8192-slot-sum, 4096, 59, 552, 36, 0, 0, 647, 1
n100x8192-slot-sum, 4096, 60, 545, 36, 0, 0, 641, 1
n100x8192-slot-sum, 4096, 60, 548, 37, 0, 0, 645, 1
n100x8192-slot-sum, 4096, 60, 548, 36, 0, 0, 644, 1
n100x8192-slot-sum, 4096, 60, 549, 36, 0, 0, 645, 1
n100x8192-slot-sum, 4096, 59, 546, 36, 0, 0, 641, 1
n100x8192-slot-sum, 4096, 61, 550, 36, 0, 0, 647, 1
n100x8192-slot-sum, 4096, 60, 546, 36, 0, 0, 642, 1
n100x8192-slot-sum, 4096, 59, 546, 36, 0, 0, 641, 1
n100x8192-slot-sum, 4096, 60, 548, 37, 0, 0, 645, 1
n100x8192-slot-sum, 4096, 61, 551, 35, 0, 0, 647, 1
n100x8192-slot-sum, 4096, 59, 545, 37, 0, 0, 641, 1
n100x8192-slot-sum, 4096, 59, 544, 35, 0, 0, 638, 1
n100x8192-slot-sum, 4096, 60, 547, 36, 0, 0, 643, 1
n100x8192-slot-sum, 4096, 59, 546, 37, 0, 0, 642, 1
n100x8192-slot-sum, 4096, 60, 547, 36, 0, 0, 643, 1
n100x8192-slot-sum, 4096, 60, 550, 37, 0, 0, 647, 1
n100x8192-slot-sum, 4096, 60, 545, 37, 0, 0, 642, 1
n100x8192-slot-sum, 4096, 60, 548, 36, 0, 0, 644, 1
n100x8192-slot-sum, 4096, 59, 548, 36, 0, 0, 643, 1
n100x8192-slot-sum, 4096, 60, 547, 36, 0, 0, 643, 1
n100x8192-slot-sum, 4096, 60, 549, 36, 0, 0, 645, 1
n100x8192-slot-sum, 4096, 59, 544, 37, 0, 0, 640, 1
n100x8192-slot-sum, 4096, 59, 547, 36, 0, 0, 642, 1
n100x8192-slot-sum, 4096, 59, 550, 36, 0, 0, 645, 1
n100x8192-slot-sum, 4096, 60, 548, 37, 0, 0, 645, 1
n100x8192-slot-sum, 4096, 60, 545, 35, 0, 0, 640, 1
n100x8192-slot-sum, 4096, 60, 549, 36, 0, 0, 645, 1
n100x8192-slot-sum, 4096, 60, 551, 36, 0, 0, 647, 1
n100x8192-slot-sum, 4096, 59, 547, 36, 0, 0, 642, 1
n100x8192-slot-sum, 4096, 60, 549, 36, 0, 0, 645, 1
n100x8192-slot-sum, 4096, 60, 547, 36, 0, 0, 643, 1
n100x8192-slot-sum, 4096, 60, 548, 36, 0, 0, 644, 1
n100x8192-slot-sum, 4096, 60, 547, 36, 0, 0, 643, 1
n100x8192-slot-sum, 4096, 59, 549, 37, 0, 0, 645, 1
n100x8192-slot-sum, 4096, 60, 551, 36, 0, 0, 647, 1
n100x8192-slot-sum, 4096, 61, 548, 36, 0, 0, 645, 1
n100x8192-slot-sum, 4096, 59, 551, 36, 0, 0, 646, 1
n100x8192-slot-sum, 4096, 60, 547, 36, 0, 0, 643, 1
n100x8192-slot-sum, 4096, 59, 548, 37, 0, 0, 644, 1
n100x8192-slot-sum, 4096, 60, 545, 36, 0, 0, 641, 1
n100x8192-slot-sum, 4096, 59, 547, 36, 0, 0, 642, 1
n100x8192-slot-sum, 4096, 59, 546, 37, 0, 0, 642, 1
n100x8192-slot-sum, 4096, 60, 548, 35, 0, 0, 643, 1
n100x8192-slot-sum, 4096, 60, 549, 36, 0, 0, 645, 1
n100x8192-slot-sum, 4096, 60, 548, 36, 0, 0, 644, 1
n100x8192-slot-sum, 4096, 60, 545, 36, 0, 0, 641, 1
n100x8192-slot-sum, 4096, 60, 546, 36, 0, 0, 642, 1
n100x8192-slot-sum, 4096, 60, 550, 36, 0, 0, 646, 1
n100x8192-slot-sum, 4096, 60, 546, 36, 0, 0, 642, 1
n100x8192-slot-sum, 4096, 60, 560, 36, 0, 0, 656, 1
n100x8192-slot-sum, 4096, 60, 553, 36, 0, 0, 649, 1
n100x8192-slot-sum, 4096, 60, 547, 37, 0, 0, 644, 1
n100x8192-slot-sum, 4096, 60, 546, 36, 0, 0, 642, 1
n100x8192-slot-sum, 4096, 59, 548, 36, 0, 0, 643, 1
n100x8192-slot-sum, 4096, 61, 552, 36, 0, 0, 649, 1
n100x8192-slot-sum, 4096, 60, 547, 36, 0, 0, 643, 1
n100x8192-slot-sum, 4096, 60, 550, 36, 0, 0, 646, 1
n100x8192-slot-sum, 4096, 60, 548, 36, 0, 0, 644, 1
n100x8192-slot-sum, 4096, 60, 548, 36, 0, 0, 644, 1
n100x8192-slot-sum, 4096, 59, 547, 36, 0, 0, 642, 1
n100x8192-slot-sum, 4096, 60, 549, 36, 0, 0, 645, 1
n100x8192-slot-sum, 4096, 60, 549, 36, 0, 0, 645, 1
n100x8192-slot-sum, 4096, 60, 549, 37, 0, 0, 646, 1
n100x8192-slot-sum, 4096, 59, 550, 36, 0, 0, 645, 1
n100x8192-slot-sum, 4096, 60, 548, 36, 0, 0, 644, 1
n100x8192-slot-sum, 4096, 59, 548, 36, 0, 0, 643, 1
n100x8192-slot-sum, 4096, 60, 548, 36, 0, 0, 644, 1
n100x8192-slot-sum, 4096, 60, 548, 35, 0, 0, 643, 1
n100x8192-slot-sum, 4096, 60, 547, 36, 0, 0, 643, 1
n100x8192-slot-sum, 4096, 59, 545, 36, 0, 0, 640, 1
n100x8192-slot-sum, 4096, 59, 551, 37, 0, 0, 647, 1
n100x8192-slot-sum, 4096, 60, 548, 36, 0, 0, 644, 1
n100x8192-slot-sum, 2048, 30, 540, 33, 0, 0, 603, 1
n100x8192-slot-sum, 2048, 30, 538, 34, 0, 0, 602, 1
n100x8192-slot-sum, 2048, 30, 540, 32, 0, 0, 602, 1
n100x8192-slot-sum, 2048, 30, 537, 34, 0, 0, 601, 1
n100x8192-slot-sum, 2048, 30, 540, 34, 0, 0, 604, 1
n100x8192-slot-sum, 2048, 30, 537, 33, 0, 0, 600, 1
n100x8192-slot-sum, 2048, 30, 541, 33, 0, 0, 604, 1
n100x8192-slot-sum, 2048, 30, 537, 33, 0, 0, 600, 1
n100x8192-slot-sum, 2048, 30, 538, 33, 0, 0, 601, 1
n100x8192-slot-sum, 2048, 30, 537, 34, 0, 0, 601, 1
n100x8192-slot-sum, 2048, 29, 539, 34, 0, 0, 602, 1
n100x8192-slot-sum, 2048, 30, 539, 33, 0, 0, 602, 1
n100x8192-slot-sum, 2048, 29, 535, 33, 0, 0, 597, 1
n100x8192-slot-sum, 2048, 30, 539, 34, 0, 0, 603, 1
n100x8192-slot-sum, 2048, 29, 538, 33, 0, 0, 600, 1
n100x8192-slot-sum, 2048, 29, 540, 33, 0, 0, 602, 1
n100x8192-slot-sum, 2048, 29, 540, 34, 0, 0, 603, 1
n100x8192-slot-sum, 2048, 30, 540, 33, 0, 0, 603, 1
n100x8192-slot-sum, 2048, 29, 536, 33, 0, 0, 598, 1
n100x8192-slot-sum, 2048, 30, 542, 33, 0, 0, 605, 1
n100x8192-slot-sum, 2048, 30, 541, 33, 0, 0, 604, 1
n100x8192-slot-sum, 2048, 30, 537, 33, 0, 0, 600, 1
n100x8192-slot-sum, 2048, 29, 539, 33, 0, 0, 601, 1
n100x8192-slot-sum, 2048, 30, 540, 33, 0, 0, 603, 1
n100x8192-slot-sum, 2048, 30, 539, 33, 0, 0, 602, 1
n100x8192-slot-sum, 2048, 29, 536, 34, 0, 0, 599, 1
n100x8192-slot-sum, 2048, 30, 540, 33, 0, 0, 603, 1
n100x8192-slot-sum, 2048, 29, 536, 33, 0, 0, 598, 1
n100x8192-slot-sum, 2048, 30, 539, 34, 0, 0, 603, 1
n100x8192-slot-sum, 2048, 29, 539, 33, 0, 0, 601, 1
n100x8192-slot-sum, 2048, 30, 537, 33, 0, 0, 600, 1
n100x8192-slot-sum, 2048, 29, 536, 33, 0, 0, 598, 1
n100x8192-slot-sum, 2048, 29, 536, 33, 0, 0, 598, 1
n100x8192-slot-sum, 2048, 29, 537, 33, 0, 0, 599, 1
n100x8192-slot-sum, 2048, 30, 539, 32, 0, 0, 601, 1
n100x8192-slot-sum, 2048, 29, 539, 33, 0, 0, 601, 1
n100x8192-slot-sum, 2048, 30, 539, 33, 0, 0, 602, 1
n100x8192-slot-sum, 2048, 30, 541, 33, 0, 0, 604, 1
n100x8192-slot-sum, 2048, 30, 539, 33, 0, 0, 602, 1
n100x8192-slot-sum, 2048, 30, 539, 33, 0, 0, 602, 1
n100x8192-slot-sum, 2048, 29, 543, 34, 0, 0, 606, 1
n100x8192-slot-sum, 2048, 30, 542, 33, 0, 0, 605, 1
n100x8192-slot-sum, 2048, 30, 542, 34, 0, 0, 606, 1
n100x8192-slot-sum, 2048, 29, 542, 33, 0, 0, 604, 1
n100x8192-slot-sum, 2048, 29, 541, 33, 0, 0, 603, 1
n100x8192-slot-sum, 2048, 29, 539, 33, 0, 0, 601, 1
n100x8192-slot-sum, 2048, 30, 537, 33, 0, 0, 600, 1
n100x8192-slot-sum, 2048, 30, 541, 34, 0, 0, 605, 1
n100x8192-slot-sum, 2048, 30, 538, 33, 0, 0, 601, 1
n100x8192-slot-sum, 2048, 30, 540, 33, 0, 0, 603, 1
n100x8192-slot-sum, 2048, 29, 544, 34, 0, 0, 607, 1
n100x8192-slot-sum, 2048, 30, 537, 33, 0, 0, 600, 1
n100x8192-slot-sum, 2048, 29, 539, 33, 0, 0, 601, 1
n100x8192-slot-sum, 2048, 30, 539, 33, 0, 0, 602, 1
n100x8192-slot-sum, 2048, 29, 568, 33, 0, 0, 630, 1
n100x8192-slot-sum, 2048, 30, 546, 33, 0, 0, 609, 1
n100x8192-slot-sum, 2048, 29, 540, 33, 0, 0, 602, 1
n100x8192-slot-sum, 2048, 30, 540, 34, 0, 0, 604, 1
n100x8192-slot-sum, 2048, 30, 539, 33, 0, 0, 602, 1
n100x8192-slot-sum, 2048, 29, 538, 32, 0, 0, 599, 1
n100x8192-slot-sum, 2048, 30, 535, 33, 0, 0, 598, 1
n100x8192-slot-sum, 2048, 30, 536, 33, 0, 0, 599, 1
n100x8192-slot-sum, 2048, 29, 538, 33, 0, 0, 600, 1
n100x8192-slot-sum, 2048, 30, 540, 33, 0, 0, 603, 1
n100x8192-slot-sum, 2048, 31, 540, 33, 0, 0, 604, 1
n100x8192-slot-sum, 2048, 30, 539, 33, 0, 0, 602, 1
n100x8192-slot-sum, 2048, 30, 553, 33, 0, 0, 616, 1
n100x8192-slot-sum, 2048, 29, 542, 34, 0, 0, 605, 1
n100x8192-slot-sum, 2048, 30, 539, 33, 0, 0, 602, 1
n100x8192-slot-sum, 2048, 30, 538, 34, 0, 0, 602, 1
n100x8192-slot-sum, 2048, 29, 540, 34, 0, 0, 603, 1
n100x8192-slot-sum, 2048, 29, 540, 36, 0, 0, 605, 1
n100x8192-slot-sum, 2048, 29, 536, 33, 0, 0, 598, 1
n100x8192-slot-sum, 2048, 30, 539, 34, 0, 0, 603, 1
n100x8192-slot-sum, 2048, 30, 539, 33, 0, 0, 602, 1
n100x8192-slot-sum, 2048, 29, 543, 33, 0, 0, 605, 1
n100x8192-slot-sum, 2048, 29, 538, 34, 0, 0, 601, 1
n100x8192-slot-sum, 2048, 30, 542, 33, 0, 0, 605, 1
n100x8192-slot-sum, 2048, 30, 539, 33, 0, 0, 602, 1
n100x8192-slot-sum, 2048, 30, 542, 34, 0, 0, 606, 1
n100x8192-slot-sum, 2048, 30, 542, 33, 0, 0, 605, 1
n100x8192-slot-sum, 2048, 30, 535, 33, 0, 0, 598, 1
n100x8192-slot-sum, 2048, 29, 538, 33, 0, 0, 600, 1
n100x8192-slot-sum, 2048, 30, 542, 33, 0, 0, 605, 1
n100x8192-slot-sum, 2048, 30, 539, 33, 0, 0, 602, 1
n100x8192-slot-sum, 2048, 30, 539, 35, 0, 0, 604, 1
n100x8192-slot-sum, 2048, 30, 540, 33, 0, 0, 603, 1
n100x8192-slot-sum, 2048, 30, 537, 33, 0, 0, 600, 1
n100x8192-slot-sum, 2048, 29, 541, 34, 0, 0, 604, 1
n100x8192-slot-sum, 2048, 29, 539, 34, 0, 0, 602, 1
n100x8192-slot-sum, 2048, 30, 540, 34, 0, 0, 604, 1
n100x8192-slot-sum, 2048, 30, 539, 33, 0, 0, 602, 1
n100x8192-slot-sum, 2048, 29, 540, 33, 0, 0, 602, 1
n100x8192-slot-sum, 2048, 30, 537, 33, 0, 0, 600, 1
n100x8192-slot-sum, 2048, 30, 538, 34, 0, 0, 602, 1
n100x8192-slot-sum, 2048, 29, 539, 33, 0, 0, 601, 1
n100x8192-slot-sum, 2048, 30, 540, 34, 0, 0, 604, 1
n100x8192-slot-sum, 2048, 30, 537, 33, 0, 0, 600, 1
n100x8192-slot-sum, 2048, 30, 538, 33, 0, 0, 601, 1
n100x8192-slot-sum, 2048, 30, 535, 33, 0, 0, 598, 1
n100x8192-slot-sum, 1024, 30, 690, 48, 0, 0, 768, 1
n100x8192-slot-sum, 1024, 30, 691, 48, 0, 0, 769, 1
n100x8192-slot-sum, 1024, 30, 691, 47, 0, 0, 768, 1
n100x8192-slot-sum, 1024, 31, 693, 48, 0, 0, 772, 1
n100x8192-slot-sum, 1024, 31, 689, 49, 0, 0, 769, 1
n100x8192-slot-sum, 1024, 30, 691, 48, 0, 0, 769, 1
n100x8192-slot-sum, 1024, 31, 690, 48, 0, 0, 769, 1
n100x8192-slot-sum, 1024, 30, 695, 48, 0, 0, 773, 1
n100x8192-slot-sum, 1024, 31, 693, 48, 0, 0, 772, 1
n100x8192-slot-sum, 1024, 32, 693, 48, 0, 0, 773, 1
n100x8192-slot-sum, 1024, 30, 689, 48, 0, 0, 767, 1
n100x8192-slot-sum, 1024, 30, 692, 48, 0, 0, 770, 1
n100x8192-slot-sum, 1024, 31, 688, 48, 0, 0, 767, 1
n100x8192-slot-sum, 1024, 30, 692, 48, 0, 0, 770, 1
n100x8192-slot-sum, 1024, 31, 698, 48, 0, 0, 777, 1
n100x8192-slot-sum, 1024, 35, 690, 49, 0, 0, 774, 1
n100x8192-slot-sum, 1024, 30, 687, 47, 0, 0, 764, 1
n100x8192-slot-sum, 1024, 30, 688, 48, 0, 0, 766, 1
n100x8192-slot-sum, 1024, 30, 690, 47, 0, 0, 767, 1
n100x8192-slot-sum, 1024, 30, 690, 49, 0, 0, 769, 1
n100x8192-slot-sum, 1024, 31, 695, 47, 0, 0, 773, 1
n100x8192-slot-sum, 1024, 30, 692, 48, 0, 0, 770, 1
n100x8192-slot-sum, 1024, 31, 691, 48, 0, 0, 770, 1
n100x8192-slot-sum, 1024, 32, 689, 47, 0, 0, 768, 1
n100x8192-slot-sum, 1024, 31, 693, 48, 0, 0, 772, 1
n100x8192-slot-sum, 1024, 30, 688, 48, 0, 0, 766, 1
n100x8192-slot-sum, 1024, 31, 699, 49, 0, 0, 779, 1
n100x8192-slot-sum, 1024, 31, 693, 48, 0, 0, 772, 1
n100x8192-slot-sum, 1024, 30, 691, 47, 0, 0, 768, 1
n100x8192-slot-sum, 1024, 29, 688, 48, 0, 0, 765, 1
n100x8192-slot-sum, 1024, 30, 691, 48, 0, 0, 769, 1
n100x8192-slot-sum, 1024, 31, 692, 48, 0, 0, 771, 1
n100x8192-slot-sum, 1024, 31, 694, 47, 0, 0, 772, 1
n100x8192-slot-sum, 1024, 30, 687, 48, 0, 0, 765, 1
n100x8192-slot-sum, 1024, 31, 692, 47, 0, 0, 770, 1
n100x8192-slot-sum, 1024, 30, 701, 48, 0, 0, 779, 1
n100x8192-slot-sum, 1024, 30, 690, 48, 0, 0, 768, 1
n100x8192-slot-sum, 1024, 30, 692, 47, 0, 0, 769, 1
n100x8192-slot-sum, 1024, 30, 688, 48, 0, 0, 766, 1
n100x8192-slot-sum, 1024, 30, 689, 48, 0, 0, 767, 1
n100x8192-slot-sum, 1024, 30, 690, 49, 0, 0, 769, 1
n100x8192-slot-sum, 1024, 31, 695, 47, 0, 0, 773, 1
n100x8192-slot-sum, 1024, 30, 686, 48, 0, 0, 764, 1
n100x8192-slot-sum, 1024, 31, 694, 48, 0, 0, 773, 1
n100x8192-slot-sum, 1024, 30, 693, 48, 0, 0, 771, 1
n100x8192-slot-sum, 1024, 32, 694, 48, 0, 0, 774, 1
n100x8192-slot-sum, 1024, 32, 691, 48, 0, 0, 771, 1
n100x8192-slot-sum, 1024, 30, 690, 48, 0, 0, 768, 1
n100x8192-slot-sum, 1024, 31, 691, 48, 0, 0, 770, 1
n100x8192-slot-sum, 1024, 30, 689, 47, 0, 0, 766, 1
n100x8192-slot-sum, 1024, 30, 687, 48, 0, 0, 765, 1
n100x8192-slot-sum, 1024, 30, 692, 48, 0, 0, 770, 1
n100x8192-slot-sum, 1024, 29, 688, 48, 0, 0, 765, 1
n100x8192-slot-sum, 1024, 30, 687, 48, 0, 0, 765, 1
n100x8192-slot-sum, 1024, 30, 694, 48, 0, 0, 772, 1
n100x8192-slot-sum, 1024, 30, 693, 47, 0, 0, 770, 1
n100x8192-slot-sum, 1024, 30, 691, 48, 0, 0, 769, 1
n100x8192-slot-sum, 1024, 30, 692, 47, 0, 0, 769, 1
n100x8192-slot-sum, 1024, 30, 696, 48, 0, 0, 774, 1
n100x8192-slot-sum, 1024, 31, 690, 48, 0, 0, 769, 1
n100x8192-slot-sum, 1024, 31, 690, 47, 0, 0, 768, 1
n100x8192-slot-sum, 1024, 30, 689, 47, 0, 0, 766, 1
n100x8192-slot-sum, 1024, 30, 691, 48, 0, 0, 769, 1
n100x8192-slot-sum, 1024, 31, 692, 48, 0, 0, 771, 1
n100x8192-slot-sum, 1024, 30, 688, 48, 0, 0, 766, 1
n100x8192-slot-sum, 1024, 30, 689, 48, 0, 0, 767, 1
n100x8192-slot-sum, 1024, 31, 687, 48, 0, 0, 766, 1
n100x8192-slot-sum, 1024, 30, 687, 47, 0, 0, 764, 1
n100x8192-slot-sum, 1024, 30, 691, 48, 0, 0, 769, 1
n100x8192-slot-sum, 1024, 30, 690, 48, 0, 0, 768, 1
n100x8192-slot-sum, 1024, 30, 690, 48, 0, 0, 768, 1
n100x8192-slot-sum, 1024, 30, 694, 48, 0, 0, 772, 1
n100x8192-slot-sum, 1024, 31, 692, 48, 0, 0, 771, 1
n100x8192-slot-sum, 1024, 30, 693, 48, 0, 0, 771, 1
n100x8192-slot-sum, 1024, 30, 692, 47, 0, 0, 769, 1
n100x8192-slot-sum, 1024, 30, 688, 47, 0, 0, 765, 1
n100x8192-slot-sum, 1024, 30, 686, 47, 0, 0, 763, 1
n100x8192-slot-sum, 1024, 30, 691, 48, 0, 0, 769, 1
n100x8192-slot-sum, 1024, 30, 689, 48, 0, 0, 767, 1
n100x8192-slot-sum, 1024, 30, 696, 47, 0, 0, 773, 1
n100x8192-slot-sum, 1024, 30, 692, 48, 0, 0, 770, 1
n100x8192-slot-sum, 1024, 30, 694, 48, 0, 0, 772, 1
n100x8192-slot-sum, 1024, 30, 688, 48, 0, 0, 766, 1
n100x8192-slot-sum, 1024, 30, 689, 48, 0, 0, 767, 1
n100x8192-slot-sum, 1024, 32, 691, 48, 0, 0, 771, 1
n100x8192-slot-sum, 1024, 31, 691, 47, 0, 0, 769, 1
n100x8192-slot-sum, 1024, 30, 692, 48, 0, 0, 770, 1
n100x8192-slot-sum, 1024, 30, 688, 48, 0, 0, 766, 1
n100x8192-slot-sum, 1024, 32, 692, 47, 0, 0, 771, 1
n100x8192-slot-sum, 1024, 30, 691, 48, 0, 0, 769, 1
n100x8192-slot-sum, 1024, 30, 688, 48, 0, 0, 766, 1
n100x8192-slot-sum, 1024, 34, 691, 48, 0, 0, 773, 1
n100x8192-slot-sum, 1024, 30, 691, 47, 0, 0, 768, 1
n100x8192-slot-sum, 1024, 31, 692, 48, 0, 0, 771, 1
n100x8192-slot-sum, 1024, 30, 690, 48, 0, 0, 768, 1
n100x8192-slot-sum, 1024, 29, 691, 48, 0, 0, 768, 1
n100x8192-slot-sum, 1024, 31, 692, 48, 0, 0, 771, 1
n100x8192-slot-sum, 1024, 31, 692, 49, 0, 0, 772, 1
n100x8192-slot-sum, 1024, 30, 695, 49, 0, 0, 774, 1
n100x8192-slot-sum, 1024, 30, 691, 48, 0, 0, 769, 1
n100x8192-slot-inner, 8192, 133, 566, 857, 0, 0, 1556, 1.36534e+06
n100x8192-slot-inner, 8192, 134, 563, 856, 0, 0, 1553, 1.36534e+06
n100x8192-slot-inner, 8192, 137, 568, 858, 0, 0, 1563, 1.36534e+06
n100x8192-slot-inner, 8192, 134, 566, 855, 0, 0, 1555, 1.36534e+06
n100x8192-slot-inner, 8192, 133, 562, 856, 0, 0, 1551, 1.36534e+06
n100x8192-slot-inner, 8192, 133, 568, 859, 0, 0, 1560, 1.36534e+06
n100x8192-slot-inner, 8192, 134, 566, 854, 0, 0, 1554, 1.36534e+06
n100x8192-slot-inner, 8192, 135, 565, 855, 0, 0, 1555, 1.36534e+06
n100x8192-slot-inner, 8192, 136, 566, 968, 1, 0, 1671, 1.36534e+06
n100x8192-slot-inner, 8192, 134, 567, 859, 0, 0, 1560, 1.36534e+06
n100x8192-slot-inner, 8192, 135, 565, 858, 0, 0, 1558, 1.36534e+06
n100x8192-slot-inner, 8192, 133, 564, 858, 0, 0, 1555, 1.36534e+06
n100x8192-slot-inner, 8192, 134, 565, 857, 0, 0, 1556, 1.36534e+06
n100x8192-slot-inner, 8192, 133, 564, 855, 0, 0, 1552, 1.36534e+06
n100x8192-slot-inner, 8192, 135, 566, 865, 1, 0, 1567, 1.36534e+06
n100x8192-slot-inner, 8192, 135, 565, 865, 0, 0, 1565, 1.36534e+06
n100x8192-slot-inner, 8192, 135, 569, 855, 0, 0, 1559, 1.36534e+06
n100x8192-slot-inner, 8192, 134, 565, 856, 0, 0, 1555, 1.36534e+06
n100x8192-slot-inner, 8192, 134, 566, 853, 0, 0, 1553, 1.36534e+06
n100x8192-slot-inner, 8192, 134, 564, 854, 0, 0, 1552, 1.36534e+06
n100x8192-slot-inner, 8192, 133, 562, 854, 0, 0, 1549, 1.36534e+06
n100x8192-slot-inner, 8192, 135, 566, 860, 0, 0, 1561, 1.36534e+06
n100x8192-slot-inner, 8192, 134, 567, 857, 0, 0, 1558, 1.36534e+06
n100x8192-slot-inner, 8192, 133, 562, 852, 0, 0, 1547, 1.36534e+06
n100x8192-slot-inner, 8192, 134, 566, 851, 0, 0, 1551, 1.36534e+06
n100x8192-slot-inner, 8192, 134, 566, 856, 0, 0, 1556, 1.36534e+06
n100x8192-slot-inner, 8192, 134, 568, 861, 0, 0, 1563, 1.36534e+06
n100x8192-slot-inner, 8192, 136, 568, 857, 0, 0, 1561, 1.36534e+06
n100x8192-slot-inner, 8192, 134, 565, 854, 0, 0, 1553, 1.36534e+06
n100x8192-slot-inner, 8192, 134, 563, 848, 0, 0, 1545, 1.36534e+06
n100x8192-slot-inner, 8192, 133, 564, 854, 0, 0, 1551, 1.36534e+06
n100x8192-slot-inner, 8192, 134, 563, 856, 0, 0, 1553, 1.36534e+06
n100x8192-slot-inner, 8192, 134, 565, 855, 0, 0, 1554, 1.36534e+06
n100x8192-slot-inner, 8192, 135, 563, 861, 0, 0, 1559, 1.36534e+06
n100x8192-slot-inner, 8192, 134, 563, 849, 0, 0, 1546, 1.36534e+06
n100x8192-slot-inner, 8192, 133, 564, 853, 0, 0, 1550, 1.36534e+06
n100x8192-slot-inner, 8192, 135, 575, 863, 0, 0, 1573, 1.36534e+06
n100x8192-slot-inner, 8192, 133, 566, 856, 0, 0, 1555, 1.36534e+06
n100x8192-slot-inner, 8192, 134, 564, 855, 0, 0, 1553, 1.36534e+06
n100x8192-slot-inner, 8192, 137, 565, 855, 0, 0, 1557, 1.36534e+06
n100x8192-slot-inner, 8192, 134, 562, 859, 0, 0, 1555, 1.36534e+06
n100x8192-slot-inner, 8192, 134, 563, 852, 0, 0, 1549, 1.36534e+06
n100x8192-slot-inner, 8192, 134, 568, 857, 0, 0, 1559, 1.36534e+06
n100x8192-slot-inner, 8192, 133, 564, 848, 0, 0, 1545, 1.36534e+06
n100x8192-slot-inner, 8192, 135, 565, 852, 0, 0, 1552, 1.36534e+06
n100x8192-slot-inner, 8192, 134, 565, 868, 0, 0, 1567, 1.36534e+06
n100x8192-slot-inner, 8192, 135, 564, 854, 0, 0, 1553, 1.36534e+06
n100x8192-slot-inner, 8192, 133, 566, 856, 0, 0, 1555, 1.36534e+06
n100x8192-slot-inner, 8192, 137, 565, 854, 0, 0, 1556, 1.36534e+06
n100x8192-slot-inner, 8192, 133, 561, 851, 0, 0, 1545, 1.36534e+06
n100x8192-slot-inner, 8192, 134, 563, 857, 0, 0, 1554, 1.36534e+06
n100x8192-slot-inner, 8192, 134, 566, 848, 0, 0, 1548, 1.36534e+06
n100x8192-slot-inner, 8192, 134, 565, 853, 0, 0, 1552, 1.36534e+06
n100x8192-slot-inner, 8192, 134, 565, 855, 0, 0, 1554, 1.36534e+06
n100x8192-slot-inner, 8192, 135, 563, 856, 0, 0, 1554, 1.36534e+06
n100x8192-slot-inner, 8192, 135, 567, 854, 0, 0, 1556, 1.36534e+06
n100x8192-slot-inner, 8192, 134, 573, 855, 0, 0, 1562, 1.36534e+06
n100x8192-slot-inner, 8192, 135, 565, 851, 0, 0, 1551, 1.36534e+06
n100x8192-slot-inner, 8192, 133, 564, 853, 0, 0, 1550, 1.36534e+06
n100x8192-slot-inner, 8192, 135, 564, 855, 0, 0, 1554, 1.36534e+06
n100x8192-slot-inner, 8192, 134, 565, 852, 0, 0, 1551, 1.36534e+06
n100x8192-slot-inner, 8192, 134, 567, 865, 0, 0, 1566, 1.36534e+06
n100x8192-slot-inner, 8192, 133, 563, 855, 0, 0, 1551, 1.36534e+06
n100x8192-slot-inner, 8192, 134, 565, 853, 0, 0, 1552, 1.36534e+06
n100x8192-slot-inner, 8192, 134, 565, 860, 0, 0, 1559, 1.36534e+06
n100x8192-slot-inner, 8192, 134, 562, 856, 0, 0, 1552, 1.36534e+06
n100x8192-slot-inner, 8192, 133, 563, 850, 0, 0, 1546, 1.36534e+06
n100x8192-slot-inner, 8192, 133, 562, 854, 0, 0, 1549, 1.36534e+06
n100x8192-slot-inner, 8192, 136, 563, 853, 0, 0, 1552, 1.36534e+06
n100x8192-slot-inner, 8192, 133, 563, 854, 0, 0, 1550, 1.36534e+06
n100x8192-slot-inner, 8192, 134, 562, 853, 0, 0, 1549, 1.36534e+06
n100x8192-slot-inner, 8192, 132, 564, 858, 0, 0, 1554, 1.36534e+06
n100x8192-slot-inner, 8192, 133, 570, 866, 0, 0, 1569, 1.36534e+06
n100x8192-slot-inner, 8192, 133, 566, 860, 0, 0, 1559, 1.36534e+06
n100x8192-slot-inner, 8192, 136, 564, 857, 1, 0, 1558, 1.36534e+06
n100x8192-slot-inner, 8192, 133, 562, 855, 0, 0, 1550, 1.36534e+06
n100x8192-slot-inner, 8192, 134, 565, 851, 0, 0, 1550, 1.36534e+06
n100x8192-slot-inner, 8192, 134, 564, 854, 0, 0, 1552, 1.36534e+06
n100x8192-slot-inner, 8192, 134, 563, 852, 0, 0, 1549, 1.36534e+06
n100x8192-slot-inner, 8192, 133, 566, 856, 0, 0, 1555, 1.36534e+06
n100x8192-slot-inner, 8192, 135, 564, 854, 0, 0, 1553, 1.36534e+06
n100x8192-slot-inner, 8192, 135, 567, 856, 0, 0, 1558, 1.36534e+06
n100x8192-slot-inner, 8192, 136, 574, 872, 0, 0, 1582, 1.36534e+06
n100x8192-slot-inner, 8192, 135, 569, 855, 0, 0, 1559, 1.36534e+06
n100x8192-slot-inner, 8192, 134, 563, 862, 0, 0, 1559, 1.36534e+06
n100x8192-slot-inner, 8192, 134, 564, 848, 0, 0, 1546, 1.36534e+06
n100x8192-slot-inner, 8192, 135, 567, 852, 0, 0, 1554, 1.36534e+06
n100x8192-slot-inner, 8192, 133, 564, 854, 0, 0, 1551, 1.36534e+06
n100x8192-slot-inner, 8192, 133, 567, 857, 0, 0, 1557, 1.36534e+06
n100x8192-slot-inner, 8192, 134, 564, 852, 0, 0, 1550, 1.36534e+06
n100x8192-slot-inner, 8192, 134, 561, 856, 0, 0, 1551, 1.36534e+06
n100x8192-slot-inner, 8192, 134, 566, 859, 1, 0, 1560, 1.36534e+06
n100x8192-slot-inner, 8192, 134, 564, 854, 0, 0, 1552, 1.36534e+06
n100x8192-slot-inner, 8192, 134, 570, 848, 0, 0, 1552, 1.36534e+06
n100x8192-slot-inner, 8192, 134, 562, 855, 0, 0, 1551, 1.36534e+06
n100x8192-slot-inner, 8192, 135, 567, 856, 0, 0, 1558, 1.36534e+06
n100x8192-slot-inner, 8192, 133, 561, 850, 0, 0, 1544, 1.36534e+06
n100x8192-slot-inner, 8192, 134, 565, 852, 0, 0, 1551, 1.36534e+06
n100x8192-slot-inner, 8192, 134, 564, 854, 0, 0, 1552, 1.36534e+06
n100x8192-slot-inner, 8192, 134, 568, 853, 0, 0, 1555, 1.36534e+06
n100x8192-slot-inner, 4096, 64, 556, 826, 0, 0, 1446, 1.36534e+06
n100x8192-slot-inner, 4096, 64, 547, 828, 0, 0, 1439, 1.36534e+06
n100x8192-slot-inner, 4096, 64, 548, 823, 0, 0, 1435, 1.36534e+06
n100x8192-slot-inner, 4096, 63, 555, 823, 0, 0, 1441, 1.36534e+06
n100x8192-slot-inner, 4096, 63, 545, 826, 0, 0, 1434, 1.36534e+06
n100x8192-slot-inner, 4096, 63, 545, 820, 0, 0, 1428, 1.36534e+06
n100x8192-slot-inner, 4096, 64, 545, 821, 0, 0, 1430, 1.36534e+06
n100x8192-slot-inner, 4096, 64, 547, 826, 0, 0, 1437, 1.36534e+06
n100x8192-slot-inner, 4096, 63, 546, 824, 0, 0, 1433, 1.36534e+06
n100x8192-slot-inner, 4096, 63, 544, 824, 0, 0, 1431, 1.36534e+06
n100x8192-slot-inner, 4096, 64, 547, 822, 0, 0, 1433, 1.36534e+06
n100x8192-slot-inner, 4096, 64, 545, 828, 0, 0, 1437, 1.36534e+06
n100x8192-slot-inner, 4096, 64, 550, 820, 0, 0, 1434, 1.36534e+06
n100x8192-slot-inner, 4096, 64, 545, 821, 0, 0, 1430, 1.36534e+06
n100x8192-slot-inner, 4096, 63, 550, 823, 0, 0, 1436, 1.36534e+06
n100x8192-slot-inner, 4096, 64, 545, 819, 0, 0, 1428, 1.36534e+06
n100x8192-slot-inner, 4096, 63, 547, 830, 0, 0, 1440, 1.36534e+06
n100x8192-slot-inner, 4096, 64, 546, 828, 0, 0, 1438, 1.36534e+06
n100x8192-slot-inner, 4096, 63, 547, 829, 0, 0, 1439, 1.36534e+06
n100x8192-slot-inner, 4096, 64, 548, 826, 0, 0, 1438, 1.36534e+06
n100x8192-slot-inner, 4096, 64, 546, 824, 0, 0, 1434, 1.36534e+06
n100x8192-slot-inner, 4096, 63, 558, 824, 0, 0, 1445, 1.36534e+06
n100x8192-slot-inner, 4096, 64, 550, 827, 0, 0, 1441, 1.36534e+06
n100x8192-slot-inner, 4096, 64, 554, 819, 0, 0, 1437, 1.36534e+06
n100x8192-slot-inner, 4096, 64, 553, 828, 0, 0, 1445, 1.36534e+06
n100x8192-slot-inner, 4096, 63, 546, 821, 0, 0, 1430, 1.36534e+06
n100x8192-slot-inner, 4096, 64, 549, 829, 0, 0, 1442, 1.36534e+06
n100x8192-slot-inner, 4096, 65, 546, 819, 0, 0, 1430, 1.36534e+06
n100x8192-slot-inner, 4096, 64, 548, 824, 0, 0, 1436, 1.36534e+06
n100x8192-slot-inner, 4096, 63, 543, 819, 0, 0, 1425, 1.36534e+06
n100x8192-slot-inner, 4096, 64, 548, 832, 0, 0, 1444, 1.36534e+06
n100x8192-slot-inner, 4096, 64, 549, 830, 0, 0, 1443, 1.36534e+06
n100x8192-slot-inner, 4096, 64, 547, 820, 0, 0, 1431, 1.36534e+06
n100x8192-slot-inner, 4096, 63, 544, 823, 0, 0, 1430, 1.36534e+06
n100x8192-slot-inner, 4096, 63, 547, 823, 0, 0, 1433, 1.36534e+06
n100x8192-slot-inner, 4096, 63, 545, 821, 0, 0, 1429, 1.36534e+06
n100x8192-slot-inner, 4096, 64, 554, 823, 0, 0, 1441, 1.36534e+06
n100x8192-slot-inner, 4096, 64, 547, 824, 0, 0, 1435, 1.36534e+06
n100x8192-slot-inner, 4096, 64, 548, 822, 0, 0, 1434, 1.36534e+06
n100x8192-slot-inner, 4096, 64, 548, 826, 0, 0, 1438, 1.36534e+06
n100x8192-slot-inner, 4096, 63, 548, 827, 0, 0, 1438, 1.36534e+06
n100x8192-slot-inner, 4096, 64, 547, 824, 0, 0, 1435, 1.36534e+06
n100x8192-slot-inner, 4096, 64, 548, 829, 0, 0, 1441, 1.36534e+06
n100x8192-slot-inner, 4096, 64, 546, 824, 0, 0, 1434, 1.36534e+06
n100x8192-slot-inner, 4096, 63, 544, 829, 0, 0, 1436, 1.36534e+06
n100x8192-slot-inner, 4096, 64, 546, 819, 0, 0, 1429, 1.36534e+06
n100x8192-slot-inner, 4096, 63, 547, 820, 0, 0, 1430, 1.36534e+06
n100x8192-slot-inner, 4096, 64, 548, 824, 0, 0, 1436, 1.36534e+06
n100x8192-slot-inner, 4096, 63, 547, 823, 0, 0, 1433, 1.36534e+06
n100x8192-slot-inner, 4096, 64, 550, 825, 0, 0, 1439, 1.36534e+06
n100x8192-slot-inner, 4096, 64, 549, 824, 0, 0, 1437, 1.36534e+06
n100x8192-slot-inner, 4096, 64, 547, 826, 0, 0, 1437, 1.36534e+06
n100x8192-slot-inner, 4096, 63, 550, 826, 0, 0, 1439, 1.36534e+06
n100x8192-slot-inner, 4096, 63, 545, 825, 0, 0, 1433, 1.36534e+06
n100x8192-slot-inner, 4096, 63, 550, 821, 0, 0, 1434, 1.36534e+06
n100x8192-slot-inner, 4096, 63, 549, 825, 0, 0, 1437, 1.36534e+06
n100x8192-slot-inner, 4096, 64, 549, 825, 0, 0, 1438, 1.36534e+06
n100x8192-slot-inner, 4096, 63, 544, 824, 0, 0, 1431, 1.36534e+06
n100x8192-slot-inner, 4096, 63, 550, 822, 0, 0, 1435, 1.36534e+06
n100x8192-slot-inner, 4096, 63, 548, 825, 0, 0, 1436, 1.36534e+06
n100x8192-slot-inner, 4096, 64, 551, 828, 0, 0, 1443, 1.36534e+06
n100x8192-slot-inner, 4096, 64, 560, 830, 0, 0, 1454, 1.36534e+06
n100x8192-slot-inner, 4096, 64, 548, 823, 0, 0, 1435, 1.36534e+06
n100x8192-slot-inner, 4096, 64, 545, 833, 0, 0, 1442, 1.36534e+06
n100x8192-slot-inner, 4096, 64, 547, 820, 0, 0, 1431, 1.36534e+06
n100x8192-slot-inner, 4096, 64, 546, 826, 0, 0, 1436, 1.36534e+06
n100x8192-slot-inner, 4096, 64, 548, 826, 0, 0, 1438, 1.36534e+06
n100x8192-slot-inner, 4096, 64, 547, 830, 0, 0, 1441, 1.36534e+06
n100x8192-slot-inner, 4096, 64, 549, 820, 0, 0, 1433, 1.36534e+06
n100x8192-slot-inner, 4096, 63, 544, 822, 0, 0, 1429, 1.36534e+06
n100x8192-slot-inner, 4096, 64, 548, 827, 0, 0, 1439, 1.36534e+06
n100x8192-slot-inner, 4096, 64, 547, 941, 0, 0, 1552, 1.36534e+06
n100x8192-slot-inner, 4096, 64, 546, 832, 0, 0, 1442, 1.36534e+06
n100x8192-slot-inner, 4096, 65, 545, 826, 0, 0, 1436, 1.36534e+06
n100x8192-slot-inner, 4096, 64, 549, 819, 0, 0, 1432, 1.36534e+06
n100x8192-slot-inner, 4096, 64, 547, 821, 0, 0, 1432, 1.36534e+06
n100x8192-slot-inner, 4096, 63, 547, 828, 0, 0, 1438, 1.36534e+06
n100x8192-slot-inner, 4096, 64, 545, 824, 0, 0, 1433, 1.36534e+06
n100x8192-slot-inner, 4096, 64, 550, 829, 0, 0, 1443, 1.36534e+06
n100x8192-slot-inner, 4096, 64, 547, 822, 0, 0, 1433, 1.36534e+06
n100x8192-slot-inner, 4096, 64, 550, 822, 0, 0, 1436, 1.36534e+06
n100x8192-slot-inner, 4096, 65, 548, 828, 0, 0, 1441, 1.36534e+06
n100x8192-slot-inner, 4096, 64, 549, 820, 0, 0, 1433, 1.36534e+06
n100x8192-slot-inner, 4096, 64, 544, 824, 0, 0, 1432, 1.36534e+06
n100x8192-slot-inner, 4096, 63, 547, 821, 0, 0, 1431, 1.36534e+06
n100x8192-slot-inner, 4096, 64, 549, 822, 0, 0, 1435, 1.36534e+06
n100x8192-slot-inner, 4096, 64, 550, 823, 0, 0, 1437, 1.36534e+06
n100x8192-slot-inner, 4096, 64, 545, 825, 0, 0, 1434, 1.36534e+06
n100x8192-slot-inner, 4096, 63, 546, 822, 0, 0, 1431, 1.36534e+06
n100x8192-slot-inner, 4096, 63, 547, 823, 0, 0, 1433, 1.36534e+06
n100x8192-slot-inner, 4096, 64, 547, 823, 0, 0, 1434, 1.36534e+06
n100x8192-slot-inner, 4096, 63, 550, 821, 0, 0, 1434, 1.36534e+06
n100x8192-slot-inner, 4096, 64, 549, 823, 0, 0, 1436, 1.36534e+06
n100x8192-slot-inner, 4096, 64, 546, 825, 0, 0, 1435, 1.36534e+06
n100x8192-slot-inner, 4096, 63, 554, 823, 0, 0, 1440, 1.36534e+06
n100x8192-slot-inner, 4096, 64, 552, 829, 0, 0, 1445, 1.36534e+06
n100x8192-slot-inner, 4096, 63, 547, 824, 0, 0, 1434, 1.36534e+06
n100x8192-slot-inner, 4096, 64, 548, 823, 0, 0, 1435, 1.36534e+06
n100x8192-slot-inner, 4096, 63, 546, 827, 0, 0, 1436, 1.36534e+06
n100x8192-slot-inner, 4096, 64, 548, 832, 0, 0, 1444, 1.36534e+06
n100x8192-slot-inner, 2048, 31, 543, 821, 0, 0, 1395, 1.36534e+06
n100x8192-slot-inner, 2048, 31, 569, 960, 0, 0, 1560, 1.36534e+06
n100x8192-slot-inner, 2048, 32, 541, 820, 0, 0, 1393, 1.36534e+06
n100x8192-slot-inner, 2048, 32, 535, 826, 0, 0, 1393, 1.36534e+06
n100x8192-slot-inner, 2048, 31, 541, 821, 0, 0, 1393, 1.36534e+06
n100x8192-slot-inner, 2048, 31, 537, 823, 0, 0, 1391, 1.36534e+06
n100x8192-slot-inner, 2048, 32, 539, 816, 0, 0, 1387, 1.36534e+06
n100x8192-slot-inner, 2048, 32, 537, 822, 0, 0, 1391, 1.36534e+06
n100x8192-slot-inner, 2048, 32, 540, 821, 0, 0, 1393, 1.36534e+06
n100x8192-slot-inner, 2048, 31, 539, 823, 0, 0, 1393, 1.36534e+06
n100x8192-slot-inner, 2048, 31, 538, 823, 0, 0, 1392, 1.36534e+06
n100x8192-slot-inner, 2048, 32, 544, 822, 0, 0, 1398, 1.36534e+06
n100x8192-slot-inner, 2048, 31, 537, 819, 0, 0, 1387, 1.36534e+06
n100x8192-slot-inner, 2048, 32, 538, 818, 0, 0, 1388, 1.36534e+06
n100x8192-slot-inner, 2048, 31, 539, 817, 0, 0, 1387, 1.36534e+06
n100x8192-slot-inner, 2048, 31, 540, 817, 0, 0, 1388, 1.36534e+06
n100x8192-slot-inner, 2048, 31, 538, 824, 0, 0, 1393, 1.36534e+06
n100x8192-slot-inner, 2048, 32, 543, 822, 0, 0, 1397, 1.36534e+06
n100x8192-slot-inner, 2048, 32, 540, 822, 0, 0, 1394, 1.36534e+06
n100x8192-slot-inner, 2048, 33, 541, 817, 0, 0, 1391, 1.36534e+06
n100x8192-slot-inner, 2048, 32, 537, 823, 0, 0, 1392, 1.36534e+06
n100x8192-slot-inner, 2048, 32, 543, 822, 0, 0, 1397, 1.36534e+06
n100x8192-slot-inner, 2048, 32, 537, 822, 0, 0, 1391, 1.36534e+06
n100x8192-slot-inner, 2048, 31, 540, 819, 0, 0, 1390, 1.36534e+06
n100x8192-slot-inner, 2048, 31, 542, 821, 0, 0, 1394, 1.36534e+06
n100x8192-slot-inner, 2048, 32, 541, 817, 0, 0, 1390, 1.36534e+06
n100x8192-slot-inner, 2048, 31, 540, 819, 0, 0, 1390, 1.36534e+06
n100x8192-slot-inner, 2048, 31, 536, 824, 0, 0, 1391, 1.36534e+06
n100x8192-slot-inner, 2048, 31, 539, 815, 0, 0, 1385, 1.36534e+06
n100x8192-slot-inner, 2048, 32, 539, 824, 0, 0, 1395, 1.36534e+06
n100x8192-slot-inner, 2048, 31, 538, 823, 0, 0, 1392, 1.36534e+06
n100x8192-slot-inner, 2048, 32, 539, 825, 0, 0, 1396, 1.36534e+06
n100x8192-slot-inner, 2048, 31, 539, 819, 0, 0, 1389, 1.36534e+06
n100x8192-slot-inner, 2048, 31, 538, 818, 0, 0, 1387, 1.36534e+06
n100x8192-slot-inner, 2048, 31, 538, 821, 0, 0, 1390, 1.36534e+06
n100x8192-slot-inner, 2048, 32, 544, 820, 0, 0, 1396, 1.36534e+06
n100x8192-slot-inner, 2048, 32, 540, 822, 0, 0, 1394, 1.36534e+06
n100x8192-slot-inner, 2048, 32, 539, 823, 0, 0, 1394, 1.36534e+06
n100x8192-slot-inner, 2048, 31, 544, 821, 0, 0, 1396, 1.36534e+06
n100x8192-slot-inner, 2048, 31, 539, 822, 0, 0, 1392, 1.36534e+06
n100x8192-slot-inner, 2048, 32, 537, 821, 0, 0, 1390, 1.36534e+06
n100x8192-slot-inner, 2048, 32, 541, 823, 0, 0, 1396, 1.36534e+06
n100x8192-slot-inner, 2048, 32, 551, 822, 0, 0, 1405, 1.36534e+06
n100x8192-slot-inner, 2048, 32, 540, 818, 0, 0, 1390, 1.36534e+06
n100x8192-slot-inner, 2048, 32, 540, 826, 0, 0, 1398, 1.36534e+06
n100x8192-slot-inner, 2048, 31, 538, 820, 0, 0, 1389, 1.36534e+06
n100x8192-slot-inner, 2048, 31, 535, 819, 0, 0, 1385, 1.36534e+06
n100x8192-slot-inner, 2048, 31, 542, 816, 0, 0, 1389, 1.36534e+06
n100x8192-slot-inner, 2048, 32, 543, 822, 0, 0, 1397, 1.36534e+06
n100x8192-slot-inner, 2048, 31, 535, 820, 0, 0, 1386, 1.36534e+06
n100x8192-slot-inner, 2048, 31, 539, 820, 0, 0, 1390, 1.36534e+06
n100x8192-slot-inner, 2048, 32, 539, 823, 0, 0, 1394, 1.36534e+06
n100x8192-slot-inner, 2048, 31, 540, 820, 0, 0, 1391, 1.36534e+06
n100x8192-slot-inner, 2048, 32, 538, 818, 0, 0, 1388, 1.36534e+06
n100x8192-slot-inner, 2048, 31, 538, 817, 0, 0, 1386, 1.36534e+06
n100x8192-slot-inner, 2048, 32, 540, 823, 0, 0, 1395, 1.36534e+06
n100x8192-slot-inner, 2048, 31, 535, 820, 0, 0, 1386, 1.36534e+06
n100x8192-slot-inner, 2048, 32, 543, 828, 0, 0, 1403, 1.36534e+06
n100x8192-slot-inner, 2048, 31, 538, 819, 0, 0, 1388, 1.36534e+06
n100x8192-slot-inner, 2048, 31, 538, 818, 0, 0, 1387, 1.36534e+06
n100x8192-slot-inner, 2048, 32, 541, 819, 0, 0, 1392, 1.36534e+06
n100x8192-slot-inner, 2048, 32, 540, 816, 0, 0, 1388, 1.36534e+06
n100x8192-slot-inner, 2048, 31, 537, 826, 0, 0, 1394, 1.36534e+06
n100x8192-slot-inner, 2048, 32, 547, 827, 0, 0, 1406, 1.36534e+06
n100x8192-slot-inner, 2048, 31, 539, 819, 0, 0, 1389, 1.36534e+06
n100x8192-slot-inner, 2048, 32, 539, 822, 0, 0, 1393, 1.36534e+06
n100x8192-slot-inner, 2048, 32, 537, 816, 0, 0, 1385, 1.36534e+06
n100x8192-slot-inner, 2048, 32, 536, 821, 0, 0, 1389, 1.36534e+06
n100x8192-slot-inner, 2048, 32, 542, 818, 0, 0, 1392, 1.36534e+06
n100x8192-slot-inner, 2048, 31, 538, 824, 0, 0, 1393, 1.36534e+06
n100x8192-slot-inner, 2048, 31, 542, 823, 0, 0, 1396, 1.36534e+06
n100x8192-slot-inner, 2048, 32, 539, 821, 0, 0, 1392, 1.36534e+06
n100x8192-slot-inner, 2048, 31, 539, 822, 0, 0, 1392, 1.36534e+06
n100x8192-slot-inner, 2048, 31, 539, 821, 0, 0, 1391, 1.36534e+06
n100x8192-slot-inner, 2048, 32, 538, 822, 0, 0, 1392, 1.36534e+06
n100x8192-slot-inner, 2048, 31, 538, 821, 0, 0, 1390, 1.36534e+06
n100x8192-slot-inner, 2048, 32, 542, 818, 0, 0, 1392, 1.36534e+06
n100x8192-slot-inner, 2048, 32, 541, 819, 0, 0, 1392, 1.36534e+06
n100x8192-slot-inner, 2048, 32, 541, 823, 0, 0, 1396, 1.36534e+06
n100x8192-slot-inner, 2048, 31, 539, 825, 0, 0, 1395, 1.36534e+06
n100x8192-slot-inner, 2048, 31, 536, 816, 0, 0, 1383, 1.36534e+06
n100x8192-slot-inner, 2048, 31, 537, 821, 0, 0, 1389, 1.36534e+06
n100x8192-slot-inner, 2048, 32, 542, 820, 0, 0, 1394, 1.36534e+06
n100x8192-slot-inner, 2048, 31, 540, 934, 0, 0, 1505, 1.36534e+06
n100x8192-slot-inner, 2048, 32, 539, 824, 0, 0, 1395, 1.36534e+06
n100x8192-slot-inner, 2048, 31, 539, 820, 0, 0, 1390, 1.36534e+06
n100x8192-slot-inner, 2048, 32, 541, 826, 0, 0, 1399, 1.36534e+06
n100x8192-slot-inner, 2048, 31, 541, 818, 0, 0, 1390, 1.36534e+06
n100x8192-slot-inner, 2048, 32, 539, 822, 0, 0, 1393, 1.36534e+06
n100x8192-slot-inner, 2048, 32, 538, 821, 0, 0, 1391, 1.36534e+06
n100x8192-slot-inner, 2048, 31, 538, 824, 0, 0, 1393, 1.36534e+06
n100x8192-slot-inner, 2048, 32, 541, 821, 0, 0, 1394, 1.36534e+06
n100x8192-slot-inner, 2048, 31, 542, 827, 0, 0, 1400, 1.36534e+06
n100x8192-slot-inner, 2048, 32, 539, 823, 0, 0, 1394, 1.36534e+06
n100x8192-slot-inner, 2048, 31, 543, 820, 0, 0, 1394, 1.36534e+06
n100x8192-slot-inner, 2048, 31, 538, 828, 0, 0, 1397, 1.36534e+06
n100x8192-slot-inner, 2048, 32, 537, 822, 0, 0, 1391, 1.36534e+06
n100x8192-slot-inner, 2048, 32, 537, 822, 0, 0, 1391, 1.36534e+06
n100x8192-slot-inner, 2048, 32, 539, 819, 0, 0, 1390, 1.36534e+06
n100x8192-slot-inner, 2048, 32, 538, 823, 0, 0, 1393, 1.36534e+06
n100x8192-slot-inner, 1024, 32, 687, 1314, 0, 0, 2033, 1.36534e+06
n100x8192-slot-inner, 1024, 32, 689, 1316, 0, 0, 2037, 1.36534e+06
n100x8192-slot-inner, 1024, 33, 695, 1324, 0, 0, 2052, 1.36534e+06
n100x8192-slot-inner, 1024, 32, 695, 1315, 0, 0, 2042, 1.36534e+06
n100x8192-slot-inner, 1024, 32, 688, 1323, 0, 0, 2043, 1.36534e+06
n100x8192-slot-inner, 1024, 32, 693, 1311, 0, 0, 2036, 1.36534e+06
n100x8192-slot-inner, 1024, 33, 688, 1307, 0, 0, 2028, 1.36534e+06
n100x8192-slot-inner, 1024, 33, 688, 1309, 0, 0, 2030, 1.36534e+06
n100x8192-slot-inner, 1024, 32, 690, 1319, 0, 0, 2041, 1.36534e+06
n100x8192-slot-inner, 1024, 36, 688, 1365, 0, 0, 2089, 1.36534e+06
n100x8192-slot-inner, 1024, 32, 692, 1319, 0, 0, 2043, 1.36534e+06
n100x8192-slot-inner, 1024, 32, 692, 1318, 0, 0, 2042, 1.36534e+06
n100x8192-slot-inner, 1024, 33, 693, 1322, 0, 0, 2048, 1.36534e+06
n100x8192-slot-inner, 1024, 32, 690, 1325, 0, 0, 2047, 1.36534e+06
n100x8192-slot-inner, 1024, 32, 692, 1318, 0, 0, 2042, 1.36534e+06
n100x8192-slot-inner, 1024, 32, 691, 1316, 0, 0, 2039, 1.36534e+06
n100x8192-slot-inner, 1024, 31, 689, 1319, 0, 0, 2039, 1.36534e+06
n100x8192-slot-inner, 1024, 33, 705, 1318, 0, 0, 2056, 1.36534e+06
n100x8192-slot-inner, 1024, 33, 693, 1339, 0, 0, 2065, 1.36534e+06
n100x8192-slot-inner, 1024, 33, 694, 1317, 0, 0, 2044, 1.36534e+06
n100x8192-slot-inner, 1024, 33, 689, 1318, 0, 0, 2040, 1.36534e+06
n100x8192-slot-inner, 1024, 33, 694, 1316, 0, 0, 2043, 1.36534e+06
n100x8192-slot-inner, 1024, 33, 690, 1320, 0, 0, 2043, 1.36534e+06
n100x8192-slot-inner, 1024, 32, 699, 1318, 0, 0, 2049, 1.36534e+06
n100x8192-slot-inner, 1024, 32, 690, 1318, 0, 0, 2040, 1.36534e+06
n100x8192-slot-inner, 1024, 32, 689, 1315, 0, 0, 2036, 1.36534e+06
n100x8192-slot-inner, 1024, 36, 693, 1368, 0, 0, 2097, 1.36534e+06
n100x8192-slot-inner, 1024, 32, 693, 1316, 0, 0, 2041, 1.36534e+06
n100x8192-slot-inner, 1024, 32, 690, 1324, 0, 0, 2046, 1.36534e+06
n100x8192-slot-inner, 1024, 33, 690, 1321, 0, 0, 2044, 1.36534e+06
n100x8192-slot-inner, 1024, 32, 687, 1323, 0, 0, 2042, 1.36534e+06
n100x8192-slot-inner, 1024, 33, 695, 1323, 0, 0, 2051, 1.36534e+06
n100x8192-slot-inner, 1024, 32, 689, 1311, 0, 0, 2032, 1.36534e+06
n100x8192-slot-inner, 1024, 32, 689, 1319, 0, 0, 2040, 1.36534e+06
n100x8192-slot-inner, 1024, 32, 689, 1314, 0, 0, 2035, 1.36534e+06
n100x8192-slot-inner, 1024, 36, 692, 1368, 0, 0, 2096, 1.36534e+06
n100x8192-slot-inner, 1024, 32, 693, 1320, 0, 0, 2045, 1.36534e+06
n100x8192-slot-inner, 1024, 32, 688, 1321, 0, 0, 2041, 1.36534e+06
n100x8192-slot-inner, 1024, 33, 692, 1325, 0, 0, 2050, 1.36534e+06
n100x8192-slot-inner, 1024, 35, 688, 1366, 0, 0, 2089, 1.36534e+06
n100x8192-slot-inner, 1024, 32, 697, 1322, 0, 0, 2051, 1.36534e+06
n100x8192-slot-inner, 1024, 32, 692, 1314, 0, 0, 2038, 1.36534e+06
n100x8192-slot-inner, 1024, 32, 691, 1320, 0, 0, 2043, 1.36534e+06
n100x8192-slot-inner, 1024, 33, 690, 1320, 0, 0, 2043, 1.36534e+06
n100x8192-slot-inner, 1024, 33, 694, 1322, 0, 0, 2049, 1.36534e+06
n100x8192-slot-inner, 1024, 32, 693, 1376, 0, 0, 2101, 1.36534e+06
n100x8192-slot-inner, 1024, 32, 688, 1319, 0, 0, 2039, 1.36534e+06
n100x8192-slot-inner, 1024, 32, 692, 1325, 0, 0, 2049, 1.36534e+06
n100x8192-slot-inner, 1024, 33, 687, 1323, 0, 0, 2043, 1.36534e+06
n100x8192-slot-inner, 1024, 32, 692, 1322, 0, 0, 2046, 1.36534e+06
n100x8192-slot-inner, 1024, 32, 690, 1313, 0, 0, 2035, 1.36534e+06
n100x8192-slot-inner, 1024, 32, 690, 1319, 0, 0, 2041, 1.36534e+06
n100x8192-slot-inner, 1024, 32, 691, 1322, 0, 0, 2045, 1.36534e+06
n100x8192-slot-inner, 1024, 31, 687, 1319, 0, 0, 2037, 1.36534e+06
n100x8192-slot-inner, 1024, 32, 691, 1310, 0, 0, 2033, 1.36534e+06
n100x8192-slot-inner, 1024, 32, 692, 1319, 0, 0, 2043, 1.36534e+06
n100x8192-slot-inner, 1024, 32, 691, 1321, 0, 0, 2044, 1.36534e+06
n100x8192-slot-inner, 1024, 32, 691, 1316, 0, 0, 2039, 1.36534e+06
n100x8192-slot-inner, 1024, 33, 694, 1314, 0, 0, 2041, 1.36534e+06
n100x8192-slot-inner, 1024, 32, 689, 1320, 0, 0, 2041, 1.36534e+06
n100x8192-slot-inner, 1024, 32, 691, 1312, 0, 0, 2035, 1.36534e+06
n100x8192-slot-inner, 1024, 33, 692, 1327, 0, 0, 2052, 1.36534e+06
n100x8192-slot-inner, 1024, 32, 690, 1312, 0, 0, 2034, 1.36534e+06
n100x8192-slot-inner, 1024, 32, 696, 1315, 0, 0, 2043, 1.36534e+06
n100x8192-slot-inner, 1024, 33, 693, 1315, 0, 0, 2041, 1.36534e+06
n100x8192-slot-inner, 1024, 32, 694, 1319, 0, 0, 2045, 1.36534e+06
n100x8192-slot-inner, 1024, 33, 695, 1327, 0, 0, 2055, 1.36534e+06
n100x8192-slot-inner, 1024, 33, 693, 1317, 0, 0, 2043, 1.36534e+06
n100x8192-slot-inner, 1024, 32, 691, 1329, 0, 0, 2052, 1.36534e+06
n100x8192-slot-inner, 1024, 32, 692, 1311, 0, 0, 2035, 1.36534e+06
n100x8192-slot-inner, 1024, 33, 690, 1316, 0, 0, 2039, 1.36534e+06
n100x8192-slot-inner, 1024, 32, 691, 1317, 0, 0, 2040, 1.36534e+06
n100x8192-slot-inner, 1024, 32, 691, 1314, 0, 0, 2037, 1.36534e+06
n100x8192-slot-inner, 1024, 32, 694, 1333, 0, 0, 2059, 1.36534e+06
n100x8192-slot-inner, 1024, 35, 689, 1365, 0, 0, 2089, 1.36534e+06
n100x8192-slot-inner, 1024, 32, 691, 1324, 0, 0, 2047, 1.36534e+06
n100x8192-slot-inner, 1024, 32, 695, 1319, 0, 0, 2046, 1.36534e+06
n100x8192-slot-inner, 1024, 32, 687, 1317, 0, 0, 2036, 1.36534e+06
n100x8192-slot-inner, 1024, 36, 689, 1365, 0, 0, 2090, 1.36534e+06
n100x8192-slot-inner, 1024, 32, 689, 1314, 0, 0, 2035, 1.36534e+06
n100x8192-slot-inner, 1024, 32, 694, 1324, 0, 0, 2050, 1.36534e+06
n100x8192-slot-inner, 1024, 33, 692, 1314, 0, 0, 2039, 1.36534e+06
n100x8192-slot-inner, 1024, 32, 694, 1319, 0, 0, 2045, 1.36534e+06
n100x8192-slot-inner, 1024, 33, 690, 1320, 0, 0, 2043, 1.36534e+06
n100x8192-slot-inner, 1024, 32, 687, 1314, 0, 0, 2033, 1.36534e+06
n100x8192-slot-inner, 1024, 33, 687, 1317, 0, 0, 2037, 1.36534e+06
n100x8192-slot-inner, 1024, 32, 688, 1326, 0, 0, 2046, 1.36534e+06
n100x8192-slot-inner, 1024, 31, 688, 1323, 0, 0, 2042, 1.36534e+06
n100x8192-slot-inner, 1024, 32, 691, 1320, 0, 0, 2043, 1.36534e+06
n100x8192-slot-inner, 1024, 32, 689, 1315, 0, 0, 2036, 1.36534e+06
n100x8192-slot-inner, 1024, 31, 689, 1318, 0, 0, 2038, 1.36534e+06
n100x8192-slot-inner, 1024, 32, 693, 1313, 0, 0, 2038, 1.36534e+06
n100x8192-slot-inner, 1024, 34, 699, 1317, 0, 0, 2050, 1.36534e+06
n100x8192-slot-inner, 1024, 32, 687, 1312, 0, 0, 2031, 1.36534e+06
n100x8192-slot-inner, 1024, 32, 687, 1322, 0, 0, 2041, 1.36534e+06
n100x8192-slot-inner, 1024, 33, 694, 1327, 0, 0, 2054, 1.36534e+06
n100x8192-slot-inner, 1024, 32, 689, 1321, 0, 0, 2042, 1.36534e+06
n100x8192-slot-inner, 1024, 33, 695, 1314, 0, 0, 2042, 1.36534e+06
n100x8192-slot-inner, 1024, 33, 692, 1310, 0, 0, 2035, 1.36534e+06
n100x8192-slot-inner, 1024, 32, 694, 1320, 0, 0, 2046, 1.36534e+06
n100x8192-coef-inner, 8192, 30, 2053, 827, 0, 0, 2910, 1.36534e+06
n100x8192-coef-inner, 8192, 29, 2054, 827, 0, 0, 2910, 1.36534e+06
n100x8192-coef-inner, 8192, 29, 2055, 837, 0, 0, 2921, 1.36534e+06
n100x8192-coef-inner, 8192, 29, 2060, 829, 0, 0, 2918, 1.36534e+06
n100x8192-coef-inner, 8192, 30, 2039, 827, 0, 0, 2896, 1.36534e+06
n100x8192-coef-inner, 8192, 30, 2047, 829, 0, 0, 2906, 1.36534e+06
n100x8192-coef-inner, 8192, 29, 2047, 835, 0, 0, 2911, 1.36534e+06
n100x8192-coef-inner, 8192, 29, 2045, 832, 0, 0, 2906, 1.36534e+06
n100x8192-coef-inner, 8192, 29, 2043, 827, 0, 0, 2899, 1.36534e+06
n100x8192-coef-inner, 8192, 29, 2038, 832, 0, 0, 2899, 1.36534e+06
n100x8192-coef-inner, 8192, 30, 2048, 826, 0, 0, 2904, 1.36534e+06
n100x8192-coef-inner, 8192, 29, 2049, 840, 0, 0, 2918, 1.36534e+06
n100x8192-coef-inner, 8192, 29, 2047, 827, 0, 0, 2903, 1.36534e+06
n100x8192-coef-inner, 8192, 30, 2049, 831, 0, 0, 2910, 1.36534e+06
n100x8192-coef-inner, 8192, 29, 2045, 827, 0, 0, 2901, 1.36534e+06
n100x8192-coef-inner, 8192, 29, 2045, 830, 0, 0, 2904, 1.36534e+06
n100x8192-coef-inner, 8192, 30, 2066, 833, 0, 0, 2929, 1.36534e+06
n100x8192-coef-inner, 8192, 29, 2053, 834, 0, 0, 2916, 1.36534e+06
n100x8192-coef-inner, 8192, 29, 2049, 833, 0, 0, 2911, 1.36534e+06
n100x8192-coef-inner, 8192, 29, 2048, 834, 0, 0, 2911, 1.36534e+06
n100x8192-coef-inner, 8192, 29, 2046, 843, 0, 0, 2918, 1.36534e+06
n100x8192-coef-inner, 8192, 30, 2056, 853, 0, 0, 2939, 1.36534e+06
n100x8192-coef-inner, 8192, 30, 2055, 835, 0, 0, 2920, 1.36534e+06
n100x8192-coef-inner, 8192, 30, 2052, 832, 0, 0, 2914, 1.36534e+06
n100x8192-coef-inner, 8192, 30, 2054, 832, 0, 0, 2916, 1.36534e+06
n100x8192-coef-inner, 8192, 29, 2065, 834, 0, 0, 2928, 1.36534e+06
n100x8192-coef-inner, 8192, 29, 2050, 830, 0, 0, 2909, 1.36534e+06
n100x8192-coef-inner, 8192, 30, 2051, 830, 0, 0, 2911, 1.36534e+06
n100x8192-coef-inner, 8192, 29, 2054, 833, 0, 0, 2916, 1.36534e+06
n100x8192-coef-inner, 8192, 29, 2048, 833, 0, 0, 2910, 1.36534e+06
n100x8192-coef-inner, 8192, 29, 2049, 827, 0, 0, 2905, 1.36534e+06
n100x8192-coef-inner, 8192, 29, 2054, 838, 0, 0, 2921, 1.36534e+06
n100x8192-coef-inner, 8192, 29, 2050, 832, 0, 0, 2911, 1.36534e+06
n100x8192-coef-inner, 8192, 29, 2050, 830, 0, 0, 2909, 1.36534e+06
n100x8192-coef-inner, 8192, 29, 2050, 834, 0, 0, 2913, 1.36534e+06
n100x8192-coef-inner, 8192, 29, 2047, 835, 0, 0, 2911, 1.36534e+06
n100x8192-coef-inner, 8192, 30, 2052, 833, 0, 0, 2915, 1.36534e+06
n100x8192-coef-inner, 8192, 29, 2046, 834, 0, 0, 2909, 1.36534e+06
n100x8192-coef-inner, 8192, 29, 2066, 837, 0, 0, 2932, 1.36534e+06
n100x8192-coef-inner, 8192, 30, 2048, 835, 0, 0, 2913, 1.36534e+06
n100x8192-coef-inner, 8192, 30, 2049, 841, 0, 0, 2920, 1.36534e+06
n100x8192-coef-inner, 8192, 30, 2075, 923, 1, 0, 3029, 1.36534e+06
n100x8192-coef-inner, 8192, 29, 2054, 837, 0, 0, 2920, 1.36534e+06
n100x8192-coef-inner, 8192, 30, 2059, 838, 0, 0, 2927, 1.36534e+06
n100x8192-coef-inner, 8192, 30, 2057, 839, 0, 0, 2926, 1.36534e+06
n100x8192-coef-inner, 8192, 29, 2055, 833, 0, 0, 2917, 1.36534e+06
n100x8192-coef-inner, 8192, 30, 2060, 838, 0, 0, 2928, 1.36534e+06
n100x8192-coef-inner, 8192, 29, 2064, 843, 0, 0, 2936, 1.36534e+06
n100x8192-coef-inner, 8192, 30, 2071, 841, 0, 0, 2942, 1.36534e+06
n100x8192-coef-inner, 8192, 30, 2065, 837, 0, 0, 2932, 1.36534e+06
n100x8192-coef-inner, 8192, 29, 2051, 831, 0, 0, 2911, 1.36534e+06
n100x8192-coef-inner, 8192, 30, 2057, 834, 0, 0, 2921, 1.36534e+06
n100x8192-coef-inner, 8192, 30, 2048, 832, 0, 0, 2910, 1.36534e+06
n100x8192-coef-inner, 8192, 30, 2054, 834, 0, 0, 2918, 1.36534e+06
n100x8192-coef-inner, 8192, 30, 2054, 835, 0, 0, 2919, 1.36534e+06
n100x8192-coef-inner, 8192, 29, 2048, 832, 0, 0, 2909, 1.36534e+06
n100x8192-coef-inner, 8192, 30, 2055, 837, 0, 0, 2922, 1.36534e+06
n100x8192-coef-inner, 8192, 30, 2053, 829, 0, 0, 2912, 1.36534e+06
n100x8192-coef-inner, 8192, 29, 2060, 845, 0, 0, 2934, 1.36534e+06
n100x8192-coef-inner, 8192, 30, 2058, 840, 0, 0, 2928, 1.36534e+06
n100x8192-coef-inner, 8192, 30, 2075, 835, 0, 0, 2940, 1.36534e+06
n100x8192-coef-inner, 8192, 30, 2054, 846, 0, 0, 2930, 1.36534e+06
n100x8192-coef-inner, 8192, 30, 2056, 835, 0, 0, 2921, 1.36534e+06
n100x8192-coef-inner, 8192, 30, 2058, 836, 0, 0, 2924, 1.36534e+06
n100x8192-coef-inner, 8192, 29, 2048, 840, 0, 0, 2917, 1.36534e+06
n100x8192-coef-inner, 8192, 30, 2059, 830, 0, 0, 2919, 1.36534e+06
n100x8192-coef-inner, 8192, 30, 2058, 835, 0, 0, 2923, 1.36534e+06
n100x8192-coef-inner, 8192, 30, 2051, 831, 0, 0, 2912, 1.36534e+06
n100x8192-coef-inner, 8192, 30, 2055, 836, 0, 0, 2921, 1.36534e+06
n100x8192-coef-inner, 8192, 29, 2071, 842, 0, 0, 2942, 1.36534e+06
n100x8192-coef-inner, 8192, 29, 2054, 838, 0, 0, 2921, 1.36534e+06
n100x8192-coef-inner, 8192, 30, 2049, 832, 0, 0, 2911, 1.36534e+06
n100x8192-coef-inner, 8192, 29, 2060, 832, 0, 0, 2921, 1.36534e+06
n100x8192-coef-inner, 8192, 29, 2056, 838, 0, 0, 2923, 1.36534e+06
n100x8192-coef-inner, 8192, 29, 2057, 832, 0, 0, 2918, 1.36534e+06
n100x8192-coef-inner, 8192, 29, 2063, 831, 0, 0, 2923, 1.36534e+06
n100x8192-coef-inner, 8192, 29, 2045, 833, 0, 0, 2907, 1.36534e+06
n100x8192-coef-inner, 8192, 29, 2060, 829, 0, 0, 2918, 1.36534e+06
n100x8192-coef-inner, 8192, 30, 2055, 841, 0, 0, 2926, 1.36534e+06
n100x8192-coef-inner, 8192, 29, 2048, 840, 0, 0, 2917, 1.36534e+06
n100x8192-coef-inner, 8192, 29, 2051, 834, 0, 0, 2914, 1.36534e+06
n100x8192-coef-inner, 8192, 29, 2060, 837, 0, 0, 2926, 1.36534e+06
n100x8192-coef-inner, 8192, 29, 2057, 837, 0, 0, 2923, 1.36534e+06
n100x8192-coef-inner, 8192, 29, 2051, 836, 0, 0, 2916, 1.36534e+06
n100x8192-coef-inner, 8192, 29, 2043, 832, 0, 0, 2904, 1.36534e+06
n100x8192-coef-inner, 8192, 29, 2054, 834, 0, 0, 2917, 1.36534e+06
n100x8192-coef-inner, 8192, 29, 2050, 838, 0, 0, 2917, 1.36534e+06
n100x8192-coef-inner, 8192, 30, 2175, 996, 1, 0, 3202, 1.36534e+06
n100x8192-coef-inner, 8192, 29, 2051, 838, 0, 0, 2918, 1.36534e+06
n100x8192-coef-inner, 8192, 29, 2057, 845, 0, 0, 2931, 1.36534e+06
n100x8192-coef-inner, 8192, 30, 2055, 836, 0, 0, 2921, 1.36534e+06
n100x8192-coef-inner, 8192, 30, 2055, 843, 0, 0, 2928, 1.36534e+06
n100x8192-coef-inner, 8192, 30, 2064, 839, 0, 0, 2933, 1.36534e+06
n100x8192-coef-inner, 8192, 30, 2056, 838, 0, 0, 2924, 1.36534e+06
n100x8192-coef-inner, 8192, 29, 2058, 833, 0, 0, 2920, 1.36534e+06
n100x8192-coef-inner, 8192, 29, 2050, 834, 0, 0, 2913, 1.36534e+06
n100x8192-coef-inner, 8192, 30, 2052, 836, 0, 0, 2918, 1.36534e+06
n100x8192-coef-inner, 8192, 29, 2052, 831, 0, 0, 2912, 1.36534e+06
n100x8192-coef-inner, 8192, 29, 2055, 839, 0, 0, 2923, 1.36534e+06
n100x8192-coef-inner, 8192, 30, 2058, 840, 0, 0, 2928, 1.36534e+06
n100x8192-coef-inner, 4096, 16, 2029, 830, 0, 0, 2875, 1.36534e+06
n100x8192-coef-inner, 4096, 16, 2031, 833, 0, 0, 2880, 1.36534e+06
n100x8192-coef-inner, 4096, 25, 2156, 989, 0, 0, 3170, 1.36534e+06
n100x8192-coef-inner, 4096, 17, 2032, 835, 0, 0, 2884, 1.36534e+06
n100x8192-coef-inner, 4096, 16, 2035, 828, 0, 0, 2879, 1.36534e+06
n100x8192-coef-inner, 4096, 16, 2023, 830, 0, 0, 2869, 1.36534e+06
n100x8192-coef-inner, 4096, 16, 2028, 833, 0, 0, 2877, 1.36534e+06
n100x8192-coef-inner, 4096, 16, 2016, 833, 0, 0, 2865, 1.36534e+06
n100x8192-coef-inner, 4096, 16, 2032, 833, 0, 0, 2881, 1.36534e+06
n100x8192-coef-inner, 4096, 16, 2027, 829, 0, 0, 2872, 1.36534e+06
n100x8192-coef-inner, 4096, 16, 2036, 833, 0, 0, 2885, 1.36534e+06
n100x8192-coef-inner, 4096, 16, 2028, 829, 0, 0, 2873, 1.36534e+06
n100x8192-coef-inner, 4096, 16, 2032, 829, 0, 0, 2877, 1.36534e+06
n100x8192-coef-inner, 4096, 16, 2036, 835, 0, 0, 2887, 1.36534e+06
n100x8192-coef-inner, 4096, 16, 2020, 834, 0, 0, 2870, 1.36534e+06
n100x8192-coef-inner, 4096, 17, 2025, 841, 0, 0, 2883, 1.36534e+06
n100x8192-coef-inner, 4096, 16, 2029, 836, 0, 0, 2881, 1.36534e+06
n100x8192-coef-inner, 4096, 16, 2022, 840, 0, 0, 2878, 1.36534e+06
n100x8192-coef-inner, 4096, 16, 2032, 832, 0, 0, 2880, 1.36534e+06
n100x8192-coef-inner, 4096, 16, 2032, 829, 0, 0, 2877, 1.36534e+06
n100x8192-coef-inner, 4096, 16, 2035, 832, 0, 0, 2883, 1.36534e+06
n100x8192-coef-inner, 4096, 17, 2028, 834, 0, 0, 2879, 1.36534e+06
n100x8192-coef-inner, 4096, 16, 2042, 826, 0, 0, 2884, 1.36534e+06
n100x8192-coef-inner, 4096, 16, 2026, 842, 0, 0, 2884, 1.36534e+06
n100x8192-coef-inner, 4096, 16, 2034, 827, 0, 0, 2877, 1.36534e+06
n100x8192-coef-inner, 4096, 16, 2028, 829, 0, 0, 2873, 1.36534e+06
n100x8192-coef-inner, 4096, 17, 2028, 836, 0, 0, 2881, 1.36534e+06
n100x8192-coef-inner, 4096, 16, 2034, 842, 0, 0, 2892, 1.36534e+06
n100x8192-coef-inner, 4096, 16, 2028, 833, 0, 0, 2877, 1.36534e+06
n100x8192-coef-inner, 4096, 16, 2025, 833, 0, 0, 2874, 1.36534e+06
n100x8192-coef-inner, 4096, 16, 2032, 830, 0, 0, 2878, 1.36534e+06
n100x8192-coef-inner, 4096, 17, 2026, 838, 0, 0, 2881, 1.36534e+06
n100x8192-coef-inner, 4096, 16, 2030, 838, 0, 0, 2884, 1.36534e+06
n100x8192-coef-inner, 4096, 16, 2040, 834, 0, 0, 2890, 1.36534e+06
n100x8192-coef-inner, 4096, 16, 2030, 835, 0, 0, 2881, 1.36534e+06
n100x8192-coef-inner, 4096, 16, 2027, 832, 0, 0, 2875, 1.36534e+06
n100x8192-coef-inner, 4096, 17, 2050, 844, 0, 0, 2911, 1.36534e+06
n100x8192-coef-inner, 4096, 16, 2036, 835, 0, 0, 2887, 1.36534e+06
n100x8192-coef-inner, 4096, 16, 2027, 834, 0, 0, 2877, 1.36534e+06
n100x8192-coef-inner, 4096, 17, 2036, 837, 0, 0, 2890, 1.36534e+06
n100x8192-coef-inner, 4096, 17, 2031, 834, 0, 0, 2882, 1.36534e+06
n100x8192-coef-inner, 4096, 16, 2029, 835, 0, 0, 2880, 1.36534e+06
n100x8192-coef-inner, 4096, 16, 2046, 834, 0, 0, 2896, 1.36534e+06
n100x8192-coef-inner, 4096, 16, 2033, 836, 0, 0, 2885, 1.36534e+06
n100x8192-coef-inner, 4096, 16, 2024, 827, 0, 0, 2867, 1.36534e+06
n100x8192-coef-inner, 4096, 16, 2024, 830, 0, 0, 2870, 1.36534e+06
n100x8192-coef-inner, 4096, 16, 2028, 831, 0, 0, 2875, 1.36534e+06
n100x8192-coef-inner, 4096, 16, 2029, 830, 0, 0, 2875, 1.36534e+06
n100x8192-coef-inner, 4096, 16, 2028, 828, 0, 0, 2872, 1.36534e+06
n100x8192-coef-inner, 4096, 16, 2018, 829, 0, 0, 2863, 1.36534e+06
n100x8192-coef-inner, 4096, 16, 2030, 839, 0, 0, 2885, 1.36534e+06
n100x8192-coef-inner, 4096, 16, 2018, 838, 0, 0, 2872, 1.36534e+06
n100x8192-coef-inner, 4096, 16, 2032, 838, 0, 0, 2886, 1.36534e+06
n100x8192-coef-inner, 4096, 16, 2036, 834, 0, 0, 2886, 1.36534e+06
n100x8192-coef-inner, 4096, 16, 2032, 832, 0, 0, 2880, 1.36534e+06
n100x8192-coef-inner, 4096, 16, 2035, 832, 0, 0, 2883, 1.36534e+06
n100x8192-coef-inner, 4096, 16, 2024, 830, 0, 0, 2870, 1.36534e+06
n100x8192-coef-inner, 4096, 16, 2030, 830, 0, 0, 2876, 1.36534e+06
n100x8192-coef-inner, 4096, 16, 2028, 829, 0, 0, 2873, 1.36534e+06
n100x8192-coef-inner, 4096, 16, 2038, 834, 0, 0, 2888, 1.36534e+06
n100x8192-coef-inner, 4096, 16, 2033, 829, 0, 0, 2878, 1.36534e+06
n100x8192-coef-inner, 4096, 16, 2028, 829, 0, 0, 2873, 1.36534e+06
n100x8192-coef-inner, 4096, 16, 2035, 833, 0, 0, 2884, 1.36534e+06
n100x8192-coef-inner, 4096, 16, 2043, 830, 0, 0, 2889, 1.36534e+06
n100x8192-coef-inner, 4096, 16, 2041, 835, 0, 0, 2892, 1.36534e+06
n100x8192-coef-inner, 4096, 16, 2029, 834, 0, 0, 2879, 1.36534e+06
n100x8192-coef-inner, 4096, 16, 2034, 831, 0, 0, 2881, 1.36534e+06
n100x8192-coef-inner, 4096, 16, 2027, 835, 0, 0, 2878, 1.36534e+06
n100x8192-coef-inner, 4096, 16, 2042, 834, 0, 0, 2892, 1.36534e+06
n100x8192-coef-inner, 4096, 16, 2021, 834, 0, 0, 2871, 1.36534e+06
n100x8192-coef-inner, 4096, 16, 2027, 834, 0, 0, 2877, 1.36534e+06
n100x8192-coef-inner, 4096, 16, 2035, 826, 0, 0, 2877, 1.36534e+06
n100x8192-coef-inner, 4096, 16, 2028, 838, 0, 0, 2882, 1.36534e+06
n100x8192-coef-inner, 4096, 16, 2039, 837, 0, 0, 2892, 1.36534e+06
n100x8192-coef-inner, 4096, 16, 2025, 828, 0, 0, 2869, 1.36534e+06
n100x8192-coef-inner, 4096, 16, 2024, 836, 0, 0, 2876, 1.36534e+06
n100x8192-coef-inner, 4096, 16, 2025, 832, 0, 0, 2873, 1.36534e+06
n100x8192-coef-inner, 4096, 16, 2032, 832, 0, 0, 2880, 1.36534e+06
n100x8192-coef-inner, 4096, 16, 2039, 834, 0, 0, 2889, 1.36534e+06
n100x8192-coef-inner, 4096, 16, 2020, 838, 0, 0, 2874, 1.36534e+06
n100x8192-coef-inner, 4096, 16, 2039, 834, 0, 0, 2889, 1.36534e+06
n100x8192-coef-inner, 4096, 16, 2028, 826, 0, 0, 2870, 1.36534e+06
n100x8192-coef-inner, 4096, 16, 2022, 830, 0, 0, 2868, 1.36534e+06
n100x8192-coef-inner, 4096, 16, 2042, 829, 0, 0, 2887, 1.36534e+06
n100x8192-coef-inner, 4096, 16, 2016, 833, 0, 0, 2865, 1.36534e+06
n100x8192-coef-inner, 4096, 16, 2039, 834, 0, 0, 2889, 1.36534e+06
n100x8192-coef-inner, 4096, 16, 2023, 835, 0, 0, 2874, 1.36534e+06
n100x8192-coef-inner, 4096, 16, 2023, 827, 0, 0, 2866, 1.36534e+06
n100x8192-coef-inner, 4096, 16, 2030, 836, 0, 0, 2882, 1.36534e+06
n100x8192-coef-inner, 4096, 16, 2019, 829, 0, 0, 2864, 1.36534e+06
n100x8192-coef-inner, 4096, 16, 2026, 814, 0, 0, 2856, 1.36534e+06
n100x8192-coef-inner, 4096, 16, 2029, 830, 0, 0, 2875, 1.36534e+06
n100x8192-coef-inner, 4096, 16, 2031, 834, 0, 0, 2881, 1.36534e+06
n100x8192-coef-inner, 4096, 16, 2032, 841, 0, 0, 2889, 1.36534e+06
n100x8192-coef-inner, 4096, 16, 2024, 833, 0, 0, 2873, 1.36534e+06
n100x8192-coef-inner, 4096, 16, 2031, 833, 0, 0, 2880, 1.36534e+06
n100x8192-coef-inner, 4096, 16, 2034, 827, 0, 0, 2877, 1.36534e+06
n100x8192-coef-inner, 4096, 16, 2030, 832, 0, 0, 2878, 1.36534e+06
n100x8192-coef-inner, 4096, 16, 2026, 828, 0, 0, 2870, 1.36534e+06
n100x8192-coef-inner, 4096, 16, 2025, 825, 0, 0, 2866, 1.36534e+06
n100x8192-coef-inner, 2048, 10, 2024, 822, 0, 0, 2856, 1.36534e+06
n100x8192-coef-inner, 2048, 10, 2026, 823, 0, 0, 2859, 1.36534e+06
n100x8192-coef-inner, 2048, 10, 2020, 825, 0, 0, 2855, 1.36534e+06
n100x8192-coef-inner, 2048, 10, 2019, 838, 0, 0, 2867, 1.36534e+06
n100x8192-coef-inner, 2048, 10, 2021, 822, 0, 0, 2853, 1.36534e+06
n100x8192-coef-inner, 2048, 10, 2022, 822, 0, 0, 2854, 1.36534e+06
n100x8192-coef-inner, 2048, 10, 2017, 827, 0, 0, 2854, 1.36534e+06
n100x8192-coef-inner, 2048, 10, 2019, 832, 0, 0, 2861, 1.36534e+06
n100x8192-coef-inner, 2048, 10, 2021, 821, 0, 0, 2852, 1.36534e+06
n100x8192-coef-inner, 2048, 10, 2026, 831, 0, 0, 2867, 1.36534e+06
n100x8192-coef-inner, 2048, 10, 2026, 820, 0, 0, 2856, 1.36534e+06
n100x8192-coef-inner, 2048, 10, 2018, 825, 0, 0, 2853, 1.36534e+06
n100x8192-coef-inner, 2048, 10, 2023, 822, 0, 0, 2855, 1.36534e+06
n100x8192-coef-inner, 2048, 10, 2023, 825, 0, 0, 2858, 1.36534e+06
n100x8192-coef-inner, 2048, 10, 2030, 825, 0, 0, 2865, 1.36534e+06
n100x8192-coef-inner, 2048, 10, 2027, 821, 0, 0, 2858, 1.36534e+06
n100x8192-coef-inner, 2048, 10, 2013, 816, 0, 0, 2839, 1.36534e+06
n100x8192-coef-inner, 2048, 10, 2012, 823, 0, 0, 2845, 1.36534e+06
n100x8192-coef-inner, 2048, 10, 2016, 825, 0, 0, 2851, 1.36534e+06
n100x8192-coef-inner, 2048, 10, 2016, 822, 0, 0, 2848, 1.36534e+06
n100x8192-coef-inner, 2048, 10, 2018, 822, 0, 0, 2850, 1.36534e+06
n100x8192-coef-inner, 2048, 10, 2027, 825, 0, 0, 2862, 1.36534e+06
n100x8192-coef-inner, 2048, 10, 2033, 826, 0, 0, 2869, 1.36534e+06
n100x8192-coef-inner, 2048, 10, 2030, 826, 0, 0, 2866, 1.36534e+06
n100x8192-coef-inner, 2048, 10, 2038, 823, 0, 0, 2871, 1.36534e+06
n100x8192-coef-inner, 2048, 10, 2021, 829, 0, 0, 2860, 1.36534e+06
n100x8192-coef-inner, 2048, 10, 2026, 830, 0, 0, 2866, 1.36534e+06
n100x8192-coef-inner, 2048, 10, 2023, 825, 0, 0, 2858, 1.36534e+06
n100x8192-coef-inner, 2048, 10, 2023, 825, 0, 0, 2858, 1.36534e+06
n100x8192-coef-inner, 2048, 10, 2021, 827, 0, 0, 2858, 1.36534e+06
n100x8192-coef-inner, 2048, 10, 2016, 824, 0, 0, 2850, 1.36534e+06
n100x8192-coef-inner, 2048, 10, 2012, 821, 0, 0, 2843, 1.36534e+06
n100x8192-coef-inner, 2048, 10, 2017, 823, 0, 0, 2850, 1.36534e+06
n100x8192-coef-inner, 2048, 10, 2017, 826, 0, 0, 2853, 1.36534e+06
n100x8192-coef-inner, 2048, 10, 2029, 829, 0, 0, 2868, 1.36534e+06
n100x8192-coef-inner, 2048, 10, 2025, 829, 0, 0, 2864, 1.36534e+06
n100x8192-coef-inner, 2048, 10, 2021, 826, 0, 0, 2857, 1.36534e+06
n100x8192-coef-inner, 2048, 10, 2017, 824, 0, 0, 2851, 1.36534e+06
n100x8192-coef-inner, 2048, 10, 2016, 823, 0, 0, 2849, 1.36534e+06
n100x8192-coef-inner, 2048, 10, 2030, 825, 0, 0, 2865, 1.36534e+06
n100x8192-coef-inner, 2048, 10, 2016, 835, 0, 0, 2861, 1.36534e+06
n100x8192-coef-inner, 2048, 10, 2027, 822, 0, 0, 2859, 1.36534e+06
n100x8192-coef-inner, 2048, 10, 2029, 834, 0, 0, 2873, 1.36534e+06
n100x8192-coef-inner, 2048, 10, 2018, 825, 0, 0, 2853, 1.36534e+06
n100x8192-coef-inner, 2048, 10, 2026, 842, 0, 0, 2878, 1.36534e+06
n100x8192-coef-inner, 2048, 10, 2018, 824, 0, 0, 2852, 1.36534e+06
n100x8192-coef-inner, 2048, 10, 2018, 821, 0, 0, 2849, 1.36534e+06
n100x8192-coef-inner, 2048, 10, 2018, 826, 0, 0, 2854, 1.36534e+06
n100x8192-coef-inner, 2048, 10, 2017, 818, 0, 0, 2845, 1.36534e+06
n100x8192-coef-inner, 2048, 10, 2020, 823, 0, 0, 2853, 1.36534e+06
n100x8192-coef-inner, 2048, 10, 2026, 823, 0, 0, 2859, 1.36534e+06
n100x8192-coef-inner, 2048, 10, 2023, 823, 0, 0, 2856, 1.36534e+06
n100x8192-coef-inner, 2048, 10, 2018, 820, 0, 0, 2848, 1.36534e+06
n100x8192-coef-inner, 2048, 10, 2022, 826, 0, 0, 2858, 1.36534e+06
n100x8192-coef-inner, 2048, 10, 2015, 828, 0, 0, 2853, 1.36534e+06
n100x8192-coef-inner, 2048, 10, 2021, 826, 0, 0, 2857, 1.36534e+06
n100x8192-coef-inner, 2048, 10, 2021, 825, 0, 0, 2856, 1.36534e+06
n100x8192-coef-inner, 2048, 10, 2019, 818, 0, 0, 2847, 1.36534e+06
n100x8192-coef-inner, 2048, 10, 2029, 824, 0, 0, 2863, 1.36534e+06
n100x8192-coef-inner, 2048, 10, 2026, 830, 0, 0, 2866, 1.36534e+06
n100x8192-coef-inner, 2048, 10, 2027, 822, 0, 0, 2859, 1.36534e+06
n100x8192-coef-inner, 2048, 10, 2027, 829, 0, 0, 2866, 1.36534e+06
n100x8192-coef-inner, 2048, 10, 2025, 828, 0, 0, 2863, 1.36534e+06
n100x8192-coef-inner, 2048, 10, 2029, 823, 0, 0, 2862, 1.36534e+06
n100x8192-coef-inner, 2048, 10, 2019, 824, 0, 0, 2853, 1.36534e+06
n100x8192-coef-inner, 2048, 10, 2095, 957, 0, 0, 3062, 1.36534e+06
n100x8192-coef-inner, 2048, 10, 2025, 834, 0, 0, 2869, 1.36534e+06
n100x8192-coef-inner, 2048, 10, 2016, 817, 0, 0, 2843, 1.36534e+06
n100x8192-coef-inner, 2048, 10, 2025, 828, 0, 0, 2863, 1.36534e+06
n100x8192-coef-inner, 2048, 10, 2021, 824, 0, 0, 2855, 1.36534e+06
n100x8192-coef-inner, 2048, 10, 2028, 827, 0, 0, 2865, 1.36534e+06
n100x8192-coef-inner, 2048, 10, 2024, 821, 0, 0, 2855, 1.36534e+06
n100x8192-coef-inner, 2048, 10, 2022, 828, 0, 0, 2860, 1.36534e+06
n100x8192-coef-inner, 2048, 10, 2016, 826, 0, 0, 2852, 1.36534e+06
n100x8192-coef-inner, 2048, 10, 2018, 828, 0, 0, 2856, 1.36534e+06
n100x8192-coef-inner, 2048, 10, 2022, 829, 0, 0, 2861, 1.36534e+06
n100x8192-coef-inner, 2048, 10, 2038, 821, 0, 0, 2869, 1.36534e+06
n100x8192-coef-inner, 2048, 10, 2028, 822, 0, 0, 2860, 1.36534e+06
n100x8192-coef-inner, 2048, 10, 2012, 828, 0, 0, 2850, 1.36534e+06
n100x8192-coef-inner, 2048, 10, 2042, 831, 0, 0, 2883, 1.36534e+06
n100x8192-coef-inner, 2048, 10, 2021, 832, 0, 0, 2863, 1.36534e+06
n100x8192-coef-inner, 2048, 10, 2018, 825, 0, 0, 2853, 1.36534e+06
n100x8192-coef-inner, 2048, 10, 2032, 826, 0, 0, 2868, 1.36534e+06
n100x8192-coef-inner, 2048, 10, 2020, 832, 0, 0, 2862, 1.36534e+06
n100x8192-coef-inner, 2048, 10, 2020, 830, 0, 0, 2860, 1.36534e+06
n100x8192-coef-inner, 2048, 10, 2019, 925, 0, 0, 2954, 1.36534e+06
n100x8192-coef-inner, 2048, 10, 2027, 832, 0, 0, 2869, 1.36534e+06
n100x8192-coef-inner, 2048, 10, 2019, 821, 0, 0, 2850, 1.36534e+06
n100x8192-coef-inner, 2048, 10, 2022, 829, 0, 0, 2861, 1.36534e+06
n100x8192-coef-inner, 2048, 10, 2028, 828, 0, 0, 2866, 1.36534e+06
n100x8192-coef-inner, 2048, 10, 2015, 823, 0, 0, 2848, 1.36534e+06
n100x8192-coef-inner, 2048, 10, 2021, 819, 0, 0, 2850, 1.36534e+06
n100x8192-coef-inner, 2048, 10, 2023, 826, 0, 0, 2859, 1.36534e+06
n100x8192-coef-inner, 2048, 10, 2030, 824, 0, 0, 2864, 1.36534e+06
n100x8192-coef-inner, 2048, 10, 2023, 824, 0, 0, 2857, 1.36534e+06
n100x8192-coef-inner, 2048, 10, 2020, 830, 0, 0, 2860, 1.36534e+06
n100x8192-coef-inner, 2048, 10, 2024, 828, 0, 0, 2862, 1.36534e+06
n100x8192-coef-inner, 2048, 10, 2026, 827, 0, 0, 2863, 1.36534e+06
n100x8192-coef-inner, 2048, 10, 2014, 829, 0, 0, 2853, 1.36534e+06
n100x8192-coef-inner, 2048, 11, 2019, 829, 0, 0, 2859, 1.36534e+06
n100x8192-coef-inner, 1024, 12, 2568, 1331, 0, 0, 3911, 1.36534e+06
n100x8192-coef-inner, 1024, 12, 2567, 1340, 0, 0, 3919, 1.36534e+06
n100x8192-coef-inner, 1024, 12, 2571, 1322, 0, 0, 3905, 1.36534e+06
n100x8192-coef-inner, 1024, 12, 2576, 1318, 0, 0, 3906, 1.36534e+06
n100x8192-coef-inner, 1024, 12, 2573, 1339, 0, 0, 3924, 1.36534e+06
n100x8192-coef-inner, 1024, 12, 2571, 1333, 0, 0, 3916, 1.36534e+06
n100x8192-coef-inner, 1024, 11, 2573, 1344, 0, 0, 3928, 1.36534e+06
n100x8192-coef-inner, 1024, 12, 2574, 1329, 0, 0, 3915, 1.36534e+06
n100x8192-coef-inner, 1024, 11, 2572, 1326, 0, 0, 3909, 1.36534e+06
n100x8192-coef-inner, 1024, 12, 2560, 1327, 0, 0, 3899, 1.36534e+06
n100x8192-coef-inner, 1024, 12, 2564, 1322, 0, 0, 3898, 1.36534e+06
n100x8192-coef-inner, 1024, 12, 2559, 1328, 0, 0, 3899, 1.36534e+06
n100x8192-coef-inner, 1024, 12, 2576, 1333, 0, 0, 3921, 1.36534e+06
n100x8192-coef-inner, 1024, 12, 2562, 1324, 0, 0, 3898, 1.36534e+06
n100x8192-coef-inner, 1024, 13, 2565, 1322, 0, 0, 3900, 1.36534e+06
n100x8192-coef-inner, 1024, 12, 2568, 1334, 0, 0, 3914, 1.36534e+06
n100x8192-coef-inner, 1024, 12, 2575, 1325, 0, 0, 3912, 1.36534e+06
n100x8192-coef-inner, 1024, 13, 2567, 1322, 0, 0, 3902, 1.36534e+06
n100x8192-coef-inner, 1024, 12, 2571, 1324, 0, 0, 3907, 1.36534e+06
n100x8192-coef-inner, 1024, 13, 2567, 1394, 0, 0, 3974, 1.36534e+06
n100x8192-coef-inner, 1024, 12, 2569, 1339, 0, 0, 3920, 1.36534e+06
n100x8192-coef-inner, 1024, 12, 2560, 1326, 0, 0, 3898, 1.36534e+06
n100x8192-coef-inner, 1024, 11, 2572, 1325, 0, 0, 3908, 1.36534e+06
n100x8192-coef-inner, 1024, 12, 2563, 1322, 0, 0, 3897, 1.36534e+06
n100x8192-coef-inner, 1024, 12, 2571, 1324, 0, 0, 3907, 1.36534e+06
n100x8192-coef-inner, 1024, 12, 2560, 1323, 0, 0, 3895, 1.36534e+06
n100x8192-coef-inner, 1024, 13, 2566, 1326, 0, 0, 3905, 1.36534e+06
n100x8192-coef-inner, 1024, 12, 2575, 1325, 0, 0, 3912, 1.36534e+06
n100x8192-coef-inner, 1024, 11, 2566, 1324, 0, 0, 3901, 1.36534e+06
n100x8192-coef-inner, 1024, 13, 2565, 1325, 0, 0, 3903, 1.36534e+06
n100x8192-coef-inner, 1024, 12, 2566, 1326, 0, 0, 3904, 1.36534e+06
n100x8192-coef-inner, 1024, 12, 2571, 1322, 0, 0, 3905, 1.36534e+06
n100x8192-coef-inner, 1024, 12, 2575, 1333, 0, 0, 3920, 1.36534e+06
n100x8192-coef-inner, 1024, 12, 2568, 1332, 0, 0, 3912, 1.36534e+06
n100x8192-coef-inner, 1024, 12, 2565, 1381, 0, 0, 3958, 1.36534e+06
n100x8192-coef-inner, 1024, 12, 2572, 1328, 0, 0, 3912, 1.36534e+06
n100x8192-coef-inner, 1024, 12, 2565, 1321, 0, 0, 3898, 1.36534e+06
n100x8192-coef-inner, 1024, 11, 2584, 1323, 0, 0, 3918, 1.36534e+06
n100x8192-coef-inner, 1024, 23, 2812, 1332, 0, 0, 4167, 1.36534e+06
n100x8192-coef-inner, 1024, 12, 2570, 1328, 0, 0, 3910, 1.36534e+06
n100x8192-coef-inner, 1024, 12, 2585, 1332, 0, 0, 3929, 1.36534e+06
n100x8192-coef-inner, 1024, 12, 2563, 1325, 0, 0, 3900, 1.36534e+06
n100x8192-coef-inner, 1024, 12, 2581, 1326, 0, 0, 3919, 1.36534e+06
n100x8192-coef-inner, 1024, 12, 2559, 1317, 0, 0, 3888, 1.36534e+06
n100x8192-coef-inner, 1024, 12, 2563, 1322, 0, 0, 3897, 1.36534e+06
n100x8192-coef-inner, 1024, 11, 2569, 1334, 0, 0, 3914, 1.36534e+06
n100x8192-coef-inner, 1024, 13, 2572, 1324, 0, 0, 3909, 1.36534e+06
n100x8192-coef-inner, 1024, 11, 2561, 1327, 0, 0, 3899, 1.36534e+06
n100x8192-coef-inner, 1024, 11, 2574, 1335, 0, 0, 3920, 1.36534e+06
n100x8192-coef-inner, 1024, 12, 2576, 1344, 0, 0, 3932, 1.36534e+06
n100x8192-coef-inner, 1024, 12, 2566, 1331, 0, 0, 3909, 1.36534e+06
n100x8192-coef-inner, 1024, 11, 2575, 1319, 0, 0, 3905, 1.36534e+06
n100x8192-coef-inner, 1024, 11, 2576, 1330, 0, 0, 3917, 1.36534e+06
n100x8192-coef-inner, 1024, 12, 2561, 1326, 0, 0, 3899, 1.36534e+06
n100x8192-coef-inner, 1024, 12, 2567, 1331, 0, 0, 3910, 1.36534e+06
n100x8192-coef-inner, 1024, 12, 2564, 1335, 0, 0, 3911, 1.36534e+06
n100x8192-coef-inner, 1024, 12, 2568, 1324, 0, 0, 3904, 1.36534e+06
n100x8192-coef-inner, 1024, 12, 2581, 1328, 0, 0, 3921, 1.36534e+06
n100x8192-coef-inner, 1024, 12, 2567, 1324, 0, 0, 3903, 1.36534e+06
n100x8192-coef-inner, 1024, 12, 2561, 1332, 0, 0, 3905, 1.36534e+06
n100x8192-coef-inner, 1024, 12, 2564, 1327, 0, 0, 3903, 1.36534e+06
n100x8192-coef-inner, 1024, 13, 2570, 1322, 0, 0, 3905, 1.36534e+06
n100x8192-coef-inner, 1024, 11, 2571, 1329, 0, 0, 3911, 1.36534e+06
n100x8192-coef-inner, 1024, 12, 2570, 1326, 0, 0, 3908, 1.36534e+06
n100x8192-coef-inner, 1024, 12, 2570, 1347, 0, 0, 3929, 1.36534e+06
n100x8192-coef-inner, 1024, 12, 2568, 1363, 0, 0, 3943, 1.36534e+06
n100x8192-coef-inner, 1024, 12, 2568, 1331, 0, 0, 3911, 1.36534e+06
n100x8192-coef-inner, 1024, 12, 2561, 1322, 0, 0, 3895, 1.36534e+06
n100x8192-coef-inner, 1024, 12, 2573, 1325, 0, 0, 3910, 1.36534e+06
n100x8192-coef-inner, 1024, 12, 2564, 1331, 0, 0, 3907, 1.36534e+06
n100x8192-coef-inner, 1024, 12, 2557, 1329, 0, 0, 3898, 1.36534e+06
n100x8192-coef-inner, 1024, 11, 2566, 1323, 0, 0, 3900, 1.36534e+06
n100x8192-coef-inner, 1024, 12, 2571, 1327, 0, 0, 3910, 1.36534e+06
n100x8192-coef-inner, 1024, 13, 2569, 1325, 0, 0, 3907, 1.36534e+06
n100x8192-coef-inner, 1024, 12, 2561, 1326, 0, 0, 3899, 1.36534e+06
n100x8192-coef-inner, 1024, 13, 2564, 1317, 0, 0, 3894, 1.36534e+06
n100x8192-coef-inner, 1024, 12, 2571, 1325, 0, 0, 3908, 1.36534e+06
n100x8192-coef-inner, 1024, 12, 2579, 1329, 0, 0, 3920, 1.36534e+06
n100x8192-coef-inner, 1024, 12, 2562, 1324, 0, 0, 3898, 1.36534e+06
n100x8192-coef-inner, 1024, 12, 2566, 1331, 0, 0, 3909, 1.36534e+06
n100x8192-coef-inner, 1024, 12, 2572, 1322, 0, 0, 3906, 1.36534e+06
n100x8192-coef-inner, 1024, 12, 2577, 1317, 0, 0, 3906, 1.36534e+06
n100x8192-coef-inner, 1024, 12, 2565, 1326, 0, 0, 3903, 1.36534e+06
n100x8192-coef-inner, 1024, 12, 2564, 1328, 0, 0, 3904, 1.36534e+06
n100x8192-coef-inner, 1024, 12, 2562, 1323, 0, 0, 3897, 1.36534e+06
n100x8192-coef-inner, 1024, 12, 2574, 1329, 0, 0, 3915, 1.36534e+06
n100x8192-coef-inner, 1024, 13, 2566, 1341, 0, 0, 3920, 1.36534e+06
n100x8192-coef-inner, 1024, 12, 2583, 1331, 0, 0, 3926, 1.36534e+06
n100x8192-coef-inner, 1024, 12, 2568, 1321, 0, 0, 3901, 1.36534e+06
n100x8192-coef-inner, 1024, 12, 2568, 1325, 0, 0, 3905, 1.36534e+06
n100x8192-coef-inner, 1024, 12, 2565, 1333, 0, 0, 3910, 1.36534e+06
n100x8192-coef-inner, 1024, 12, 2566, 1323, 0, 0, 3901, 1.36534e+06
n100x8192-coef-inner, 1024, 12, 2572, 1322, 0, 0, 3906, 1.36534e+06
n100x8192-coef-inner, 1024, 12, 2565, 1353, 0, 0, 3930, 1.36534e+06
n100x8192-coef-inner, 1024, 12, 2575, 1347, 0, 0, 3934, 1.36534e+06
n100x8192-coef-inner, 1024, 12, 2578, 1328, 0, 0, 3918, 1.36534e+06
n100x8192-coef-inner, 1024, 11, 2579, 1333, 0, 0, 3923, 1.36534e+06
n100x8192-coef-inner, 1024, 11, 2567, 1327, 0, 0, 3905, 1.36534e+06
n100x8192-coef-inner, 1024, 11, 2580, 1382, 0, 0, 3973, 1.36534e+06
n100x8192-coef-inner, 1024, 11, 2561, 1328, 0, 0, 3900, 1.36534e+06
n250x8192-coef-sum, 8192, 34, 2573, 65, 0, 0, 2672, 1
n250x8192-coef-sum, 8192, 35, 2562, 64, 0, 0, 2661, 1
n250x8192-coef-sum, 8192, 34, 2558, 64, 3, 0, 2659, 1
n250x8192-coef-sum, 8192, 35, 2566, 64, 0, 0, 2665, 1
n250x8192-coef-sum, 8192, 35, 2643, 67, 1, 0, 2746, 1
n250x8192-coef-sum, 8192, 35, 2567, 64, 0, 0, 2666, 1
n250x8192-coef-sum, 8192, 34, 2564, 64, 0, 0, 2662, 1
n250x8192-coef-sum, 8192, 35, 2553, 64, 0, 0, 2652, 1
n250x8192-coef-sum, 8192, 34, 2672, 67, 1, 0, 2774, 1
n250x8192-coef-sum, 8192, 35, 2553, 64, 0, 0, 2652, 1
n250x8192-coef-sum, 8192, 35, 2597, 67, 1, 0, 2700, 1
n250x8192-coef-sum, 8192, 34, 2555, 63, 0, 0, 2652, 1
n250x8192-coef-sum, 8192, 35, 2564, 68, 0, 0, 2667, 1
n250x8192-coef-sum, 8192, 34, 2581, 65, 0, 0, 2680, 1
n250x8192-coef-sum, 8192, 35, 2555, 64, 0, 0, 2654, 1
n250x8192-coef-sum, 8192, 34, 2577, 64, 0, 0, 2675, 1
n250x8192-coef-sum, 8192, 34, 2661, 66, 1, 0, 2762, 1
n250x8192-coef-sum, 8192, 35, 2564, 64, 0, 0, 2663, 1
n250x8192-coef-sum, 8192, 34, 2557, 64, 0, 0, 2655, 1
n250x8192-coef-sum, 8192, 35, 2557, 64, 0, 0, 2656, 1
n250x8192-coef-sum, 8192, 34, 2550, 65, 0, 0, 2649, 1
n250x8192-coef-sum, 8192, 35, 2561, 64, 0, 0, 2660, 1
n250x8192-coef-sum, 8192, 34, 2551, 65, 0, 0, 2650, 1
n250x8192-coef-sum, 8192, 35, 2558, 64, 0, 0, 2657, 1
n250x8192-coef-sum, 8192, 35, 2557, 64, 0, 0, 2656, 1
n250x8192-coef-sum, 8192, 35, 2552, 64, 0, 0, 2651, 1
n250x8192-coef-sum, 8192, 35, 2556, 65, 0, 0, 2656, 1
n250x8192-coef-sum, 8192, 35, 2555, 63, 0, 0, 2653, 1
n250x8192-coef-sum, 8192, 35, 2559, 66, 0, 0, 2660, 1
n250x8192-coef-sum, 8192, 35, 2558, 65, 0, 0, 2658, 1
n250x8192-coef-sum, 8192, 35, 2561, 64, 1, 0, 2661, 1
n250x8192-coef-sum, 8192, 34, 2561, 65, 0, 0, 2660, 1
n250x8192-coef-sum, 8192, 35, 2551, 63, 0, 0, 2649, 1
n250x8192-coef-sum, 8192, 35, 2563, 64, 0, 0, 2662, 1
n250x8192-coef-sum, 8192, 34, 2563, 64, 0, 0, 2661, 1
n250x8192-coef-sum, 8192, 35, 2711, 67, 1, 0, 2814, 1
n250x8192-coef-sum, 8192, 34, 2578, 64, 0, 0, 2676, 1
n250x8192-coef-sum, 8192, 35, 2549, 65, 0, 0, 2649, 1
n250x8192-coef-sum, 8192, 34, 2558, 64, 0, 0, 2656, 1
n250x8192-coef-sum, 8192, 35, 2548, 64, 0, 0, 2647, 1
n250x8192-coef-sum, 8192, 34, 2559, 65, 0, 0, 2658, 1
n250x8192-coef-sum, 8192, 35, 2552, 64, 0, 0, 2651, 1
n250x8192-coef-sum, 8192, 35, 2549, 65, 0, 0, 2649, 1
n250x8192-coef-sum, 8192, 35, 2564, 64, 0, 0, 2663, 1
n250x8192-coef-sum, 8192, 35, 2561, 66, 0, 0, 2662, 1
n250x8192-coef-sum, 8192, 35, 2558, 65, 0, 0, 2658, 1
n250x8192-coef-sum, 8192, 34, 2548, 65, 0, 0, 2647, 1
n250x8192-coef-sum, 8192, 34, 2552, 63, 0, 0, 2649, 1
n250x8192-coef-sum, 8192, 35, 2543, 64, 0, 0, 2642, 1
n250x8192-coef-sum, 8192, 35, 2560, 65, 0, 0, 2660, 1
n250x8192-coef-sum, 8192, 35, 2549, 63, 0, 0, 2647, 1
n250x8192-coef-sum, 8192, 35, 2563, 65, 0, 0, 2663, 1
n250x8192-coef-sum, 8192, 35, 2561, 65, 0, 0, 2661, 1
n250x8192-coef-sum, 8192, 34, 2552, 64, 0, 0, 2650, 1
n250x8192-coef-sum, 8192, 35, 2562, 64, 0, 0, 2661, 1
n250x8192-coef-sum, 8192, 35, 2557, 64, 0, 0, 2656, 1
n250x8192-coef-sum, 8192, 34, 2626, 65, 1, 0, 2726, 1
n250x8192-coef-sum, 8192, 35, 2555, 65, 0, 0, 2655, 1
n250x8192-coef-sum, 8192, 34, 2543, 64, 0, 0, 2641, 1
n250x8192-coef-sum, 8192, 34, 2549, 64, 0, 0, 2647, 1
n250x8192-coef-sum, 8192, 35, 2565, 63, 0, 0, 2663, 1
n250x8192-coef-sum, 8192, 34, 2552, 64, 0, 0, 2650, 1
n250x8192-coef-sum, 8192, 34, 2563, 65, 0, 0, 2662, 1
n250x8192-coef-sum, 8192, 34, 2551, 64, 0, 0, 2649, 1
n250x8192-coef-sum, 8192, 35, 2563, 63, 0, 0, 2661, 1
n250x8192-coef-sum, 8192, 34, 2562, 64, 0, 0, 2660, 1
n250x8192-coef-sum, 8192, 35, 2555, 65, 0, 0, 2655, 1
n250x8192-coef-sum, 8192, 35, 2561, 65, 0, 0, 2661, 1
n250x8192-coef-sum, 8192, 34, 2560, 64, 0, 0, 2658, 1
n250x8192-coef-sum, 8192, 35, 2546, 66, 0, 0, 2647, 1
n250x8192-coef-sum, 8192, 34, 2555, 63, 0, 0, 2652, 1
n250x8192-coef-sum, 8192, 35, 2554, 66, 0, 0, 2655, 1
n250x8192-coef-sum, 8192, 34, 2560, 65, 0, 0, 2659, 1
n250x8192-coef-sum, 8192, 34, 2558, 64, 0, 0, 2656, 1
n250x8192-coef-sum, 8192, 35, 2554, 64, 0, 0, 2653, 1
n250x8192-coef-sum, 8192, 35, 2546, 66, 0, 0, 2647, 1
n250x8192-coef-sum, 8192, 34, 2553, 63, 0, 0, 2650, 1
n250x8192-coef-sum, 8192, 35, 2551, 65, 0, 0, 2651, 1
n250x8192-coef-sum, 8192, 34, 2569, 65, 0, 0, 2668, 1
n250x8192-coef-sum, 8192, 34, 2552, 64, 0, 0, 2650, 1
n250x8192-coef-sum, 8192, 35, 2550, 64, 0, 0, 2649, 1
n250x8192-coef-sum, 8192, 35, 2554, 64, 0, 0, 2653, 1
n250x8192-coef-sum, 8192, 34, 2551, 64, 0, 0, 2649, 1
n250x8192-coef-sum, 8192, 35, 2556, 65, 0, 0, 2656, 1
n250x8192-coef-sum, 8192, 35, 2550, 65, 0, 0, 2650, 1
n250x8192-coef-sum, 8192, 35, 2551, 65, 0, 0, 2651, 1
n250x8192-coef-sum, 8192, 35, 2550, 64, 0, 0, 2649, 1
n250x8192-coef-sum, 8192, 35, 2551, 65, 0, 0, 2651, 1
n250x8192-coef-sum, 8192, 34, 2555, 64, 0, 0, 2653, 1
n250x8192-coef-sum, 8192, 34, 2552, 68, 0, 0, 2654, 1
n250x8192-coef-sum, 8192, 34, 2551, 64, 0, 0, 2649, 1
n250x8192-coef-sum, 8192, 35, 2555, 65, 0, 0, 2655, 1
n250x8192-coef-sum, 8192, 35, 2557, 64, 0, 0, 2656, 1
n250x8192-coef-sum, 8192, 34, 2559, 66, 0, 0, 2659, 1
n250x8192-coef-sum, 8192, 35, 2557, 65, 0, 0, 2657, 1
n250x8192-coef-sum, 8192, 34, 2552, 65, 0, 0, 2651, 1
n250x8192-coef-sum, 8192, 35, 2557, 65, 0, 0, 2657, 1
n250x8192-coef-sum, 8192, 34, 2553, 63, 0, 0, 2650, 1
n250x8192-coef-sum, 8192, 34, 2555, 65, 0, 0, 2654, 1
n250x8192-coef-sum, 8192, 35, 2559, 65, 0, 0, 2659, 1
n250x8192-coef-sum, 4096, 19, 2517, 65, 0, 0, 2601, 1
n250x8192-coef-sum, 4096, 19, 2519, 65, 0, 0, 2603, 1
n250x8192-coef-sum, 4096, 19, 2531, 65, 0, 0, 2615, 1
n250x8192-coef-sum, 4096, 19, 2519, 63, 0, 0, 2601, 1
n250x8192-coef-sum, 4096, 19, 2532, 64, 0, 0, 2615, 1
n250x8192-coef-sum, 4096, 19, 2523, 64, 0, 0, 2606, 1
n250x8192-coef-sum, 4096, 19, 2522, 64, 0, 0, 2605, 1
n250x8192-coef-sum, 4096, 19, 2523, 64, 0, 0, 2606, 1
n250x8192-coef-sum, 4096, 19, 2523, 65, 0, 0, 2607, 1
n250x8192-coef-sum, 4096, 19, 2516, 65, 0, 0, 2600, 1
n250x8192-coef-sum, 4096, 19, 2526, 65, 0, 0, 2610, 1
n250x8192-coef-sum, 4096, 19, 2520, 63, 0, 0, 2602, 1
n250x8192-coef-sum, 4096, 19, 2517, 64, 0, 0, 2600, 1
n250x8192-coef-sum, 4096, 19, 2522, 64, 0, 0, 2605, 1
n250x8192-coef-sum, 4096, 19, 2514, 64, 0, 0, 2597, 1
n250x8192-coef-sum, 4096, 19, 2526, 63, 0, 0, 2608, 1
n250x8192-coef-sum, 4096, 19, 2513, 64, 0, 0, 2596, 1
n250x8192-coef-sum, 4096, 19, 2522, 64, 0, 0, 2605, 1
n250x8192-coef-sum, 4096, 19, 2524, 64, 0, 0, 2607, 1
n250x8192-coef-sum, 4096, 19, 2522, 63, 0, 0, 2604, 1
n250x8192-coef-sum, 4096, 19, 2526, 65, 0, 0, 2610, 1
n250x8192-coef-sum, 4096, 19, 2531, 64, 0, 0, 2614, 1
n250x8192-coef-sum, 4096, 19, 2520, 64, 0, 0, 2603, 1
n250x8192-coef-sum, 4096, 19, 2523, 64, 0, 0, 2606, 1
n250x8192-coef-sum, 4096, 19, 2517, 65, 0, 0, 2601, 1
n250x8192-coef-sum, 4096, 19, 2520, 64, 0, 0, 2603, 1
n250x8192-coef-sum, 4096, 19, 2541, 65, 0, 0, 2625, 1
n250x8192-coef-sum, 4096, 19, 2523, 64, 0, 0, 2606, 1
n250x8192-coef-sum, 4096, 19, 2515, 65, 0, 0, 2599, 1
n250x8192-coef-sum, 4096, 19, 2515, 64, 0, 0, 2598, 1
n250x8192-coef-sum, 4096, 19, 2522, 65, 0, 0, 2606, 1
n250x8192-coef-sum, 4096, 19, 2525, 65, 0, 0, 2609, 1
n250x8192-coef-sum, 4096, 19, 2532, 65, 0, 0, 2616, 1
n250x8192-coef-sum, 4096, 19, 2517, 64, 0, 0, 2600, 1
n250x8192-coef-sum, 4096, 19, 2516, 64, 0, 0, 2599, 1
n250x8192-coef-sum, 4096, 19, 2523, 63, 0, 0, 2605, 1
n250x8192-coef-sum, 4096, 19, 2513, 64, 0, 0, 2596, 1
n250x8192-coef-sum, 4096, 19, 2520, 63, 0, 0, 2602, 1
n250x8192-coef-sum, 4096, 19, 2518, 65, 0, 0, 2602, 1
n250x8192-coef-sum, 4096, 19, 2518, 64, 0, 0, 2601, 1
n250x8192-coef-sum, 4096, 19, 2510, 64, 0, 0, 2593, 1
n250x8192-coef-sum, 4096, 19, 2523, 63, 0, 0, 2605, 1
n250x8192-coef-sum, 4096, 19, 2534, 65, 0, 0, 2618, 1
n250x8192-coef-sum, 4096, 19, 2538, 64, 0, 0, 2621, 1
n250x8192-coef-sum, 4096, 19, 2524, 66, 0, 0, 2609, 1
n250x8192-coef-sum, 4096, 19, 2525, 64, 0, 0, 2608, 1
n250x8192-coef-sum, 4096, 19, 2530, 65, 0, 0, 2614, 1
n250x8192-coef-sum, 4096, 19, 2516, 64, 0, 0, 2599, 1
n250x8192-coef-sum, 4096, 21, 2530, 65, 0, 0, 2616, 1
n250x8192-coef-sum, 4096, 19, 2515, 63, 0, 0, 2597, 1
n250x8192-coef-sum, 4096, 19, 2515, 65, 0, 0, 2599, 1
n250x8192-coef-sum, 4096, 19, 2524, 63, 0, 0, 2606, 1
n250x8192-coef-sum, 4096, 19, 2515, 65, 0, 0, 2599, 1
n250x8192-coef-sum, 4096, 19, 2522, 64, 0, 0, 2605, 1
n250x8192-coef-sum, 4096, 19, 2520, 64, 0, 0, 2603, 1
n250x8192-coef-sum, 4096, 19, 2520, 64, 0, 0, 2603, 1
n250x8192-coef-sum, 4096, 19, 2522, 64, 0, 0, 2605, 1
n250x8192-coef-sum, 4096, 19, 2522, 64, 0, 0, 2605, 1
n250x8192-coef-sum, 4096, 19, 2511, 64, 0, 0, 2594, 1
n250x8192-coef-sum, 4096, 19, 2521, 63, 0, 0, 2603, 1
n250x8192-coef-sum, 4096, 19, 2517, 64, 0, 0, 2600, 1
n250x8192-coef-sum, 4096, 19, 2523, 64, 0, 0, 2606, 1
n250x8192-coef-sum, 4096, 19, 2527, 64, 0, 0, 2610, 1
n250x8192-coef-sum, 4096, 19, 2520, 64, 0, 0, 2603, 1
n250x8192-coef-sum, 4096, 19, 2533, 64, 0, 0, 2616, 1
n250x8192-coef-sum, 4096, 19, 2521, 64, 0, 0, 2604, 1
n250x8192-coef-sum, 4096, 19, 2514, 65, 0, 0, 2598, 1
n250x8192-coef-sum, 4096, 19, 2520, 63, 0, 0, 2602, 1
n250x8192-coef-sum, 4096, 19, 2520, 64, 0, 0, 2603, 1
n250x8192-coef-sum, 4096, 19, 2519, 63, 0, 0, 2601, 1
n250x8192-coef-sum, 4096, 19, 2529, 64, 0, 0, 2612, 1
n250x8192-coef-sum, 4096, 19, 2520, 64, 0, 0, 2603, 1
n250x8192-coef-sum, 4096, 19, 2511, 65, 0, 0, 2595, 1
n250x8192-coef-sum, 4096, 19, 2517, 64, 0, 0, 2600, 1
n250x8192-coef-sum, 4096, 19, 2516, 64, 0, 0, 2599, 1
n250x8192-coef-sum, 4096, 19, 2541, 64, 0, 0, 2624, 1
n250x8192-coef-sum, 4096, 19, 2513, 64, 0, 0, 2596, 1
n250x8192-coef-sum, 4096, 19, 2516, 63, 0, 0, 2598, 1
n250x8192-coef-sum, 4096, 19, 2525, 65, 0, 0, 2609, 1
n250x8192-coef-sum, 4096, 19, 2518, 63, 0, 0, 2600, 1
n250x8192-coef-sum, 4096, 19, 2518, 64, 0, 0, 2601, 1
n250x8192-coef-sum, 4096, 19, 2522, 63, 0, 0, 2604, 1
n250x8192-coef-sum, 4096, 19, 2524, 65, 0, 0, 2608, 1
n250x8192-coef-sum, 4096, 19, 2520, 63, 0, 0, 2602, 1
n250x8192-coef-sum, 4096, 19, 2510, 65, 0, 0, 2594, 1
n250x8192-coef-sum, 4096, 19, 2516, 63, 0, 0, 2598, 1
n250x8192-coef-sum, 4096, 19, 2537, 64, 0, 0, 2620, 1
n250x8192-coef-sum, 4096, 19, 2520, 64, 0, 0, 2603, 1
n250x8192-coef-sum, 4096, 19, 2519, 64, 0, 0, 2602, 1
n250x8192-coef-sum, 4096, 19, 2514, 64, 0, 0, 2597, 1
n250x8192-coef-sum, 4096, 19, 2518, 64, 0, 0, 2601, 1
n250x8192-coef-sum, 4096, 19, 2518, 65, 0, 0, 2602, 1
n250x8192-coef-sum, 4096, 19, 2519, 64, 0, 0, 2602, 1
n250x8192-coef-sum, 4096, 19, 2527, 63, 0, 0, 2609, 1
n250x8192-coef-sum, 4096, 18, 2524, 64, 0, 0, 2606, 1
n250x8192-coef-sum, 4096, 19, 2521, 63, 0, 0, 2603, 1
n250x8192-coef-sum, 4096, 19, 2524, 64, 0, 0, 2607, 1
n250x8192-coef-sum, 4096, 19, 2526, 64, 0, 0, 2609, 1
n250x8192-coef-sum, 4096, 19, 2528, 64, 0, 0, 2611, 1
n250x8192-coef-sum, 4096, 19, 2519, 64, 0, 0, 2602, 1
n250x8192-coef-sum, 2048, 11, 2514, 73, 0, 0, 2598, 1
n250x8192-coef-sum, 2048, 11, 2509, 73, 0, 0, 2593, 1
n250x8192-coef-sum, 2048, 11, 2520, 72, 0, 0, 2603, 1
n250x8192-coef-sum, 2048, 11, 2522, 74, 0, 0, 2607, 1
n250x8192-coef-sum, 2048, 12, 2518, 72, 0, 0, 2602, 1
n250x8192-coef-sum, 2048, 11, 2519, 72, 0, 0, 2602, 1
n250x8192-coef-sum, 2048, 11, 2517, 72, 0, 0, 2600, 1
n250x8192-coef-sum, 2048, 11, 2520, 73, 0, 0, 2604, 1
n250x8192-coef-sum, 2048, 11, 2540, 73, 0, 0, 2624, 1
n250x8192-coef-sum, 2048, 11, 2514, 73, 0, 0, 2598, 1
n250x8192-coef-sum, 2048, 11, 2524, 73, 0, 0, 2608, 1
n250x8192-coef-sum, 2048, 11, 2516, 73, 0, 0, 2600, 1
n250x8192-coef-sum, 2048, 11, 2533, 73, 0, 0, 2617, 1
n250x8192-coef-sum, 2048, 11, 2523, 74, 0, 0, 2608, 1
n250x8192-coef-sum, 2048, 12, 2530, 73, 0, 0, 2615, 1
n250x8192-coef-sum, 2048, 11, 2530, 73, 0, 0, 2614, 1
n250x8192-coef-sum, 2048, 11, 2518, 73, 0, 0, 2602, 1
n250x8192-coef-sum, 2048, 11, 2522, 73, 0, 0, 2606, 1
n250x8192-coef-sum, 2048, 11, 2516, 74, 0, 0, 2601, 1
n250x8192-coef-sum, 2048, 11, 2520, 74, 0, 0, 2605, 1
n250x8192-coef-sum, 2048, 11, 2513, 73, 0, 0, 2597, 1
n250x8192-coef-sum, 2048, 11, 2515, 73, 0, 0, 2599, 1
n250x8192-coef-sum, 2048, 12, 2514, 73, 0, 0, 2599, 1
n250x8192-coef-sum, 2048, 11, 2513, 73, 0, 0, 2597, 1
n250x8192-coef-sum, 2048, 11, 2518, 72, 0, 0, 2601, 1
n250x8192-coef-sum, 2048, 11, 2533, 72, 0, 0, 2616, 1
n250x8192-coef-sum, 2048, 11, 2527, 73, 0, 0, 2611, 1
n250x8192-coef-sum, 2048, 11, 2524, 74, 0, 0, 2609, 1
n250x8192-coef-sum, 2048, 11, 2516, 72, 0, 0, 2599, 1
n250x8192-coef-sum, 2048, 11, 2529, 73, 0, 0, 2613, 1
n250x8192-coef-sum, 2048, 11, 2546, 73, 0, 0, 2630, 1
n250x8192-coef-sum, 2048, 11, 2524, 73, 0, 0, 2608, 1
n250x8192-coef-sum, 2048, 11, 2520, 73, 0, 0, 2604, 1
n250x8192-coef-sum, 2048, 11, 2521, 73, 0, 0, 2605, 1
n250x8192-coef-sum, 2048, 11, 2511, 73, 0, 0, 2595, 1
n250x8192-coef-sum, 2048, 11, 2528, 73, 0, 0, 2612, 1
n250x8192-coef-sum, 2048, 11, 2528, 72, 0, 0, 2611, 1
n250x8192-coef-sum, 2048, 11, 2520, 73, 0, 0, 2604, 1
n250x8192-coef-sum, 2048, 12, 2515, 73, 0, 0, 2600, 1
n250x8192-coef-sum, 2048, 11, 2517, 73, 0, 0, 2601, 1
n250x8192-coef-sum, 2048, 11, 2524, 73, 0, 0, 2608, 1
n250x8192-coef-sum, 2048, 12, 2534, 73, 0, 0, 2619, 1
n250x8192-coef-sum, 2048, 11, 2521, 74, 0, 0, 2606, 1
n250x8192-coef-sum, 2048, 11, 2510, 73, 0, 0, 2594, 1
n250x8192-coef-sum, 2048, 11, 2521, 73, 0, 0, 2605, 1
n250x8192-coef-sum, 2048, 11, 2526, 73, 0, 0, 2610, 1
n250x8192-coef-sum, 2048, 11, 2526, 73, 0, 0, 2610, 1
n250x8192-coef-sum, 2048, 11, 2522, 73, 0, 0, 2606, 1
n250x8192-coef-sum, 2048, 11, 2520, 73, 0, 0, 2604, 1
n250x8192-coef-sum, 2048, 11, 2521, 72, 0, 0, 2604, 1
n250x8192-coef-sum, 2048, 11, 2527, 72, 0, 0, 2610, 1
n250x8192-coef-sum, 2048, 12, 2522, 74, 0, 0, 2608, 1
n250x8192-coef-sum, 2048, 11, 2649, 75, 0, 0, 2735, 1
n250x8192-coef-sum, 2048, 11, 2532, 74, 0, 0, 2617, 1
n250x8192-coef-sum, 2048, 11, 2513, 73, 0, 0, 2597, 1
n250x8192-coef-sum, 2048, 11, 2532, 74, 0, 0, 2617, 1
n250x8192-coef-sum, 2048, 11, 2520, 73, 0, 0, 2604, 1
n250x8192-coef-sum, 2048, 11, 2531, 73, 0, 0, 2615, 1
n250x8192-coef-sum, 2048, 11, 2529, 73, 0, 0, 2613, 1
n250x8192-coef-sum, 2048, 12, 2526, 73, 0, 0, 2611, 1
n250x8192-coef-sum, 2048, 11, 2525, 74, 0, 0, 2610, 1
n250x8192-coef-sum, 2048, 11, 2526, 73, 0, 0, 2610, 1
n250x8192-coef-sum, 2048, 11, 2517, 74, 0, 0, 2602, 1
n250x8192-coef-sum, 2048, 11, 2524, 73, 0, 0, 2608, 1
n250x8192-coef-sum, 2048, 11, 2518, 73, 0, 0, 2602, 1
n250x8192-coef-sum, 2048, 11, 2520, 72, 0, 0, 2603, 1
n250x8192-coef-sum, 2048, 11, 2514, 73, 0, 0, 2598, 1
n250x8192-coef-sum, 2048, 11, 2512, 74, 0, 0, 2597, 1
n250x8192-coef-sum, 2048, 11, 2519, 73, 0, 0, 2603, 1
n250x8192-coef-sum, 2048, 12, 2521, 73, 0, 0, 2606, 1
n250x8192-coef-sum, 2048, 11, 2520, 73, 0, 0, 2604, 1
n250x8192-coef-sum, 2048, 11, 2520, 73, 0, 0, 2604, 1
n250x8192-coef-sum, 2048, 11, 2519, 74, 0, 0, 2604, 1
n250x8192-coef-sum, 2048, 11, 2534, 73, 0, 0, 2618, 1
n250x8192-coef-sum, 2048, 11, 2521, 72, 0, 0, 2604, 1
n250x8192-coef-sum, 2048, 11, 2537, 74, 0, 0, 2622, 1
n250x8192-coef-sum, 2048, 12, 2521, 73, 0, 0, 2606, 1
n250x8192-coef-sum, 2048, 11, 2521, 73, 0, 0, 2605, 1
n250x8192-coef-sum, 2048, 11, 2521, 73, 0, 0, 2605, 1
n250x8192-coef-sum, 2048, 11, 2524, 73, 0, 0, 2608, 1
n250x8192-coef-sum, 2048, 12, 2519, 75, 0, 0, 2606, 1
n250x8192-coef-sum, 2048, 11, 2517, 73, 0, 0, 2601, 1
n250x8192-coef-sum, 2048, 12, 2520, 73, 0, 0, 2605, 1
n250x8192-coef-sum, 2048, 11, 2518, 73, 0, 0, 2602, 1
n250x8192-coef-sum, 2048, 12, 2524, 73, 0, 0, 2609, 1
n250x8192-coef-sum, 2048, 11, 2521, 72, 0, 0, 2604, 1
n250x8192-coef-sum, 2048, 11, 2522, 73, 0, 0, 2606, 1
n250x8192-coef-sum, 2048, 11, 2516, 74, 0, 0, 2601, 1
n250x8192-coef-sum, 2048, 11, 2522, 74, 0, 0, 2607, 1
n250x8192-coef-sum, 2048, 11, 2520, 75, 0, 0, 2606, 1
n250x8192-coef-sum, 2048, 12, 2524, 73, 0, 0, 2609, 1
n250x8192-coef-sum, 2048, 11, 2518, 73, 0, 0, 2602, 1
n250x8192-coef-sum, 2048, 11, 2523, 74, 0, 0, 2608, 1
n250x8192-coef-sum, 2048, 12, 2526, 73, 0, 0, 2611, 1
n250x8192-coef-sum, 2048, 11, 2520, 73, 0, 0, 2604, 1
n250x8192-coef-sum, 2048, 11, 2533, 74, 0, 0, 2618, 1
n250x8192-coef-sum, 2048, 11, 2522, 73, 0, 0, 2606, 1
n250x8192-coef-sum, 2048, 11, 2522, 72, 0, 0, 2605, 1
n250x8192-coef-sum, 2048, 11, 2515, 73, 0, 0, 2599, 1
n250x8192-coef-sum, 2048, 11, 2529, 73, 0, 0, 2613, 1
n250x8192-coef-sum, 1024, 12, 3197, 115, 0, 0, 3324, 1
n250x8192-coef-sum, 1024, 13, 3197, 114, 0, 0, 3324, 1
n250x8192-coef-sum, 1024, 13, 3219, 116, 0, 0, 3348, 1
n250x8192-coef-sum, 1024, 13, 3196, 114, 0, 0, 3323, 1
n250x8192-coef-sum, 1024, 12, 3194, 115, 0, 0, 3321, 1
n250x8192-coef-sum, 1024, 12, 3204, 114, 0, 0, 3330, 1
n250x8192-coef-sum, 1024, 13, 3198, 114, 0, 0, 3325, 1
n250x8192-coef-sum, 1024, 13, 3198, 113, 0, 0, 3324, 1
n250x8192-coef-sum, 1024, 12, 3202, 114, 0, 0, 3328, 1
n250x8192-coef-sum, 1024, 13, 3203, 114, 0, 0, 3330, 1
n250x8192-coef-sum, 1024, 12, 3211, 114, 0, 0, 3337, 1
n250x8192-coef-sum, 1024, 13, 3204, 115, 0, 0, 3332, 1
n250x8192-coef-sum, 1024, 12, 3204, 117, 0, 0, 3333, 1
n250x8192-coef-sum, 1024, 13, 3215, 116, 0, 0, 3344, 1
n250x8192-coef-sum, 1024, 13, 3196, 115, 0, 0, 3324, 1
n250x8192-coef-sum, 1024, 12, 3198, 114, 0, 0, 3324, 1
n250x8192-coef-sum, 1024, 13, 3205, 113, 0, 0, 3331, 1
n250x8192-coef-sum, 1024, 14, 3206, 116, 0, 0, 3336, 1
n250x8192-coef-sum, 1024, 13, 3230, 112, 0, 0, 3355, 1
n250x8192-coef-sum, 1024, 13, 3203, 113, 0, 0, 3329, 1
n250x8192-coef-sum, 1024, 13, 3207, 113, 0, 0, 3333, 1
n250x8192-coef-sum, 1024, 12, 3201, 115, 0, 0, 3328, 1
n250x8192-coef-sum, 1024, 13, 3213, 114, 0, 0, 3340, 1
n250x8192-coef-sum, 1024, 13, 3204, 113, 0, 0, 3330, 1
n250x8192-coef-sum, 1024, 12, 3199, 114, 0, 0, 3325, 1
n250x8192-coef-sum, 1024, 14, 3206, 114, 0, 0, 3334, 1
n250x8192-coef-sum, 1024, 13, 3213, 114, 0, 0, 3340, 1
n250x8192-coef-sum, 1024, 13, 3204, 114, 0, 0, 3331, 1
n250x8192-coef-sum, 1024, 12, 3214, 113, 0, 0, 3339, 1
n250x8192-coef-sum, 1024, 12, 3197, 114, 0, 0, 3323, 1
n250x8192-coef-sum, 1024, 13, 3205, 114, 0, 0, 3332, 1
n250x8192-coef-sum, 1024, 12, 3223, 115, 0, 0, 3350, 1
n250x8192-coef-sum, 1024, 13, 3197, 113, 0, 0, 3323, 1
n250x8192-coef-sum, 1024, 12, 3200, 114, 0, 0, 3326, 1
n250x8192-coef-sum, 1024, 12, 3193, 112, 0, 0, 3317, 1
n250x8192-coef-sum, 1024, 13, 3197, 114, 0, 0, 3324, 1
n250x8192-coef-sum, 1024, 13, 3196, 114, 0, 0, 3323, 1
n250x8192-coef-sum, 1024, 12, 3199, 114, 0, 0, 3325, 1
n250x8192-coef-sum, 1024, 14, 3205, 114, 0, 0, 3333, 1
n250x8192-coef-sum, 1024, 14, 3207, 116, 0, 0, 3337, 1
n250x8192-coef-sum, 1024, 12, 3204, 115, 0, 0, 3331, 1
n250x8192-coef-sum, 1024, 12, 3206, 115, 0, 0, 3333, 1
n250x8192-coef-sum, 1024, 12, 3206, 112, 0, 0, 3330, 1
n250x8192-coef-sum, 1024, 13, 3203, 113, 0, 0, 3329, 1
n250x8192-coef-sum, 1024, 13, 3208, 113, 0, 0, 3334, 1
n250x8192-coef-sum, 1024, 13, 3207, 114, 0, 0, 3334, 1
n250x8192-coef-sum, 1024, 12, 3204, 114, 0, 0, 3330, 1
n250x8192-coef-sum, 1024, 13, 3209, 115, 0, 0, 3337, 1
n250x8192-coef-sum, 1024, 13, 3224, 112, 0, 0, 3349, 1
n250x8192-coef-sum, 1024, 13, 3219, 114, 0, 0, 3346, 1
n250x8192-coef-sum, 1024, 13, 3194, 113, 0, 0, 3320, 1
n250x8192-coef-sum, 1024, 20, 3220, 115, 0, 0, 3355, 1
n250x8192-coef-sum, 1024, 13, 3213, 115, 0, 0, 3341, 1
n250x8192-coef-sum, 1024, 12, 3196, 114, 0, 0, 3322, 1
n250x8192-coef-sum, 1024, 12, 3211, 114, 0, 0, 3337, 1
n250x8192-coef-sum, 1024, 13, 3207, 117, 0, 0, 3337, 1
n250x8192-coef-sum, 1024, 12, 3227, 115, 0, 0, 3354, 1
n250x8192-coef-sum, 1024, 13, 3201, 116, 0, 0, 3330, 1
n250x8192-coef-sum, 1024, 13, 3217, 114, 0, 0, 3344, 1
n250x8192-coef-sum, 1024, 13, 3219, 117, 0, 0, 3349, 1
n250x8192-coef-sum, 1024, 12, 3203, 114, 0, 0, 3329, 1
n250x8192-coef-sum, 1024, 13, 3214, 114, 0, 0, 3341, 1
n250x8192-coef-sum, 1024, 12, 3207, 113, 0, 0, 3332, 1
n250x8192-coef-sum, 1024, 13, 3209, 116, 0, 0, 3338, 1
n250x8192-coef-sum, 1024, 13, 3210, 113, 0, 0, 3336, 1
n250x8192-coef-sum, 1024, 12, 3224, 116, 0, 0, 3352, 1
n250x8192-coef-sum, 1024, 12, 3209, 112, 0, 0, 3333, 1
n250x8192-coef-sum, 1024, 13, 3192, 115, 0, 0, 3320, 1
n250x8192-coef-sum, 1024, 13, 3206, 113, 0, 0, 3332, 1
n250x8192-coef-sum, 1024, 13, 3195, 115, 0, 0, 3323, 1
n250x8192-coef-sum, 1024, 13, 3192, 113, 0, 0, 3318, 1
n250x8192-coef-sum, 1024, 12, 3201, 114, 0, 0, 3327, 1
n250x8192-coef-sum, 1024, 12, 3210, 112, 0, 0, 3334, 1
n250x8192-coef-sum, 1024, 12, 3199, 113, 0, 0, 3324, 1
n250x8192-coef-sum, 1024, 13, 3203, 114, 0, 0, 3330, 1
n250x8192-coef-sum, 1024, 13, 3201, 114, 0, 0, 3328, 1
n250x8192-coef-sum, 1024, 12, 3198, 113, 0, 0, 3323, 1
n250x8192-coef-sum, 1024, 14, 3209, 114, 0, 0, 3337, 1
n250x8192-coef-sum, 1024, 14, 3198, 115, 0, 0, 3327, 1
n250x8192-coef-sum, 1024, 13, 3218, 114, 0, 0, 3345, 1
n250x8192-coef-sum, 1024, 12, 3206, 115, 0, 0, 3333, 1
n250x8192-coef-sum, 1024, 13, 3197, 115, 0, 0, 3325, 1
n250x8192-coef-sum, 1024, 13, 3220, 115, 0, 0, 3348, 1
n250x8192-coef-sum, 1024, 13, 3205, 116, 0, 0, 3334, 1
n250x8192-coef-sum, 1024, 13, 3213, 115, 0, 0, 3341, 1
n250x8192-coef-sum, 1024, 13, 3204, 115, 0, 0, 3332, 1
n250x8192-coef-sum, 1024, 17, 3204, 115, 0, 0, 3336, 1
n250x8192-coef-sum, 1024, 13, 3211, 115, 0, 0, 3339, 1
n250x8192-coef-sum, 1024, 13, 3211, 114, 0, 0, 3338, 1
n250x8192-coef-sum, 1024, 13, 3200, 113, 0, 0, 3326, 1
n250x8192-coef-sum, 1024, 12, 3206, 115, 0, 0, 3333, 1
n250x8192-coef-sum, 1024, 13, 3205, 113, 0, 0, 3331, 1
n250x8192-coef-sum, 1024, 13, 3200, 112, 0, 0, 3325, 1
n250x8192-coef-sum, 1024, 12, 3193, 116, 0, 0, 3321, 1
n250x8192-coef-sum, 1024, 13, 3205, 113, 0, 0, 3331, 1
n250x8192-coef-sum, 1024, 13, 3204, 116, 0, 0, 3333, 1
n250x8192-coef-sum, 1024, 13, 3207, 113, 0, 0, 3333, 1
n250x8192-coef-sum, 1024, 13, 3205, 114, 0, 0, 3332, 1
n250x8192-coef-sum, 1024, 12, 3209, 112, 0, 0, 3333, 1
n250x8192-coef-sum, 1024, 12, 3201, 114, 0, 0, 3327, 1
n250x8192-slot-sum, 8192, 126, 1426, 85, 0, 0, 1637, 1
n250x8192-slot-sum, 8192, 126, 1411, 85, 0, 0, 1622, 1
n250x8192-slot-sum, 8192, 125, 1414, 84, 0, 0, 1623, 1
n250x8192-slot-sum, 8192, 127, 1411, 85, 0, 0, 1623, 1
n250x8192-slot-sum, 8192, 126, 1404, 85, 0, 0, 1615, 1
n250x8192-slot-sum, 8192, 126, 1413, 85, 0, 0, 1624, 1
n250x8192-slot-sum, 8192, 127, 1415, 85, 0, 0, 1627, 1
n250x8192-slot-sum, 8192, 127, 1409, 85, 0, 0, 1621, 1
n250x8192-slot-sum, 8192, 127, 1413, 84, 0, 0, 1624, 1
n250x8192-slot-sum, 8192, 126, 1413, 85, 0, 0, 1624, 1
n250x8192-slot-sum, 8192, 126, 1415, 83, 0, 0, 1624, 1
n250x8192-slot-sum, 8192, 126, 1404, 85, 0, 0, 1615, 1
n250x8192-slot-sum, 8192, 126, 1414, 85, 0, 0, 1625, 1
n250x8192-slot-sum, 8192, 126, 1412, 84, 0, 0, 1622, 1
n250x8192-slot-sum, 8192, 125, 1409, 85, 0, 0, 1619, 1
n250x8192-slot-sum, 8192, 127, 1408, 85, 0, 0, 1620, 1
n250x8192-slot-sum, 8192, 125, 1416, 85, 0, 0, 1626, 1
n250x8192-slot-sum, 8192, 126, 1414, 85, 0, 0, 1625, 1
n250x8192-slot-sum, 8192, 125, 1407, 85, 0, 0, 1617, 1
n250x8192-slot-sum, 8192, 126, 1422, 85, 0, 0, 1633, 1
n250x8192-slot-sum, 8192, 126, 1407, 84, 0, 0, 1617, 1
n250x8192-slot-sum, 8192, 127, 1407, 85, 0, 0, 1619, 1
n250x8192-slot-sum, 8192, 125, 1407, 83, 0, 0, 1615, 1
n250x8192-slot-sum, 8192, 127, 1476, 93, 1, 0, 1697, 1
n250x8192-slot-sum, 8192, 127, 1413, 84, 0, 0, 1624, 1
n250x8192-slot-sum, 8192, 127, 1407, 85, 0, 0, 1619, 1
n250x8192-slot-sum, 8192, 127, 1411, 85, 0, 0, 1623, 1
n250x8192-slot-sum, 8192, 127, 1405, 85, 0, 0, 1617, 1
n250x8192-slot-sum, 8192, 128, 1414, 85, 0, 0, 1627, 1
n250x8192-slot-sum, 8192, 126, 1410, 85, 0, 0, 1621, 1
n250x8192-slot-sum, 8192, 126, 1408, 84, 1, 0, 1619, 1
n250x8192-slot-sum, 8192, 126, 1404, 85, 0, 0, 1615, 1
n250x8192-slot-sum, 8192, 126, 1405, 84, 0, 0, 1615, 1
n250x8192-slot-sum, 8192, 126, 1420, 85, 0, 0, 1631, 1
n250x8192-slot-sum, 8192, 138, 1410, 85, 0, 0, 1633, 1
n250x8192-slot-sum, 8192, 125, 1406, 85, 0, 0, 1616, 1
n250x8192-slot-sum, 8192, 126, 1414, 84, 0, 0, 1624, 1
n250x8192-slot-sum, 8192, 126, 1410, 85, 0, 0, 1621, 1
n250x8192-slot-sum, 8192, 126, 1417, 84, 0, 0, 1627, 1
n250x8192-slot-sum, 8192, 126, 1417, 86, 0, 0, 1629, 1
n250x8192-slot-sum, 8192, 128, 1410, 83, 0, 0, 1621, 1
n250x8192-slot-sum, 8192, 128, 1412, 86, 0, 0, 1626, 1
n250x8192-slot-sum, 8192, 127, 1415, 85, 0, 0, 1627, 1
n250x8192-slot-sum, 8192, 126, 1412, 85, 0, 0, 1623, 1
n250x8192-slot-sum, 8192, 126, 1406, 84, 0, 0, 1616, 1
n250x8192-slot-sum, 8192, 127, 1406, 85, 0, 0, 1618, 1
n250x8192-slot-sum, 8192, 127, 1412, 86, 0, 0, 1625, 1
n250x8192-slot-sum, 8192, 126, 1411, 84, 0, 0, 1621, 1
n250x8192-slot-sum, 8192, 126, 1402, 83, 0, 0, 1611, 1
n250x8192-slot-sum, 8192, 126, 1404, 84, 0, 0, 1614, 1
n250x8192-slot-sum, 8192, 126, 1414, 85, 0, 0, 1625, 1
n250x8192-slot-sum, 8192, 126, 1413, 86, 0, 0, 1625, 1
n250x8192-slot-sum, 8192, 125, 1409, 85, 1, 0, 1620, 1
n250x8192-slot-sum, 8192, 126, 1411, 85, 0, 0, 1622, 1
n250x8192-slot-sum, 8192, 127, 1410, 83, 0, 0, 1620, 1
n250x8192-slot-sum, 8192, 125, 1418, 86, 0, 0, 1629, 1
n250x8192-slot-sum, 8192, 127, 1410, 84, 0, 0, 1621, 1
n250x8192-slot-sum, 8192, 126, 1410, 86, 0, 0, 1622, 1
n250x8192-slot-sum, 8192, 126, 1412, 83, 0, 0, 1621, 1
n250x8192-slot-sum, 8192, 126, 1413, 85, 0, 0, 1624, 1
n250x8192-slot-sum, 8192, 127, 1412, 85, 0, 0, 1624, 1
n250x8192-slot-sum, 8192, 126, 1410, 84, 0, 0, 1620, 1
n250x8192-slot-sum, 8192, 128, 1407, 84, 0, 0, 1619, 1
n250x8192-slot-sum, 8192, 128, 1431, 85, 0, 0, 1644, 1
n250x8192-slot-sum, 8192, 125, 1406, 86, 0, 0, 1617, 1
n250x8192-slot-sum, 8192, 126, 1408, 85, 0, 0, 1619, 1
n250x8192-slot-sum, 8192, 125, 1408, 84, 0, 0, 1617, 1
n250x8192-slot-sum, 8192, 126, 1417, 86, 0, 0, 1629, 1
n250x8192-slot-sum, 8192, 126, 1419, 85, 0, 0, 1630, 1
n250x8192-slot-sum, 8192, 126, 1407, 84, 0, 0, 1617, 1
n250x8192-slot-sum, 8192, 126, 1417, 85, 0, 0, 1628, 1
n250x8192-slot-sum, 8192, 127, 1408, 84, 0, 0, 1619, 1
n250x8192-slot-sum, 8192, 126, 1407, 85, 0, 0, 1618, 1
n250x8192-slot-sum, 8192, 128, 1412, 84, 0, 0, 1624, 1
n250x8192-slot-sum, 8192, 127, 1414, 85, 0, 0, 1626, 1
n250x8192-slot-sum, 8192, 127, 1424, 84, 0, 0, 1635, 1
n250x8192-slot-sum, 8192, 125, 1417, 84, 0, 0, 1626, 1
n250x8192-slot-sum, 8192, 125, 1410, 84, 0, 0, 1619, 1
n250x8192-slot-sum, 8192, 126, 1418, 84, 0, 0, 1628, 1
n250x8192-slot-sum, 8192, 126, 1406, 83, 0, 0, 1615, 1
n250x8192-slot-sum, 8192, 127, 1411, 84, 0, 0, 1622, 1
n250x8192-slot-sum, 8192, 126, 1409, 84, 0, 0, 1619, 1
n250x8192-slot-sum, 8192, 126, 1403, 85, 0, 0, 1614, 1
n250x8192-slot-sum, 8192, 125, 1411, 84, 0, 0, 1620, 1
n250x8192-slot-sum, 8192, 127, 1415, 84, 0, 0, 1626, 1
n250x8192-slot-sum, 8192, 127, 1425, 84, 0, 0, 1636, 1
n250x8192-slot-sum, 8192, 126, 1404, 84, 0, 0, 1614, 1
n250x8192-slot-sum, 8192, 126, 1406, 84, 0, 0, 1616, 1
n250x8192-slot-sum, 8192, 126, 1414, 84, 0, 0, 1624, 1
n250x8192-slot-sum, 8192, 127, 1408, 83, 0, 0, 1618, 1
n250x8192-slot-sum, 8192, 126, 1411, 83, 0, 0, 1620, 1
n250x8192-slot-sum, 8192, 125, 1407, 84, 0, 0, 1616, 1
n250x8192-slot-sum, 8192, 125, 1412, 84, 0, 0, 1621, 1
n250x8192-slot-sum, 8192, 126, 1414, 85, 0, 0, 1625, 1
n250x8192-slot-sum, 8192, 126, 1416, 85, 0, 0, 1627, 1
n250x8192-slot-sum, 8192, 126, 1407, 83, 0, 0, 1616, 1
n250x8192-slot-sum, 8192, 127, 1410, 84, 0, 0, 1621, 1
n250x8192-slot-sum, 8192, 127, 1412, 84, 0, 0, 1623, 1
n250x8192-slot-sum, 8192, 126, 1417, 85, 0, 0, 1628, 1
n250x8192-slot-sum, 8192, 126, 1407, 84, 0, 0, 1617, 1
n250x8192-slot-sum, 4096, 60, 1365, 74, 0, 0, 1499, 1
n250x8192-slot-sum, 4096, 63, 1374, 76, 0, 0, 1513, 1
n250x8192-slot-sum, 4096, 73, 1370, 75, 0, 0, 1518, 1
n250x8192-slot-sum, 4096, 60, 1370, 75, 0, 0, 1505, 1
n250x8192-slot-sum, 4096, 60, 1367, 75, 0, 0, 1502, 1
n250x8192-slot-sum, 4096, 60, 1373, 74, 0, 0, 1507, 1
n250x8192-slot-sum, 4096, 60, 1365, 75, 0, 0, 1500, 1
n250x8192-slot-sum, 4096, 60, 1364, 75, 0, 0, 1499, 1
n250x8192-slot-sum, 4096, 59, 1371, 75, 0, 0, 1505, 1
n250x8192-slot-sum, 4096, 60, 1369, 74, 0, 0, 1503, 1
n250x8192-slot-sum, 4096, 60, 1370, 74, 0, 0, 1504, 1
n250x8192-slot-sum, 4096, 59, 1368, 75, 0, 0, 1502, 1
n250x8192-slot-sum, 4096, 60, 1375, 74, 0, 0, 1509, 1
n250x8192-slot-sum, 4096, 59, 1369, 75, 0, 0, 1503, 1
n250x8192-slot-sum, 4096, 60, 1370, 74, 0, 0, 1504, 1
n250x8192-slot-sum, 4096, 60, 1372, 74, 0, 0, 1506, 1
n250x8192-slot-sum, 4096, 60, 1370, 75, 0, 0, 1505, 1
n250x8192-slot-sum, 4096, 60, 1367, 74, 0, 0, 1501, 1
n250x8192-slot-sum, 4096, 60, 1382, 75, 0, 0, 1517, 1
n250x8192-slot-sum, 4096, 60, 1369, 75, 0, 0, 1504, 1
n250x8192-slot-sum, 4096, 60, 1377, 74, 0, 0, 1511, 1
n250x8192-slot-sum, 4096, 60, 1371, 75, 0, 0, 1506, 1
n250x8192-slot-sum, 4096, 60, 1374, 75, 0, 0, 1509, 1
n250x8192-slot-sum, 4096, 60, 1371, 74, 0, 0, 1505, 1
n250x8192-slot-sum, 4096, 61, 1369, 74, 0, 0, 1504, 1
n250x8192-slot-sum, 4096, 60, 1368, 75, 0, 0, 1503, 1
n250x8192-slot-sum, 4096, 60, 1365, 74, 0, 0, 1499, 1
n250x8192-slot-sum, 4096, 60, 1371, 75, 0, 0, 1506, 1
n250x8192-slot-sum, 4096, 60, 1370, 75, 0, 0, 1505, 1
n250x8192-slot-sum, 4096, 60, 1377, 75, 0, 0, 1512, 1
n250x8192-slot-sum, 4096, 59, 1368, 75, 0, 0, 1502, 1
n250x8192-slot-sum, 4096, 60, 1364, 75, 0, 0, 1499, 1
n250x8192-slot-sum, 4096, 61, 1372, 75, 0, 0, 1508, 1
n250x8192-slot-sum, 4096, 60, 1371, 74, 0, 0, 1505, 1
n250x8192-slot-sum, 4096, 60, 1366, 74, 0, 0, 1500, 1
n250x8192-slot-sum, 4096, 59, 1373, 74, 0, 0, 1506, 1
n250x8192-slot-sum, 4096, 60, 1370, 75, 0, 0, 1505, 1
n250x8192-slot-sum, 4096, 61, 1367, 74, 0, 0, 1502, 1
n250x8192-slot-sum, 4096, 60, 1388, 75, 0, 0, 1523, 1
n250x8192-slot-sum, 4096, 59, 1368, 75, 0, 0, 1502, 1
n250x8192-slot-sum, 4096, 60, 1363, 74, 0, 0, 1497, 1
n250x8192-slot-sum, 4096, 61, 1374, 75, 0, 0, 1510, 1
n250x8192-slot-sum, 4096, 60, 1368, 75, 0, 0, 1503, 1
n250x8192-slot-sum, 4096, 59, 1365, 76, 0, 0, 1500, 1
n250x8192-slot-sum, 4096, 59, 1371, 74, 0, 0, 1504, 1
n250x8192-slot-sum, 4096, 60, 1368, 75, 0, 0, 1503, 1
n250x8192-slot-sum, 4096, 60, 1365, 74, 0, 0, 1499, 1
n250x8192-slot-sum, 4096, 59, 1370, 75, 0, 0, 1504, 1
n250x8192-slot-sum, 4096, 60, 1367, 75, 0, 0, 1502, 1
n250x8192-slot-sum, 4096, 60, 1360, 75, 0, 0, 1495, 1
n250x8192-slot-sum, 4096, 59, 1369, 75, 0, 0, 1503, 1
n250x8192-slot-sum, 4096, 60, 1368, 75, 0, 0, 1503, 1
n250x8192-slot-sum, 4096, 60, 1365, 74, 0, 0, 1499, 1
n250x8192-slot-sum, 4096, 60, 1368, 75, 0, 0, 1503, 1
n250x8192-slot-sum, 4096, 60, 1365, 74, 0, 0, 1499, 1
n250x8192-slot-sum, 4096, 60, 1368, 75, 0, 0, 1503, 1
n250x8192-slot-sum, 4096, 61, 1370, 76, 0, 0, 1507, 1
n250x8192-slot-sum, 4096, 60, 1368, 75, 0, 0, 1503, 1
n250x8192-slot-sum, 4096, 60, 1370, 76, 0, 0, 1506, 1
n250x8192-slot-sum, 4096, 60, 1368, 76, 0, 0, 1504, 1
n250x8192-slot-sum, 4096, 59, 1365, 75, 0, 0, 1499, 1
n250x8192-slot-sum, 4096, 60, 1364, 75, 0, 0, 1499, 1
n250x8192-slot-sum, 4096, 59, 1367, 76, 0, 0, 1502, 1
n250x8192-slot-sum, 4096, 60, 1369, 76, 0, 0, 1505, 1
n250x8192-slot-sum, 4096, 59, 1362, 74, 0, 0, 1495, 1
n250x8192-slot-sum, 4096, 60, 1364, 77, 0, 0, 1501, 1
n250x8192-slot-sum, 4096, 60, 1374, 75, 0, 0, 1509, 1
n250x8192-slot-sum, 4096, 59, 1365, 76, 0, 0, 1500, 1
n250x8192-slot-sum, 4096, 60, 1372, 74, 0, 0, 1506, 1
n250x8192-slot-sum, 4096, 60, 1374, 76, 0, 0, 1510, 1
n250x8192-slot-sum, 4096, 59, 1371, 76, 0, 0, 1506, 1
n250x8192-slot-sum, 4096, 60, 1364, 75, 0, 0, 1499, 1
n250x8192-slot-sum, 4096, 60, 1375, 74, 0, 0, 1509, 1
n250x8192-slot-sum, 4096, 60, 1367, 76, 0, 0, 1503, 1
n250x8192-slot-sum, 4096, 59, 1385, 76, 0, 0, 1520, 1
n250x8192-slot-sum, 4096, 61, 1376, 76, 0, 0, 1513, 1
n250x8192-slot-sum, 4096, 60, 1371, 75, 0, 0, 1506, 1
n250x8192-slot-sum, 4096, 59, 1372, 75, 0, 0, 1506, 1
n250x8192-slot-sum, 4096, 60, 1373, 75, 0, 0, 1508, 1
n250x8192-slot-sum, 4096, 60, 1366, 75, 0, 0, 1501, 1
n250x8192-slot-sum, 4096, 59, 1365, 74, 0, 0, 1498, 1
n250x8192-slot-sum, 4096, 60, 1371, 76, 0, 0, 1507, 1
n250x8192-slot-sum, 4096, 59, 1370, 75, 0, 0, 1504, 1
n250x8192-slot-sum, 4096, 60, 1370, 77, 0, 0, 1507, 1
n250x8192-slot-sum, 4096, 60, 1374, 75, 0, 0, 1509, 1
n250x8192-slot-sum, 4096, 60, 1367, 75, 0, 0, 1502, 1
n250x8192-slot-sum, 4096, 60, 1362, 75, 0, 0, 1497, 1
n250x8192-slot-sum, 4096, 60, 1366, 75, 0, 0, 1501, 1
n250x8192-slot-sum, 4096, 60, 1369, 74, 0, 0, 1503, 1
n250x8192-slot-sum, 4096, 60, 1369, 75, 0, 0, 1504, 1
n250x8192-slot-sum, 4096, 60, 1369, 75, 0, 0, 1504, 1
n250x8192-slot-sum, 4096, 60, 1371, 75, 0, 0, 1506, 1
n250x8192-slot-sum, 4096, 60, 1376, 75, 0, 0, 1511, 1
n250x8192-slot-sum, 4096, 61, 1372, 76, 0, 0, 1509, 1
n250x8192-slot-sum, 4096, 60, 1364, 74, 0, 0, 1498, 1
n250x8192-slot-sum, 4096, 60, 1370, 76, 0, 0, 1506, 1
n250x8192-slot-sum, 4096, 60, 1365, 75, 0, 0, 1500, 1
n250x8192-slot-sum, 4096, 62, 1366, 76, 0, 0, 1504, 1
n250x8192-slot-sum, 4096, 60, 1372, 74, 0, 0, 1506, 1
n250x8192-slot-sum, 4096, 59, 1367, 76, 0, 0, 1502, 1
n250x8192-slot-sum, 2048, 30, 1351, 77, 0, 0, 1458, 1
n250x8192-slot-sum, 2048, 30, 1356, 78, 0, 0, 1464, 1
n250x8192-slot-sum, 2048, 30, 1350, 75, 0, 0, 1455, 1
n250x8192-slot-sum, 2048, 30, 1347, 76, 0, 0, 1453, 1
n250x8192-slot-sum, 2048, 30, 1350, 77, 0, 0, 1457, 1
n250x8192-slot-sum, 2048, 30, 1351, 76, 0, 0, 1457, 1
n250x8192-slot-sum, 2048, 29, 1350, 77, 0, 0, 1456, 1
n250x8192-slot-sum, 2048, 30, 1350, 76, 0, 0, 1456, 1
n250x8192-slot-sum, 2048, 30, 1348, 76, 0, 0, 1454, 1
n250x8192-slot-sum, 2048, 30, 1350, 80, 0, 0, 1460, 1
n250x8192-slot-sum, 2048, 30, 1349, 76, 0, 0, 1455, 1
n250x8192-slot-sum, 2048, 30, 1365, 75, 0, 0, 1470, 1
n250x8192-slot-sum, 2048, 30, 1349, 75, 0, 0, 1454, 1
n250x8192-slot-sum, 2048, 30, 1351, 76, 0, 0, 1457, 1
n250x8192-slot-sum, 2048, 29, 1412, 77, 0, 0, 1518, 1
n250x8192-slot-sum, 2048, 29, 1348, 76, 0, 0, 1453, 1
n250x8192-slot-sum, 2048, 30, 1350, 75, 0, 0, 1455, 1
n250x8192-slot-sum, 2048, 30, 1349, 75, 0, 0, 1454, 1
n250x8192-slot-sum, 2048, 29, 1352, 75, 0, 0, 1456, 1
n250x8192-slot-sum, 2048, 30, 1346, 76, 0, 0, 1452, 1
n250x8192-slot-sum, 2048, 30, 1350, 77, 0, 0, 1457, 1
n250x8192-slot-sum, 2048, 30, 1351, 77, 0, 0, 1458, 1
n250x8192-slot-sum, 2048, 30, 1348, 75, 0, 0, 1453, 1
n250x8192-slot-sum, 2048, 30, 1350, 76, 0, 0, 1456, 1
n250x8192-slot-sum, 2048, 30, 1352, 76, 0, 0, 1458, 1
n250x8192-slot-sum, 2048, 29, 1346, 77, 0, 0, 1452, 1
n250x8192-slot-sum, 2048, 30, 1348, 75, 0, 0, 1453, 1
n250x8192-slot-sum, 2048, 30, 1349, 75, 0, 0, 1454, 1
n250x8192-slot-sum, 2048, 30, 1350, 75, 0, 0, 1455, 1
n250x8192-slot-sum, 2048, 29, 1350, 76, 0, 0, 1455, 1
n250x8192-slot-sum, 2048, 30, 1350, 77, 0, 0, 1457, 1
n250x8192-slot-sum, 2048, 29, 1355, 76, 0, 0, 1460, 1
n250x8192-slot-sum, 2048, 29, 1346, 76, 0, 0, 1451, 1
n250x8192-slot-sum, 2048, 29, 1345, 75, 0, 0, 1449, 1
n250x8192-slot-sum, 2048, 30, 1348, 75, 0, 0, 1453, 1
n250x8192-slot-sum, 2048, 29, 1344, 76, 0, 0, 1449, 1
n250x8192-slot-sum, 2048, 30, 1346, 76, 0, 0, 1452, 1
n250x8192-slot-sum, 2048, 30, 1344, 75, 0, 0, 1449, 1
n250x8192-slot-sum, 2048, 30, 1348, 75, 0, 0, 1453, 1
n250x8192-slot-sum, 2048, 29, 1352, 76, 0, 0, 1457, 1
n250x8192-slot-sum, 2048, 30, 1348, 76, 0, 0, 1454, 1
n250x8192-slot-sum, 2048, 29, 1345, 76, 0, 0, 1450, 1
n250x8192-slot-sum, 2048, 30, 1354, 75, 0, 0, 1459, 1
n250x8192-slot-sum, 2048, 30, 1356, 76, 0, 0, 1462, 1
n250x8192-slot-sum, 2048, 30, 1354, 76, 0, 0, 1460, 1
n250x8192-slot-sum, 2048, 30, 1346, 76, 0, 0, 1452, 1
n250x8192-slot-sum, 2048, 30, 1351, 76, 0, 0, 1457, 1
n250x8192-slot-sum, 2048, 29, 1350, 75, 0, 0, 1454, 1
n250x8192-slot-sum, 2048, 30, 1349, 76, 0, 0, 1455, 1
n250x8192-slot-sum, 2048, 30, 1367, 76, 0, 0, 1473, 1
n250x8192-slot-sum, 2048, 30, 1357, 76, 0, 0, 1463, 1
n250x8192-slot-sum, 2048, 30, 1348, 76, 0, 0, 1454, 1
n250x8192-slot-sum, 2048, 30, 1350, 75, 0, 0, 1455, 1
n250x8192-slot-sum, 2048, 30, 1357, 77, 0, 0, 1464, 1
n250x8192-slot-sum, 2048, 30, 1354, 77, 0, 0, 1461, 1
n250x8192-slot-sum, 2048, 30, 1349, 77, 0, 0, 1456, 1
n250x8192-slot-sum, 2048, 30, 1350, 76, 0, 0, 1456, 1
n250x8192-slot-sum, 2048, 29, 1347, 75, 0, 0, 1451, 1
n250x8192-slot-sum, 2048, 30, 1348, 77, 0, 0, 1455, 1
n250x8192-slot-sum, 2048, 30, 1350, 78, 0, 0, 1458, 1
n250x8192-slot-sum, 2048, 30, 1347, 77, 0, 0, 1454, 1
n250x8192-slot-sum, 2048, 30, 1347, 76, 0, 0, 1453, 1
n250x8192-slot-sum, 2048, 30, 1350, 76, 0, 0, 1456, 1
n250x8192-slot-sum, 2048, 30, 1353, 76, 0, 0, 1459, 1
n250x8192-slot-sum, 2048, 29, 1348, 76, 0, 0, 1453, 1
n250x8192-slot-sum, 2048, 30, 1350, 76, 0, 0, 1456, 1
n250x8192-slot-sum, 2048, 30, 1360, 77, 0, 0, 1467, 1
n250x8192-slot-sum, 2048, 30, 1351, 76, 0, 0, 1457, 1
n250x8192-slot-sum, 2048, 30, 1353, 77, 0, 0, 1460, 1
n250x8192-slot-sum, 2048, 30, 1350, 77, 0, 0, 1457, 1
n250x8192-slot-sum, 2048, 30, 1353, 77, 0, 0, 1460, 1
n250x8192-slot-sum, 2048, 29, 1352, 75, 0, 0, 1456, 1
n250x8192-slot-sum, 2048, 29, 1344, 76, 0, 0, 1449, 1
n250x8192-slot-sum, 2048, 30, 1349, 75, 0, 0, 1454, 1
n250x8192-slot-sum, 2048, 30, 1345, 76, 0, 0, 1451, 1
n250x8192-slot-sum, 2048, 30, 1349, 76, 0, 0, 1455, 1
n250x8192-slot-sum, 2048, 30, 1348, 75, 0, 0, 1453, 1
n250x8192-slot-sum, 2048, 29, 1349, 75, 0, 0, 1453, 1
n250x8192-slot-sum, 2048, 30, 1353, 75, 0, 0, 1458, 1
n250x8192-slot-sum, 2048, 30, 1348, 75, 0, 0, 1453, 1
n250x8192-slot-sum, 2048, 30, 1351, 77, 0, 0, 1458, 1
n250x8192-slot-sum, 2048, 30, 1352, 76, 0, 0, 1458, 1
n250x8192-slot-sum, 2048, 29, 1351, 77, 0, 0, 1457, 1
n250x8192-slot-sum, 2048, 30, 1347, 76, 0, 0, 1453, 1
n250x8192-slot-sum, 2048, 30, 1357, 76, 0, 0, 1463, 1
n250x8192-slot-sum, 2048, 29, 1350, 76, 0, 0, 1455, 1
n250x8192-slot-sum, 2048, 30, 1363, 77, 0, 0, 1470, 1
n250x8192-slot-sum, 2048, 30, 1356, 76, 0, 0, 1462, 1
n250x8192-slot-sum, 2048, 30, 1353, 76, 0, 0, 1459, 1
n250x8192-slot-sum, 2048, 30, 1354, 76, 0, 0, 1460, 1
n250x8192-slot-sum, 2048, 30, 1349, 77, 0, 0, 1456, 1
n250x8192-slot-sum, 2048, 30, 1358, 76, 0, 0, 1464, 1
n250x8192-slot-sum, 2048, 29, 1351, 75, 0, 0, 1455, 1
n250x8192-slot-sum, 2048, 30, 1350, 75, 0, 0, 1455, 1
n250x8192-slot-sum, 2048, 29, 1350, 77, 0, 0, 1456, 1
n250x8192-slot-sum, 2048, 29, 1346, 77, 0, 0, 1452, 1
n250x8192-slot-sum, 2048, 30, 1352, 76, 0, 0, 1458, 1
n250x8192-slot-sum, 2048, 29, 1351, 76, 0, 0, 1456, 1
n250x8192-slot-sum, 2048, 30, 1361, 77, 0, 0, 1468, 1
n250x8192-slot-sum, 2048, 29, 1351, 77, 0, 0, 1457, 1
n250x8192-slot-sum, 1024, 30, 1752, 119, 0, 0, 1901, 1
n250x8192-slot-sum, 1024, 31, 1741, 115, 0, 0, 1887, 1
n250x8192-slot-sum, 1024, 30, 1729, 116, 0, 0, 1875, 1
n250x8192-slot-sum, 1024, 30, 1730, 116, 0, 0, 1876, 1
n250x8192-slot-sum, 1024, 32, 1746, 116, 0, 0, 1894, 1
n250x8192-slot-sum, 1024, 30, 1735, 116, 0, 0, 1881, 1
n250x8192-slot-sum, 1024, 31, 1738, 116, 0, 0, 1885, 1
n250x8192-slot-sum, 1024, 30, 1729, 114, 0, 0, 1873, 1
n250x8192-slot-sum, 1024, 31, 1732, 115, 0, 0, 1878, 1
n250x8192-slot-sum, 1024, 31, 1731, 113, 0, 0, 1875, 1
n250x8192-slot-sum, 1024, 31, 1731, 114, 0, 0, 1876, 1
n250x8192-slot-sum, 1024, 30, 1733, 115, 0, 0, 1878, 1
n250x8192-slot-sum, 1024, 30, 1728, 115, 0, 0, 1873, 1
n250x8192-slot-sum, 1024, 30, 1736, 115, 0, 0, 1881, 1
n250x8192-slot-sum, 1024, 30, 1731, 117, 0, 0, 1878, 1
n250x8192-slot-sum, 1024, 30, 1727, 115, 0, 0, 1872, 1
n250x8192-slot-sum, 1024, 30, 1736, 118, 0, 0, 1884, 1
n250x8192-slot-sum, 1024, 31, 1728, 116, 0, 0, 1875, 1
n250x8192-slot-sum, 1024, 31, 1739, 130, 0, 0, 1900, 1
n250x8192-slot-sum, 1024, 32, 1740, 116, 0, 0, 1888, 1
n250x8192-slot-sum, 1024, 31, 1747, 114, 0, 0, 1892, 1
n250x8192-slot-sum, 1024, 31, 1744, 116, 0, 0, 1891, 1
n250x8192-slot-sum, 1024, 30, 1739, 117, 0, 0, 1886, 1
n250x8192-slot-sum, 1024, 30, 1733, 116, 0, 0, 1879, 1
n250x8192-slot-sum, 1024, 30, 1732, 116, 0, 0, 1878, 1
n250x8192-slot-sum, 1024, 31, 1735, 116, 0, 0, 1882, 1
n250x8192-slot-sum, 1024, 31, 1740, 117, 0, 0, 1888, 1
n250x8192-slot-sum, 1024, 30, 1730, 115, 0, 0, 1875, 1
n250x8192-slot-sum, 1024, 30, 1737, 115, 0, 0, 1882, 1
n250x8192-slot-sum, 1024, 30, 1732, 116, 0, 0, 1878, 1
n250x8192-slot-sum, 1024, 31, 1743, 117, 0, 0, 1891, 1
n250x8192-slot-sum, 1024, 30, 1725, 116, 0, 0, 1871, 1
n250x8192-slot-sum, 1024, 31, 1739, 117, 0, 0, 1887, 1
n250x8192-slot-sum, 1024, 30, 1743, 119, 0, 0, 1892, 1
n250x8192-slot-sum, 1024, 31, 1743, 116, 0, 0, 1890, 1
n250x8192-slot-sum, 1024, 30, 1734, 115, 0, 0, 1879, 1
n250x8192-slot-sum, 1024, 30, 1743, 120, 0, 0, 1893, 1
n250x8192-slot-sum, 1024, 31, 1735, 115, 0, 0, 1881, 1
n250x8192-slot-sum, 1024, 30, 1732, 117, 0, 0, 1879, 1
n250x8192-slot-sum, 1024, 31, 1729, 114, 0, 0, 1874, 1
n250x8192-slot-sum, 1024, 30, 1739, 116, 0, 0, 1885, 1
n250x8192-slot-sum, 1024, 31, 1737, 115, 0, 0, 1883, 1
n250x8192-slot-sum, 1024, 30, 1734, 115, 0, 0, 1879, 1
n250x8192-slot-sum, 1024, 30, 1731, 115, 0, 0, 1876, 1
n250x8192-slot-sum, 1024, 31, 1732, 117, 0, 0, 1880, 1
n250x8192-slot-sum, 1024, 31, 1727, 116, 0, 0, 1874, 1
n250x8192-slot-sum, 1024, 31, 1741, 116, 0, 0, 1888, 1
n250x8192-slot-sum, 1024, 32, 1734, 116, 0, 0, 1882, 1
n250x8192-slot-sum, 1024, 30, 1756, 116, 0, 0, 1902, 1
n250x8192-slot-sum, 1024, 31, 1736, 117, 0, 0, 1884, 1
n250x8192-slot-sum, 1024, 30, 1728, 115, 0, 0, 1873, 1
n250x8192-slot-sum, 1024, 30, 1728, 116, 0, 0, 1874, 1
n250x8192-slot-sum, 1024, 31, 1734, 114, 0, 0, 1879, 1
n250x8192-slot-sum, 1024, 31, 1726, 115, 0, 0, 1872, 1
n250x8192-slot-sum, 1024, 31, 1731, 117, 0, 0, 1879, 1
n250x8192-slot-sum, 1024, 30, 1727, 116, 0, 0, 1873, 1
n250x8192-slot-sum, 1024, 30, 1724, 114, 0, 0, 1868, 1
n250x8192-slot-sum, 1024, 31, 1729, 115, 0, 0, 1875, 1
n250x8192-slot-sum, 1024, 31, 1732, 117, 0, 0, 1880, 1
n250x8192-slot-sum, 1024, 31, 1731, 114, 0, 0, 1876, 1
n250x8192-slot-sum, 1024, 30, 1727, 115, 0, 0, 1872, 1
n250x8192-slot-sum, 1024, 30, 1733, 116, 0, 0, 1879, 1
n250x8192-slot-sum, 1024, 30, 1726, 117, 0, 0, 1873, 1
n250x8192-slot-sum, 1024, 31, 1736, 116, 0, 0, 1883, 1
n250x8192-slot-sum, 1024, 30, 1730, 123, 0, 0, 1883, 1
n250x8192-slot-sum, 1024, 31, 1729, 116, 0, 0, 1876, 1
n250x8192-slot-sum, 1024, 31, 1743, 115, 0, 0, 1889, 1
n250x8192-slot-sum, 1024, 29, 1732, 115, 0, 0, 1876, 1
n250x8192-slot-sum, 1024, 30, 1732, 114, 0, 0, 1876, 1
n250x8192-slot-sum, 1024, 30, 1730, 115, 0, 0, 1875, 1
n250x8192-slot-sum, 1024, 30, 1731, 117, 0, 0, 1878, 1
n250x8192-slot-sum, 1024, 31, 1733, 115, 0, 0, 1879, 1
n250x8192-slot-sum, 1024, 34, 1736, 117, 0, 0, 1887, 1
n250x8192-slot-sum, 1024, 30, 1726, 114, 0, 0, 1870, 1
n250x8192-slot-sum, 1024, 31, 1729, 115, 0, 0, 1875, 1
n250x8192-slot-sum, 1024, 30, 1732, 115, 0, 0, 1877, 1
n250x8192-slot-sum, 1024, 31, 1731, 114, 0, 0, 1876, 1
n250x8192-slot-sum, 1024, 30, 1728, 115, 0, 0, 1873, 1
n250x8192-slot-sum, 1024, 30, 1741, 116, 0, 0, 1887, 1
n250x8192-slot-sum, 1024, 30, 1740, 115, 0, 0, 1885, 1
n250x8192-slot-sum, 1024, 30, 1738, 116, 0, 0, 1884, 1
n250x8192-slot-sum, 1024, 30, 1733, 117, 0, 0, 1880, 1
n250x8192-slot-sum, 1024, 30, 1742, 114, 0, 0, 1886, 1
n250x8192-slot-sum, 1024, 30, 1735, 114, 0, 0, 1879, 1
n250x8192-slot-sum, 1024, 31, 1760, 116, 0, 0, 1907, 1
n250x8192-slot-sum, 1024, 31, 1736, 114, 0, 0, 1881, 1
n250x8192-slot-sum, 1024, 30, 1734, 115, 0, 0, 1879, 1
n250x8192-slot-sum, 1024, 30, 1736, 119, 0, 0, 1885, 1
n250x8192-slot-sum, 1024, 30, 1730, 115, 0, 0, 1875, 1
n250x8192-slot-sum, 1024, 31, 1738, 115, 0, 0, 1884, 1
n250x8192-slot-sum, 1024, 31, 1727, 115, 0, 0, 1873, 1
n250x8192-slot-sum, 1024, 31, 1732, 115, 0, 0, 1878, 1
n250x8192-slot-sum, 1024, 30, 1730, 115, 0, 0, 1875, 1
n250x8192-slot-sum, 1024, 31, 1738, 114, 0, 0, 1883, 1
n250x8192-slot-sum, 1024, 30, 1729, 117, 0, 0, 1876, 1
n250x8192-slot-sum, 1024, 30, 1726, 116, 0, 0, 1872, 1
n250x8192-slot-sum, 1024, 30, 1733, 116, 0, 0, 1879, 1
n250x8192-slot-sum, 1024, 30, 1726, 115, 0, 0, 1871, 1
n250x8192-slot-sum, 1024, 30, 1734, 116, 0, 0, 1880, 1
n250x8192-slot-sum, 1024, 31, 1734, 116, 0, 0, 1881, 1
n250x8192-slot-inner, 8192, 135, 1410, 2110, 0, 0, 3655, 3.41334e+06
n250x8192-slot-inner, 8192, 134, 1418, 2120, 0, 0, 3672, 3.41334e+06
n250x8192-slot-inner, 8192, 134, 1406, 2109, 0, 0, 3649, 3.41334e+06
n250x8192-slot-inner, 8192, 134, 1411, 2116, 0, 0, 3661, 3.41334e+06
n250x8192-slot-inner, 8192, 136, 1424, 2106, 0, 0, 3666, 3.41334e+06
n250x8192-slot-inner, 8192, 135, 1421, 2119, 0, 0, 3675, 3.41334e+06
n250x8192-slot-inner, 8192, 134, 1414, 2102, 0, 0, 3650, 3.41334e+06
n250x8192-slot-inner, 8192, 134, 1407, 2109, 0, 0, 3650, 3.41334e+06
n250x8192-slot-inner, 8192, 133, 1418, 2104, 0, 0, 3655, 3.41334e+06
n250x8192-slot-inner, 8192, 133, 1406, 2101, 0, 0, 3640, 3.41334e+06
n250x8192-slot-inner, 8192, 133, 1405, 2107, 0, 0, 3645, 3.41334e+06
n250x8192-slot-inner, 8192, 134, 1414, 2112, 0, 0, 3660, 3.41334e+06
n250x8192-slot-inner, 8192, 134, 1410, 2109, 0, 0, 3653, 3.41334e+06
n250x8192-slot-inner, 8192, 135, 1416, 2103, 0, 0, 3654, 3.41334e+06
n250x8192-slot-inner, 8192, 133, 1409, 2106, 0, 0, 3648, 3.41334e+06
n250x8192-slot-inner, 8192, 133, 1412, 2116, 0, 0, 3661, 3.41334e+06
n250x8192-slot-inner, 8192, 134, 1410, 2100, 0, 0, 3644, 3.41334e+06
n250x8192-slot-inner, 8192, 135, 1414, 2115, 0, 0, 3664, 3.41334e+06
n250x8192-slot-inner, 8192, 135, 1414, 2118, 0, 0, 3667, 3.41334e+06
n250x8192-slot-inner, 8192, 135, 1418, 2144, 0, 0, 3697, 3.41334e+06
n250x8192-slot-inner, 8192, 135, 1414, 2121, 0, 0, 3670, 3.41334e+06
n250x8192-slot-inner, 8192, 136, 1416, 2113, 0, 0, 3665, 3.41334e+06
n250x8192-slot-inner, 8192, 135, 1423, 2107, 0, 0, 3665, 3.41334e+06
n250x8192-slot-inner, 8192, 135, 1415, 2106, 0, 0, 3656, 3.41334e+06
n250x8192-slot-inner, 8192, 135, 1418, 2117, 0, 0, 3670, 3.41334e+06
n250x8192-slot-inner, 8192, 136, 1414, 2112, 0, 0, 3662, 3.41334e+06
n250x8192-slot-inner, 8192, 133, 1411, 2112, 0, 0, 3656, 3.41334e+06
n250x8192-slot-inner, 8192, 134, 1417, 2118, 0, 0, 3669, 3.41334e+06
n250x8192-slot-inner, 8192, 136, 1412, 2104, 0, 0, 3652, 3.41334e+06
n250x8192-slot-inner, 8192, 134, 1413, 2108, 0, 0, 3655, 3.41334e+06
n250x8192-slot-inner, 8192, 135, 1412, 2113, 0, 0, 3660, 3.41334e+06
n250x8192-slot-inner, 8192, 133, 1409, 2110, 0, 0, 3652, 3.41334e+06
n250x8192-slot-inner, 8192, 135, 1410, 2102, 0, 0, 3647, 3.41334e+06
n250x8192-slot-inner, 8192, 135, 1408, 2108, 0, 0, 3651, 3.41334e+06
n250x8192-slot-inner, 8192, 133, 1408, 2110, 0, 0, 3651, 3.41334e+06
n250x8192-slot-inner, 8192, 134, 1422, 2433, 1, 0, 3990, 3.41334e+06
n250x8192-slot-inner, 8192, 134, 1412, 2108, 0, 0, 3654, 3.41334e+06
n250x8192-slot-inner, 8192, 134, 1417, 2113, 0, 0, 3664, 3.41334e+06
n250x8192-slot-inner, 8192, 134, 1409, 2100, 0, 0, 3643, 3.41334e+06
n250x8192-slot-inner, 8192, 134, 1410, 2114, 0, 0, 3658, 3.41334e+06
n250x8192-slot-inner, 8192, 134, 1406, 2106, 0, 0, 3646, 3.41334e+06
n250x8192-slot-inner, 8192, 134, 1409, 2101, 0, 0, 3644, 3.41334e+06
n250x8192-slot-inner, 8192, 134, 1408, 2108, 0, 0, 3650, 3.41334e+06
n250x8192-slot-inner, 8192, 135, 1416, 2108, 0, 0, 3659, 3.41334e+06
n250x8192-slot-inner, 8192, 134, 1407, 2093, 0, 0, 3634, 3.41334e+06
n250x8192-slot-inner, 8192, 135, 1412, 2109, 0, 0, 3656, 3.41334e+06
n250x8192-slot-inner, 8192, 135, 1450, 2106, 0, 0, 3691, 3.41334e+06
n250x8192-slot-inner, 8192, 134, 1412, 2122, 0, 0, 3668, 3.41334e+06
n250x8192-slot-inner, 8192, 134, 1404, 2110, 0, 0, 3648, 3.41334e+06
n250x8192-slot-inner, 8192, 134, 1410, 2102, 0, 0, 3646, 3.41334e+06
n250x8192-slot-inner, 8192, 134, 1412, 2107, 0, 0, 3653, 3.41334e+06
n250x8192-slot-inner, 8192, 134, 1506, 2523, 1, 0, 4164, 3.41334e+06
n250x8192-slot-inner, 8192, 135, 1410, 2357, 1, 0, 3903, 3.41334e+06
n250x8192-slot-inner, 8192, 135, 1410, 2113, 0, 0, 3658, 3.41334e+06
n250x8192-slot-inner, 8192, 136, 1413, 2112, 0, 0, 3661, 3.41334e+06
n250x8192-slot-inner, 8192, 134, 1420, 2102, 0, 0, 3656, 3.41334e+06
n250x8192-slot-inner, 8192, 133, 1405, 2110, 0, 0, 3648, 3.41334e+06
n250x8192-slot-inner, 8192, 134, 1414, 2116, 0, 0, 3664, 3.41334e+06
n250x8192-slot-inner, 8192, 134, 1419, 2117, 0, 0, 3670, 3.41334e+06
n250x8192-slot-inner, 8192, 133, 1417, 2119, 0, 0, 3669, 3.41334e+06
n250x8192-slot-inner, 8192, 133, 1412, 2108, 0, 0, 3653, 3.41334e+06
n250x8192-slot-inner, 8192, 134, 1406, 2139, 1, 0, 3680, 3.41334e+06
n250x8192-slot-inner, 8192, 135, 1413, 2121, 0, 0, 3669, 3.41334e+06
n250x8192-slot-inner, 8192, 134, 1409, 2094, 0, 0, 3637, 3.41334e+06
n250x8192-slot-inner, 8192, 135, 1417, 2110, 0, 0, 3662, 3.41334e+06
n250x8192-slot-inner, 8192, 135, 1413, 2111, 0, 0, 3659, 3.41334e+06
n250x8192-slot-inner, 8192, 134, 1408, 2124, 0, 0, 3666, 3.41334e+06
n250x8192-slot-inner, 8192, 134, 1412, 2095, 0, 0, 3641, 3.41334e+06
n250x8192-slot-inner, 8192, 133, 1413, 2106, 0, 0, 3652, 3.41334e+06
n250x8192-slot-inner, 8192, 134, 1416, 2107, 0, 0, 3657, 3.41334e+06
n250x8192-slot-inner, 8192, 133, 1408, 2116, 0, 0, 3657, 3.41334e+06
n250x8192-slot-inner, 8192, 135, 1414, 2110, 0, 0, 3659, 3.41334e+06
n250x8192-slot-inner, 8192, 134, 1410, 2127, 0, 0, 3671, 3.41334e+06
n250x8192-slot-inner, 8192, 134, 1422, 2099, 0, 0, 3655, 3.41334e+06
n250x8192-slot-inner, 8192, 135, 1415, 2112, 0, 0, 3662, 3.41334e+06
n250x8192-slot-inner, 8192, 134, 1419, 2106, 0, 0, 3659, 3.41334e+06
n250x8192-slot-inner, 8192, 135, 1417, 2102, 0, 0, 3654, 3.41334e+06
n250x8192-slot-inner, 8192, 134, 1411, 2107, 0, 0, 3652, 3.41334e+06
n250x8192-slot-inner, 8192, 134, 1413, 2111, 0, 0, 3658, 3.41334e+06
n250x8192-slot-inner, 8192, 135, 1412, 2131, 0, 0, 3678, 3.41334e+06
n250x8192-slot-inner, 8192, 135, 1416, 2101, 0, 0, 3652, 3.41334e+06
n250x8192-slot-inner, 8192, 134, 1409, 2103, 0, 0, 3646, 3.41334e+06
n250x8192-slot-inner, 8192, 133, 1852, 2137, 0, 0, 4122, 3.41334e+06
n250x8192-slot-inner, 8192, 134, 1411, 2115, 0, 0, 3660, 3.41334e+06
n250x8192-slot-inner, 8192, 134, 1410, 2124, 0, 0, 3668, 3.41334e+06
n250x8192-slot-inner, 8192, 136, 1423, 2099, 0, 0, 3658, 3.41334e+06
n250x8192-slot-inner, 8192, 134, 1413, 2107, 0, 0, 3654, 3.41334e+06
n250x8192-slot-inner, 8192, 134, 1411, 2096, 0, 0, 3641, 3.41334e+06
n250x8192-slot-inner, 8192, 134, 1409, 2095, 0, 0, 3638, 3.41334e+06
n250x8192-slot-inner, 8192, 133, 1409, 2127, 0, 0, 3669, 3.41334e+06
n250x8192-slot-inner, 8192, 134, 1408, 2112, 0, 0, 3654, 3.41334e+06
n250x8192-slot-inner, 8192, 135, 1412, 2116, 0, 0, 3663, 3.41334e+06
n250x8192-slot-inner, 8192, 134, 1410, 2116, 0, 0, 3660, 3.41334e+06
n250x8192-slot-inner, 8192, 134, 1417, 2117, 0, 0, 3668, 3.41334e+06
n250x8192-slot-inner, 8192, 136, 1415, 2116, 0, 0, 3667, 3.41334e+06
n250x8192-slot-inner, 8192, 134, 1402, 2114, 0, 0, 3650, 3.41334e+06
n250x8192-slot-inner, 8192, 135, 1413, 2117, 0, 0, 3665, 3.41334e+06
n250x8192-slot-inner, 8192, 134, 1408, 2109, 0, 0, 3651, 3.41334e+06
n250x8192-slot-inner, 8192, 134, 1491, 2537, 1, 0, 4163, 3.41334e+06
n250x8192-slot-inner, 8192, 135, 1408, 2108, 0, 0, 3651, 3.41334e+06
n250x8192-slot-inner, 4096, 63, 1376, 2062, 0, 0, 3501, 3.41334e+06
n250x8192-slot-inner, 4096, 64, 1377, 2062, 0, 0, 3503, 3.41334e+06
n250x8192-slot-inner, 4096, 64, 1375, 2062, 0, 0, 3501, 3.41334e+06
n250x8192-slot-inner, 4096, 64, 1373, 2058, 0, 0, 3495, 3.41334e+06
n250x8192-slot-inner, 4096, 64, 1372, 2046, 0, 0, 3482, 3.41334e+06
n250x8192-slot-inner, 4096, 65, 1372, 2051, 0, 0, 3488, 3.41334e+06
n250x8192-slot-inner, 4096, 64, 1373, 2067, 0, 0, 3504, 3.41334e+06
n250x8192-slot-inner, 4096, 64, 1367, 2048, 0, 0, 3479, 3.41334e+06
n250x8192-slot-inner, 4096, 64, 1369, 2045, 0, 0, 3478, 3.41334e+06
n250x8192-slot-inner, 4096, 64, 1364, 2049, 0, 0, 3477, 3.41334e+06
n250x8192-slot-inner, 4096, 64, 1371, 2062, 0, 0, 3497, 3.41334e+06
n250x8192-slot-inner, 4096, 63, 1370, 2066, 0, 0, 3499, 3.41334e+06
n250x8192-slot-inner, 4096, 63, 1369, 2056, 0, 0, 3488, 3.41334e+06
n250x8192-slot-inner, 4096, 64, 1371, 2044, 0, 0, 3479, 3.41334e+06
n250x8192-slot-inner, 4096, 64, 1368, 2352, 0, 0, 3784, 3.41334e+06
n250x8192-slot-inner, 4096, 64, 1372, 2044, 0, 0, 3480, 3.41334e+06
n250x8192-slot-inner, 4096, 64, 1501, 2435, 0, 0, 4000, 3.41334e+06
n250x8192-slot-inner, 4096, 64, 1374, 2060, 0, 0, 3498, 3.41334e+06
n250x8192-slot-inner, 4096, 64, 1369, 2057, 0, 0, 3490, 3.41334e+06
n250x8192-slot-inner, 4096, 63, 1368, 2061, 0, 0, 3492, 3.41334e+06
n250x8192-slot-inner, 4096, 64, 1372, 2054, 0, 0, 3490, 3.41334e+06
n250x8192-slot-inner, 4096, 64, 1372, 2047, 0, 0, 3483, 3.41334e+06
n250x8192-slot-inner, 4096, 64, 1370, 2064, 0, 0, 3498, 3.41334e+06
n250x8192-slot-inner, 4096, 64, 1376, 2054, 0, 0, 3494, 3.41334e+06
n250x8192-slot-inner, 4096, 64, 1366, 2047, 0, 0, 3477, 3.41334e+06
n250x8192-slot-inner, 4096, 63, 1372, 2046, 0, 0, 3481, 3.41334e+06
n250x8192-slot-inner, 4096, 64, 1370, 2049, 0, 0, 3483, 3.41334e+06
n250x8192-slot-inner, 4096, 64, 1371, 2046, 0, 0, 3481, 3.41334e+06
n250x8192-slot-inner, 4096, 64, 1367, 2038, 0, 0, 3469, 3.41334e+06
n250x8192-slot-inner, 4096, 64, 1369, 2037, 0, 0, 3470, 3.41334e+06
n250x8192-slot-inner, 4096, 63, 1361, 2064, 0, 0, 3488, 3.41334e+06
n250x8192-slot-inner, 4096, 65, 1385, 2046, 0, 0, 3496, 3.41334e+06
n250x8192-slot-inner, 4096, 64, 1379, 2062, 0, 0, 3505, 3.41334e+06
n250x8192-slot-inner, 4096, 63, 1369, 2056, 0, 0, 3488, 3.41334e+06
n250x8192-slot-inner, 4096, 65, 1370, 2054, 0, 0, 3489, 3.41334e+06
n250x8192-slot-inner, 4096, 64, 1371, 2066, 0, 0, 3501, 3.41334e+06
n250x8192-slot-inner, 4096, 64, 1368, 2052, 0, 0, 3484, 3.41334e+06
n250x8192-slot-inner, 4096, 64, 1370, 2056, 0, 0, 3490, 3.41334e+06
n250x8192-slot-inner, 4096, 64, 1368, 2057, 0, 0, 3489, 3.41334e+06
n250x8192-slot-inner, 4096, 64, 1375, 2049, 0, 0, 3488, 3.41334e+06
n250x8192-slot-inner, 4096, 64, 1366, 2044, 0, 0, 3474, 3.41334e+06
n250x8192-slot-inner, 4096, 64, 1370, 2062, 0, 0, 3496, 3.41334e+06
n250x8192-slot-inner, 4096, 65, 1386, 2058, 0, 0, 3509, 3.41334e+06
n250x8192-slot-inner, 4096, 64, 1377, 2055, 0, 0, 3496, 3.41334e+06
n250x8192-slot-inner, 4096, 63, 1370, 2065, 0, 0, 3498, 3.41334e+06
n250x8192-slot-inner, 4096, 63, 1368, 2058, 0, 0, 3489, 3.41334e+06
n250x8192-slot-inner, 4096, 64, 1374, 2047, 0, 0, 3485, 3.41334e+06
n250x8192-slot-inner, 4096, 64, 1403, 2426, 0, 0, 3893, 3.41334e+06
n250x8192-slot-inner, 4096, 64, 1375, 2055, 0, 0, 3494, 3.41334e+06
n250x8192-slot-inner, 4096, 64, 1368, 2048, 0, 0, 3480, 3.41334e+06
n250x8192-slot-inner, 4096, 64, 1376, 2064, 0, 0, 3504, 3.41334e+06
n250x8192-slot-inner, 4096, 63, 1377, 2047, 0, 0, 3487, 3.41334e+06
n250x8192-slot-inner, 4096, 64, 1368, 2059, 0, 0, 3491, 3.41334e+06
n250x8192-slot-inner, 4096, 64, 1369, 2051, 0, 0, 3484, 3.41334e+06
n250x8192-slot-inner, 4096, 63, 1365, 2053, 0, 0, 3481, 3.41334e+06
n250x8192-slot-inner, 4096, 64, 1375, 2062, 0, 0, 3501, 3.41334e+06
n250x8192-slot-inner, 4096, 64, 1372, 2061, 0, 0, 3497, 3.41334e+06
n250x8192-slot-inner, 4096, 64, 1365, 2048, 0, 0, 3477, 3.41334e+06
n250x8192-slot-inner, 4096, 64, 1371, 2055, 0, 0, 3490, 3.41334e+06
n250x8192-slot-inner, 4096, 64, 1370, 2050, 0, 0, 3484, 3.41334e+06
n250x8192-slot-inner, 4096, 65, 1369, 2056, 0, 0, 3490, 3.41334e+06
n250x8192-slot-inner, 4096, 64, 1376, 2053, 0, 0, 3493, 3.41334e+06
n250x8192-slot-inner, 4096, 64, 1364, 2064, 0, 0, 3492, 3.41334e+06
n250x8192-slot-inner, 4096, 64, 1365, 2229, 0, 0, 3658, 3.41334e+06
n250x8192-slot-inner, 4096, 64, 1361, 2049, 0, 0, 3474, 3.41334e+06
n250x8192-slot-inner, 4096, 65, 1533, 2426, 0, 0, 4024, 3.41334e+06
n250x8192-slot-inner, 4096, 65, 1366, 2072, 0, 0, 3503, 3.41334e+06
n250x8192-slot-inner, 4096, 64, 1377, 2063, 0, 0, 3504, 3.41334e+06
n250x8192-slot-inner, 4096, 65, 1370, 2062, 0, 0, 3497, 3.41334e+06
n250x8192-slot-inner, 4096, 63, 1370, 2062, 0, 0, 3495, 3.41334e+06
n250x8192-slot-inner, 4096, 64, 1365, 2063, 0, 0, 3492, 3.41334e+06
n250x8192-slot-inner, 4096, 63, 1368, 2065, 0, 0, 3496, 3.41334e+06
n250x8192-slot-inner, 4096, 64, 1369, 2050, 0, 0, 3483, 3.41334e+06
n250x8192-slot-inner, 4096, 64, 1373, 2051, 0, 0, 3488, 3.41334e+06
n250x8192-slot-inner, 4096, 64, 1372, 2051, 0, 0, 3487, 3.41334e+06
n250x8192-slot-inner, 4096, 64, 1371, 2052, 0, 0, 3487, 3.41334e+06
n250x8192-slot-inner, 4096, 64, 1373, 2063, 0, 0, 3500, 3.41334e+06
n250x8192-slot-inner, 4096, 64, 1374, 2058, 0, 0, 3496, 3.41334e+06
n250x8192-slot-inner, 4096, 63, 1361, 2053, 0, 0, 3477, 3.41334e+06
n250x8192-slot-inner, 4096, 64, 1364, 2057, 0, 0, 3485, 3.41334e+06
n250x8192-slot-inner, 4096, 64, 1382, 2051, 0, 0, 3497, 3.41334e+06
n250x8192-slot-inner, 4096, 65, 1367, 2051, 0, 0, 3483, 3.41334e+06
n250x8192-slot-inner, 4096, 64, 1367, 2058, 0, 0, 3489, 3.41334e+06
n250x8192-slot-inner, 4096, 64, 1384, 2062, 0, 0, 3510, 3.41334e+06
n250x8192-slot-inner, 4096, 64, 1374, 2052, 0, 0, 3490, 3.41334e+06
n250x8192-slot-inner, 4096, 63, 1372, 2056, 0, 0, 3491, 3.41334e+06
n250x8192-slot-inner, 4096, 64, 1367, 2057, 0, 0, 3488, 3.41334e+06
n250x8192-slot-inner, 4096, 64, 1372, 2062, 0, 0, 3498, 3.41334e+06
n250x8192-slot-inner, 4096, 64, 1364, 2053, 0, 0, 3481, 3.41334e+06
n250x8192-slot-inner, 4096, 64, 1373, 2061, 0, 0, 3498, 3.41334e+06
n250x8192-slot-inner, 4096, 65, 1373, 2049, 0, 0, 3487, 3.41334e+06
n250x8192-slot-inner, 4096, 64, 1368, 2042, 0, 0, 3474, 3.41334e+06
n250x8192-slot-inner, 4096, 63, 1374, 2053, 0, 0, 3490, 3.41334e+06
n250x8192-slot-inner, 4096, 64, 1366, 2059, 0, 0, 3489, 3.41334e+06
n250x8192-slot-inner, 4096, 64, 1368, 2055, 0, 0, 3487, 3.41334e+06
n250x8192-slot-inner, 4096, 64, 1365, 2034, 0, 0, 3463, 3.41334e+06
n250x8192-slot-inner, 4096, 64, 1368, 2068, 0, 0, 3500, 3.41334e+06
n250x8192-slot-inner, 4096, 64, 1367, 2086, 0, 0, 3517, 3.41334e+06
n250x8192-slot-inner, 4096, 63, 1366, 2057, 0, 0, 3486, 3.41334e+06
n250x8192-slot-inner, 4096, 64, 1376, 2049, 0, 0, 3489, 3.41334e+06
n250x8192-slot-inner, 2048, 32, 1355, 2062, 0, 0, 3449, 3.41334e+06
n250x8192-slot-inner, 2048, 31, 1357, 2046, 0, 0, 3434, 3.41334e+06
n250x8192-slot-inner, 2048, 32, 1352, 2051, 0, 0, 3435, 3.41334e+06
n250x8192-slot-inner, 2048, 32, 1348, 2057, 0, 0, 3437, 3.41334e+06
n250x8192-slot-inner, 2048, 31, 1347, 2051, 0, 0, 3429, 3.41334e+06
n250x8192-slot-inner, 2048, 32, 1372, 2052, 0, 0, 3456, 3.41334e+06
n250x8192-slot-inner, 2048, 32, 1347, 2053, 0, 0, 3432, 3.41334e+06
n250x8192-slot-inner, 2048, 31, 1346, 2053, 0, 0, 3430, 3.41334e+06
n250x8192-slot-inner, 2048, 31, 1350, 2055, 0, 0, 3436, 3.41334e+06
n250x8192-slot-inner, 2048, 32, 1350, 2059, 0, 0, 3441, 3.41334e+06
n250x8192-slot-inner, 2048, 32, 1347, 2057, 0, 0, 3436, 3.41334e+06
n250x8192-slot-inner, 2048, 32, 1355, 2067, 0, 0, 3454, 3.41334e+06
n250x8192-slot-inner, 2048, 32, 1347, 2059, 0, 0, 3438, 3.41334e+06
n250x8192-slot-inner, 2048, 32, 1369, 2062, 0, 0, 3463, 3.41334e+06
n250x8192-slot-inner, 2048, 31, 1357, 2105, 0, 0, 3493, 3.41334e+06
n250x8192-slot-inner, 2048, 31, 1353, 2046, 0, 0, 3430, 3.41334e+06
n250x8192-slot-inner, 2048, 32, 1353, 2062, 0, 0, 3447, 3.41334e+06
n250x8192-slot-inner, 2048, 32, 1345, 2068, 0, 0, 3445, 3.41334e+06
n250x8192-slot-inner, 2048, 32, 1353, 2063, 0, 0, 3448, 3.41334e+06
n250x8192-slot-inner, 2048, 32, 1346, 2057, 0, 0, 3435, 3.41334e+06
n250x8192-slot-inner, 2048, 32, 1354, 2049, 0, 0, 3435, 3.41334e+06
n250x8192-slot-inner, 2048, 32, 1354, 2065, 0, 0, 3451, 3.41334e+06
n250x8192-slot-inner, 2048, 32, 1358, 2055, 0, 0, 3445, 3.41334e+06
n250x8192-slot-inner, 2048, 32, 1344, 2071, 0, 0, 3447, 3.41334e+06
n250x8192-slot-inner, 2048, 31, 1353, 2069, 0, 0, 3453, 3.41334e+06
n250x8192-slot-inner, 2048, 32, 1345, 2065, 0, 0, 3442, 3.41334e+06
n250x8192-slot-inner, 2048, 32, 1353, 2057, 0, 0, 3442, 3.41334e+06
n250x8192-slot-inner, 2048, 32, 1357, 2064, 0, 0, 3453, 3.41334e+06
n250x8192-slot-inner, 2048, 32, 1356, 2066, 0, 0, 3454, 3.41334e+06
n250x8192-slot-inner, 2048, 32, 1348, 2101, 0, 0, 3481, 3.41334e+06
n250x8192-slot-inner, 2048, 31, 1355, 2055, 0, 0, 3441, 3.41334e+06
n250x8192-slot-inner, 2048, 31, 1352, 2061, 0, 0, 3444, 3.41334e+06
n250x8192-slot-inner, 2048, 31, 1352, 2061, 0, 0, 3444, 3.41334e+06
n250x8192-slot-inner, 2048, 32, 1348, 2049, 0, 0, 3429, 3.41334e+06
n250x8192-slot-inner, 2048, 32, 1355, 2063, 0, 0, 3450, 3.41334e+06
n250x8192-slot-inner, 2048, 31, 1350, 2047, 0, 0, 3428, 3.41334e+06
n250x8192-slot-inner, 2048, 31, 1347, 2057, 0, 0, 3435, 3.41334e+06
n250x8192-slot-inner, 2048, 32, 1352, 2064, 0, 0, 3448, 3.41334e+06
n250x8192-slot-inner, 2048, 32, 1346, 2054, 0, 0, 3432, 3.41334e+06
n250x8192-slot-inner, 2048, 32, 1344, 2052, 0, 0, 3428, 3.41334e+06
n250x8192-slot-inner, 2048, 32, 1350, 2052, 0, 0, 3434, 3.41334e+06
n250x8192-slot-inner, 2048, 32, 1350, 2057, 0, 0, 3439, 3.41334e+06
n250x8192-slot-inner, 2048, 31, 1351, 2061, 0, 0, 3443, 3.41334e+06
n250x8192-slot-inner, 2048, 32, 1346, 2064, 0, 0, 3442, 3.41334e+06
n250x8192-slot-inner, 2048, 32, 1353, 2055, 0, 0, 3440, 3.41334e+06
n250x8192-slot-inner, 2048, 31, 1345, 2049, 0, 0, 3425, 3.41334e+06
n250x8192-slot-inner, 2048, 31, 1344, 2138, 0, 0, 3513, 3.41334e+06
n250x8192-slot-inner, 2048, 32, 1344, 2055, 0, 0, 3431, 3.41334e+06
n250x8192-slot-inner, 2048, 32, 1353, 2053, 0, 0, 3438, 3.41334e+06
n250x8192-slot-inner, 2048, 32, 1344, 2057, 0, 0, 3433, 3.41334e+06
n250x8192-slot-inner, 2048, 31, 1349, 2059, 0, 0, 3439, 3.41334e+06
n250x8192-slot-inner, 2048, 31, 1356, 2056, 0, 0, 3443, 3.41334e+06
n250x8192-slot-inner, 2048, 31, 1346, 2059, 0, 0, 3436, 3.41334e+06
n250x8192-slot-inner, 2048, 32, 1351, 2068, 0, 0, 3451, 3.41334e+06
n250x8192-slot-inner, 2048, 32, 1343, 2055, 0, 0, 3430, 3.41334e+06
n250x8192-slot-inner, 2048, 32, 1349, 2056, 0, 0, 3437, 3.41334e+06
n250x8192-slot-inner, 2048, 32, 1350, 2055, 0, 0, 3437, 3.41334e+06
n250x8192-slot-inner, 2048, 32, 1351, 2054, 0, 0, 3437, 3.41334e+06
n250x8192-slot-inner, 2048, 32, 1351, 2071, 0, 0, 3454, 3.41334e+06
n250x8192-slot-inner, 2048, 32, 1355, 2062, 0, 0, 3449, 3.41334e+06
n250x8192-slot-inner, 2048, 31, 1347, 2065, 0, 0, 3443, 3.41334e+06
n250x8192-slot-inner, 2048, 31, 1344, 2057, 0, 0, 3432, 3.41334e+06
n250x8192-slot-inner, 2048, 31, 1350, 2056, 0, 0, 3437, 3.41334e+06
n250x8192-slot-inner, 2048, 32, 1363, 2066, 0, 0, 3461, 3.41334e+06
n250x8192-slot-inner, 2048, 31, 1349, 2061, 0, 0, 3441, 3.41334e+06
n250x8192-slot-inner, 2048, 31, 1347, 2049, 0, 0, 3427, 3.41334e+06
n250x8192-slot-inner, 2048, 32, 1353, 2057, 0, 0, 3442, 3.41334e+06
n250x8192-slot-inner, 2048, 32, 1350, 2070, 0, 0, 3452, 3.41334e+06
n250x8192-slot-inner, 2048, 31, 1351, 2052, 0, 0, 3434, 3.41334e+06
n250x8192-slot-inner, 2048, 32, 1348, 2053, 0, 0, 3433, 3.41334e+06
n250x8192-slot-inner, 2048, 32, 1353, 2045, 0, 0, 3430, 3.41334e+06
n250x8192-slot-inner, 2048, 32, 1357, 2065, 0, 0, 3454, 3.41334e+06
n250x8192-slot-inner, 2048, 32, 1350, 2056, 0, 0, 3438, 3.41334e+06
n250x8192-slot-inner, 2048, 31, 1351, 2066, 0, 0, 3448, 3.41334e+06
n250x8192-slot-inner, 2048, 32, 1354, 2047, 0, 0, 3433, 3.41334e+06
n250x8192-slot-inner, 2048, 31, 1350, 2059, 0, 0, 3440, 3.41334e+06
n250x8192-slot-inner, 2048, 32, 1352, 2048, 0, 0, 3432, 3.41334e+06
n250x8192-slot-inner, 2048, 32, 1354, 2048, 0, 0, 3434, 3.41334e+06
n250x8192-slot-inner, 2048, 31, 1347, 2062, 0, 0, 3440, 3.41334e+06
n250x8192-slot-inner, 2048, 31, 1351, 2057, 0, 0, 3439, 3.41334e+06
n250x8192-slot-inner, 2048, 32, 1455, 2384, 0, 0, 3871, 3.41334e+06
n250x8192-slot-inner, 2048, 32, 1359, 2058, 0, 0, 3449, 3.41334e+06
n250x8192-slot-inner, 2048, 32, 1354, 2060, 0, 0, 3446, 3.41334e+06
n250x8192-slot-inner, 2048, 31, 1353, 2078, 0, 0, 3462, 3.41334e+06
n250x8192-slot-inner, 2048, 32, 1359, 2060, 0, 0, 3451, 3.41334e+06
n250x8192-slot-inner, 2048, 32, 1344, 2061, 0, 0, 3437, 3.41334e+06
n250x8192-slot-inner, 2048, 32, 1350, 2053, 0, 0, 3435, 3.41334e+06
n250x8192-slot-inner, 2048, 31, 1353, 2047, 0, 0, 3431, 3.41334e+06
n250x8192-slot-inner, 2048, 32, 1347, 2069, 0, 0, 3448, 3.41334e+06
n250x8192-slot-inner, 2048, 31, 1350, 2059, 0, 0, 3440, 3.41334e+06
n250x8192-slot-inner, 2048, 32, 1351, 2052, 0, 0, 3435, 3.41334e+06
n250x8192-slot-inner, 2048, 32, 1345, 2049, 0, 0, 3426, 3.41334e+06
n250x8192-slot-inner, 2048, 31, 1357, 2056, 0, 0, 3444, 3.41334e+06
n250x8192-slot-inner, 2048, 32, 1349, 2053, 0, 0, 3434, 3.41334e+06
n250x8192-slot-inner, 2048, 32, 1352, 2056, 0, 0, 3440, 3.41334e+06
n250x8192-slot-inner, 2048, 32, 1359, 2053, 0, 0, 3444, 3.41334e+06
n250x8192-slot-inner, 2048, 32, 1348, 2209, 0, 0, 3589, 3.41334e+06
n250x8192-slot-inner, 2048, 32, 1353, 2063, 0, 0, 3448, 3.41334e+06
n250x8192-slot-inner, 2048, 32, 1355, 2049, 0, 0, 3436, 3.41334e+06
n250x8192-slot-inner, 2048, 32, 1352, 2057, 0, 0, 3441, 3.41334e+06
n250x8192-slot-inner, 1024, 32, 1728, 3327, 0, 0, 5087, 3.41334e+06
n250x8192-slot-inner, 1024, 32, 1727, 3308, 0, 0, 5067, 3.41334e+06
n250x8192-slot-inner, 1024, 32, 1724, 3309, 0, 0, 5065, 3.41334e+06
n250x8192-slot-inner, 1024, 32, 1730, 3343, 0, 0, 5105, 3.41334e+06
n250x8192-slot-inner, 1024, 32, 1729, 3308, 0, 0, 5069, 3.41334e+06
n250x8192-slot-inner, 1024, 32, 1725, 3337, 0, 0, 5094, 3.41334e+06
n250x8192-slot-inner, 1024, 33, 1734, 3317, 0, 0, 5084, 3.41334e+06
n250x8192-slot-inner, 1024, 32, 1729, 3328, 0, 0, 5089, 3.41334e+06
n250x8192-slot-inner, 1024, 33, 1735, 3328, 0, 0, 5096, 3.41334e+06
n250x8192-slot-inner, 1024, 33, 1752, 3435, 0, 0, 5220, 3.41334e+06
n250x8192-slot-inner, 1024, 33, 1732, 3325, 0, 0, 5090, 3.41334e+06
n250x8192-slot-inner, 1024, 32, 1731, 3307, 0, 0, 5070, 3.41334e+06
n250x8192-slot-inner, 1024, 32, 1734, 3308, 0, 0, 5074, 3.41334e+06
n250x8192-slot-inner, 1024, 32, 1731, 3308, 0, 0, 5071, 3.41334e+06
n250x8192-slot-inner, 1024, 33, 1734, 3326, 0, 0, 5093, 3.41334e+06
n250x8192-slot-inner, 1024, 34, 1727, 3450, 0, 0, 5211, 3.41334e+06
n250x8192-slot-inner, 1024, 33, 1728, 3307, 0, 0, 5068, 3.41334e+06
n250x8192-slot-inner, 1024, 32, 1772, 3323, 0, 0, 5127, 3.41334e+06
n250x8192-slot-inner, 1024, 32, 1733, 3317, 0, 0, 5082, 3.41334e+06
n250x8192-slot-inner, 1024, 32, 1725, 3308, 0, 0, 5065, 3.41334e+06
n250x8192-slot-inner, 1024, 32, 1728, 3351, 0, 0, 5111, 3.41334e+06
n250x8192-slot-inner, 1024, 32, 1724, 3325, 0, 0, 5081, 3.41334e+06
n250x8192-slot-inner, 1024, 32, 1733, 3323, 0, 0, 5088, 3.41334e+06
n250x8192-slot-inner, 1024, 33, 1724, 3332, 0, 0, 5089, 3.41334e+06
n250x8192-slot-inner, 1024, 31, 1725, 3310, 0, 0, 5066, 3.41334e+06
n250x8192-slot-inner, 1024, 33, 1727, 3312, 0, 0, 5072, 3.41334e+06
n250x8192-slot-inner, 1024, 33, 1731, 3325, 0, 0, 5089, 3.41334e+06
n250x8192-slot-inner, 1024, 32, 1739, 3313, 0, 0, 5084, 3.41334e+06
n250x8192-slot-inner, 1024, 32, 1726, 3302, 0, 0, 5060, 3.41334e+06
n250x8192-slot-inner, 1024, 33, 1734, 3316, 0, 0, 5083, 3.41334e+06
n250x8192-slot-inner, 1024, 33, 1732, 3309, 0, 0, 5074, 3.41334e+06
n250x8192-slot-inner, 1024, 32, 1735, 3329, 0, 0, 5096, 3.41334e+06
n250x8192-slot-inner, 1024, 32, 1748, 3330, 0, 0, 5110, 3.41334e+06
n250x8192-slot-inner, 1024, 33, 1730, 3311, 0, 0, 5074, 3.41334e+06
n250x8192-slot-inner, 1024, 33, 1729, 3325, 0, 0, 5087, 3.41334e+06
n250x8192-slot-inner, 1024, 33, 1736, 3327, 0, 0, 5096, 3.41334e+06
n250x8192-slot-inner, 1024, 32, 1732, 3322, 0, 0, 5086, 3.41334e+06
n250x8192-slot-inner, 1024, 33, 1727, 3324, 0, 0, 5084, 3.41334e+06
n250x8192-slot-inner, 1024, 33, 1734, 3306, 0, 0, 5073, 3.41334e+06
n250x8192-slot-inner, 1024, 33, 1737, 3308, 0, 0, 5078, 3.41334e+06
n250x8192-slot-inner, 1024, 33, 1733, 3325, 0, 0, 5091, 3.41334e+06
n250x8192-slot-inner, 1024, 32, 1735, 3315, 0, 0, 5082, 3.41334e+06
n250x8192-slot-inner, 1024, 32, 1726, 3315, 0, 0, 5073, 3.41334e+06
n250x8192-slot-inner, 1024, 33, 1737, 3345, 0, 0, 5115, 3.41334e+06
n250x8192-slot-inner, 1024, 32, 1732, 3311, 0, 0, 5075, 3.41334e+06
n250x8192-slot-inner, 1024, 32, 1734, 3303, 0, 0, 5069, 3.41334e+06
n250x8192-slot-inner, 1024, 32, 1732, 3320, 0, 0, 5084, 3.41334e+06
n250x8192-slot-inner, 1024, 33, 1731, 3315, 0, 0, 5079, 3.41334e+06
n250x8192-slot-inner, 1024, 33, 1731, 3301, 0, 0, 5065, 3.41334e+06
n250x8192-slot-inner, 1024, 32, 1737, 3325, 0, 0, 5094, 3.41334e+06
n250x8192-slot-inner, 1024, 32, 1737, 3322, 0, 0, 5091, 3.41334e+06
n250x8192-slot-inner, 1024, 32, 1727, 3300, 0, 0, 5059, 3.41334e+06
n250x8192-slot-inner, 1024, 33, 1731, 3316, 0, 0, 5080, 3.41334e+06
n250x8192-slot-inner, 1024, 32, 1728, 3309, 0, 0, 5069, 3.41334e+06
n250x8192-slot-inner, 1024, 31, 1728, 3319, 0, 0, 5078, 3.41334e+06
n250x8192-slot-inner, 1024, 32, 1747, 3329, 0, 0, 5108, 3.41334e+06
n250x8192-slot-inner, 1024, 32, 1734, 3307, 0, 0, 5073, 3.41334e+06
n250x8192-slot-inner, 1024, 33, 1724, 3313, 0, 0, 5070, 3.41334e+06
n250x8192-slot-inner, 1024, 32, 1728, 3295, 0, 0, 5055, 3.41334e+06
n250x8192-slot-inner, 1024, 34, 1753, 3323, 0, 0, 5110, 3.41334e+06
n250x8192-slot-inner, 1024, 32, 1738, 3332, 0, 0, 5102, 3.41334e+06
n250x8192-slot-inner, 1024, 37, 1725, 3419, 0, 0, 5181, 3.41334e+06
n250x8192-slot-inner, 1024, 32, 1732, 3304, 0, 0, 5068, 3.41334e+06
n250x8192-slot-inner, 1024, 32, 1733, 3328, 0, 0, 5093, 3.41334e+06
n250x8192-slot-inner, 1024, 32, 1736, 3325, 0, 0, 5093, 3.41334e+06
n250x8192-slot-inner, 1024, 32, 1725, 3318, 0, 0, 5075, 3.41334e+06
n250x8192-slot-inner, 1024, 32, 1732, 3340, 0, 0, 5104, 3.41334e+06
n250x8192-slot-inner, 1024, 33, 1745, 3340, 0, 0, 5118, 3.41334e+06
n250x8192-slot-inner, 1024, 32, 1742, 3320, 0, 0, 5094, 3.41334e+06
n250x8192-slot-inner, 1024, 32, 1729, 3336, 0, 0, 5097, 3.41334e+06
n250x8192-slot-inner, 1024, 32, 1728, 3312, 0, 0, 5072, 3.41334e+06
n250x8192-slot-inner, 1024, 33, 1732, 3325, 0, 0, 5090, 3.41334e+06
n250x8192-slot-inner, 1024, 34, 1735, 3327, 0, 0, 5096, 3.41334e+06
n250x8192-slot-inner, 1024, 32, 1732, 3325, 0, 0, 5089, 3.41334e+06
n250x8192-slot-inner, 1024, 33, 1742, 3324, 0, 0, 5099, 3.41334e+06
n250x8192-slot-inner, 1024, 32, 1735, 3315, 0, 0, 5082, 3.41334e+06
n250x8192-slot-inner, 1024, 32, 1737, 3333, 0, 0, 5102, 3.41334e+06
n250x8192-slot-inner, 1024, 33, 1736, 3343, 0, 0, 5112, 3.41334e+06
n250x8192-slot-inner, 1024, 33, 1734, 3343, 0, 0, 5110, 3.41334e+06
n250x8192-slot-inner, 1024, 33, 1749, 3337, 0, 0, 5119, 3.41334e+06
n250x8192-slot-inner, 1024, 32, 1735, 3363, 0, 0, 5130, 3.41334e+06
n250x8192-slot-inner, 1024, 33, 1741, 3308, 0, 0, 5082, 3.41334e+06
n250x8192-slot-inner, 1024, 33, 1741, 3311, 0, 0, 5085, 3.41334e+06
n250x8192-slot-inner, 1024, 32, 1726, 3342, 0, 0, 5100, 3.41334e+06
n250x8192-slot-inner, 1024, 34, 1726, 3294, 0, 0, 5054, 3.41334e+06
n250x8192-slot-inner, 1024, 32, 1729, 3329, 0, 0, 5090, 3.41334e+06
n250x8192-slot-inner, 1024, 34, 1731, 3327, 0, 0, 5092, 3.41334e+06
n250x8192-slot-inner, 1024, 33, 1736, 3315, 0, 0, 5084, 3.41334e+06
n250x8192-slot-inner, 1024, 32, 1733, 3322, 0, 0, 5087, 3.41334e+06
n250x8192-slot-inner, 1024, 34, 1744, 3328, 0, 0, 5106, 3.41334e+06
n250x8192-slot-inner, 1024, 33, 1739, 3324, 0, 0, 5096, 3.41334e+06
n250x8192-slot-inner, 1024, 33, 1733, 3307, 0, 0, 5073, 3.41334e+06
n250x8192-slot-inner, 1024, 32, 1736, 3328, 0, 0, 5096, 3.41334e+06
n250x8192-slot-inner, 1024, 32, 1725, 3303, 0, 0, 5060, 3.41334e+06
n250x8192-slot-inner, 1024, 33, 1731, 3314, 0, 0, 5078, 3.41334e+06
n250x8192-slot-inner, 1024, 32, 1726, 3317, 0, 0, 5075, 3.41334e+06
n250x8192-slot-inner, 1024, 32, 1733, 3312, 0, 0, 5077, 3.41334e+06
n250x8192-slot-inner, 1024, 32, 1732, 3315, 0, 0, 5079, 3.41334e+06
n250x8192-slot-inner, 1024, 33, 1730, 3325, 0, 0, 5088, 3.41334e+06
n250x8192-slot-inner, 1024, 32, 1730, 3322, 0, 0, 5084, 3.41334e+06
n250x8192-coef-inner, 8192, 30, 5228, 2499, 1, 0, 7758, 3.41334e+06
n250x8192-coef-inner, 8192, 29, 5149, 2084, 0, 0, 7262, 3.41334e+06
n250x8192-coef-inner, 8192, 29, 5128, 2083, 0, 0, 7240, 3.41334e+06
n250x8192-coef-inner, 8192, 29, 5132, 2075, 0, 0, 7236, 3.41334e+06
n250x8192-coef-inner, 8192, 30, 5142, 2084, 0, 0, 7256, 3.41334e+06
n250x8192-coef-inner, 8192, 30, 5128, 2096, 0, 0, 7254, 3.41334e+06
n250x8192-coef-inner, 8192, 30, 5147, 2087, 0, 0, 7264, 3.41334e+06
n250x8192-coef-inner, 8192, 30, 5138, 2090, 0, 0, 7258, 3.41334e+06
n250x8192-coef-inner, 8192, 29, 5152, 2090, 0, 0, 7271, 3.41334e+06
n250x8192-coef-inner, 8192, 29, 5147, 2085, 0, 0, 7261, 3.41334e+06
n250x8192-coef-inner, 8192, 30, 5145, 2096, 0, 0, 7271, 3.41334e+06
n250x8192-coef-inner, 8192, 30, 5142, 2081, 0, 0, 7253, 3.41334e+06
n250x8192-coef-inner, 8192, 30, 5118, 2104, 0, 0, 7252, 3.41334e+06
n250x8192-coef-inner, 8192, 29, 5118, 2089, 0, 0, 7236, 3.41334e+06
n250x8192-coef-inner, 8192, 29, 5136, 2099, 0, 0, 7264, 3.41334e+06
n250x8192-coef-inner, 8192, 30, 5149, 2090, 0, 0, 7269, 3.41334e+06
n250x8192-coef-inner, 8192, 29, 5149, 2503, 1, 0, 7682, 3.41334e+06
n250x8192-coef-inner, 8192, 29, 5149, 2083, 0, 0, 7261, 3.41334e+06
n250x8192-coef-inner, 8192, 30, 5132, 2095, 0, 0, 7257, 3.41334e+06
n250x8192-coef-inner, 8192, 29, 5127, 2094, 0, 0, 7250, 3.41334e+06
n250x8192-coef-inner, 8192, 29, 5136, 2099, 0, 0, 7264, 3.41334e+06
n250x8192-coef-inner, 8192, 30, 5126, 2078, 0, 0, 7234, 3.41334e+06
n250x8192-coef-inner, 8192, 30, 5137, 2090, 0, 0, 7257, 3.41334e+06
n250x8192-coef-inner, 8192, 30, 5126, 2078, 0, 0, 7234, 3.41334e+06
n250x8192-coef-inner, 8192, 29, 5415, 2093, 0, 0, 7537, 3.41334e+06
n250x8192-coef-inner, 8192, 30, 5118, 2095, 0, 0, 7243, 3.41334e+06
n250x8192-coef-inner, 8192, 29, 5130, 2092, 0, 0, 7251, 3.41334e+06
n250x8192-coef-inner, 8192, 29, 5135, 2080, 0, 0, 7244, 3.41334e+06
n250x8192-coef-inner, 8192, 29, 5127, 2096, 0, 0, 7252, 3.41334e+06
n250x8192-coef-inner, 8192, 29, 5131, 2091, 0, 0, 7251, 3.41334e+06
n250x8192-coef-inner, 8192, 29, 5123, 2093, 0, 0, 7245, 3.41334e+06
n250x8192-coef-inner, 8192, 29, 5126, 2083, 0, 0, 7238, 3.41334e+06
n250x8192-coef-inner, 8192, 30, 5139, 2114, 0, 0, 7283, 3.41334e+06
n250x8192-coef-inner, 8192, 30, 5129, 2078, 0, 0, 7237, 3.41334e+06
n250x8192-coef-inner, 8192, 29, 5118, 2092, 0, 0, 7239, 3.41334e+06
n250x8192-coef-inner, 8192, 29, 5123, 2082, 0, 0, 7234, 3.41334e+06
n250x8192-coef-inner, 8192, 30, 5131, 2091, 0, 0, 7252, 3.41334e+06
n250x8192-coef-inner, 8192, 30, 5137, 2080, 0, 0, 7247, 3.41334e+06
n250x8192-coef-inner, 8192, 29, 5130, 2093, 0, 0, 7252, 3.41334e+06
n250x8192-coef-inner, 8192, 29, 5123, 2084, 0, 0, 7236, 3.41334e+06
n250x8192-coef-inner, 8192, 29, 5135, 2122, 0, 0, 7286, 3.41334e+06
n250x8192-coef-inner, 8192, 29, 5151, 2089, 0, 0, 7269, 3.41334e+06
n250x8192-coef-inner, 8192, 29, 5195, 2503, 1, 0, 7728, 3.41334e+06
n250x8192-coef-inner, 8192, 30, 5150, 2091, 0, 0, 7271, 3.41334e+06
n250x8192-coef-inner, 8192, 30, 5135, 2084, 0, 0, 7249, 3.41334e+06
n250x8192-coef-inner, 8192, 29, 5126, 2083, 0, 0, 7238, 3.41334e+06
n250x8192-coef-inner, 8192, 30, 5551, 2495, 1, 0, 8077, 3.41334e+06
n250x8192-coef-inner, 8192, 30, 5251, 2492, 1, 0, 7774, 3.41334e+06
n250x8192-coef-inner, 8192, 30, 5123, 2096, 0, 0, 7249, 3.41334e+06
n250x8192-coef-inner, 8192, 29, 5162, 2099, 0, 0, 7290, 3.41334e+06
n250x8192-coef-inner, 8192, 30, 5129, 2096, 0, 0, 7255, 3.41334e+06
n250x8192-coef-inner, 8192, 30, 5125, 2084, 0, 0, 7239, 3.41334e+06
n250x8192-coef-inner, 8192, 30, 5128, 2090, 0, 0, 7248, 3.41334e+06
n250x8192-coef-inner, 8192, 29, 5131, 2080, 0, 0, 7240, 3.41334e+06
n250x8192-coef-inner, 8192, 30, 5115, 2101, 0, 0, 7246, 3.41334e+06
n250x8192-coef-inner, 8192, 29, 5132, 2095, 0, 0, 7256, 3.41334e+06
n250x8192-coef-inner, 8192, 30, 5128, 2098, 0, 0, 7256, 3.41334e+06
n250x8192-coef-inner, 8192, 29, 5149, 2089, 0, 0, 7267, 3.41334e+06
n250x8192-coef-inner, 8192, 29, 5130, 2101, 0, 0, 7260, 3.41334e+06
n250x8192-coef-inner, 8192, 30, 5140, 2090, 0, 0, 7260, 3.41334e+06
n250x8192-coef-inner, 8192, 29, 5123, 2082, 0, 0, 7234, 3.41334e+06
n250x8192-coef-inner, 8192, 30, 5139, 2086, 0, 0, 7255, 3.41334e+06
n250x8192-coef-inner, 8192, 30, 5121, 2082, 0, 0, 7233, 3.41334e+06
n250x8192-coef-inner, 8192, 30, 5131, 2094, 0, 0, 7255, 3.41334e+06
n250x8192-coef-inner, 8192, 29, 5116, 2082, 0, 0, 7227, 3.41334e+06
n250x8192-coef-inner, 8192, 30, 5137, 2082, 0, 0, 7249, 3.41334e+06
n250x8192-coef-inner, 8192, 30, 5121, 2089, 0, 0, 7240, 3.41334e+06
n250x8192-coef-inner, 8192, 30, 5429, 2501, 1, 0, 7961, 3.41334e+06
n250x8192-coef-inner, 8192, 29, 5131, 2099, 0, 0, 7259, 3.41334e+06
n250x8192-coef-inner, 8192, 29, 5127, 2087, 0, 0, 7243, 3.41334e+06
n250x8192-coef-inner, 8192, 29, 5146, 2084, 0, 0, 7259, 3.41334e+06
n250x8192-coef-inner, 8192, 30, 5138, 2080, 0, 0, 7248, 3.41334e+06
n250x8192-coef-inner, 8192, 29, 5124, 2081, 0, 0, 7234, 3.41334e+06
n250x8192-coef-inner, 8192, 30, 5444, 2084, 0, 0, 7558, 3.41334e+06
n250x8192-coef-inner, 8192, 30, 5130, 2090, 0, 0, 7250, 3.41334e+06
n250x8192-coef-inner, 8192, 30, 5144, 2085, 0, 0, 7259, 3.41334e+06
n250x8192-coef-inner, 8192, 30, 5126, 2094, 0, 0, 7250, 3.41334e+06
n250x8192-coef-inner, 8192, 29, 5132, 2087, 0, 0, 7248, 3.41334e+06
n250x8192-coef-inner, 8192, 29, 5113, 2091, 0, 0, 7233, 3.41334e+06
n250x8192-coef-inner, 8192, 30, 5133, 2083, 0, 0, 7246, 3.41334e+06
n250x8192-coef-inner, 8192, 29, 5124, 2085, 0, 0, 7238, 3.41334e+06
n250x8192-coef-inner, 8192, 30, 5152, 2083, 0, 0, 7265, 3.41334e+06
n250x8192-coef-inner, 8192, 29, 5343, 2499, 1, 0, 7872, 3.41334e+06
n250x8192-coef-inner, 8192, 30, 5141, 2082, 0, 0, 7253, 3.41334e+06
n250x8192-coef-inner, 8192, 29, 5129, 2084, 0, 0, 7242, 3.41334e+06
n250x8192-coef-inner, 8192, 29, 5144, 2080, 0, 0, 7253, 3.41334e+06
n250x8192-coef-inner, 8192, 30, 5130, 2081, 0, 0, 7241, 3.41334e+06
n250x8192-coef-inner, 8192, 29, 5145, 2079, 0, 0, 7253, 3.41334e+06
n250x8192-coef-inner, 8192, 29, 5122, 2087, 0, 0, 7238, 3.41334e+06
n250x8192-coef-inner, 8192, 30, 5161, 2301, 1, 0, 7493, 3.41334e+06
n250x8192-coef-inner, 8192, 29, 5117, 2083, 0, 0, 7229, 3.41334e+06
n250x8192-coef-inner, 8192, 30, 5140, 2090, 0, 0, 7260, 3.41334e+06
n250x8192-coef-inner, 8192, 30, 5120, 2090, 0, 0, 7240, 3.41334e+06
n250x8192-coef-inner, 8192, 30, 5126, 2084, 0, 0, 7240, 3.41334e+06
n250x8192-coef-inner, 8192, 30, 5118, 2082, 0, 0, 7230, 3.41334e+06
n250x8192-coef-inner, 8192, 29, 5136, 2092, 0, 0, 7257, 3.41334e+06
n250x8192-coef-inner, 8192, 30, 5130, 2108, 0, 0, 7268, 3.41334e+06
n250x8192-coef-inner, 8192, 29, 5162, 2085, 0, 0, 7276, 3.41334e+06
n250x8192-coef-inner, 8192, 30, 5143, 2085, 0, 0, 7258, 3.41334e+06
n250x8192-coef-inner, 8192, 29, 5152, 2094, 0, 0, 7275, 3.41334e+06
n250x8192-coef-inner, 4096, 16, 5064, 2042, 0, 0, 7122, 3.41334e+06
n250x8192-coef-inner, 4096, 16, 5070, 2037, 0, 0, 7123, 3.41334e+06
n250x8192-coef-inner, 4096, 16, 5368, 2416, 0, 0, 7800, 3.41334e+06
n250x8192-coef-inner, 4096, 17, 5068, 2053, 0, 0, 7138, 3.41334e+06
n250x8192-coef-inner, 4096, 16, 5081, 2052, 0, 0, 7149, 3.41334e+06
n250x8192-coef-inner, 4096, 16, 5104, 2044, 0, 0, 7164, 3.41334e+06
n250x8192-coef-inner, 4096, 16, 5096, 2047, 0, 0, 7159, 3.41334e+06
n250x8192-coef-inner, 4096, 17, 5095, 2049, 0, 0, 7161, 3.41334e+06
n250x8192-coef-inner, 4096, 17, 5093, 2041, 0, 0, 7151, 3.41334e+06
n250x8192-coef-inner, 4096, 16, 5081, 2042, 0, 0, 7139, 3.41334e+06
n250x8192-coef-inner, 4096, 16, 5070, 2033, 0, 0, 7119, 3.41334e+06
n250x8192-coef-inner, 4096, 16, 5057, 2038, 0, 0, 7111, 3.41334e+06
n250x8192-coef-inner, 4096, 17, 5055, 2041, 0, 0, 7113, 3.41334e+06
n250x8192-coef-inner, 4096, 16, 5083, 2052, 0, 0, 7151, 3.41334e+06
n250x8192-coef-inner, 4096, 16, 5203, 2409, 0, 0, 7628, 3.41334e+06
n250x8192-coef-inner, 4096, 16, 5073, 2043, 0, 0, 7132, 3.41334e+06
n250x8192-coef-inner, 4096, 16, 5067, 2047, 0, 0, 7130, 3.41334e+06
n250x8192-coef-inner, 4096, 16, 5080, 2041, 0, 0, 7137, 3.41334e+06
n250x8192-coef-inner, 4096, 16, 5057, 2036, 0, 0, 7109, 3.41334e+06
n250x8192-coef-inner, 4096, 16, 5062, 2047, 0, 0, 7125, 3.41334e+06
n250x8192-coef-inner, 4096, 16, 5070, 2047, 0, 0, 7133, 3.41334e+06
n250x8192-coef-inner, 4096, 16, 5056, 2058, 0, 0, 7130, 3.41334e+06
n250x8192-coef-inner, 4096, 16, 5071, 2047, 0, 0, 7134, 3.41334e+06
n250x8192-coef-inner, 4096, 16, 5054, 2051, 0, 0, 7121, 3.41334e+06
n250x8192-coef-inner, 4096, 16, 5067, 2053, 0, 0, 7136, 3.41334e+06
n250x8192-coef-inner, 4096, 16, 5068, 2070, 0, 0, 7154, 3.41334e+06
n250x8192-coef-inner, 4096, 16, 5059, 2046, 0, 0, 7121, 3.41334e+06
n250x8192-coef-inner, 4096, 16, 5057, 2044, 0, 0, 7117, 3.41334e+06
n250x8192-coef-inner, 4096, 16, 5076, 2050, 0, 0, 7142, 3.41334e+06
n250x8192-coef-inner, 4096, 17, 5056, 2064, 0, 0, 7137, 3.41334e+06
n250x8192-coef-inner, 4096, 17, 5068, 2040, 0, 0, 7125, 3.41334e+06
n250x8192-coef-inner, 4096, 16, 5060, 2040, 0, 0, 7116, 3.41334e+06
n250x8192-coef-inner, 4096, 16, 5053, 2045, 0, 0, 7114, 3.41334e+06
n250x8192-coef-inner, 4096, 16, 5069, 2048, 0, 0, 7133, 3.41334e+06
n250x8192-coef-inner, 4096, 16, 5067, 2056, 0, 0, 7139, 3.41334e+06
n250x8192-coef-inner, 4096, 16, 5061, 2044, 0, 0, 7121, 3.41334e+06
n250x8192-coef-inner, 4096, 16, 5064, 2052, 0, 0, 7132, 3.41334e+06
n250x8192-coef-inner, 4096, 16, 5068, 2046, 0, 0, 7130, 3.41334e+06
n250x8192-coef-inner, 4096, 16, 5076, 2043, 0, 0, 7135, 3.41334e+06
n250x8192-coef-inner, 4096, 16, 5067, 2036, 0, 0, 7119, 3.41334e+06
n250x8192-coef-inner, 4096, 16, 5069, 2053, 0, 0, 7138, 3.41334e+06
n250x8192-coef-inner, 4096, 16, 5064, 2048, 0, 0, 7128, 3.41334e+06
n250x8192-coef-inner, 4096, 16, 5069, 2037, 0, 0, 7122, 3.41334e+06
n250x8192-coef-inner, 4096, 16, 5061, 2046, 0, 0, 7123, 3.41334e+06
n250x8192-coef-inner, 4096, 17, 5075, 2044, 0, 0, 7136, 3.41334e+06
n250x8192-coef-inner, 4096, 16, 5069, 2049, 0, 0, 7134, 3.41334e+06
n250x8192-coef-inner, 4096, 16, 5071, 2058, 0, 0, 7145, 3.41334e+06
n250x8192-coef-inner, 4096, 16, 5065, 2055, 0, 0, 7136, 3.41334e+06
n250x8192-coef-inner, 4096, 17, 5050, 2049, 0, 0, 7116, 3.41334e+06
n250x8192-coef-inner, 4096, 16, 5059, 2051, 0, 0, 7126, 3.41334e+06
n250x8192-coef-inner, 4096, 16, 5076, 2037, 0, 0, 7129, 3.41334e+06
n250x8192-coef-inner, 4096, 16, 5066, 2043, 0, 0, 7125, 3.41334e+06
n250x8192-coef-inner, 4096, 16, 5062, 2046, 0, 0, 7124, 3.41334e+06
n250x8192-coef-inner, 4096, 17, 5062, 2037, 0, 0, 7116, 3.41334e+06
n250x8192-coef-inner, 4096, 16, 5077, 2412, 0, 0, 7505, 3.41334e+06
n250x8192-coef-inner, 4096, 16, 5064, 2051, 0, 0, 7131, 3.41334e+06
n250x8192-coef-inner, 4096, 16, 5055, 2056, 0, 0, 7127, 3.41334e+06
n250x8192-coef-inner, 4096, 16, 5049, 2040, 0, 0, 7105, 3.41334e+06
n250x8192-coef-inner, 4096, 16, 5070, 2048, 0, 0, 7134, 3.41334e+06
n250x8192-coef-inner, 4096, 17, 5051, 2035, 0, 0, 7103, 3.41334e+06
n250x8192-coef-inner, 4096, 16, 5059, 2057, 0, 0, 7132, 3.41334e+06
n250x8192-coef-inner, 4096, 16, 5057, 2038, 0, 0, 7111, 3.41334e+06
n250x8192-coef-inner, 4096, 16, 5066, 2178, 0, 0, 7260, 3.41334e+06
n250x8192-coef-inner, 4096, 16, 5065, 2044, 0, 0, 7125, 3.41334e+06
n250x8192-coef-inner, 4096, 17, 5062, 2050, 0, 0, 7129, 3.41334e+06
n250x8192-coef-inner, 4096, 16, 5071, 2040, 0, 0, 7127, 3.41334e+06
n250x8192-coef-inner, 4096, 16, 5061, 2049, 0, 0, 7126, 3.41334e+06
n250x8192-coef-inner, 4096, 17, 5078, 2046, 0, 0, 7141, 3.41334e+06
n250x8192-coef-inner, 4096, 16, 5105, 2053, 0, 0, 7174, 3.41334e+06
n250x8192-coef-inner, 4096, 16, 5063, 2052, 0, 0, 7131, 3.41334e+06
n250x8192-coef-inner, 4096, 16, 5061, 2046, 0, 0, 7123, 3.41334e+06
n250x8192-coef-inner, 4096, 16, 5072, 2048, 0, 0, 7136, 3.41334e+06
n250x8192-coef-inner, 4096, 16, 5068, 2037, 0, 0, 7121, 3.41334e+06
n250x8192-coef-inner, 4096, 16, 5056, 2048, 0, 0, 7120, 3.41334e+06
n250x8192-coef-inner, 4096, 17, 5072, 2040, 0, 0, 7129, 3.41334e+06
n250x8192-coef-inner, 4096, 16, 5083, 2043, 0, 0, 7142, 3.41334e+06
n250x8192-coef-inner, 4096, 16, 5062, 2046, 0, 0, 7124, 3.41334e+06
n250x8192-coef-inner, 4096, 16, 5065, 2050, 0, 0, 7131, 3.41334e+06
n250x8192-coef-inner, 4096, 16, 5070, 2051, 0, 0, 7137, 3.41334e+06
n250x8192-coef-inner, 4096, 16, 5090, 2057, 0, 0, 7163, 3.41334e+06
n250x8192-coef-inner, 4096, 16, 5072, 2045, 0, 0, 7133, 3.41334e+06
n250x8192-coef-inner, 4096, 16, 5069, 2049, 0, 0, 7134, 3.41334e+06
n250x8192-coef-inner, 4096, 16, 5069, 2059, 0, 0, 7144, 3.41334e+06
n250x8192-coef-inner, 4096, 17, 5094, 2053, 0, 0, 7164, 3.41334e+06
n250x8192-coef-inner, 4096, 16, 5068, 2045, 0, 0, 7129, 3.41334e+06
n250x8192-coef-inner, 4096, 16, 5065, 2045, 0, 0, 7126, 3.41334e+06
n250x8192-coef-inner, 4096, 17, 5060, 2039, 0, 0, 7116, 3.41334e+06
n250x8192-coef-inner, 4096, 16, 5140, 2414, 0, 0, 7570, 3.41334e+06
n250x8192-coef-inner, 4096, 16, 5071, 2045, 0, 0, 7132, 3.41334e+06
n250x8192-coef-inner, 4096, 16, 5077, 2054, 0, 0, 7147, 3.41334e+06
n250x8192-coef-inner, 4096, 17, 5066, 2036, 0, 0, 7119, 3.41334e+06
n250x8192-coef-inner, 4096, 17, 5051, 2065, 0, 0, 7133, 3.41334e+06
n250x8192-coef-inner, 4096, 17, 5049, 2040, 0, 0, 7106, 3.41334e+06
n250x8192-coef-inner, 4096, 17, 5067, 2048, 0, 0, 7132, 3.41334e+06
n250x8192-coef-inner, 4096, 16, 5065, 2044, 0, 0, 7125, 3.41334e+06
n250x8192-coef-inner, 4096, 16, 5051, 2057, 0, 0, 7124, 3.41334e+06
n250x8192-coef-inner, 4096, 16, 5060, 2055, 0, 0, 7131, 3.41334e+06
n250x8192-coef-inner, 4096, 16, 5077, 2058, 0, 0, 7151, 3.41334e+06
n250x8192-coef-inner, 4096, 16, 5068, 2038, 0, 0, 7122, 3.41334e+06
n250x8192-coef-inner, 4096, 16, 5060, 2050, 0, 0, 7126, 3.41334e+06
n250x8192-coef-inner, 2048, 10, 5061, 2066, 0, 0, 7137, 3.41334e+06
n250x8192-coef-inner, 2048, 10, 5061, 2061, 0, 0, 7132, 3.41334e+06
n250x8192-coef-inner, 2048, 10, 5051, 2056, 0, 0, 7117, 3.41334e+06
n250x8192-coef-inner, 2048, 10, 5045, 2061, 0, 0, 7116, 3.41334e+06
n250x8192-coef-inner, 2048, 10, 5079, 2064, 0, 0, 7153, 3.41334e+06
n250x8192-coef-inner, 2048, 10, 5050, 2062, 0, 0, 7122, 3.41334e+06
n250x8192-coef-inner, 2048, 10, 5056, 2069, 0, 0, 7135, 3.41334e+06
n250x8192-coef-inner, 2048, 10, 5043, 2072, 0, 0, 7125, 3.41334e+06
n250x8192-coef-inner, 2048, 10, 5069, 2057, 0, 0, 7136, 3.41334e+06
n250x8192-coef-inner, 2048, 10, 5068, 2061, 0, 0, 7139, 3.41334e+06
n250x8192-coef-inner, 2048, 10, 5056, 2079, 0, 0, 7145, 3.41334e+06
n250x8192-coef-inner, 2048, 10, 5049, 2069, 0, 0, 7128, 3.41334e+06
n250x8192-coef-inner, 2048, 10, 5076, 2068, 0, 0, 7154, 3.41334e+06
n250x8192-coef-inner, 2048, 10, 5062, 2071, 0, 0, 7143, 3.41334e+06
n250x8192-coef-inner, 2048, 10, 5060, 2073, 0, 0, 7143, 3.41334e+06
n250x8192-coef-inner, 2048, 10, 5058, 2059, 0, 0, 7127, 3.41334e+06
n250x8192-coef-inner, 2048, 10, 5069, 2067, 0, 0, 7146, 3.41334e+06
n250x8192-coef-inner, 2048, 10, 5058, 2064, 0, 0, 7132, 3.41334e+06
n250x8192-coef-inner, 2048, 10, 5053, 2047, 0, 0, 7110, 3.41334e+06
n250x8192-coef-inner, 2048, 10, 5064, 2071, 0, 0, 7145, 3.41334e+06
n250x8192-coef-inner, 2048, 10, 5088, 2070, 0, 0, 7168, 3.41334e+06
n250x8192-coef-inner, 2048, 10, 5059, 2062, 0, 0, 7131, 3.41334e+06
n250x8192-coef-inner, 2048, 10, 5077, 2058, 0, 0, 7145, 3.41334e+06
n250x8192-coef-inner, 2048, 10, 5053, 2053, 0, 0, 7116, 3.41334e+06
n250x8192-coef-inner, 2048, 10, 5063, 2073, 0, 0, 7146, 3.41334e+06
n250x8192-coef-inner, 2048, 10, 5063, 2061, 0, 0, 7134, 3.41334e+06
n250x8192-coef-inner, 2048, 10, 5060, 2067, 0, 0, 7137, 3.41334e+06
n250x8192-coef-inner, 2048, 10, 5055, 2053, 0, 0, 7118, 3.41334e+06
n250x8192-coef-inner, 2048, 10, 5055, 2089, 0, 0, 7154, 3.41334e+06
n250x8192-coef-inner, 2048, 10, 5054, 2085, 0, 0, 7149, 3.41334e+06
n250x8192-coef-inner, 2048, 10, 5043, 2069, 0, 0, 7122, 3.41334e+06
n250x8192-coef-inner, 2048, 10, 5057, 2053, 0, 0, 7120, 3.41334e+06
n250x8192-coef-inner, 2048, 10, 5053, 2069, 0, 0, 7132, 3.41334e+06
n250x8192-coef-inner, 2048, 10, 5063, 2067, 0, 0, 7140, 3.41334e+06
n250x8192-coef-inner, 2048, 10, 5047, 2071, 0, 0, 7128, 3.41334e+06
n250x8192-coef-inner, 2048, 10, 5049, 2051, 0, 0, 7110, 3.41334e+06
n250x8192-coef-inner, 2048, 10, 5051, 2108, 0, 0, 7169, 3.41334e+06
n250x8192-coef-inner, 2048, 10, 5048, 2383, 0, 0, 7441, 3.41334e+06
n250x8192-coef-inner, 2048, 10, 5056, 2068, 0, 0, 7134, 3.41334e+06
n250x8192-coef-inner, 2048, 10, 5050, 2063, 0, 0, 7123, 3.41334e+06
n250x8192-coef-inner, 2048, 10, 5063, 2072, 0, 0, 7145, 3.41334e+06
n250x8192-coef-inner, 2048, 10, 5053, 2054, 0, 0, 7117, 3.41334e+06
n250x8192-coef-inner, 2048, 10, 5048, 2065, 0, 0, 7123, 3.41334e+06
n250x8192-coef-inner, 2048, 10, 5069, 2058, 0, 0, 7137, 3.41334e+06
n250x8192-coef-inner, 2048, 10, 5054, 2062, 0, 0, 7126, 3.41334e+06
n250x8192-coef-inner, 2048, 10, 5064, 2064, 0, 0, 7138, 3.41334e+06
n250x8192-coef-inner, 2048, 10, 5070, 2061, 0, 0, 7141, 3.41334e+06
n250x8192-coef-inner, 2048, 10, 5077, 2056, 0, 0, 7143, 3.41334e+06
n250x8192-coef-inner, 2048, 10, 5049, 2055, 0, 0, 7114, 3.41334e+06
n250x8192-coef-inner, 2048, 10, 5064, 2065, 0, 0, 7139, 3.41334e+06
n250x8192-coef-inner, 2048, 14, 5044, 2070, 0, 0, 7128, 3.41334e+06
n250x8192-coef-inner, 2048, 10, 5055, 2057, 0, 0, 7122, 3.41334e+06
n250x8192-coef-inner, 2048, 10, 5077, 2077, 0, 0, 7164, 3.41334e+06
n250x8192-coef-inner, 2048, 11, 5083, 2068, 0, 0, 7162, 3.41334e+06
n250x8192-coef-inner, 2048, 10, 5066, 2075, 0, 0, 7151, 3.41334e+06
n250x8192-coef-inner, 2048, 10, 5058, 2068, 0, 0, 7136, 3.41334e+06
n250x8192-coef-inner, 2048, 10, 5058, 2060, 0, 0, 7128, 3.41334e+06
n250x8192-coef-inner, 2048, 10, 5074, 2060, 0, 0, 7144, 3.41334e+06
n250x8192-coef-inner, 2048, 10, 5052, 2076, 0, 0, 7138, 3.41334e+06
n250x8192-coef-inner, 2048, 10, 5075, 2057, 0, 0, 7142, 3.41334e+06
n250x8192-coef-inner, 2048, 10, 5056, 2059, 0, 0, 7125, 3.41334e+06
n250x8192-coef-inner, 2048, 10, 5075, 2075, 0, 0, 7160, 3.41334e+06
n250x8192-coef-inner, 2048, 10, 5060, 2071, 0, 0, 7141, 3.41334e+06
n250x8192-coef-inner, 2048, 10, 5052, 2078, 0, 0, 7140, 3.41334e+06
n250x8192-coef-inner, 2048, 10, 5045, 2065, 0, 0, 7120, 3.41334e+06
n250x8192-coef-inner, 2048, 10, 5067, 2074, 0, 0, 7151, 3.41334e+06
n250x8192-coef-inner, 2048, 10, 5055, 2078, 0, 0, 7143, 3.41334e+06
n250x8192-coef-inner, 2048, 10, 5066, 2063, 0, 0, 7139, 3.41334e+06
n250x8192-coef-inner, 2048, 10, 5047, 2060, 0, 0, 7117, 3.41334e+06
n250x8192-coef-inner, 2048, 10, 5067, 2089, 0, 0, 7166, 3.41334e+06
n250x8192-coef-inner, 2048, 10, 5088, 2074, 0, 0, 7172, 3.41334e+06
n250x8192-coef-inner, 2048, 10, 5059, 2063, 0, 0, 7132, 3.41334e+06
n250x8192-coef-inner, 2048, 10, 5056, 2061, 0, 0, 7127, 3.41334e+06
n250x8192-coef-inner, 2048, 10, 5045, 2074, 0, 0, 7129, 3.41334e+06
n250x8192-coef-inner, 2048, 10, 5059, 2061, 0, 0, 7130, 3.41334e+06
n250x8192-coef-inner, 2048, 10, 5052, 2060, 0, 0, 7122, 3.41334e+06
n250x8192-coef-inner, 2048, 10, 5061, 2054, 0, 0, 7125, 3.41334e+06
n250x8192-coef-inner, 2048, 10, 5058, 2061, 0, 0, 7129, 3.41334e+06
n250x8192-coef-inner, 2048, 10, 5292, 2402, 0, 0, 7704, 3.41334e+06
n250x8192-coef-inner, 2048, 10, 5043, 2058, 0, 0, 7111, 3.41334e+06
n250x8192-coef-inner, 2048, 10, 5055, 2068, 0, 0, 7133, 3.41334e+06
n250x8192-coef-inner, 2048, 10, 5049, 2064, 0, 0, 7123, 3.41334e+06
n250x8192-coef-inner, 2048, 10, 5059, 2066, 0, 0, 7135, 3.41334e+06
n250x8192-coef-inner, 2048, 10, 5040, 2068, 0, 0, 7118, 3.41334e+06
n250x8192-coef-inner, 2048, 10, 5059, 2071, 0, 0, 7140, 3.41334e+06
n250x8192-coef-inner, 2048, 10, 5042, 2063, 0, 0, 7115, 3.41334e+06
n250x8192-coef-inner, 2048, 10, 5075, 2063, 0, 0, 7148, 3.41334e+06
n250x8192-coef-inner, 2048, 10, 5058, 2064, 0, 0, 7132, 3.41334e+06
n250x8192-coef-inner, 2048, 10, 5062, 2070, 0, 0, 7142, 3.41334e+06
n250x8192-coef-inner, 2048, 10, 5060, 2076, 0, 0, 7146, 3.41334e+06
n250x8192-coef-inner, 2048, 10, 5067, 2070, 0, 0, 7147, 3.41334e+06
n250x8192-coef-inner, 2048, 10, 5049, 2063, 0, 0, 7122, 3.41334e+06
n250x8192-coef-inner, 2048, 10, 5058, 2063, 0, 0, 7131, 3.41334e+06
n250x8192-coef-inner, 2048, 12, 5317, 2417, 0, 0, 7746, 3.41334e+06
n250x8192-coef-inner, 2048, 10, 5214, 2413, 0, 0, 7637, 3.41334e+06
n250x8192-coef-inner, 2048, 10, 5062, 2072, 0, 0, 7144, 3.41334e+06
n250x8192-coef-inner, 2048, 10, 5069, 2070, 0, 0, 7149, 3.41334e+06
n250x8192-coef-inner, 2048, 10, 5062, 2069, 0, 0, 7141, 3.41334e+06
n250x8192-coef-inner, 2048, 10, 5067, 2061, 0, 0, 7138, 3.41334e+06
n250x8192-coef-inner, 2048, 10, 5069, 2067, 0, 0, 7146, 3.41334e+06
n250x8192-coef-inner, 1024, 11, 6450, 3322, 0, 0, 9783, 3.41334e+06
n250x8192-coef-inner, 1024, 11, 6455, 3353, 0, 0, 9819, 3.41334e+06
n250x8192-coef-inner, 1024, 12, 6449, 3455, 0, 0, 9916, 3.41334e+06
n250x8192-coef-inner, 1024, 12, 6462, 3317, 0, 0, 9791, 3.41334e+06
n250x8192-coef-inner, 1024, 11, 6459, 3348, 0, 0, 9818, 3.41334e+06
n250x8192-coef-inner, 1024, 12, 6458, 3357, 0, 0, 9827, 3.41334e+06
n250x8192-coef-inner, 1024, 12, 6482, 3367, 0, 0, 9861, 3.41334e+06
n250x8192-coef-inner, 1024, 12, 6465, 3411, 0, 0, 9888, 3.41334e+06
n250x8192-coef-inner, 1024, 11, 6465, 3329, 0, 0, 9805, 3.41334e+06
n250x8192-coef-inner, 1024, 11, 6457, 3329, 0, 0, 9797, 3.41334e+06
n250x8192-coef-inner, 1024, 13, 6458, 3458, 0, 0, 9929, 3.41334e+06
n250x8192-coef-inner, 1024, 12, 6467, 3328, 0, 0, 9807, 3.41334e+06
n250x8192-coef-inner, 1024, 15, 6455, 3458, 0, 0, 9928, 3.41334e+06
n250x8192-coef-inner, 1024, 12, 6460, 3405, 0, 0, 9877, 3.41334e+06
n250x8192-coef-inner, 1024, 12, 6457, 3449, 0, 0, 9918, 3.41334e+06
n250x8192-coef-inner, 1024, 11, 6464, 3339, 0, 0, 9814, 3.41334e+06
n250x8192-coef-inner, 1024, 12, 6456, 3342, 0, 0, 9810, 3.41334e+06
n250x8192-coef-inner, 1024, 12, 6470, 3341, 0, 0, 9823, 3.41334e+06
n250x8192-coef-inner, 1024, 12, 6460, 3338, 0, 0, 9810, 3.41334e+06
n250x8192-coef-inner, 1024, 12, 6475, 3354, 0, 0, 9841, 3.41334e+06
n250x8192-coef-inner, 1024, 12, 6471, 3341, 0, 0, 9824, 3.41334e+06
n250x8192-coef-inner, 1024, 11, 6462, 3344, 0, 0, 9817, 3.41334e+06
n250x8192-coef-inner, 1024, 12, 6513, 3340, 0, 0, 9865, 3.41334e+06
n250x8192-coef-inner, 1024, 14, 6458, 3472, 0, 0, 9944, 3.41334e+06
n250x8192-coef-inner, 1024, 12, 6481, 3350, 0, 0, 9843, 3.41334e+06
n250x8192-coef-inner, 1024, 12, 6517, 3374, 0, 0, 9903, 3.41334e+06
n250x8192-coef-inner, 1024, 12, 6489, 3482, 0, 0, 9983, 3.41334e+06
n250x8192-coef-inner, 1024, 12, 6487, 3359, 0, 0, 9858, 3.41334e+06
n250x8192-coef-inner, 1024, 12, 6472, 3335, 0, 0, 9819, 3.41334e+06
n250x8192-coef-inner, 1024, 12, 6471, 3337, 0, 0, 9820, 3.41334e+06
n250x8192-coef-inner, 1024, 13, 6484, 3379, 0, 0, 9876, 3.41334e+06
n250x8192-coef-inner, 1024, 12, 6493, 3381, 0, 0, 9886, 3.41334e+06
n250x8192-coef-inner, 1024, 12, 6491, 3346, 0, 0, 9849, 3.41334e+06
n250x8192-coef-inner, 1024, 12, 6481, 3342, 0, 0, 9835, 3.41334e+06
n250x8192-coef-inner, 1024, 12, 6485, 3357, 0, 0, 9854, 3.41334e+06
n250x8192-coef-inner, 1024, 12, 6466, 3340, 0, 0, 9818, 3.41334e+06
n250x8192-coef-inner, 1024, 11, 6466, 3344, 0, 0, 9821, 3.41334e+06
n250x8192-coef-inner, 1024, 12, 6465, 3442, 0, 0, 9919, 3.41334e+06
n250x8192-coef-inner, 1024, 12, 6479, 3340, 0, 0, 9831, 3.41334e+06
n250x8192-coef-inner, 1024, 11, 6452, 3325, 0, 0, 9788, 3.41334e+06
n250x8192-coef-inner, 1024, 12, 6483, 3356, 0, 0, 9851, 3.41334e+06
n250x8192-coef-inner, 1024, 12, 6486, 3334, 0, 0, 9832, 3.41334e+06
n250x8192-coef-inner, 1024, 12, 6503, 3350, 0, 0, 9865, 3.41334e+06
n250x8192-coef-inner, 1024, 11, 6487, 3359, 0, 0, 9857, 3.41334e+06
n250x8192-coef-inner, 1024, 12, 6487, 3349, 0, 0, 9848, 3.41334e+06
n250x8192-coef-inner, 1024, 12, 6483, 3327, 0, 0, 9822, 3.41334e+06
n250x8192-coef-inner, 1024, 12, 6490, 3354, 0, 0, 9856, 3.41334e+06
n250x8192-coef-inner, 1024, 11, 6474, 3344, 0, 0, 9829, 3.41334e+06
n250x8192-coef-inner, 1024, 12, 6475, 3345, 0, 0, 9832, 3.41334e+06
n250x8192-coef-inner, 1024, 12, 6488, 3363, 0, 0, 9863, 3.41334e+06
n250x8192-coef-inner, 1024, 12, 6475, 3468, 0, 0, 9955, 3.41334e+06
n250x8192-coef-inner, 1024, 11, 6476, 3321, 0, 0, 9808, 3.41334e+06
n250x8192-coef-inner, 1024, 12, 6473, 3346, 0, 0, 9831, 3.41334e+06
n250x8192-coef-inner, 1024, 12, 6499, 3345, 0, 0, 9856, 3.41334e+06
n250x8192-coef-inner, 1024, 12, 6470, 3368, 0, 0, 9850, 3.41334e+06
n250x8192-coef-inner, 1024, 12, 6460, 3389, 0, 0, 9861, 3.41334e+06
n250x8192-coef-inner, 1024, 12, 6492, 3367, 0, 0, 9871, 3.41334e+06
n250x8192-coef-inner, 1024, 12, 6458, 3365, 0, 0, 9835, 3.41334e+06
n250x8192-coef-inner, 1024, 12, 6500, 3373, 0, 0, 9885, 3.41334e+06
n250x8192-coef-inner, 1024, 12, 6454, 3345, 0, 0, 9811, 3.41334e+06
n250x8192-coef-inner, 1024, 12, 6471, 3366, 0, 0, 9849, 3.41334e+06
n250x8192-coef-inner, 1024, 12, 6495, 3376, 0, 0, 9883, 3.41334e+06
n250x8192-coef-inner, 1024, 12, 6487, 3456, 0, 0, 9955, 3.41334e+06
n250x8192-coef-inner, 1024, 12, 6477, 3352, 0, 0, 9841, 3.41334e+06
n250x8192-coef-inner, 1024, 12, 6481, 3354, 0, 0, 9847, 3.41334e+06
n250x8192-coef-inner, 1024, 12, 6470, 3349, 0, 0, 9831, 3.41334e+06
n250x8192-coef-inner, 1024, 12, 6479, 3365, 0, 0, 9856, 3.41334e+06
n250x8192-coef-inner, 1024, 12, 6478, 3457, 0, 0, 9947, 3.41334e+06
n250x8192-coef-inner, 1024, 12, 6479, 3346, 0, 0, 9837, 3.41334e+06
n250x8192-coef-inner, 1024, 12, 6470, 3338, 0, 0, 9820, 3.41334e+06
n250x8192-coef-inner, 1024, 12, 6474, 3362, 0, 0, 9848, 3.41334e+06
n250x8192-coef-inner, 1024, 13, 6467, 3354, 0, 0, 9834, 3.41334e+06
n250x8192-coef-inner, 1024, 12, 6477, 3377, 0, 0, 9866, 3.41334e+06
n250x8192-coef-inner, 1024, 11, 6483, 3391, 0, 0, 9885, 3.41334e+06
n250x8192-coef-inner, 1024, 11, 6490, 3351, 0, 0, 9852, 3.41334e+06
n250x8192-coef-inner, 1024, 13, 6501, 3346, 0, 0, 9860, 3.41334e+06
n250x8192-coef-inner, 1024, 12, 6460, 3348, 0, 0, 9820, 3.41334e+06
n250x8192-coef-inner, 1024, 12, 6480, 3335, 0, 0, 9827, 3.41334e+06
n250x8192-coef-inner, 1024, 12, 6490, 3363, 0, 0, 9865, 3.41334e+06
n250x8192-coef-inner, 1024, 12, 6475, 3368, 0, 0, 9855, 3.41334e+06
n250x8192-coef-inner, 1024, 12, 6471, 3356, 0, 0, 9839, 3.41334e+06
n250x8192-coef-inner, 1024, 12, 6475, 3361, 0, 0, 9848, 3.41334e+06
n250x8192-coef-inner, 1024, 11, 6496, 3369, 0, 0, 9876, 3.41334e+06
n250x8192-coef-inner, 1024, 12, 6484, 3351, 0, 0, 9847, 3.41334e+06
n250x8192-coef-inner, 1024, 13, 6461, 3467, 0, 0, 9941, 3.41334e+06
n250x8192-coef-inner, 1024, 12, 6478, 3408, 0, 0, 9898, 3.41334e+06
n250x8192-coef-inner, 1024, 12, 6486, 3475, 0, 0, 9973, 3.41334e+06
n250x8192-coef-inner, 1024, 12, 6511, 3360, 0, 0, 9883, 3.41334e+06
n250x8192-coef-inner, 1024, 12, 6481, 3369, 0, 0, 9862, 3.41334e+06
n250x8192-coef-inner, 1024, 12, 6489, 3362, 0, 0, 9863, 3.41334e+06
n250x8192-coef-inner, 1024, 11, 6502, 3358, 0, 0, 9871, 3.41334e+06
n250x8192-coef-inner, 1024, 13, 6514, 3375, 0, 0, 9902, 3.41334e+06
n250x8192-coef-inner, 1024, 12, 6484, 3339, 0, 0, 9835, 3.41334e+06
n250x8192-coef-inner, 1024, 12, 6493, 3360, 0, 0, 9865, 3.41334e+06
n250x8192-coef-inner, 1024, 12, 6483, 3365, 0, 0, 9860, 3.41334e+06
n250x8192-coef-inner, 1024, 13, 6461, 3340, 0, 0, 9814, 3.41334e+06
n250x8192-coef-inner, 1024, 12, 6507, 3354, 0, 0, 9873, 3.41334e+06
n250x8192-coef-inner, 1024, 13, 6487, 3395, 0, 0, 9895, 3.41334e+06
n250x8192-coef-inner, 1024, 12, 6487, 3459, 0, 0, 9958, 3.41334e+06
n250x8192-coef-inner, 1024, 13, 6480, 3341, 0, 0, 9834, 3.41334e+06
n500x8192-coef-sum, 8192, 34, 5121, 133, 0, 0, 5288, 1
n500x8192-coef-sum, 8192, 35, 5115, 129, 0, 0, 5279, 1
n500x8192-coef-sum, 8192, 35, 5262, 137, 1, 0, 5435, 1
n500x8192-coef-sum, 8192, 35, 5139, 130, 0, 0, 5304, 1
n500x8192-coef-sum, 8192, 35, 5270, 133, 0, 0, 5438, 1
n500x8192-coef-sum, 8192, 34, 5130, 135, 0, 0, 5299, 1
n500x8192-coef-sum, 8192, 34, 5140, 130, 0, 0, 5304, 1
n500x8192-coef-sum, 8192, 35, 5136, 129, 0, 0, 5300, 1
n500x8192-coef-sum, 8192, 35, 5116, 131, 0, 0, 5282, 1
n500x8192-coef-sum, 8192, 34, 5111, 130, 0, 0, 5275, 1
n500x8192-coef-sum, 8192, 34, 5106, 129, 0, 0, 5269, 1
n500x8192-coef-sum, 8192, 35, 5119, 130, 0, 0, 5284, 1
n500x8192-coef-sum, 8192, 35, 5116, 130, 0, 0, 5281, 1
n500x8192-coef-sum, 8192, 34, 5116, 131, 0, 0, 5281, 1
n500x8192-coef-sum, 8192, 35, 5127, 130, 0, 0, 5292, 1
n500x8192-coef-sum, 8192, 35, 5129, 129, 0, 0, 5293, 1
n500x8192-coef-sum, 8192, 34, 5121, 144, 1, 0, 5300, 1
n500x8192-coef-sum, 8192, 35, 5108, 128, 0, 0, 5271, 1
n500x8192-coef-sum, 8192, 34, 5425, 134, 1, 0, 5594, 1
n500x8192-coef-sum, 8192, 34, 5195, 134, 1, 0, 5364, 1
n500x8192-coef-sum, 8192, 35, 5110, 130, 0, 0, 5275, 1
n500x8192-coef-sum, 8192, 35, 5119, 131, 0, 0, 5285, 1
n500x8192-coef-sum, 8192, 35, 5104, 131, 0, 0, 5270, 1
n500x8192-coef-sum, 8192, 34, 5104, 130, 0, 0, 5268, 1
n500x8192-coef-sum, 8192, 35, 5103, 133, 0, 0, 5271, 1
n500x8192-coef-sum, 8192, 35, 5112, 129, 0, 0, 5276, 1
n500x8192-coef-sum, 8192, 34, 5106, 135, 0, 0, 5275, 1
n500x8192-coef-sum, 8192, 34, 5141, 130, 0, 0, 5305, 1
n500x8192-coef-sum, 8192, 34, 5328, 134, 0, 0, 5496, 1
n500x8192-coef-sum, 8192, 35, 5115, 129, 0, 0, 5279, 1
n500x8192-coef-sum, 8192, 35, 5116, 134, 0, 0, 5285, 1
n500x8192-coef-sum, 8192, 35, 5103, 128, 0, 0, 5266, 1
n500x8192-coef-sum, 8192, 35, 5116, 133, 0, 0, 5284, 1
n500x8192-coef-sum, 8192, 34, 5116, 128, 0, 0, 5278, 1
n500x8192-coef-sum, 8192, 35, 5112, 134, 0, 0, 5281, 1
n500x8192-coef-sum, 8192, 34, 5118, 132, 0, 0, 5284, 1
n500x8192-coef-sum, 8192, 34, 5116, 132, 0, 0, 5282, 1
n500x8192-coef-sum, 8192, 34, 5105, 130, 0, 0, 5269, 1
n500x8192-coef-sum, 8192, 34, 5127, 132, 0, 0, 5293, 1
n500x8192-coef-sum, 8192, 35, 5114, 129, 0, 0, 5278, 1
n500x8192-coef-sum, 8192, 35, 5102, 133, 0, 0, 5270, 1
n500x8192-coef-sum, 8192, 34, 5109, 131, 0, 0, 5274, 1
n500x8192-coef-sum, 8192, 34, 5104, 134, 0, 0, 5272, 1
n500x8192-coef-sum, 8192, 34, 5111, 131, 0, 0, 5276, 1
n500x8192-coef-sum, 8192, 35, 5113, 132, 0, 0, 5280, 1
n500x8192-coef-sum, 8192, 35, 5115, 130, 0, 0, 5280, 1
n500x8192-coef-sum, 8192, 35, 5118, 134, 0, 0, 5287, 1
n500x8192-coef-sum, 8192, 34, 5320, 134, 1, 0, 5489, 1
n500x8192-coef-sum, 8192, 35, 5108, 133, 0, 0, 5276, 1
n500x8192-coef-sum, 8192, 34, 5386, 134, 1, 0, 5555, 1
n500x8192-coef-sum, 8192, 34, 5118, 132, 0, 0, 5284, 1
n500x8192-coef-sum, 8192, 35, 5117, 130, 0, 0, 5282, 1
n500x8192-coef-sum, 8192, 35, 5111, 132, 0, 0, 5278, 1
n500x8192-coef-sum, 8192, 34, 5102, 130, 0, 0, 5266, 1
n500x8192-coef-sum, 8192, 34, 5119, 132, 0, 0, 5285, 1
n500x8192-coef-sum, 8192, 34, 5113, 129, 0, 0, 5276, 1
n500x8192-coef-sum, 8192, 34, 5115, 135, 0, 0, 5284, 1
n500x8192-coef-sum, 8192, 35, 5107, 130, 0, 0, 5272, 1
n500x8192-coef-sum, 8192, 35, 5127, 135, 0, 0, 5297, 1
n500x8192-coef-sum, 8192, 34, 5112, 142, 0, 0, 5288, 1
n500x8192-coef-sum, 8192, 34, 5107, 132, 0, 0, 5273, 1
n500x8192-coef-sum, 8192, 34, 5227, 131, 0, 0, 5392, 1
n500x8192-coef-sum, 8192, 34, 5114, 131, 0, 0, 5279, 1
n500x8192-coef-sum, 8192, 35, 5130, 130, 1, 0, 5296, 1
n500x8192-coef-sum, 8192, 34, 5114, 136, 0, 0, 5284, 1
n500x8192-coef-sum, 8192, 35, 5119, 131, 0, 0, 5285, 1
n500x8192-coef-sum, 8192, 34, 5113, 133, 0, 0, 5280, 1
n500x8192-coef-sum, 8192, 35, 5115, 130, 0, 0, 5280, 1
n500x8192-coef-sum, 8192, 35, 5118, 132, 0, 0, 5285, 1
n500x8192-coef-sum, 8192, 34, 5125, 129, 0, 0, 5288, 1
n500x8192-coef-sum, 8192, 34, 5136, 132, 0, 0, 5302, 1
n500x8192-coef-sum, 8192, 35, 5131, 131, 0, 0, 5297, 1
n500x8192-coef-sum, 8192, 35, 5120, 135, 0, 0, 5290, 1
n500x8192-coef-sum, 8192, 35, 5106, 129, 0, 0, 5270, 1
n500x8192-coef-sum, 8192, 34, 5119, 134, 0, 0, 5287, 1
n500x8192-coef-sum, 8192, 34, 5120, 129, 0, 0, 5283, 1
n500x8192-coef-sum, 8192, 34, 5114, 134, 0, 0, 5282, 1
n500x8192-coef-sum, 8192, 34, 5101, 130, 0, 0, 5265, 1
n500x8192-coef-sum, 8192, 35, 5128, 134, 0, 0, 5297, 1
n500x8192-coef-sum, 8192, 34, 5108, 130, 0, 0, 5272, 1
n500x8192-coef-sum, 8192, 34, 5115, 133, 0, 0, 5282, 1
n500x8192-coef-sum, 8192, 35, 5135, 132, 0, 0, 5302, 1
n500x8192-coef-sum, 8192, 34, 5112, 133, 0, 0, 5279, 1
n500x8192-coef-sum, 8192, 35, 5103, 129, 0, 0, 5267, 1
n500x8192-coef-sum, 8192, 35, 5096, 132, 0, 0, 5263, 1
n500x8192-coef-sum, 8192, 35, 5115, 130, 0, 0, 5280, 1
n500x8192-coef-sum, 8192, 34, 5106, 133, 0, 0, 5273, 1
n500x8192-coef-sum, 8192, 35, 5108, 132, 0, 0, 5275, 1
n500x8192-coef-sum, 8192, 34, 5108, 134, 0, 0, 5276, 1
n500x8192-coef-sum, 8192, 35, 5113, 130, 0, 0, 5278, 1
n500x8192-coef-sum, 8192, 34, 5129, 135, 0, 0, 5298, 1
n500x8192-coef-sum, 8192, 35, 5109, 132, 0, 0, 5276, 1
n500x8192-coef-sum, 8192, 34, 5132, 133, 0, 0, 5299, 1
n500x8192-coef-sum, 8192, 34, 5113, 130, 0, 0, 5277, 1
n500x8192-coef-sum, 8192, 35, 5117, 133, 0, 0, 5285, 1
n500x8192-coef-sum, 8192, 34, 5119, 131, 0, 0, 5284, 1
n500x8192-coef-sum, 8192, 35, 5120, 132, 0, 0, 5287, 1
n500x8192-coef-sum, 8192, 34, 5122, 131, 0, 0, 5287, 1
n500x8192-coef-sum, 8192, 35, 5110, 132, 0, 0, 5277, 1
n500x8192-coef-sum, 8192, 35, 5116, 130, 0, 0, 5281, 1
n500x8192-coef-sum, 4096, 19, 5039, 132, 0, 0, 5190, 1
n500x8192-coef-sum, 4096, 19, 5043, 128, 0, 0, 5190, 1
n500x8192-coef-sum, 4096, 19, 5051, 131, 0, 0, 5201, 1
n500x8192-coef-sum, 4096, 19, 5303, 132, 0, 0, 5454, 1
n500x8192-coef-sum, 4096, 19, 5076, 131, 0, 0, 5226, 1
n500x8192-coef-sum, 4096, 19, 5049, 130, 0, 0, 5198, 1
n500x8192-coef-sum, 4096, 19, 5038, 132, 0, 0, 5189, 1
n500x8192-coef-sum, 4096, 19, 5026, 129, 0, 0, 5174, 1
n500x8192-coef-sum, 4096, 19, 5076, 132, 0, 0, 5227, 1
n500x8192-coef-sum, 4096, 19, 5050, 129, 0, 0, 5198, 1
n500x8192-coef-sum, 4096, 19, 5045, 131, 0, 0, 5195, 1
n500x8192-coef-sum, 4096, 19, 5030, 130, 0, 0, 5179, 1
n500x8192-coef-sum, 4096, 19, 5050, 133, 0, 0, 5202, 1
n500x8192-coef-sum, 4096, 19, 5053, 129, 0, 0, 5201, 1
n500x8192-coef-sum, 4096, 19, 5060, 131, 0, 0, 5210, 1
n500x8192-coef-sum, 4096, 19, 5053, 129, 0, 0, 5201, 1
n500x8192-coef-sum, 4096, 19, 5038, 135, 0, 0, 5192, 1
n500x8192-coef-sum, 4096, 19, 5039, 130, 0, 0, 5188, 1
n500x8192-coef-sum, 4096, 19, 5044, 131, 0, 0, 5194, 1
n500x8192-coef-sum, 4096, 19, 5049, 130, 0, 0, 5198, 1
n500x8192-coef-sum, 4096, 19, 5041, 131, 0, 0, 5191, 1
n500x8192-coef-sum, 4096, 19, 5049, 129, 0, 0, 5197, 1
n500x8192-coef-sum, 4096, 19, 5043, 130, 0, 0, 5192, 1
n500x8192-coef-sum, 4096, 19, 5039, 128, 0, 0, 5186, 1
n500x8192-coef-sum, 4096, 18, 5043, 131, 0, 0, 5192, 1
n500x8192-coef-sum, 4096, 19, 5039, 129, 0, 0, 5187, 1
n500x8192-coef-sum, 4096, 19, 5292, 134, 0, 0, 5445, 1
n500x8192-coef-sum, 4096, 19, 5044, 131, 0, 0, 5194, 1
n500x8192-coef-sum, 4096, 19, 5041, 132, 0, 0, 5192, 1
n500x8192-coef-sum, 4096, 19, 5040, 129, 0, 0, 5188, 1
n500x8192-coef-sum, 4096, 19, 5056, 132, 0, 0, 5207, 1
n500x8192-coef-sum, 4096, 19, 5060, 130, 0, 0, 5209, 1
n500x8192-coef-sum, 4096, 19, 5040, 130, 0, 0, 5189, 1
n500x8192-coef-sum, 4096, 19, 5044, 128, 0, 0, 5191, 1
n500x8192-coef-sum, 4096, 19, 5040, 132, 0, 0, 5191, 1
n500x8192-coef-sum, 4096, 19, 5063, 133, 0, 0, 5215, 1
n500x8192-coef-sum, 4096, 19, 5033, 127, 0, 0, 5179, 1
n500x8192-coef-sum, 4096, 19, 5036, 128, 0, 0, 5183, 1
n500x8192-coef-sum, 4096, 19, 5065, 131, 0, 0, 5215, 1
n500x8192-coef-sum, 4096, 19, 5049, 131, 0, 0, 5199, 1
n500x8192-coef-sum, 4096, 19, 5030, 128, 0, 0, 5177, 1
n500x8192-coef-sum, 4096, 19, 5051, 129, 0, 0, 5199, 1
n500x8192-coef-sum, 4096, 19, 5056, 128, 0, 0, 5203, 1
n500x8192-coef-sum, 4096, 19, 5053, 129, 0, 0, 5201, 1
n500x8192-coef-sum, 4096, 19, 5049, 130, 0, 0, 5198, 1
n500x8192-coef-sum, 4096, 19, 5041, 128, 0, 0, 5188, 1
n500x8192-coef-sum, 4096, 19, 5094, 128, 0, 0, 5241, 1
n500x8192-coef-sum, 4096, 19, 5054, 130, 0, 0, 5203, 1
n500x8192-coef-sum, 4096, 19, 5054, 130, 0, 0, 5203, 1
n500x8192-coef-sum, 4096, 19, 5055, 128, 0, 0, 5202, 1
n500x8192-coef-sum, 4096, 19, 5040, 131, 0, 0, 5190, 1
n500x8192-coef-sum, 4096, 19, 5050, 129, 0, 0, 5198, 1
n500x8192-coef-sum, 4096, 19, 5044, 129, 0, 0, 5192, 1
n500x8192-coef-sum, 4096, 19, 5031, 128, 0, 0, 5178, 1
n500x8192-coef-sum, 4096, 19, 5046, 129, 0, 0, 5194, 1
n500x8192-coef-sum, 4096, 19, 5036, 131, 0, 0, 5186, 1
n500x8192-coef-sum, 4096, 19, 5054, 129, 0, 0, 5202, 1
n500x8192-coef-sum, 4096, 19, 5040, 130, 0, 0, 5189, 1
n500x8192-coef-sum, 4096, 19, 5027, 127, 0, 0, 5173, 1
n500x8192-coef-sum, 4096, 19, 5048, 129, 0, 0, 5196, 1
n500x8192-coef-sum, 4096, 19, 5050, 128, 0, 0, 5197, 1
n500x8192-coef-sum, 4096, 19, 5040, 129, 0, 0, 5188, 1
n500x8192-coef-sum, 4096, 19, 5034, 129, 0, 0, 5182, 1
n500x8192-coef-sum, 4096, 19, 5049, 127, 0, 0, 5195, 1
n500x8192-coef-sum, 4096, 18, 5033, 128, 0, 0, 5179, 1
n500x8192-coef-sum, 4096, 19, 5042, 129, 0, 0, 5190, 1
n500x8192-coef-sum, 4096, 19, 5043, 128, 0, 0, 5190, 1
n500x8192-coef-sum, 4096, 19, 5047, 129, 0, 0, 5195, 1
n500x8192-coef-sum, 4096, 19, 5092, 131, 0, 0, 5242, 1
n500x8192-coef-sum, 4096, 19, 5048, 132, 0, 0, 5199, 1
n500x8192-coef-sum, 4096, 18, 5037, 129, 0, 0, 5184, 1
n500x8192-coef-sum, 4096, 19, 5052, 130, 0, 0, 5201, 1
n500x8192-coef-sum, 4096, 19, 5031, 129, 0, 0, 5179, 1
n500x8192-coef-sum, 4096, 19, 5033, 129, 0, 0, 5181, 1
n500x8192-coef-sum, 4096, 19, 5052, 129, 0, 0, 5200, 1
n500x8192-coef-sum, 4096, 19, 5038, 128, 0, 0, 5185, 1
n500x8192-coef-sum, 4096, 19, 5047, 129, 0, 0, 5195, 1
n500x8192-coef-sum, 4096, 19, 5051, 130, 0, 0, 5200, 1
n500x8192-coef-sum, 4096, 19, 5053, 128, 0, 0, 5200, 1
n500x8192-coef-sum, 4096, 19, 5062, 131, 0, 0, 5212, 1
n500x8192-coef-sum, 4096, 19, 5035, 129, 0, 0, 5183, 1
n500x8192-coef-sum, 4096, 19, 5044, 128, 0, 0, 5191, 1
n500x8192-coef-sum, 4096, 19, 5041, 129, 0, 0, 5189, 1
n500x8192-coef-sum, 4096, 19, 5043, 129, 0, 0, 5191, 1
n500x8192-coef-sum, 4096, 19, 5047, 129, 0, 0, 5195, 1
n500x8192-coef-sum, 4096, 19, 5053, 131, 0, 0, 5203, 1
n500x8192-coef-sum, 4096, 19, 5045, 131, 0, 0, 5195, 1
n500x8192-coef-sum, 4096, 19, 5066, 129, 0, 0, 5214, 1
n500x8192-coef-sum, 4096, 19, 5052, 129, 0, 0, 5200, 1
n500x8192-coef-sum, 4096, 19, 5035, 128, 0, 0, 5182, 1
n500x8192-coef-sum, 4096, 19, 5055, 130, 0, 0, 5204, 1
n500x8192-coef-sum, 4096, 19, 5076, 132, 0, 0, 5227, 1
n500x8192-coef-sum, 4096, 19, 5080, 130, 0, 0, 5229, 1
n500x8192-coef-sum, 4096, 19, 5042, 128, 0, 0, 5189, 1
n500x8192-coef-sum, 4096, 19, 5045, 130, 0, 0, 5194, 1
n500x8192-coef-sum, 4096, 19, 5038, 129, 0, 0, 5186, 1
n500x8192-coef-sum, 4096, 19, 5049, 128, 0, 0, 5196, 1
n500x8192-coef-sum, 4096, 19, 5047, 128, 0, 0, 5194, 1
n500x8192-coef-sum, 4096, 19, 5054, 129, 0, 0, 5202, 1
n500x8192-coef-sum, 4096, 19, 5044, 127, 0, 0, 5190, 1
n500x8192-coef-sum, 2048, 11, 5038, 148, 0, 0, 5197, 1
n500x8192-coef-sum, 2048, 11, 5079, 150, 0, 0, 5240, 1
n500x8192-coef-sum, 2048, 11, 5037, 150, 0, 0, 5198, 1
n500x8192-coef-sum, 2048, 11, 5049, 149, 0, 0, 5209, 1
n500x8192-coef-sum, 2048, 11, 5045, 149, 0, 0, 5205, 1
n500x8192-coef-sum, 2048, 11, 5042, 150, 0, 0, 5203, 1
n500x8192-coef-sum, 2048, 11, 5037, 147, 0, 0, 5195, 1
n500x8192-coef-sum, 2048, 11, 5046, 149, 0, 0, 5206, 1
n500x8192-coef-sum, 2048, 11, 5287, 148, 0, 0, 5446, 1
n500x8192-coef-sum, 2048, 11, 5035, 148, 0, 0, 5194, 1
n500x8192-coef-sum, 2048, 11, 5033, 147, 0, 0, 5191, 1
n500x8192-coef-sum, 2048, 11, 5031, 148, 0, 0, 5190, 1
n500x8192-coef-sum, 2048, 11, 5070, 149, 0, 0, 5230, 1
n500x8192-coef-sum, 2048, 11, 5035, 148, 0, 0, 5194, 1
n500x8192-coef-sum, 2048, 11, 5041, 147, 0, 0, 5199, 1
n500x8192-coef-sum, 2048, 11, 5038, 147, 0, 0, 5196, 1
n500x8192-coef-sum, 2048, 11, 5043, 149, 0, 0, 5203, 1
n500x8192-coef-sum, 2048, 12, 5075, 147, 0, 0, 5234, 1
n500x8192-coef-sum, 2048, 11, 5039, 148, 0, 0, 5198, 1
n500x8192-coef-sum, 2048, 11, 5030, 149, 0, 0, 5190, 1
n500x8192-coef-sum, 2048, 11, 5035, 147, 0, 0, 5193, 1
n500x8192-coef-sum, 2048, 11, 5039, 149, 0, 0, 5199, 1
n500x8192-coef-sum, 2048, 11, 5030, 147, 0, 0, 5188, 1
n500x8192-coef-sum, 2048, 11, 5180, 152, 0, 0, 5343, 1
n500x8192-coef-sum, 2048, 11, 5043, 148, 0, 0, 5202, 1
n500x8192-coef-sum, 2048, 12, 5040, 148, 0, 0, 5200, 1
n500x8192-coef-sum, 2048, 11, 5050, 148, 0, 0, 5209, 1
n500x8192-coef-sum, 2048, 11, 5062, 147, 0, 0, 5220, 1
n500x8192-coef-sum, 2048, 11, 5034, 148, 0, 0, 5193, 1
n500x8192-coef-sum, 2048, 11, 5032, 148, 0, 0, 5191, 1
n500x8192-coef-sum, 2048, 11, 5038, 147, 0, 0, 5196, 1
n500x8192-coef-sum, 2048, 11, 5039, 149, 0, 0, 5199, 1
n500x8192-coef-sum, 2048, 11, 5030, 148, 0, 0, 5189, 1
n500x8192-coef-sum, 2048, 11, 5040, 148, 0, 0, 5199, 1
n500x8192-coef-sum, 2048, 11, 5066, 147, 0, 0, 5224, 1
n500x8192-coef-sum, 2048, 11, 5049, 148, 0, 0, 5208, 1
n500x8192-coef-sum, 2048, 11, 5093, 148, 0, 0, 5252, 1
n500x8192-coef-sum, 2048, 11, 5037, 149, 0, 0, 5197, 1
n500x8192-coef-sum, 2048, 11, 5041, 148, 0, 0, 5200, 1
n500x8192-coef-sum, 2048, 12, 5040, 154, 0, 0, 5206, 1
n500x8192-coef-sum, 2048, 11, 5040, 148, 0, 0, 5199, 1
n500x8192-coef-sum, 2048, 11, 5030, 148, 0, 0, 5189, 1
n500x8192-coef-sum, 2048, 11, 5036, 148, 0, 0, 5195, 1
n500x8192-coef-sum, 2048, 11, 5038, 150, 0, 0, 5199, 1
n500x8192-coef-sum, 2048, 11, 5041, 149, 0, 0, 5201, 1
n500x8192-coef-sum, 2048, 11, 5078, 150, 0, 0, 5239, 1
n500x8192-coef-sum, 2048, 11, 5057, 148, 0, 0, 5216, 1
n500x8192-coef-sum, 2048, 11, 5030, 149, 0, 0, 5190, 1
n500x8192-coef-sum, 2048, 11, 5042, 148, 0, 0, 5201, 1
n500x8192-coef-sum, 2048, 11, 5040, 147, 0, 0, 5198, 1
n500x8192-coef-sum, 2048, 11, 5052, 149, 0, 0, 5212, 1
n500x8192-coef-sum, 2048, 11, 5044, 146, 0, 0, 5201, 1
n500x8192-coef-sum, 2048, 13, 5053, 147, 0, 0, 5213, 1
n500x8192-coef-sum, 2048, 11, 5049, 149, 0, 0, 5209, 1
n500x8192-coef-sum, 2048, 12, 5042, 147, 0, 0, 5201, 1
n500x8192-coef-sum, 2048, 11, 5046, 147, 0, 0, 5204, 1
n500x8192-coef-sum, 2048, 12, 5047, 147, 0, 0, 5206, 1
n500x8192-coef-sum, 2048, 11, 5056, 150, 0, 0, 5217, 1
n500x8192-coef-sum, 2048, 11, 5030, 149, 0, 0, 5190, 1
n500x8192-coef-sum, 2048, 11, 5033, 146, 0, 0, 5190, 1
n500x8192-coef-sum, 2048, 11, 5036, 148, 0, 0, 5195, 1
n500x8192-coef-sum, 2048, 11, 5054, 148, 0, 0, 5213, 1
n500x8192-coef-sum, 2048, 11, 5068, 147, 0, 0, 5226, 1
n500x8192-coef-sum, 2048, 11, 5027, 148, 0, 0, 5186, 1
n500x8192-coef-sum, 2048, 12, 5045, 147, 0, 0, 5204, 1
n500x8192-coef-sum, 2048, 11, 5038, 149, 0, 0, 5198, 1
n500x8192-coef-sum, 2048, 11, 5045, 149, 0, 0, 5205, 1
n500x8192-coef-sum, 2048, 11, 5258, 150, 0, 0, 5419, 1
n500x8192-coef-sum, 2048, 11, 5048, 148, 0, 0, 5207, 1
n500x8192-coef-sum, 2048, 11, 5049, 148, 0, 0, 5208, 1
n500x8192-coef-sum, 2048, 11, 5018, 147, 0, 0, 5176, 1
n500x8192-coef-sum, 2048, 11, 5051, 148, 0, 0, 5210, 1
n500x8192-coef-sum, 2048, 11, 5051, 149, 0, 0, 5211, 1
n500x8192-coef-sum, 2048, 11, 5074, 147, 0, 0, 5232, 1
n500x8192-coef-sum, 2048, 11, 5025, 149, 0, 0, 5185, 1
n500x8192-coef-sum, 2048, 11, 5058, 147, 0, 0, 5216, 1
n500x8192-coef-sum, 2048, 11, 5043, 148, 0, 0, 5202, 1
n500x8192-coef-sum, 2048, 11, 5049, 151, 0, 0, 5211, 1
n500x8192-coef-sum, 2048, 11, 5050, 148, 0, 0, 5209, 1
n500x8192-coef-sum, 2048, 11, 5057, 147, 0, 0, 5215, 1
n500x8192-coef-sum, 2048, 11, 5051, 148, 0, 0, 5210, 1
n500x8192-coef-sum, 2048, 12, 5032, 148, 0, 0, 5192, 1
n500x8192-coef-sum, 2048, 11, 5033, 149, 0, 0, 5193, 1
n500x8192-coef-sum, 2048, 11, 5077, 150, 0, 0, 5238, 1
n500x8192-coef-sum, 2048, 11, 5033, 149, 0, 0, 5193, 1
n500x8192-coef-sum, 2048, 11, 5041, 147, 0, 0, 5199, 1
n500x8192-coef-sum, 2048, 11, 5051, 150, 0, 0, 5212, 1
n500x8192-coef-sum, 2048, 11, 5053, 149, 0, 0, 5213, 1
n500x8192-coef-sum, 2048, 11, 5044, 148, 0, 0, 5203, 1
n500x8192-coef-sum, 2048, 11, 5054, 149, 0, 0, 5214, 1
n500x8192-coef-sum, 2048, 11, 5060, 147, 0, 0, 5218, 1
n500x8192-coef-sum, 2048, 11, 5047, 147, 0, 0, 5205, 1
n500x8192-coef-sum, 2048, 11, 5044, 149, 0, 0, 5204, 1
n500x8192-coef-sum, 2048, 11, 5033, 148, 7, 0, 5199, 1
n500x8192-coef-sum, 2048, 11, 5048, 149, 0, 0, 5208, 1
n500x8192-coef-sum, 2048, 11, 5036, 148, 0, 0, 5195, 1
n500x8192-coef-sum, 2048, 11, 5043, 149, 0, 0, 5203, 1
n500x8192-coef-sum, 2048, 11, 5037, 150, 0, 0, 5198, 1
n500x8192-coef-sum, 2048, 11, 5030, 148, 0, 0, 5189, 1
n500x8192-coef-sum, 2048, 11, 5047, 148, 0, 0, 5206, 1
n500x8192-coef-sum, 1024, 13, 6463, 228, 0, 0, 6704, 1
n500x8192-coef-sum, 1024, 12, 6488, 233, 0, 0, 6733, 1
n500x8192-coef-sum, 1024, 12, 6462, 225, 0, 0, 6699, 1
n500x8192-coef-sum, 1024, 12, 6454, 232, 0, 0, 6698, 1
n500x8192-coef-sum, 1024, 12, 6450, 227, 0, 0, 6689, 1
n500x8192-coef-sum, 1024, 13, 6458, 228, 0, 0, 6699, 1
n500x8192-coef-sum, 1024, 13, 6453, 227, 0, 0, 6693, 1
n500x8192-coef-sum, 1024, 13, 6465, 230, 0, 0, 6708, 1
n500x8192-coef-sum, 1024, 14, 6482, 226, 0, 0, 6722, 1
n500x8192-coef-sum, 1024, 13, 6489, 228, 0, 0, 6730, 1
n500x8192-coef-sum, 1024, 12, 6452, 231, 0, 0, 6695, 1
n500x8192-coef-sum, 1024, 13, 6468, 227, 0, 0, 6708, 1
n500x8192-coef-sum, 1024, 12, 6471, 228, 0, 0, 6711, 1
n500x8192-coef-sum, 1024, 13, 6473, 231, 0, 0, 6717, 1
n500x8192-coef-sum, 1024, 12, 6477, 228, 0, 0, 6717, 1
n500x8192-coef-sum, 1024, 13, 6469, 229, 0, 0, 6711, 1
n500x8192-coef-sum, 1024, 13, 6483, 229, 0, 0, 6725, 1
n500x8192-coef-sum, 1024, 12, 6471, 229, 0, 0, 6712, 1
n500x8192-coef-sum, 1024, 12, 6472, 228, 0, 0, 6712, 1
n500x8192-coef-sum, 1024, 12, 6473, 230, 0, 0, 6715, 1
n500x8192-coef-sum, 1024, 13, 6462, 233, 0, 0, 6708, 1
n500x8192-coef-sum, 1024, 13, 6455, 231, 0, 0, 6699, 1
n500x8192-coef-sum, 1024, 13, 6466, 228, 0, 0, 6707, 1
n500x8192-coef-sum, 1024, 13, 6462, 230, 0, 0, 6705, 1
n500x8192-coef-sum, 1024, 12, 6471, 228, 0, 0, 6711, 1
n500x8192-coef-sum, 1024, 21, 6523, 230, 0, 0, 6774, 1
n500x8192-coef-sum, 1024, 14, 6481, 225, 0, 0, 6720, 1
n500x8192-coef-sum, 1024, 12, 6464, 230, 0, 0, 6706, 1
n500x8192-coef-sum, 1024, 13, 6447, 227, 0, 0, 6687, 1
n500x8192-coef-sum, 1024, 12, 6456, 227, 0, 0, 6695, 1
n500x8192-coef-sum, 1024, 12, 6455, 228, 0, 0, 6695, 1
n500x8192-coef-sum, 1024, 13, 6451, 233, 0, 0, 6697, 1
n500x8192-coef-sum, 1024, 12, 6452, 228, 0, 0, 6692, 1
n500x8192-coef-sum, 1024, 12, 6463, 230, 0, 0, 6705, 1
n500x8192-coef-sum, 1024, 13, 6486, 229, 0, 0, 6728, 1
n500x8192-coef-sum, 1024, 13, 6475, 230, 0, 0, 6718, 1
n500x8192-coef-sum, 1024, 12, 6469, 228, 0, 0, 6709, 1
n500x8192-coef-sum, 1024, 12, 6455, 230, 0, 0, 6697, 1
n500x8192-coef-sum, 1024, 13, 6472, 230, 0, 0, 6715, 1
n500x8192-coef-sum, 1024, 12, 6449, 231, 0, 0, 6692, 1
n500x8192-coef-sum, 1024, 13, 6468, 228, 0, 0, 6709, 1
n500x8192-coef-sum, 1024, 13, 6462, 227, 0, 0, 6702, 1
n500x8192-coef-sum, 1024, 13, 6452, 232, 0, 0, 6697, 1
n500x8192-coef-sum, 1024, 12, 6453, 229, 0, 0, 6694, 1
n500x8192-coef-sum, 1024, 12, 6475, 227, 0, 0, 6714, 1
n500x8192-coef-sum, 1024, 13, 6448, 227, 0, 0, 6688, 1
n500x8192-coef-sum, 1024, 12, 6447, 226, 0, 0, 6685, 1
n500x8192-coef-sum, 1024, 13, 6450, 229, 0, 0, 6692, 1
n500x8192-coef-sum, 1024, 12, 6444, 225, 0, 0, 6681, 1
n500x8192-coef-sum, 1024, 13, 6450, 231, 0, 0, 6694, 1
n500x8192-coef-sum, 1024, 12, 6442, 225, 0, 0, 6679, 1
n500x8192-coef-sum, 1024, 13, 6467, 225, 0, 0, 6705, 1
n500x8192-coef-sum, 1024, 13, 6472, 230, 0, 0, 6715, 1
n500x8192-coef-sum, 1024, 13, 6454, 229, 0, 0, 6696, 1
n500x8192-coef-sum, 1024, 13, 6449, 232, 0, 0, 6694, 1
n500x8192-coef-sum, 1024, 13, 6461, 227, 0, 0, 6701, 1
n500x8192-coef-sum, 1024, 13, 6446, 229, 0, 0, 6688, 1
n500x8192-coef-sum, 1024, 12, 6455, 228, 0, 0, 6695, 1
n500x8192-coef-sum, 1024, 12, 6524, 230, 0, 0, 6766, 1
n500x8192-coef-sum, 1024, 14, 6483, 227, 0, 0, 6724, 1
n500x8192-coef-sum, 1024, 13, 6487, 231, 0, 0, 6731, 1
n500x8192-coef-sum, 1024, 13, 6470, 226, 0, 0, 6709, 1
n500x8192-coef-sum, 1024, 13, 6453, 231, 0, 0, 6697, 1
n500x8192-coef-sum, 1024, 12, 6490, 227, 0, 0, 6729, 1
n500x8192-coef-sum, 1024, 13, 6469, 230, 0, 0, 6712, 1
n500x8192-coef-sum, 1024, 13, 6491, 225, 0, 0, 6729, 1
n500x8192-coef-sum, 1024, 14, 6472, 230, 0, 0, 6716, 1
n500x8192-coef-sum, 1024, 12, 6452, 230, 0, 0, 6694, 1
n500x8192-coef-sum, 1024, 13, 6492, 230, 0, 0, 6735, 1
n500x8192-coef-sum, 1024, 12, 6452, 227, 0, 0, 6691, 1
n500x8192-coef-sum, 1024, 13, 6461, 230, 0, 0, 6704, 1
n500x8192-coef-sum, 1024, 13, 6445, 229, 0, 0, 6687, 1
n500x8192-coef-sum, 1024, 12, 6465, 234, 0, 0, 6711, 1
n500x8192-coef-sum, 1024, 13, 6460, 226, 0, 0, 6699, 1
n500x8192-coef-sum, 1024, 12, 6460, 231, 0, 0, 6703, 1
n500x8192-coef-sum, 1024, 14, 6465, 228, 0, 0, 6707, 1
n500x8192-coef-sum, 1024, 12, 6457, 232, 0, 0, 6701, 1
n500x8192-coef-sum, 1024, 13, 6490, 226, 0, 0, 6729, 1
n500x8192-coef-sum, 1024, 13, 6471, 230, 0, 0, 6714, 1
n500x8192-coef-sum, 1024, 13, 6465, 229, 0, 0, 6707, 1
n500x8192-coef-sum, 1024, 14, 6454, 230, 0, 0, 6698, 1
n500x8192-coef-sum, 1024, 13, 6471, 226, 0, 0, 6710, 1
n500x8192-coef-sum, 1024, 12, 6437, 230, 0, 0, 6679, 1
n500x8192-coef-sum, 1024, 12, 6464, 228, 0, 0, 6704, 1
n500x8192-coef-sum, 1024, 12, 6473, 228, 0, 0, 6713, 1
n500x8192-coef-sum, 1024, 13, 6480, 229, 0, 0, 6722, 1
n500x8192-coef-sum, 1024, 13, 6457, 231, 0, 0, 6701, 1
n500x8192-coef-sum, 1024, 12, 6464, 229, 0, 0, 6705, 1
n500x8192-coef-sum, 1024, 13, 6470, 231, 0, 0, 6714, 1
n500x8192-coef-sum, 1024, 13, 6456, 227, 0, 0, 6696, 1
n500x8192-coef-sum, 1024, 12, 6471, 228, 0, 0, 6711, 1
n500x8192-coef-sum, 1024, 13, 6472, 227, 0, 0, 6712, 1
n500x8192-coef-sum, 1024, 13, 6466, 229, 0, 0, 6708, 1
n500x8192-coef-sum, 1024, 12, 6458, 228, 0, 0, 6698, 1
n500x8192-coef-sum, 1024, 13, 6486, 231, 0, 0, 6730, 1
n500x8192-coef-sum, 1024, 13, 6471, 227, 0, 0, 6711, 1
n500x8192-coef-sum, 1024, 14, 6471, 230, 0, 0, 6715, 1
n500x8192-coef-sum, 1024, 13, 6445, 229, 0, 0, 6687, 1
n500x8192-coef-sum, 1024, 13, 6475, 230, 0, 0, 6718, 1
n500x8192-coef-sum, 1024, 13, 6463, 227, 0, 0, 6703, 1
n500x8192-slot-sum, 8192, 125, 2808, 150, 0, 0, 3083, 1
n500x8192-slot-sum, 8192, 125, 2824, 149, 0, 0, 3098, 1
n500x8192-slot-sum, 8192, 127, 2808, 149, 0, 0, 3084, 1
n500x8192-slot-sum, 8192, 125, 2825, 147, 0, 0, 3097, 1
n500x8192-slot-sum, 8192, 126, 2818, 150, 0, 0, 3094, 1
n500x8192-slot-sum, 8192, 127, 2827, 148, 0, 0, 3102, 1
n500x8192-slot-sum, 8192, 138, 3127, 161, 1, 0, 3427, 1
n500x8192-slot-sum, 8192, 125, 2819, 150, 0, 0, 3094, 1
n500x8192-slot-sum, 8192, 125, 2810, 149, 0, 0, 3084, 1
n500x8192-slot-sum, 8192, 128, 2815, 146, 0, 0, 3089, 1
n500x8192-slot-sum, 8192, 126, 2821, 149, 1, 0, 3097, 1
n500x8192-slot-sum, 8192, 125, 2815, 147, 0, 0, 3087, 1
n500x8192-slot-sum, 8192, 126, 2810, 150, 0, 0, 3086, 1
n500x8192-slot-sum, 8192, 126, 2811, 148, 0, 0, 3085, 1
n500x8192-slot-sum, 8192, 126, 2809, 151, 0, 0, 3086, 1
n500x8192-slot-sum, 8192, 126, 2815, 149, 0, 0, 3090, 1
n500x8192-slot-sum, 8192, 125, 2814, 150, 0, 0, 3089, 1
n500x8192-slot-sum, 8192, 126, 2808, 147, 0, 0, 3081, 1
n500x8192-slot-sum, 8192, 125, 2815, 150, 0, 0, 3090, 1
n500x8192-slot-sum, 8192, 126, 2822, 146, 0, 0, 3094, 1
n500x8192-slot-sum, 8192, 125, 2817, 150, 0, 0, 3092, 1
n500x8192-slot-sum, 8192, 126, 2820, 146, 0, 0, 3092, 1
n500x8192-slot-sum, 8192, 127, 2824, 152, 0, 0, 3103, 1
n500x8192-slot-sum, 8192, 125, 2828, 148, 0, 0, 3101, 1
n500x8192-slot-sum, 8192, 125, 2812, 150, 0, 0, 3087, 1
n500x8192-slot-sum, 8192, 125, 2818, 146, 0, 0, 3089, 1
n500x8192-slot-sum, 8192, 128, 2821, 151, 0, 0, 3100, 1
n500x8192-slot-sum, 8192, 126, 2811, 148, 0, 0, 3085, 1
n500x8192-slot-sum, 8192, 126, 2826, 151, 0, 0, 3103, 1
n500x8192-slot-sum, 8192, 126, 2808, 147, 0, 0, 3081, 1
n500x8192-slot-sum, 8192, 127, 2817, 150, 0, 0, 3094, 1
n500x8192-slot-sum, 8192, 126, 2807, 146, 0, 0, 3079, 1
n500x8192-slot-sum, 8192, 125, 2846, 151, 0, 0, 3122, 1
n500x8192-slot-sum, 8192, 126, 2807, 149, 0, 0, 3082, 1
n500x8192-slot-sum, 8192, 125, 2810, 149, 0, 0, 3084, 1
n500x8192-slot-sum, 8192, 125, 2808, 146, 0, 0, 3079, 1
n500x8192-slot-sum, 8192, 125, 2810, 149, 0, 0, 3084, 1
n500x8192-slot-sum, 8192, 126, 2817, 146, 0, 0, 3089, 1
n500x8192-slot-sum, 8192, 126, 2822, 149, 0, 0, 3097, 1
n500x8192-slot-sum, 8192, 126, 2810, 148, 0, 0, 3084, 1
n500x8192-slot-sum, 8192, 126, 2813, 150, 0, 0, 3089, 1
n500x8192-slot-sum, 8192, 126, 2838, 146, 0, 0, 3110, 1
n500x8192-slot-sum, 8192, 126, 2843, 150, 0, 0, 3119, 1
n500x8192-slot-sum, 8192, 125, 2821, 147, 0, 0, 3093, 1
n500x8192-slot-sum, 8192, 126, 2819, 149, 0, 0, 3094, 1
n500x8192-slot-sum, 8192, 127, 2812, 146, 0, 0, 3085, 1
n500x8192-slot-sum, 8192, 126, 2810, 151, 0, 0, 3087, 1
n500x8192-slot-sum, 8192, 125, 2808, 147, 0, 0, 3080, 1
n500x8192-slot-sum, 8192, 126, 2808, 149, 0, 0, 3083, 1
n500x8192-slot-sum, 8192, 125, 2809, 146, 0, 0, 3080, 1
n500x8192-slot-sum, 8192, 126, 2828, 150, 0, 0, 3104, 1
n500x8192-slot-sum, 8192, 125, 2808, 146, 0, 0, 3079, 1
n500x8192-slot-sum, 8192, 125, 2799, 149, 0, 0, 3073, 1
n500x8192-slot-sum, 8192, 126, 2810, 147, 0, 0, 3083, 1
n500x8192-slot-sum, 8192, 126, 2820, 149, 0, 0, 3095, 1
n500x8192-slot-sum, 8192, 125, 2806, 146, 0, 0, 3077, 1
n500x8192-slot-sum, 8192, 127, 2822, 149, 0, 0, 3098, 1
n500x8192-slot-sum, 8192, 127, 2811, 147, 0, 0, 3085, 1
n500x8192-slot-sum, 8192, 125, 2804, 148, 0, 0, 3077, 1
n500x8192-slot-sum, 8192, 124, 2830, 147, 0, 0, 3101, 1
n500x8192-slot-sum, 8192, 126, 2810, 151, 0, 0, 3087, 1
n500x8192-slot-sum, 8192, 126, 2824, 148, 0, 0, 3098, 1
n500x8192-slot-sum, 8192, 127, 2821, 150, 0, 0, 3098, 1
n500x8192-slot-sum, 8192, 126, 2813, 148, 0, 0, 3087, 1
n500x8192-slot-sum, 8192, 129, 3132, 159, 1, 0, 3421, 1
n500x8192-slot-sum, 8192, 128, 2810, 146, 0, 0, 3084, 1
n500x8192-slot-sum, 8192, 125, 2812, 150, 0, 0, 3087, 1
n500x8192-slot-sum, 8192, 127, 2822, 147, 0, 0, 3096, 1
n500x8192-slot-sum, 8192, 125, 2825, 149, 0, 0, 3099, 1
n500x8192-slot-sum, 8192, 125, 2823, 146, 0, 0, 3094, 1
n500x8192-slot-sum, 8192, 126, 2818, 151, 0, 0, 3095, 1
n500x8192-slot-sum, 8192, 126, 2812, 146, 0, 0, 3084, 1
n500x8192-slot-sum, 8192, 126, 2818, 151, 0, 0, 3095, 1
n500x8192-slot-sum, 8192, 126, 2814, 149, 0, 0, 3089, 1
n500x8192-slot-sum, 8192, 126, 2826, 151, 0, 0, 3103, 1
n500x8192-slot-sum, 8192, 125, 2812, 148, 0, 0, 3085, 1
n500x8192-slot-sum, 8192, 125, 2816, 150, 0, 0, 3091, 1
n500x8192-slot-sum, 8192, 125, 2825, 147, 0, 0, 3097, 1
n500x8192-slot-sum, 8192, 126, 2808, 148, 0, 0, 3082, 1
n500x8192-slot-sum, 8192, 126, 2813, 147, 0, 0, 3086, 1
n500x8192-slot-sum, 8192, 126, 2823, 147, 0, 0, 3096, 1
n500x8192-slot-sum, 8192, 126, 2822, 148, 0, 0, 3096, 1
n500x8192-slot-sum, 8192, 127, 2817, 148, 0, 0, 3092, 1
n500x8192-slot-sum, 8192, 126, 2804, 148, 0, 0, 3078, 1
n500x8192-slot-sum, 8192, 126, 2820, 147, 0, 0, 3093, 1
n500x8192-slot-sum, 8192, 127, 2879, 148, 0, 0, 3154, 1
n500x8192-slot-sum, 8192, 126, 2825, 148, 0, 0, 3099, 1
n500x8192-slot-sum, 8192, 127, 2801, 145, 0, 0, 3073, 1
n500x8192-slot-sum, 8192, 127, 2802, 146, 0, 0, 3075, 1
n500x8192-slot-sum, 8192, 129, 2815, 149, 1, 0, 3094, 1
n500x8192-slot-sum, 8192, 127, 2818, 149, 0, 0, 3094, 1
n500x8192-slot-sum, 8192, 126, 2815, 149, 0, 0, 3090, 1
n500x8192-slot-sum, 8192, 125, 2819, 146, 0, 0, 3090, 1
n500x8192-slot-sum, 8192, 125, 2820, 145, 0, 0, 3090, 1
n500x8192-slot-sum, 8192, 125, 2832, 147, 0, 0, 3104, 1
n500x8192-slot-sum, 8192, 125, 2815, 148, 0, 0, 3088, 1
n500x8192-slot-sum, 8192, 126, 2826, 147, 0, 0, 3099, 1
n500x8192-slot-sum, 8192, 125, 2814, 148, 0, 0, 3087, 1
n500x8192-slot-sum, 8192, 128, 2818, 146, 0, 0, 3092, 1
n500x8192-slot-sum, 8192, 126, 2823, 148, 0, 0, 3097, 1
n500x8192-slot-sum, 4096, 60, 2729, 139, 0, 0, 2928, 1
n500x8192-slot-sum, 4096, 59, 2732, 141, 0, 0, 2932, 1
n500x8192-slot-sum, 4096, 59, 2728, 140, 0, 0, 2927, 1
n500x8192-slot-sum, 4096, 61, 2745, 141, 0, 0, 2947, 1
n500x8192-slot-sum, 4096, 60, 2727, 140, 0, 0, 2927, 1
n500x8192-slot-sum, 4096, 59, 2732, 141, 0, 0, 2932, 1
n500x8192-slot-sum, 4096, 59, 2731, 140, 0, 0, 2930, 1
n500x8192-slot-sum, 4096, 60, 2729, 140, 0, 0, 2929, 1
n500x8192-slot-sum, 4096, 59, 2739, 140, 0, 0, 2938, 1
n500x8192-slot-sum, 4096, 60, 2741, 142, 0, 0, 2943, 1
n500x8192-slot-sum, 4096, 60, 2736, 139, 0, 0, 2935, 1
n500x8192-slot-sum, 4096, 59, 2735, 140, 0, 0, 2934, 1
n500x8192-slot-sum, 4096, 60, 2744, 139, 0, 0, 2943, 1
n500x8192-slot-sum, 4096, 60, 2748, 139, 0, 0, 2947, 1
n500x8192-slot-sum, 4096, 60, 2734, 139, 0, 0, 2933, 1
n500x8192-slot-sum, 4096, 60, 2950, 147, 0, 0, 3157, 1
n500x8192-slot-sum, 4096, 60, 2732, 140, 0, 0, 2932, 1
n500x8192-slot-sum, 4096, 60, 2738, 141, 0, 0, 2939, 1
n500x8192-slot-sum, 4096, 60, 2735, 139, 0, 0, 2934, 1
n500x8192-slot-sum, 4096, 59, 2726, 142, 0, 0, 2927, 1
n500x8192-slot-sum, 4096, 60, 2733, 139, 0, 0, 2932, 1
n500x8192-slot-sum, 4096, 60, 2738, 140, 0, 0, 2938, 1
n500x8192-slot-sum, 4096, 60, 2740, 139, 0, 0, 2939, 1
n500x8192-slot-sum, 4096, 60, 2730, 139, 0, 0, 2929, 1
n500x8192-slot-sum, 4096, 60, 2794, 140, 0, 0, 2994, 1
n500x8192-slot-sum, 4096, 60, 2734, 140, 0, 0, 2934, 1
n500x8192-slot-sum, 4096, 59, 2732, 139, 0, 0, 2930, 1
n500x8192-slot-sum, 4096, 60, 2725, 140, 0, 0, 2925, 1
n500x8192-slot-sum, 4096, 59, 2739, 140, 0, 0, 2938, 1
n500x8192-slot-sum, 4096, 60, 2730, 140, 0, 0, 2930, 1
n500x8192-slot-sum, 4096, 59, 2726, 141, 0, 0, 2926, 1
n500x8192-slot-sum, 4096, 60, 2795, 147, 0, 0, 3002, 1
n500x8192-slot-sum, 4096, 59, 2733, 139, 0, 0, 2931, 1
n500x8192-slot-sum, 4096, 60, 2732, 140, 0, 0, 2932, 1
n500x8192-slot-sum, 4096, 61, 2745, 141, 0, 0, 2947, 1
n500x8192-slot-sum, 4096, 59, 2725, 141, 0, 0, 2925, 1
n500x8192-slot-sum, 4096, 60, 2736, 140, 0, 0, 2936, 1
n500x8192-slot-sum, 4096, 61, 2738, 140, 0, 0, 2939, 1
n500x8192-slot-sum, 4096, 60, 2728, 139, 0, 0, 2927, 1
n500x8192-slot-sum, 4096, 60, 2729, 141, 0, 0, 2930, 1
n500x8192-slot-sum, 4096, 60, 2739, 140, 0, 0, 2939, 1
n500x8192-slot-sum, 4096, 60, 2737, 141, 0, 0, 2938, 1
n500x8192-slot-sum, 4096, 60, 2727, 140, 0, 0, 2927, 1
n500x8192-slot-sum, 4096, 60, 2728, 140, 0, 0, 2928, 1
n500x8192-slot-sum, 4096, 59, 2729, 141, 0, 0, 2929, 1
n500x8192-slot-sum, 4096, 60, 2739, 140, 0, 0, 2939, 1
n500x8192-slot-sum, 4096, 60, 2735, 139, 0, 0, 2934, 1
n500x8192-slot-sum, 4096, 60, 2737, 139, 0, 0, 2936, 1
n500x8192-slot-sum, 4096, 60, 2747, 141, 0, 0, 2948, 1
n500x8192-slot-sum, 4096, 59, 2730, 140, 0, 0, 2929, 1
n500x8192-slot-sum, 4096, 60, 2757, 140, 0, 0, 2957, 1
n500x8192-slot-sum, 4096, 60, 2736, 139, 0, 0, 2935, 1
n500x8192-slot-sum, 4096, 60, 2733, 140, 0, 0, 2933, 1
n500x8192-slot-sum, 4096, 59, 2737, 141, 0, 0, 2937, 1
n500x8192-slot-sum, 4096, 59, 2735, 140, 0, 0, 2934, 1
n500x8192-slot-sum, 4096, 60, 2729, 138, 0, 0, 2927, 1
n500x8192-slot-sum, 4096, 59, 2732, 142, 0, 0, 2933, 1
n500x8192-slot-sum, 4096, 60, 2729, 139, 0, 0, 2928, 1
n500x8192-slot-sum, 4096, 60, 2733, 140, 0, 0, 2933, 1
n500x8192-slot-sum, 4096, 59, 2734, 142, 0, 0, 2935, 1
n500x8192-slot-sum, 4096, 60, 2731, 140, 0, 0, 2931, 1
n500x8192-slot-sum, 4096, 60, 2724, 138, 0, 0, 2922, 1
n500x8192-slot-sum, 4096, 60, 2733, 140, 0, 0, 2933, 1
n500x8192-slot-sum, 4096, 60, 2731, 139, 0, 0, 2930, 1
n500x8192-slot-sum, 4096, 60, 2770, 139, 0, 0, 2969, 1
n500x8192-slot-sum, 4096, 60, 2739, 140, 0, 0, 2939, 1
n500x8192-slot-sum, 4096, 60, 2732, 140, 0, 0, 2932, 1
n500x8192-slot-sum, 4096, 60, 2735, 139, 0, 0, 2934, 1
n500x8192-slot-sum, 4096, 60, 2738, 142, 0, 0, 2940, 1
n500x8192-slot-sum, 4096, 75, 2737, 140, 0, 0, 2952, 1
n500x8192-slot-sum, 4096, 60, 2732, 141, 0, 0, 2933, 1
n500x8192-slot-sum, 4096, 61, 2748, 141, 0, 0, 2950, 1
n500x8192-slot-sum, 4096, 60, 2727, 141, 0, 0, 2928, 1
n500x8192-slot-sum, 4096, 60, 2725, 140, 0, 0, 2925, 1
n500x8192-slot-sum, 4096, 60, 2727, 142, 0, 0, 2929, 1
n500x8192-slot-sum, 4096, 59, 2722, 141, 0, 0, 2922, 1
n500x8192-slot-sum, 4096, 60, 2731, 138, 0, 0, 2929, 1
n500x8192-slot-sum, 4096, 59, 2725, 139, 0, 0, 2923, 1
n500x8192-slot-sum, 4096, 62, 2734, 144, 0, 0, 2940, 1
n500x8192-slot-sum, 4096, 60, 2732, 142, 0, 0, 2934, 1
n500x8192-slot-sum, 4096, 60, 2728, 140, 0, 0, 2928, 1
n500x8192-slot-sum, 4096, 60, 2728, 140, 0, 0, 2928, 1
n500x8192-slot-sum, 4096, 60, 2730, 139, 0, 0, 2929, 1
n500x8192-slot-sum, 4096, 60, 2732, 138, 0, 0, 2930, 1
n500x8192-slot-sum, 4096, 60, 2734, 138, 0, 0, 2932, 1
n500x8192-slot-sum, 4096, 60, 2721, 140, 0, 0, 2921, 1
n500x8192-slot-sum, 4096, 60, 2750, 141, 0, 0, 2951, 1
n500x8192-slot-sum, 4096, 60, 2761, 140, 0, 0, 2961, 1
n500x8192-slot-sum, 4096, 60, 2729, 140, 0, 0, 2929, 1
n500x8192-slot-sum, 4096, 59, 2740, 140, 0, 0, 2939, 1
n500x8192-slot-sum, 4096, 59, 2731, 140, 0, 0, 2930, 1
n500x8192-slot-sum, 4096, 60, 2731, 141, 0, 0, 2932, 1
n500x8192-slot-sum, 4096, 60, 2739, 141, 0, 0, 2940, 1
n500x8192-slot-sum, 4096, 60, 2740, 140, 0, 0, 2940, 1
n500x8192-slot-sum, 4096, 60, 2734, 140, 0, 0, 2934, 1
n500x8192-slot-sum, 4096, 59, 2744, 140, 0, 0, 2943, 1
n500x8192-slot-sum, 4096, 59, 2736, 140, 0, 0, 2935, 1
n500x8192-slot-sum, 4096, 59, 2740, 139, 0, 0, 2938, 1
n500x8192-slot-sum, 4096, 60, 2731, 139, 0, 0, 2930, 1
n500x8192-slot-sum, 4096, 60, 2728, 140, 0, 0, 2928, 1
n500x8192-slot-sum, 2048, 30, 2696, 149, 0, 0, 2875, 1
n500x8192-slot-sum, 2048, 30, 2699, 148, 0, 0, 2877, 1
n500x8192-slot-sum, 2048, 30, 2687, 149, 0, 0, 2866, 1
n500x8192-slot-sum, 2048, 30, 2704, 148, 0, 0, 2882, 1
n500x8192-slot-sum, 2048, 30, 2697, 148, 0, 0, 2875, 1
n500x8192-slot-sum, 2048, 30, 2704, 150, 0, 0, 2884, 1
n500x8192-slot-sum, 2048, 29, 2711, 150, 0, 0, 2890, 1
n500x8192-slot-sum, 2048, 30, 2699, 149, 0, 0, 2878, 1
n500x8192-slot-sum, 2048, 29, 2704, 148, 0, 0, 2881, 1
n500x8192-slot-sum, 2048, 30, 2701, 149, 0, 0, 2880, 1
n500x8192-slot-sum, 2048, 30, 2706, 149, 0, 0, 2885, 1
n500x8192-slot-sum, 2048, 29, 2698, 149, 0, 0, 2876, 1
n500x8192-slot-sum, 2048, 30, 2700, 150, 0, 0, 2880, 1
n500x8192-slot-sum, 2048, 30, 2690, 149, 0, 0, 2869, 1
n500x8192-slot-sum, 2048, 29, 2697, 149, 0, 0, 2875, 1
n500x8192-slot-sum, 2048, 29, 2704, 149, 0, 0, 2882, 1
n500x8192-slot-sum, 2048, 30, 2704, 149, 0, 0, 2883, 1
n500x8192-slot-sum, 2048, 30, 2706, 149, 0, 0, 2885, 1
n500x8192-slot-sum, 2048, 29, 2697, 150, 0, 0, 2876, 1
n500x8192-slot-sum, 2048, 30, 2693, 149, 0, 0, 2872, 1
n500x8192-slot-sum, 2048, 30, 2704, 148, 0, 0, 2882, 1
n500x8192-slot-sum, 2048, 29, 2702, 149, 0, 0, 2880, 1
n500x8192-slot-sum, 2048, 30, 2697, 148, 0, 0, 2875, 1
n500x8192-slot-sum, 2048, 29, 2696, 149, 0, 0, 2874, 1
n500x8192-slot-sum, 2048, 30, 2702, 150, 0, 0, 2882, 1
n500x8192-slot-sum, 2048, 30, 2714, 149, 0, 0, 2893, 1
n500x8192-slot-sum, 2048, 30, 2701, 149, 0, 0, 2880, 1
n500x8192-slot-sum, 2048, 30, 2705, 148, 0, 0, 2883, 1
n500x8192-slot-sum, 2048, 30, 2701, 148, 0, 0, 2879, 1
n500x8192-slot-sum, 2048, 30, 2702, 150, 0, 0, 2882, 1
n500x8192-slot-sum, 2048, 30, 2706, 153, 0, 0, 2889, 1
n500x8192-slot-sum, 2048, 29, 2688, 150, 0, 0, 2867, 1
n500x8192-slot-sum, 2048, 30, 2696, 149, 0, 0, 2875, 1
n500x8192-slot-sum, 2048, 30, 2701, 147, 0, 0, 2878, 1
n500x8192-slot-sum, 2048, 30, 2706, 150, 0, 0, 2886, 1
n500x8192-slot-sum, 2048, 30, 2700, 147, 0, 0, 2877, 1
n500x8192-slot-sum, 2048, 30, 2698, 149, 0, 0, 2877, 1
n500x8192-slot-sum, 2048, 30, 2693, 150, 0, 0, 2873, 1
n500x8192-slot-sum, 2048, 29, 2691, 147, 0, 0, 2867, 1
n500x8192-slot-sum, 2048, 30, 2698, 148, 0, 0, 2876, 1
n500x8192-slot-sum, 2048, 30, 2707, 149, 0, 0, 2886, 1
n500x8192-slot-sum, 2048, 30, 2703, 149, 0, 0, 2882, 1
n500x8192-slot-sum, 2048, 30, 2701, 149, 0, 0, 2880, 1
n500x8192-slot-sum, 2048, 29, 2694, 150, 0, 0, 2873, 1
n500x8192-slot-sum, 2048, 30, 2862, 154, 0, 0, 3046, 1
n500x8192-slot-sum, 2048, 29, 2703, 152, 0, 0, 2884, 1
n500x8192-slot-sum, 2048, 29, 2698, 150, 0, 0, 2877, 1
n500x8192-slot-sum, 2048, 29, 2695, 148, 0, 0, 2872, 1
n500x8192-slot-sum, 2048, 30, 2699, 151, 0, 0, 2880, 1
n500x8192-slot-sum, 2048, 30, 2706, 149, 0, 0, 2885, 1
n500x8192-slot-sum, 2048, 30, 2694, 149, 0, 0, 2873, 1
n500x8192-slot-sum, 2048, 30, 2698, 148, 0, 0, 2876, 1
n500x8192-slot-sum, 2048, 30, 2687, 148, 0, 0, 2865, 1
n500x8192-slot-sum, 2048, 30, 2709, 148, 0, 0, 2887, 1
n500x8192-slot-sum, 2048, 30, 2694, 147, 0, 0, 2871, 1
n500x8192-slot-sum, 2048, 29, 2717, 149, 0, 0, 2895, 1
n500x8192-slot-sum, 2048, 30, 2702, 150, 0, 0, 2882, 1
n500x8192-slot-sum, 2048, 30, 2700, 149, 0, 0, 2879, 1
n500x8192-slot-sum, 2048, 30, 2707, 149, 0, 0, 2886, 1
n500x8192-slot-sum, 2048, 30, 2702, 152, 0, 0, 2884, 1
n500x8192-slot-sum, 2048, 30, 2695, 149, 0, 0, 2874, 1
n500x8192-slot-sum, 2048, 29, 2694, 150, 0, 0, 2873, 1
n500x8192-slot-sum, 2048, 30, 2698, 150, 0, 0, 2878, 1
n500x8192-slot-sum, 2048, 29, 2710, 147, 0, 0, 2886, 1
n500x8192-slot-sum, 2048, 30, 2696, 148, 0, 0, 2874, 1
n500x8192-slot-sum, 2048, 30, 2708, 151, 0, 0, 2889, 1
n500x8192-slot-sum, 2048, 30, 2696, 148, 0, 0, 2874, 1
n500x8192-slot-sum, 2048, 30, 2697, 149, 0, 0, 2876, 1
n500x8192-slot-sum, 2048, 30, 2713, 152, 0, 0, 2895, 1
n500x8192-slot-sum, 2048, 29, 2696, 148, 0, 0, 2873, 1
n500x8192-slot-sum, 2048, 30, 2697, 149, 0, 0, 2876, 1
n500x8192-slot-sum, 2048, 30, 2698, 148, 0, 0, 2876, 1
n500x8192-slot-sum, 2048, 30, 2707, 150, 0, 0, 2887, 1
n500x8192-slot-sum, 2048, 30, 2695, 150, 0, 0, 2875, 1
n500x8192-slot-sum, 2048, 30, 2701, 148, 0, 0, 2879, 1
n500x8192-slot-sum, 2048, 30, 2698, 149, 0, 0, 2877, 1
n500x8192-slot-sum, 2048, 29, 2695, 149, 0, 0, 2873, 1
n500x8192-slot-sum, 2048, 30, 2697, 147, 0, 0, 2874, 1
n500x8192-slot-sum, 2048, 30, 2687, 149, 0, 0, 2866, 1
n500x8192-slot-sum, 2048, 29, 2703, 150, 0, 0, 2882, 1
n500x8192-slot-sum, 2048, 30, 2703, 151, 0, 0, 2884, 1
n500x8192-slot-sum, 2048, 29, 2703, 151, 0, 0, 2883, 1
n500x8192-slot-sum, 2048, 29, 2726, 149, 0, 0, 2904, 1
n500x8192-slot-sum, 2048, 30, 2700, 149, 0, 0, 2879, 1
n500x8192-slot-sum, 2048, 30, 2702, 151, 0, 0, 2883, 1
n500x8192-slot-sum, 2048, 30, 2695, 149, 0, 0, 2874, 1
n500x8192-slot-sum, 2048, 30, 2704, 148, 0, 0, 2882, 1
n500x8192-slot-sum, 2048, 30, 2707, 148, 0, 0, 2885, 1
n500x8192-slot-sum, 2048, 29, 2699, 148, 0, 0, 2876, 1
n500x8192-slot-sum, 2048, 30, 2706, 149, 0, 0, 2885, 1
n500x8192-slot-sum, 2048, 30, 2708, 147, 0, 0, 2885, 1
n500x8192-slot-sum, 2048, 30, 2709, 150, 0, 0, 2889, 1
n500x8192-slot-sum, 2048, 30, 2700, 148, 0, 0, 2878, 1
n500x8192-slot-sum, 2048, 30, 2704, 148, 0, 0, 2882, 1
n500x8192-slot-sum, 2048, 29, 2692, 148, 0, 0, 2869, 1
n500x8192-slot-sum, 2048, 30, 2697, 150, 0, 0, 2877, 1
n500x8192-slot-sum, 2048, 30, 2700, 149, 0, 0, 2879, 1
n500x8192-slot-sum, 2048, 30, 2686, 151, 0, 0, 2867, 1
n500x8192-slot-sum, 2048, 30, 2705, 148, 0, 0, 2883, 1
n500x8192-slot-sum, 2048, 30, 2698, 150, 0, 0, 2878, 1
n500x8192-slot-sum, 1024, 30, 3459, 229, 0, 0, 3718, 1
n500x8192-slot-sum, 1024, 30, 3485, 226, 0, 0, 3741, 1
n500x8192-slot-sum, 1024, 30, 3466, 225, 0, 0, 3721, 1
n500x8192-slot-sum, 1024, 30, 3467, 226, 0, 0, 3723, 1
n500x8192-slot-sum, 1024, 31, 3463, 226, 0, 0, 3720, 1
n500x8192-slot-sum, 1024, 30, 3467, 226, 0, 0, 3723, 1
n500x8192-slot-sum, 1024, 30, 3464, 226, 0, 0, 3720, 1
n500x8192-slot-sum, 1024, 30, 3491, 228, 0, 0, 3749, 1
n500x8192-slot-sum, 1024, 30, 3468, 225, 0, 0, 3723, 1
n500x8192-slot-sum, 1024, 30, 3462, 229, 0, 0, 3721, 1
n500x8192-slot-sum, 1024, 31, 3466, 225, 0, 0, 3722, 1
n500x8192-slot-sum, 1024, 30, 3460, 230, 0, 0, 3720, 1
n500x8192-slot-sum, 1024, 31, 3467, 227, 0, 0, 3725, 1
n500x8192-slot-sum, 1024, 31, 3471, 227, 0, 0, 3729, 1
n500x8192-slot-sum, 1024, 30, 3475, 227, 0, 0, 3732, 1
n500x8192-slot-sum, 1024, 30, 3468, 240, 0, 0, 3738, 1
n500x8192-slot-sum, 1024, 30, 3466, 226, 0, 0, 3722, 1
n500x8192-slot-sum, 1024, 30, 3468, 240, 0, 0, 3738, 1
n500x8192-slot-sum, 1024, 30, 3461, 229, 0, 0, 3720, 1
n500x8192-slot-sum, 1024, 30, 3461, 228, 0, 0, 3719, 1
n500x8192-slot-sum, 1024, 30, 3467, 228, 0, 0, 3725, 1
n500x8192-slot-sum, 1024, 31, 3456, 226, 0, 0, 3713, 1
n500x8192-slot-sum, 1024, 30, 3451, 225, 0, 0, 3706, 1
n500x8192-slot-sum, 1024, 29, 3468, 227, 0, 0, 3724, 1
n500x8192-slot-sum, 1024, 31, 3469, 228, 0, 0, 3728, 1
n500x8192-slot-sum, 1024, 30, 3456, 226, 0, 0, 3712, 1
n500x8192-slot-sum, 1024, 30, 3462, 226, 0, 0, 3718, 1
n500x8192-slot-sum, 1024, 31, 3474, 229, 0, 0, 3734, 1
n500x8192-slot-sum, 1024, 31, 3484, 230, 0, 0, 3745, 1
n500x8192-slot-sum, 1024, 30, 3449, 225, 0, 0, 3704, 1
n500x8192-slot-sum, 1024, 30, 3474, 229, 0, 0, 3733, 1
n500x8192-slot-sum, 1024, 30, 3463, 226, 0, 0, 3719, 1
n500x8192-slot-sum, 1024, 30, 3460, 230, 0, 0, 3720, 1
n500x8192-slot-sum, 1024, 30, 3473, 227, 0, 0, 3730, 1
n500x8192-slot-sum, 1024, 31, 3462, 229, 0, 0, 3722, 1
n500x8192-slot-sum, 1024, 31, 3461, 228, 0, 0, 3720, 1
n500x8192-slot-sum, 1024, 31, 3458, 226, 0, 0, 3715, 1
n500x8192-slot-sum, 1024, 31, 3451, 226, 0, 0, 3708, 1
n500x8192-slot-sum, 1024, 31, 3462, 227, 0, 0, 3720, 1
n500x8192-slot-sum, 1024, 31, 3459, 229, 0, 0, 3719, 1
n500x8192-slot-sum, 1024, 30, 3462, 227, 0, 0, 3719, 1
n500x8192-slot-sum, 1024, 30, 3457, 228, 0, 0, 3715, 1
n500x8192-slot-sum, 1024, 30, 3465, 227, 0, 0, 3722, 1
n500x8192-slot-sum, 1024, 30, 3467, 225, 0, 0, 3722, 1
n500x8192-slot-sum, 1024, 31, 3466, 229, 0, 0, 3726, 1
n500x8192-slot-sum, 1024, 30, 3484, 230, 0, 0, 3744, 1
n500x8192-slot-sum, 1024, 30, 3468, 227, 0, 0, 3725, 1
n500x8192-slot-sum, 1024, 31, 3466, 227, 0, 0, 3724, 1
n500x8192-slot-sum, 1024, 33, 3458, 227, 0, 0, 3718, 1
n500x8192-slot-sum, 1024, 30, 3465, 227, 0, 0, 3722, 1
n500x8192-slot-sum, 1024, 30, 3469, 229, 0, 0, 3728, 1
n500x8192-slot-sum, 1024, 31, 3463, 226, 0, 0, 3720, 1
n500x8192-slot-sum, 1024, 31, 3460, 227, 0, 0, 3718, 1
n500x8192-slot-sum, 1024, 31, 3462, 225, 0, 0, 3718, 1
n500x8192-slot-sum, 1024, 31, 3452, 227, 0, 0, 3710, 1
n500x8192-slot-sum, 1024, 31, 3447, 229, 0, 0, 3707, 1
n500x8192-slot-sum, 1024, 31, 3460, 228, 0, 0, 3719, 1
n500x8192-slot-sum, 1024, 31, 3458, 227, 0, 0, 3716, 1
n500x8192-slot-sum, 1024, 31, 3471, 227, 0, 0, 3729, 1
n500x8192-slot-sum, 1024, 30, 3464, 228, 0, 0, 3722, 1
n500x8192-slot-sum, 1024, 30, 3486, 229, 0, 0, 3745, 1
n500x8192-slot-sum, 1024, 30, 3465, 226, 0, 0, 3721, 1
n500x8192-slot-sum, 1024, 30, 3462, 228, 0, 0, 3720, 1
n500x8192-slot-sum, 1024, 31, 3458, 227, 0, 0, 3716, 1
n500x8192-slot-sum, 1024, 30, 3467, 227, 0, 0, 3724, 1
n500x8192-slot-sum, 1024, 30, 3457, 226, 0, 0, 3713, 1
n500x8192-slot-sum, 1024, 31, 3475, 228, 0, 0, 3734, 1
n500x8192-slot-sum, 1024, 30, 3455, 228, 0, 0, 3713, 1
n500x8192-slot-sum, 1024, 30, 3473, 227, 0, 0, 3730, 1
n500x8192-slot-sum, 1024, 30, 3468, 227, 0, 0, 3725, 1
n500x8192-slot-sum, 1024, 30, 3460, 224, 0, 0, 3714, 1
n500x8192-slot-sum, 1024, 31, 3468, 230, 0, 0, 3729, 1
n500x8192-slot-sum, 1024, 32, 3464, 227, 0, 0, 3723, 1
n500x8192-slot-sum, 1024, 30, 3462, 225, 0, 0, 3717, 1
n500x8192-slot-sum, 1024, 31, 3471, 230, 0, 0, 3732, 1
n500x8192-slot-sum, 1024, 31, 3486, 228, 0, 0, 3745, 1
n500x8192-slot-sum, 1024, 31, 3466, 231, 0, 0, 3728, 1
n500x8192-slot-sum, 1024, 31, 3483, 228, 0, 0, 3742, 1
n500x8192-slot-sum, 1024, 35, 3471, 228, 0, 0, 3734, 1
n500x8192-slot-sum, 1024, 30, 3464, 225, 0, 0, 3719, 1
n500x8192-slot-sum, 1024, 30, 3461, 230, 0, 0, 3721, 1
n500x8192-slot-sum, 1024, 30, 3463, 227, 0, 0, 3720, 1
n500x8192-slot-sum, 1024, 31, 3467, 227, 0, 0, 3725, 1
n500x8192-slot-sum, 1024, 30, 3473, 227, 0, 0, 3730, 1
n500x8192-slot-sum, 1024, 31, 3465, 225, 0, 0, 3721, 1
n500x8192-slot-sum, 1024, 30, 3459, 227, 0, 0, 3716, 1
n500x8192-slot-sum, 1024, 30, 3473, 230, 0, 0, 3733, 1
n500x8192-slot-sum, 1024, 31, 3478, 228, 0, 0, 3737, 1
n500x8192-slot-sum, 1024, 31, 3473, 227, 0, 0, 3731, 1
n500x8192-slot-sum, 1024, 31, 3459, 225, 0, 0, 3715, 1
n500x8192-slot-sum, 1024, 30, 3487, 229, 0, 0, 3746, 1
n500x8192-slot-sum, 1024, 31, 3456, 227, 0, 0, 3714, 1
n500x8192-slot-sum, 1024, 30, 3465, 227, 0, 0, 3722, 1
n500x8192-slot-sum, 1024, 30, 3464, 224, 0, 0, 3718, 1
n500x8192-slot-sum, 1024, 30, 3474, 228, 0, 0, 3732, 1
n500x8192-slot-sum, 1024, 31, 3461, 229, 0, 0, 3721, 1
n500x8192-slot-sum, 1024, 30, 3475, 228, 0, 0, 3733, 1
n500x8192-slot-sum, 1024, 30, 3468, 231, 0, 0, 3729, 1
n500x8192-slot-sum, 1024, 32, 3467, 229, 0, 0, 3728, 1
n500x8192-slot-sum, 1024, 31, 3467, 229, 0, 0, 3727, 1
n500x8192-slot-inner, 8192, 134, 2812, 4203, 0, 0, 7149, 6.82667e+06
n500x8192-slot-inner, 8192, 133, 2815, 4185, 0, 0, 7133, 6.82667e+06
n500x8192-slot-inner, 8192, 134, 2818, 4199, 0, 0, 7151, 6.82667e+06
n500x8192-slot-inner, 8192, 135, 2828, 4194, 0, 0, 7157, 6.82667e+06
n500x8192-slot-inner, 8192, 134, 2834, 4195, 0, 0, 7163, 6.82667e+06
n500x8192-slot-inner, 8192, 133, 2813, 4180, 0, 0, 7126, 6.82667e+06
n500x8192-slot-inner, 8192, 134, 2813, 4183, 0, 0, 7130, 6.82667e+06
n500x8192-slot-inner, 8192, 134, 2814, 4171, 0, 0, 7119, 6.82667e+06
n500x8192-slot-inner, 8192, 134, 2818, 4181, 0, 0, 7133, 6.82667e+06
n500x8192-slot-inner, 8192, 135, 2827, 4204, 0, 0, 7166, 6.82667e+06
n500x8192-slot-inner, 8192, 133, 2817, 4191, 0, 0, 7141, 6.82667e+06
n500x8192-slot-inner, 8192, 136, 2836, 4177, 0, 0, 7149, 6.82667e+06
n500x8192-slot-inner, 8192, 137, 2817, 4179, 0, 0, 7133, 6.82667e+06
n500x8192-slot-inner, 8192, 134, 2830, 4177, 0, 0, 7141, 6.82667e+06
n500x8192-slot-inner, 8192, 133, 2812, 4183, 0, 0, 7128, 6.82667e+06
n500x8192-slot-inner, 8192, 135, 2832, 4175, 0, 0, 7142, 6.82667e+06
n500x8192-slot-inner, 8192, 135, 2807, 4179, 0, 0, 7121, 6.82667e+06
n500x8192-slot-inner, 8192, 133, 2811, 4182, 0, 0, 7126, 6.82667e+06
n500x8192-slot-inner, 8192, 135, 2814, 4182, 0, 0, 7131, 6.82667e+06
n500x8192-slot-inner, 8192, 133, 2843, 4184, 0, 0, 7160, 6.82667e+06
n500x8192-slot-inner, 8192, 134, 2826, 4184, 0, 0, 7144, 6.82667e+06
n500x8192-slot-inner, 8192, 134, 2819, 4195, 0, 0, 7148, 6.82667e+06
n500x8192-slot-inner, 8192, 134, 2817, 4190, 0, 0, 7141, 6.82667e+06
n500x8192-slot-inner, 8192, 135, 2841, 4179, 0, 0, 7155, 6.82667e+06
n500x8192-slot-inner, 8192, 133, 2817, 4185, 0, 0, 7135, 6.82667e+06
n500x8192-slot-inner, 8192, 135, 2822, 4203, 0, 0, 7160, 6.82667e+06
n500x8192-slot-inner, 8192, 135, 2821, 4190, 0, 0, 7146, 6.82667e+06
n500x8192-slot-inner, 8192, 133, 2838, 4175, 0, 0, 7146, 6.82667e+06
n500x8192-slot-inner, 8192, 134, 2832, 4202, 0, 0, 7168, 6.82667e+06
n500x8192-slot-inner, 8192, 135, 2830, 4190, 1, 0, 7156, 6.82667e+06
n500x8192-slot-inner, 8192, 134, 2828, 4171, 0, 0, 7133, 6.82667e+06
n500x8192-slot-inner, 8192, 132, 2819, 4192, 0, 0, 7143, 6.82667e+06
n500x8192-slot-inner, 8192, 135, 2816, 4182, 0, 0, 7133, 6.82667e+06
n500x8192-slot-inner, 8192, 134, 2809, 4190, 0, 0, 7133, 6.82667e+06
n500x8192-slot-inner, 8192, 135, 2819, 4190, 0, 0, 7144, 6.82667e+06
n500x8192-slot-inner, 8192, 135, 2840, 4183, 0, 0, 7158, 6.82667e+06
n500x8192-slot-inner, 8192, 133, 2812, 4189, 0, 0, 7134, 6.82667e+06
n500x8192-slot-inner, 8192, 133, 2822, 4203, 0, 0, 7158, 6.82667e+06
n500x8192-slot-inner, 8192, 133, 2811, 4177, 0, 0, 7121, 6.82667e+06
n500x8192-slot-inner, 8192, 135, 2820, 4197, 0, 0, 7152, 6.82667e+06
n500x8192-slot-inner, 8192, 134, 2809, 4173, 0, 0, 7116, 6.82667e+06
n500x8192-slot-inner, 8192, 134, 2828, 4182, 0, 0, 7144, 6.82667e+06
n500x8192-slot-inner, 8192, 134, 2815, 4186, 0, 0, 7135, 6.82667e+06
n500x8192-slot-inner, 8192, 133, 2820, 5008, 1, 0, 7962, 6.82667e+06
n500x8192-slot-inner, 8192, 135, 2943, 5003, 1, 0, 8082, 6.82667e+06
n500x8192-slot-inner, 8192, 133, 2821, 4190, 0, 0, 7144, 6.82667e+06
n500x8192-slot-inner, 8192, 133, 2821, 4176, 0, 0, 7130, 6.82667e+06
n500x8192-slot-inner, 8192, 135, 2822, 4194, 0, 0, 7151, 6.82667e+06
n500x8192-slot-inner, 8192, 134, 2804, 4182, 0, 0, 7120, 6.82667e+06
n500x8192-slot-inner, 8192, 135, 2831, 5078, 0, 0, 8044, 6.82667e+06
n500x8192-slot-inner, 8192, 133, 2816, 4183, 0, 0, 7132, 6.82667e+06
n500x8192-slot-inner, 8192, 133, 3058, 5002, 1, 0, 8194, 6.82667e+06
n500x8192-slot-inner, 8192, 134, 2822, 4194, 0, 0, 7150, 6.82667e+06
n500x8192-slot-inner, 8192, 134, 2815, 4187, 0, 0, 7136, 6.82667e+06
n500x8192-slot-inner, 8192, 134, 2816, 4195, 0, 0, 7145, 6.82667e+06
n500x8192-slot-inner, 8192, 135, 2824, 4195, 0, 0, 7154, 6.82667e+06
n500x8192-slot-inner, 8192, 134, 2815, 4381, 1, 0, 7331, 6.82667e+06
n500x8192-slot-inner, 8192, 136, 2973, 4684, 0, 0, 7793, 6.82667e+06
n500x8192-slot-inner, 8192, 133, 2807, 4199, 0, 0, 7139, 6.82667e+06
n500x8192-slot-inner, 8192, 137, 3042, 4234, 0, 0, 7413, 6.82667e+06
n500x8192-slot-inner, 8192, 133, 2829, 4198, 0, 0, 7160, 6.82667e+06
n500x8192-slot-inner, 8192, 133, 2817, 4188, 0, 0, 7138, 6.82667e+06
n500x8192-slot-inner, 8192, 135, 2808, 4193, 0, 0, 7136, 6.82667e+06
n500x8192-slot-inner, 8192, 134, 2821, 4184, 0, 0, 7139, 6.82667e+06
n500x8192-slot-inner, 8192, 134, 2815, 4176, 0, 0, 7125, 6.82667e+06
n500x8192-slot-inner, 8192, 134, 2817, 4205, 0, 0, 7156, 6.82667e+06
n500x8192-slot-inner, 8192, 134, 2819, 4193, 0, 0, 7146, 6.82667e+06
n500x8192-slot-inner, 8192, 141, 3135, 5018, 1, 0, 8295, 6.82667e+06
n500x8192-slot-inner, 8192, 133, 2834, 4210, 0, 0, 7177, 6.82667e+06
n500x8192-slot-inner, 8192, 134, 2819, 4180, 0, 0, 7133, 6.82667e+06
n500x8192-slot-inner, 8192, 134, 2810, 4201, 0, 0, 7145, 6.82667e+06
n500x8192-slot-inner, 8192, 135, 2812, 4172, 0, 0, 7119, 6.82667e+06
n500x8192-slot-inner, 8192, 134, 2815, 4195, 1, 0, 7145, 6.82667e+06
n500x8192-slot-inner, 8192, 134, 2818, 4559, 1, 0, 7512, 6.82667e+06
n500x8192-slot-inner, 8192, 135, 2814, 4206, 0, 0, 7155, 6.82667e+06
n500x8192-slot-inner, 8192, 134, 2827, 4346, 1, 0, 7308, 6.82667e+06
n500x8192-slot-inner, 8192, 134, 2814, 4202, 0, 0, 7150, 6.82667e+06
n500x8192-slot-inner, 8192, 136, 2817, 4186, 0, 0, 7139, 6.82667e+06
n500x8192-slot-inner, 8192, 133, 2812, 4192, 0, 0, 7137, 6.82667e+06
n500x8192-slot-inner, 8192, 134, 2818, 4192, 0, 0, 7144, 6.82667e+06
n500x8192-slot-inner, 8192, 134, 2799, 4197, 0, 0, 7130, 6.82667e+06
n500x8192-slot-inner, 8192, 133, 2814, 4182, 0, 0, 7129, 6.82667e+06
n500x8192-slot-inner, 8192, 133, 2817, 4212, 1, 0, 7163, 6.82667e+06
n500x8192-slot-inner, 8192, 134, 2813, 4191, 0, 0, 7138, 6.82667e+06
n500x8192-slot-inner, 8192, 135, 3096, 5014, 1, 0, 8246, 6.82667e+06
n500x8192-slot-inner, 8192, 135, 2822, 4186, 0, 0, 7143, 6.82667e+06
n500x8192-slot-inner, 8192, 134, 2824, 4198, 0, 0, 7156, 6.82667e+06
n500x8192-slot-inner, 8192, 133, 2811, 4207, 0, 0, 7151, 6.82667e+06
n500x8192-slot-inner, 8192, 133, 2803, 4178, 0, 0, 7114, 6.82667e+06
n500x8192-slot-inner, 8192, 135, 2816, 4206, 0, 0, 7157, 6.82667e+06
n500x8192-slot-inner, 8192, 137, 2813, 4348, 1, 0, 7299, 6.82667e+06
n500x8192-slot-inner, 8192, 133, 2819, 4380, 1, 0, 7333, 6.82667e+06
n500x8192-slot-inner, 8192, 134, 2811, 4196, 0, 0, 7141, 6.82667e+06
n500x8192-slot-inner, 8192, 134, 2816, 4163, 0, 0, 7113, 6.82667e+06
n500x8192-slot-inner, 8192, 135, 2808, 4186, 0, 0, 7129, 6.82667e+06
n500x8192-slot-inner, 8192, 135, 2820, 4196, 0, 0, 7151, 6.82667e+06
n500x8192-slot-inner, 8192, 135, 2811, 4191, 1, 0, 7138, 6.82667e+06
n500x8192-slot-inner, 8192, 135, 2814, 4182, 0, 0, 7131, 6.82667e+06
n500x8192-slot-inner, 8192, 134, 2812, 4276, 1, 0, 7223, 6.82667e+06
n500x8192-slot-inner, 8192, 133, 2816, 4203, 0, 0, 7152, 6.82667e+06
n500x8192-slot-inner, 4096, 64, 2743, 4077, 0, 0, 6884, 6.82667e+06
n500x8192-slot-inner, 4096, 64, 2728, 4081, 0, 0, 6873, 6.82667e+06
n500x8192-slot-inner, 4096, 64, 2731, 4080, 0, 0, 6875, 6.82667e+06
n500x8192-slot-inner, 4096, 63, 2739, 4071, 0, 0, 6873, 6.82667e+06
n500x8192-slot-inner, 4096, 63, 2740, 4071, 0, 0, 6874, 6.82667e+06
n500x8192-slot-inner, 4096, 64, 2749, 4072, 0, 0, 6885, 6.82667e+06
n500x8192-slot-inner, 4096, 63, 2737, 4080, 0, 0, 6880, 6.82667e+06
n500x8192-slot-inner, 4096, 64, 2853, 4814, 0, 0, 7731, 6.82667e+06
n500x8192-slot-inner, 4096, 64, 2752, 4102, 0, 0, 6918, 6.82667e+06
n500x8192-slot-inner, 4096, 63, 2738, 4107, 0, 0, 6908, 6.82667e+06
n500x8192-slot-inner, 4096, 64, 2741, 4077, 0, 0, 6882, 6.82667e+06
n500x8192-slot-inner, 4096, 63, 2734, 4083, 0, 0, 6880, 6.82667e+06
n500x8192-slot-inner, 4096, 65, 2734, 4081, 0, 0, 6880, 6.82667e+06
n500x8192-slot-inner, 4096, 64, 2730, 4091, 0, 0, 6885, 6.82667e+06
n500x8192-slot-inner, 4096, 64, 2728, 4095, 0, 0, 6887, 6.82667e+06
n500x8192-slot-inner, 4096, 64, 2740, 4104, 0, 0, 6908, 6.82667e+06
n500x8192-slot-inner, 4096, 64, 2746, 4107, 0, 0, 6917, 6.82667e+06
n500x8192-slot-inner, 4096, 64, 2737, 4081, 0, 0, 6882, 6.82667e+06
n500x8192-slot-inner, 4096, 64, 2728, 4072, 0, 0, 6864, 6.82667e+06
n500x8192-slot-inner, 4096, 63, 2728, 4088, 0, 0, 6879, 6.82667e+06
n500x8192-slot-inner, 4096, 63, 2731, 4091, 0, 0, 6885, 6.82667e+06
n500x8192-slot-inner, 4096, 64, 2729, 4093, 0, 0, 6886, 6.82667e+06
n500x8192-slot-inner, 4096, 65, 2736, 4088, 0, 0, 6889, 6.82667e+06
n500x8192-slot-inner, 4096, 63, 2735, 4225, 0, 0, 7023, 6.82667e+06
n500x8192-slot-inner, 4096, 64, 2729, 4205, 0, 0, 6998, 6.82667e+06
n500x8192-slot-inner, 4096, 65, 2736, 4092, 0, 0, 6893, 6.82667e+06
n500x8192-slot-inner, 4096, 64, 2734, 4068, 0, 0, 6866, 6.82667e+06
n500x8192-slot-inner, 4096, 63, 2729, 4099, 0, 0, 6891, 6.82667e+06
n500x8192-slot-inner, 4096, 64, 2741, 4078, 0, 0, 6883, 6.82667e+06
n500x8192-slot-inner, 4096, 63, 2731, 4095, 0, 0, 6889, 6.82667e+06
n500x8192-slot-inner, 4096, 64, 2724, 4093, 0, 0, 6881, 6.82667e+06
n500x8192-slot-inner, 4096, 64, 2729, 4095, 0, 0, 6888, 6.82667e+06
n500x8192-slot-inner, 4096, 64, 2899, 4825, 0, 0, 7788, 6.82667e+06
n500x8192-slot-inner, 4096, 64, 2746, 4087, 0, 0, 6897, 6.82667e+06
n500x8192-slot-inner, 4096, 64, 2738, 4078, 0, 0, 6880, 6.82667e+06
n500x8192-slot-inner, 4096, 63, 2742, 4092, 0, 0, 6897, 6.82667e+06
n500x8192-slot-inner, 4096, 64, 2737, 4088, 0, 0, 6889, 6.82667e+06
n500x8192-slot-inner, 4096, 64, 2725, 4083, 0, 0, 6872, 6.82667e+06
n500x8192-slot-inner, 4096, 64, 2747, 4099, 0, 0, 6910, 6.82667e+06
n500x8192-slot-inner, 4096, 64, 2737, 4073, 0, 0, 6874, 6.82667e+06
n500x8192-slot-inner, 4096, 63, 2736, 4113, 0, 0, 6912, 6.82667e+06
n500x8192-slot-inner, 4096, 64, 2742, 4745, 0, 0, 7551, 6.82667e+06
n500x8192-slot-inner, 4096, 64, 2741, 4113, 0, 0, 6918, 6.82667e+06
n500x8192-slot-inner, 4096, 63, 2734, 4088, 0, 0, 6885, 6.82667e+06
n500x8192-slot-inner, 4096, 64, 2742, 4091, 0, 0, 6897, 6.82667e+06
n500x8192-slot-inner, 4096, 63, 2742, 4066, 0, 0, 6871, 6.82667e+06
n500x8192-slot-inner, 4096, 63, 2757, 4087, 0, 0, 6907, 6.82667e+06
n500x8192-slot-inner, 4096, 63, 2735, 4083, 0, 0, 6881, 6.82667e+06
n500x8192-slot-inner, 4096, 65, 2734, 4106, 0, 0, 6905, 6.82667e+06
n500x8192-slot-inner, 4096, 63, 2738, 4080, 0, 0, 6881, 6.82667e+06
n500x8192-slot-inner, 4096, 64, 2737, 4086, 0, 0, 6887, 6.82667e+06
n500x8192-slot-inner, 4096, 65, 2784, 4104, 0, 0, 6953, 6.82667e+06
n500x8192-slot-inner, 4096, 64, 2739, 4119, 0, 0, 6922, 6.82667e+06
n500x8192-slot-inner, 4096, 64, 2742, 4080, 0, 0, 6886, 6.82667e+06
n500x8192-slot-inner, 4096, 63, 2737, 4079, 0, 0, 6879, 6.82667e+06
n500x8192-slot-inner, 4096, 64, 2732, 4104, 0, 0, 6900, 6.82667e+06
n500x8192-slot-inner, 4096, 65, 2741, 4093, 0, 0, 6899, 6.82667e+06
n500x8192-slot-inner, 4096, 64, 2748, 4081, 0, 0, 6893, 6.82667e+06
n500x8192-slot-inner, 4096, 64, 2743, 4075, 0, 0, 6882, 6.82667e+06
n500x8192-slot-inner, 4096, 63, 2740, 4077, 0, 0, 6880, 6.82667e+06
n500x8192-slot-inner, 4096, 64, 2738, 4088, 0, 0, 6890, 6.82667e+06
n500x8192-slot-inner, 4096, 63, 2729, 4077, 0, 0, 6869, 6.82667e+06
n500x8192-slot-inner, 4096, 64, 2740, 4081, 0, 0, 6885, 6.82667e+06
n500x8192-slot-inner, 4096, 64, 2736, 4137, 0, 0, 6937, 6.82667e+06
n500x8192-slot-inner, 4096, 66, 4472, 5380, 0, 0, 9918, 6.82667e+06
n500x8192-slot-inner, 4096, 87, 3407, 5022, 0, 0, 8516, 6.82667e+06
n500x8192-slot-inner, 4096, 78, 2898, 4272, 0, 0, 7248, 6.82667e+06
n500x8192-slot-inner, 4096, 64, 3141, 4098, 0, 0, 7303, 6.82667e+06
n500x8192-slot-inner, 4096, 63, 2750, 4137, 0, 0, 6950, 6.82667e+06
n500x8192-slot-inner, 4096, 64, 2759, 4101, 0, 0, 6924, 6.82667e+06
n500x8192-slot-inner, 4096, 63, 2741, 4128, 0, 0, 6932, 6.82667e+06
n500x8192-slot-inner, 4096, 64, 2738, 4464, 0, 0, 7266, 6.82667e+06
n500x8192-slot-inner, 4096, 64, 3029, 4694, 0, 0, 7787, 6.82667e+06
n500x8192-slot-inner, 4096, 64, 2728, 4098, 0, 0, 6890, 6.82667e+06
n500x8192-slot-inner, 4096, 63, 2748, 4081, 0, 0, 6892, 6.82667e+06
n500x8192-slot-inner, 4096, 64, 2735, 4078, 0, 0, 6877, 6.82667e+06
n500x8192-slot-inner, 4096, 64, 2738, 4085, 0, 0, 6887, 6.82667e+06
n500x8192-slot-inner, 4096, 64, 2735, 4078, 0, 0, 6877, 6.82667e+06
n500x8192-slot-inner, 4096, 64, 2741, 4094, 0, 0, 6899, 6.82667e+06
n500x8192-slot-inner, 4096, 63, 2732, 4092, 0, 0, 6887, 6.82667e+06
n500x8192-slot-inner, 4096, 63, 2735, 4093, 0, 0, 6891, 6.82667e+06
n500x8192-slot-inner, 4096, 65, 2760, 4087, 0, 0, 6912, 6.82667e+06
n500x8192-slot-inner, 4096, 63, 2730, 4095, 0, 0, 6888, 6.82667e+06
n500x8192-slot-inner, 4096, 63, 2731, 4078, 0, 0, 6872, 6.82667e+06
n500x8192-slot-inner, 4096, 64, 2724, 4095, 0, 0, 6883, 6.82667e+06
n500x8192-slot-inner, 4096, 63, 2735, 4090, 0, 0, 6888, 6.82667e+06
n500x8192-slot-inner, 4096, 64, 2724, 4093, 0, 0, 6881, 6.82667e+06
n500x8192-slot-inner, 4096, 64, 2723, 4121, 0, 0, 6908, 6.82667e+06
n500x8192-slot-inner, 4096, 63, 2746, 4097, 0, 0, 6906, 6.82667e+06
n500x8192-slot-inner, 4096, 64, 2732, 4118, 0, 0, 6914, 6.82667e+06
n500x8192-slot-inner, 4096, 65, 2738, 4109, 0, 0, 6912, 6.82667e+06
n500x8192-slot-inner, 4096, 64, 2773, 4103, 0, 0, 6940, 6.82667e+06
n500x8192-slot-inner, 4096, 65, 2726, 4082, 0, 0, 6873, 6.82667e+06
n500x8192-slot-inner, 4096, 64, 2728, 4154, 0, 0, 6946, 6.82667e+06
n500x8192-slot-inner, 4096, 64, 2742, 4091, 0, 0, 6897, 6.82667e+06
n500x8192-slot-inner, 4096, 65, 2729, 4086, 0, 0, 6880, 6.82667e+06
n500x8192-slot-inner, 4096, 64, 2735, 4096, 0, 0, 6895, 6.82667e+06
n500x8192-slot-inner, 4096, 64, 2733, 4178, 0, 0, 6975, 6.82667e+06
n500x8192-slot-inner, 4096, 63, 2736, 4090, 0, 0, 6889, 6.82667e+06
n500x8192-slot-inner, 4096, 65, 2735, 4091, 0, 0, 6891, 6.82667e+06
n500x8192-slot-inner, 2048, 62, 3509, 6392, 0, 0, 9963, 6.82667e+06
n500x8192-slot-inner, 2048, 61, 3466, 6423, 0, 0, 9950, 6.82667e+06
n500x8192-slot-inner, 2048, 62, 3462, 6406, 0, 0, 9930, 6.82667e+06
n500x8192-slot-inner, 2048, 61, 3467, 6415, 0, 0, 9943, 6.82667e+06
n500x8192-slot-inner, 2048, 61, 3467, 6447, 0, 0, 9975, 6.82667e+06
n500x8192-slot-inner, 2048, 61, 3464, 6425, 0, 0, 9950, 6.82667e+06
n500x8192-slot-inner, 2048, 61, 3458, 6389, 0, 0, 9908, 6.82667e+06
n500x8192-slot-inner, 2048, 61, 3484, 6416, 0, 0, 9961, 6.82667e+06
n500x8192-slot-inner, 2048, 61, 3467, 6408, 0, 0, 9936, 6.82667e+06
n500x8192-slot-inner, 2048, 63, 3470, 6683, 0, 0, 10216, 6.82667e+06
n500x8192-slot-inner, 2048, 61, 3484, 6420, 0, 0, 9965, 6.82667e+06
n500x8192-slot-inner, 2048, 60, 3461, 6430, 0, 0, 9951, 6.82667e+06
n500x8192-slot-inner, 2048, 63, 3469, 6427, 0, 0, 9959, 6.82667e+06
n500x8192-slot-inner, 2048, 64, 3489, 6435, 0, 0, 9988, 6.82667e+06
n500x8192-slot-inner, 2048, 61, 3470, 6429, 0, 0, 9960, 6.82667e+06
n500x8192-slot-inner, 2048, 61, 3465, 6436, 0, 0, 9962, 6.82667e+06
n500x8192-slot-inner, 2048, 64, 3508, 6437, 0, 0, 10009, 6.82667e+06
n500x8192-slot-inner, 2048, 61, 3466, 6435, 0, 0, 9962, 6.82667e+06
n500x8192-slot-inner, 2048, 60, 3453, 6424, 0, 0, 9937, 6.82667e+06
n500x8192-slot-inner, 2048, 61, 3462, 6416, 0, 0, 9939, 6.82667e+06
n500x8192-slot-inner, 2048, 61, 3462, 6402, 0, 0, 9925, 6.82667e+06
n500x8192-slot-inner, 2048, 60, 3456, 6428, 0, 0, 9944, 6.82667e+06
n500x8192-slot-inner, 2048, 62, 3469, 6502, 0, 0, 10033, 6.82667e+06
n500x8192-slot-inner, 2048, 60, 3465, 6415, 0, 0, 9940, 6.82667e+06
n500x8192-slot-inner, 2048, 63, 3460, 6411, 0, 0, 9934, 6.82667e+06
n500x8192-slot-inner, 2048, 60, 3464, 6409, 0, 0, 9933, 6.82667e+06
n500x8192-slot-inner, 2048, 61, 3469, 6437, 0, 0, 9967, 6.82667e+06
n500x8192-slot-inner, 2048, 61, 3472, 6426, 0, 0, 9959, 6.82667e+06
n500x8192-slot-inner, 2048, 61, 3449, 6417, 0, 0, 9927, 6.82667e+06
n500x8192-slot-inner, 2048, 61, 3501, 6386, 0, 0, 9948, 6.82667e+06
n500x8192-slot-inner, 2048, 60, 3477, 6399, 0, 0, 9936, 6.82667e+06
n500x8192-slot-inner, 2048, 72, 3462, 6644, 0, 0, 10178, 6.82667e+06
n500x8192-slot-inner, 2048, 61, 3468, 6442, 0, 0, 9971, 6.82667e+06
n500x8192-slot-inner, 2048, 61, 3476, 6439, 0, 0, 9976, 6.82667e+06
n500x8192-slot-inner, 2048, 62, 3461, 6640, 0, 0, 10163, 6.82667e+06
n500x8192-slot-inner, 2048, 61, 3469, 6404, 0, 0, 9934, 6.82667e+06
n500x8192-slot-inner, 2048, 61, 3462, 6444, 0, 0, 9967, 6.82667e+06
n500x8192-slot-inner, 2048, 61, 3463, 6418, 0, 0, 9942, 6.82667e+06
n500x8192-slot-inner, 2048, 61, 3463, 6402, 0, 0, 9926, 6.82667e+06
n500x8192-slot-inner, 2048, 61, 3471, 6438, 0, 0, 9970, 6.82667e+06
n500x8192-slot-inner, 2048, 60, 3460, 6427, 0, 0, 9947, 6.82667e+06
n500x8192-slot-inner, 2048, 61, 3458, 6397, 0, 0, 9916, 6.82667e+06
n500x8192-slot-inner, 2048, 60, 3481, 6411, 0, 0, 9952, 6.82667e+06
n500x8192-slot-inner, 2048, 63, 3458, 6408, 0, 0, 9929, 6.82667e+06
n500x8192-slot-inner, 2048, 62, 3468, 6416, 0, 0, 9946, 6.82667e+06
n500x8192-slot-inner, 2048, 63, 3489, 6429, 0, 0, 9981, 6.82667e+06
n500x8192-slot-inner, 2048, 61, 3479, 6422, 0, 0, 9962, 6.82667e+06
n500x8192-slot-inner, 2048, 60, 3465, 6406, 0, 0, 9931, 6.82667e+06
n500x8192-slot-inner, 2048, 61, 3478, 6412, 0, 0, 9951, 6.82667e+06
n500x8192-slot-inner, 2048, 61, 3468, 6403, 0, 0, 9932, 6.82667e+06
n500x8192-slot-inner, 2048, 61, 3464, 6424, 0, 0, 9949, 6.82667e+06
n500x8192-slot-inner, 2048, 61, 3484, 6394, 0, 0, 9939, 6.82667e+06
n500x8192-slot-inner, 2048, 61, 3465, 6433, 0, 0, 9959, 6.82667e+06
n500x8192-slot-inner, 2048, 61, 3461, 6425, 0, 0, 9947, 6.82667e+06
n500x8192-slot-inner, 2048, 61, 3465, 6403, 0, 0, 9929, 6.82667e+06
n500x8192-slot-inner, 2048, 65, 3475, 6443, 0, 0, 9983, 6.82667e+06
n500x8192-slot-inner, 2048, 66, 3482, 6491, 0, 0, 10039, 6.82667e+06
n500x8192-slot-inner, 2048, 61, 3491, 6458, 0, 0, 10010, 6.82667e+06
n500x8192-slot-inner, 2048, 61, 3458, 6414, 0, 0, 9933, 6.82667e+06
n500x8192-slot-inner, 2048, 62, 3460, 6424, 0, 0, 9946, 6.82667e+06
n500x8192-slot-inner, 2048, 61, 3472, 6460, 0, 0, 9993, 6.82667e+06
n500x8192-slot-inner, 2048, 61, 3465, 6412, 0, 0, 9938, 6.82667e+06
n500x8192-slot-inner, 2048, 61, 3462, 6446, 0, 0, 9969, 6.82667e+06
n500x8192-slot-inner, 2048, 62, 3500, 6438, 0, 0, 10000, 6.82667e+06
n500x8192-slot-inner, 2048, 61, 3472, 6402, 0, 0, 9935, 6.82667e+06
n500x8192-slot-inner, 2048, 60, 3469, 6434, 0, 0, 9963, 6.82667e+06
n500x8192-slot-inner, 2048, 61, 3469, 6403, 0, 0, 9933, 6.82667e+06
n500x8192-slot-inner, 2048, 63, 3478, 6446, 0, 0, 9987, 6.82667e+06
n500x8192-slot-inner, 2048, 61, 3462, 6555, 0, 0, 10078, 6.82667e+06
n500x8192-slot-inner, 2048, 61, 3463, 6601, 0, 0, 10125, 6.82667e+06
n500x8192-slot-inner, 2048, 62, 3473, 6411, 0, 0, 9946, 6.82667e+06
n500x8192-slot-inner, 2048, 60, 3468, 6430, 0, 0, 9958, 6.82667e+06
n500x8192-slot-inner, 2048, 60, 3467, 6419, 0, 0, 9946, 6.82667e+06
n500x8192-slot-inner, 2048, 60, 3464, 6425, 0, 0, 9949, 6.82667e+06
n500x8192-slot-inner, 2048, 61, 3479, 6451, 0, 0, 9991, 6.82667e+06
n500x8192-slot-inner, 2048, 61, 3475, 6425, 0, 0, 9961, 6.82667e+06
n500x8192-slot-inner, 2048, 61, 3474, 6404, 0, 0, 9939, 6.82667e+06
n500x8192-slot-inner, 2048, 61, 3468, 6432, 0, 0, 9961, 6.82667e+06
n500x8192-slot-inner, 2048, 61, 3453, 6396, 0, 0, 9910, 6.82667e+06
n500x8192-slot-inner, 2048, 61, 3458, 6408, 0, 0, 9927, 6.82667e+06
n500x8192-slot-inner, 2048, 61, 3465, 6650, 0, 0, 10176, 6.82667e+06
n500x8192-slot-inner, 2048, 61, 3473, 6412, 0, 0, 9946, 6.82667e+06
n500x8192-slot-inner, 2048, 61, 3473, 6393, 0, 0, 9927, 6.82667e+06
n500x8192-slot-inner, 2048, 61, 3468, 6470, 0, 0, 9999, 6.82667e+06
n500x8192-slot-inner, 2048, 60, 3450, 6438, 0, 0, 9948, 6.82667e+06
n500x8192-slot-inner, 2048, 61, 3462, 6404, 0, 0, 9927, 6.82667e+06
n500x8192-slot-inner, 2048, 62, 3489, 6407, 0, 0, 9958, 6.82667e+06
n500x8192-slot-inner, 2048, 61, 3475, 6415, 0, 0, 9951, 6.82667e+06
n500x8192-slot-inner, 2048, 61, 3449, 6401, 0, 0, 9911, 6.82667e+06
n500x8192-slot-inner, 2048, 61, 3478, 6408, 0, 0, 9947, 6.82667e+06
n500x8192-slot-inner, 2048, 61, 3464, 6420, 0, 0, 9945, 6.82667e+06
n500x8192-slot-inner, 2048, 63, 3470, 6433, 0, 0, 9966, 6.82667e+06
n500x8192-slot-inner, 2048, 61, 3479, 6679, 0, 0, 10219, 6.82667e+06
n500x8192-slot-inner, 2048, 62, 3458, 6678, 0, 0, 10198, 6.82667e+06
n500x8192-slot-inner, 2048, 61, 3457, 6416, 0, 0, 9934, 6.82667e+06
n500x8192-slot-inner, 2048, 69, 3462, 6645, 0, 0, 10176, 6.82667e+06
n500x8192-slot-inner, 2048, 61, 3480, 6428, 0, 0, 9969, 6.82667e+06
n500x8192-slot-inner, 2048, 61, 3454, 6407, 0, 0, 9922, 6.82667e+06
n500x8192-slot-inner, 2048, 61, 3453, 6406, 0, 0, 9920, 6.82667e+06
n500x8192-slot-inner, 2048, 60, 3468, 6417, 0, 0, 9945, 6.82667e+06
n500x8192-slot-inner, 1024, 33, 3472, 6673, 0, 0, 10178, 6.82667e+06
n500x8192-slot-inner, 1024, 33, 3463, 6663, 0, 0, 10159, 6.82667e+06
n500x8192-slot-inner, 1024, 33, 3471, 6660, 0, 0, 10164, 6.82667e+06
n500x8192-slot-inner, 1024, 33, 3464, 6689, 0, 0, 10186, 6.82667e+06
n500x8192-slot-inner, 1024, 33, 3467, 6666, 0, 0, 10166, 6.82667e+06
n500x8192-slot-inner, 1024, 32, 3456, 6678, 0, 0, 10166, 6.82667e+06
n500x8192-slot-inner, 1024, 32, 3458, 6669, 0, 0, 10159, 6.82667e+06
n500x8192-slot-inner, 1024, 34, 3458, 6631, 0, 0, 10123, 6.82667e+06
n500x8192-slot-inner, 1024, 32, 3464, 6652, 0, 0, 10148, 6.82667e+06
n500x8192-slot-inner, 1024, 33, 3464, 6698, 0, 0, 10195, 6.82667e+06
n500x8192-slot-inner, 1024, 32, 3488, 6688, 0, 0, 10208, 6.82667e+06
n500x8192-slot-inner, 1024, 32, 3459, 6634, 0, 0, 10125, 6.82667e+06
n500x8192-slot-inner, 1024, 33, 3471, 6610, 0, 0, 10114, 6.82667e+06
n500x8192-slot-inner, 1024, 33, 3477, 6700, 0, 0, 10210, 6.82667e+06
n500x8192-slot-inner, 1024, 32, 3467, 6642, 0, 0, 10141, 6.82667e+06
n500x8192-slot-inner, 1024, 33, 3487, 6661, 0, 0, 10181, 6.82667e+06
n500x8192-slot-inner, 1024, 33, 3491, 6705, 0, 0, 10229, 6.82667e+06
n500x8192-slot-inner, 1024, 32, 3476, 6659, 0, 0, 10167, 6.82667e+06
n500x8192-slot-inner, 1024, 32, 3476, 6626, 0, 0, 10134, 6.82667e+06
n500x8192-slot-inner, 1024, 34, 3467, 6677, 0, 0, 10178, 6.82667e+06
n500x8192-slot-inner, 1024, 33, 3463, 6654, 0, 0, 10150, 6.82667e+06
n500x8192-slot-inner, 1024, 33, 3463, 6670, 0, 0, 10166, 6.82667e+06
n500x8192-slot-inner, 1024, 32, 3471, 6661, 0, 0, 10164, 6.82667e+06
n500x8192-slot-inner, 1024, 33, 3472, 6676, 0, 0, 10181, 6.82667e+06
n500x8192-slot-inner, 1024, 33, 3475, 6648, 0, 0, 10156, 6.82667e+06
n500x8192-slot-inner, 1024, 33, 3458, 6652, 0, 0, 10143, 6.82667e+06
n500x8192-slot-inner, 1024, 33, 3465, 6710, 0, 0, 10208, 6.82667e+06
n500x8192-slot-inner, 1024, 32, 3466, 6630, 0, 0, 10128, 6.82667e+06
n500x8192-slot-inner, 1024, 32, 3464, 6628, 0, 0, 10124, 6.82667e+06
n500x8192-slot-inner, 1024, 32, 3458, 6644, 0, 0, 10134, 6.82667e+06
n500x8192-slot-inner, 1024, 32, 3461, 6659, 0, 0, 10152, 6.82667e+06
n500x8192-slot-inner, 1024, 35, 3463, 6651, 0, 0, 10149, 6.82667e+06
n500x8192-slot-inner, 1024, 32, 3472, 6881, 0, 0, 10385, 6.82667e+06
n500x8192-slot-inner, 1024, 32, 3459, 6883, 0, 0, 10374, 6.82667e+06
n500x8192-slot-inner, 1024, 33, 3459, 6636, 0, 0, 10128, 6.82667e+06
n500x8192-slot-inner, 1024, 32, 3471, 6655, 0, 0, 10158, 6.82667e+06
n500x8192-slot-inner, 1024, 32, 3461, 6663, 0, 0, 10156, 6.82667e+06
n500x8192-slot-inner, 1024, 32, 3476, 6642, 0, 0, 10150, 6.82667e+06
n500x8192-slot-inner, 1024, 33, 3479, 6669, 0, 0, 10181, 6.82667e+06
n500x8192-slot-inner, 1024, 33, 3465, 6668, 0, 0, 10166, 6.82667e+06
n500x8192-slot-inner, 1024, 32, 3454, 6648, 0, 0, 10134, 6.82667e+06
n500x8192-slot-inner, 1024, 33, 3484, 6659, 0, 0, 10176, 6.82667e+06
n500x8192-slot-inner, 1024, 33, 3468, 6654, 0, 0, 10155, 6.82667e+06
n500x8192-slot-inner, 1024, 33, 3465, 6664, 0, 0, 10162, 6.82667e+06
n500x8192-slot-inner, 1024, 32, 3464, 6666, 0, 0, 10162, 6.82667e+06
n500x8192-slot-inner, 1024, 33, 3463, 6647, 0, 0, 10143, 6.82667e+06
n500x8192-slot-inner, 1024, 33, 3476, 6681, 0, 0, 10190, 6.82667e+06
n500x8192-slot-inner, 1024, 33, 3467, 6652, 0, 0, 10152, 6.82667e+06
n500x8192-slot-inner, 1024, 34, 3468, 6673, 0, 0, 10175, 6.82667e+06
n500x8192-slot-inner, 1024, 32, 3466, 6666, 0, 0, 10164, 6.82667e+06
n500x8192-slot-inner, 1024, 32, 3471, 6650, 0, 0, 10153, 6.82667e+06
n500x8192-slot-inner, 1024, 32, 3468, 6647, 0, 0, 10147, 6.82667e+06
n500x8192-slot-inner, 1024, 32, 3454, 6659, 0, 0, 10145, 6.82667e+06
n500x8192-slot-inner, 1024, 32, 3465, 6646, 0, 0, 10143, 6.82667e+06
n500x8192-slot-inner, 1024, 32, 3467, 6660, 0, 0, 10159, 6.82667e+06
n500x8192-slot-inner, 1024, 32, 3481, 6649, 0, 0, 10162, 6.82667e+06
n500x8192-slot-inner, 1024, 33, 3471, 6655, 0, 0, 10159, 6.82667e+06
n500x8192-slot-inner, 1024, 32, 3457, 6652, 0, 0, 10141, 6.82667e+06
n500x8192-slot-inner, 1024, 32, 3470, 6629, 0, 0, 10131, 6.82667e+06
n500x8192-slot-inner, 1024, 32, 3466, 6646, 0, 0, 10144, 6.82667e+06
n500x8192-slot-inner, 1024, 33, 3466, 6649, 0, 0, 10148, 6.82667e+06
n500x8192-slot-inner, 1024, 34, 3470, 6884, 0, 0, 10388, 6.82667e+06
n500x8192-slot-inner, 1024, 32, 3461, 6671, 0, 0, 10164, 6.82667e+06
n500x8192-slot-inner, 1024, 32, 3446, 6638, 0, 0, 10116, 6.82667e+06
n500x8192-slot-inner, 1024, 33, 3461, 6651, 0, 0, 10145, 6.82667e+06
n500x8192-slot-inner, 1024, 34, 3464, 6674, 0, 0, 10172, 6.82667e+06
n500x8192-slot-inner, 1024, 32, 3449, 6653, 0, 0, 10134, 6.82667e+06
n500x8192-slot-inner, 1024, 32, 3469, 6638, 0, 0, 10139, 6.82667e+06
n500x8192-slot-inner, 1024, 32, 3466, 6646, 0, 0, 10144, 6.82667e+06
n500x8192-slot-inner, 1024, 33, 3473, 6644, 0, 0, 10150, 6.82667e+06
n500x8192-slot-inner, 1024, 33, 3450, 6670, 0, 0, 10153, 6.82667e+06
n500x8192-slot-inner, 1024, 33, 3463, 6638, 0, 0, 10134, 6.82667e+06
n500x8192-slot-inner, 1024, 33, 3470, 6836, 0, 0, 10339, 6.82667e+06
n500x8192-slot-inner, 1024, 32, 3469, 6633, 0, 0, 10134, 6.82667e+06
n500x8192-slot-inner, 1024, 33, 3468, 6662, 0, 0, 10163, 6.82667e+06
n500x8192-slot-inner, 1024, 32, 3457, 6634, 0, 0, 10123, 6.82667e+06
n500x8192-slot-inner, 1024, 32, 3457, 6669, 0, 0, 10158, 6.82667e+06
n500x8192-slot-inner, 1024, 32, 3464, 6631, 0, 0, 10127, 6.82667e+06
n500x8192-slot-inner, 1024, 32, 3475, 6649, 0, 0, 10156, 6.82667e+06
n500x8192-slot-inner, 1024, 32, 3466, 6674, 0, 0, 10172, 6.82667e+06
n500x8192-slot-inner, 1024, 32, 3461, 6663, 0, 0, 10156, 6.82667e+06
n500x8192-slot-inner, 1024, 32, 3463, 6649, 0, 0, 10144, 6.82667e+06
n500x8192-slot-inner, 1024, 32, 3469, 6660, 0, 0, 10161, 6.82667e+06
n500x8192-slot-inner, 1024, 33, 3462, 6657, 0, 0, 10152, 6.82667e+06
n500x8192-slot-inner, 1024, 32, 3468, 6885, 0, 0, 10385, 6.82667e+06
n500x8192-slot-inner, 1024, 34, 3474, 6674, 0, 0, 10182, 6.82667e+06
n500x8192-slot-inner, 1024, 33, 3461, 6658, 0, 0, 10152, 6.82667e+06
n500x8192-slot-inner, 1024, 32, 3454, 6642, 0, 0, 10128, 6.82667e+06
n500x8192-slot-inner, 1024, 32, 3456, 6659, 0, 0, 10147, 6.82667e+06
n500x8192-slot-inner, 1024, 32, 3453, 6750, 0, 0, 10235, 6.82667e+06
n500x8192-slot-inner, 1024, 32, 3475, 6828, 0, 0, 10335, 6.82667e+06
n500x8192-slot-inner, 1024, 32, 3471, 6663, 0, 0, 10166, 6.82667e+06
n500x8192-slot-inner, 1024, 34, 3465, 6659, 0, 0, 10158, 6.82667e+06
n500x8192-slot-inner, 1024, 32, 3467, 6646, 0, 0, 10145, 6.82667e+06
n500x8192-slot-inner, 1024, 32, 3472, 6642, 0, 0, 10146, 6.82667e+06
n500x8192-slot-inner, 1024, 32, 3464, 6660, 0, 0, 10156, 6.82667e+06
n500x8192-slot-inner, 1024, 33, 3482, 6660, 0, 0, 10175, 6.82667e+06
n500x8192-slot-inner, 1024, 32, 3467, 6634, 0, 0, 10133, 6.82667e+06
n500x8192-slot-inner, 1024, 32, 3459, 6637, 0, 0, 10128, 6.82667e+06
n500x8192-slot-inner, 1024, 32, 3459, 6626, 0, 0, 10117, 6.82667e+06
n500x8192-coef-inner, 8192, 30, 10255, 4564, 1, 0, 14850, 6.82667e+06
n500x8192-coef-inner, 8192, 30, 10270, 4179, 0, 0, 14479, 6.82667e+06
n500x8192-coef-inner, 8192, 30, 10889, 5009, 1, 0, 15929, 6.82667e+06
n500x8192-coef-inner, 8192, 30, 10266, 4191, 0, 0, 14487, 6.82667e+06
n500x8192-coef-inner, 8192, 29, 10288, 4203, 0, 0, 14520, 6.82667e+06
n500x8192-coef-inner, 8192, 30, 10245, 4183, 0, 0, 14458, 6.82667e+06
n500x8192-coef-inner, 8192, 30, 10284, 4185, 0, 0, 14499, 6.82667e+06
n500x8192-coef-inner, 8192, 30, 10257, 4180, 0, 0, 14467, 6.82667e+06
n500x8192-coef-inner, 8192, 29, 10257, 4195, 0, 0, 14481, 6.82667e+06
n500x8192-coef-inner, 8192, 29, 10262, 4190, 0, 0, 14481, 6.82667e+06
n500x8192-coef-inner, 8192, 30, 10355, 4200, 0, 0, 14585, 6.82667e+06
n500x8192-coef-inner, 8192, 29, 10280, 4180, 0, 0, 14489, 6.82667e+06
n500x8192-coef-inner, 8192, 30, 10913, 5001, 1, 0, 15945, 6.82667e+06
n500x8192-coef-inner, 8192, 30, 10263, 4187, 0, 0, 14480, 6.82667e+06
n500x8192-coef-inner, 8192, 30, 10258, 4169, 0, 0, 14457, 6.82667e+06
n500x8192-coef-inner, 8192, 30, 10243, 4174, 0, 0, 14447, 6.82667e+06
n500x8192-coef-inner, 8192, 29, 10273, 4192, 0, 0, 14494, 6.82667e+06
n500x8192-coef-inner, 8192, 29, 10273, 4190, 0, 0, 14492, 6.82667e+06
n500x8192-coef-inner, 8192, 29, 10246, 4174, 0, 0, 14449, 6.82667e+06
n500x8192-coef-inner, 8192, 30, 10255, 4181, 0, 0, 14466, 6.82667e+06
n500x8192-coef-inner, 8192, 30, 10257, 4173, 0, 0, 14460, 6.82667e+06
n500x8192-coef-inner, 8192, 29, 10296, 4178, 0, 0, 14503, 6.82667e+06
n500x8192-coef-inner, 8192, 30, 10282, 4196, 0, 0, 14508, 6.82667e+06
n500x8192-coef-inner, 8192, 29, 10255, 4175, 0, 0, 14459, 6.82667e+06
n500x8192-coef-inner, 8192, 29, 10271, 4177, 0, 0, 14477, 6.82667e+06
n500x8192-coef-inner, 8192, 30, 10297, 4171, 0, 0, 14498, 6.82667e+06
n500x8192-coef-inner, 8192, 29, 10261, 4165, 0, 0, 14455, 6.82667e+06
n500x8192-coef-inner, 8192, 30, 10247, 4168, 0, 0, 14445, 6.82667e+06
n500x8192-coef-inner, 8192, 30, 10274, 4169, 0, 0, 14473, 6.82667e+06
n500x8192-coef-inner, 8192, 29, 10287, 4168, 0, 0, 14484, 6.82667e+06
n500x8192-coef-inner, 8192, 30, 10280, 4161, 0, 0, 14471, 6.82667e+06
n500x8192-coef-inner, 8192, 29, 10249, 4174, 0, 0, 14452, 6.82667e+06
n500x8192-coef-inner, 8192, 29, 10260, 4178, 0, 0, 14467, 6.82667e+06
n500x8192-coef-inner, 8192, 29, 10749, 4175, 0, 0, 14953, 6.82667e+06
n500x8192-coef-inner, 8192, 29, 10268, 4154, 0, 0, 14451, 6.82667e+06
n500x8192-coef-inner, 8192, 29, 10253, 4154, 0, 0, 14436, 6.82667e+06
n500x8192-coef-inner, 8192, 30, 10261, 4175, 0, 0, 14466, 6.82667e+06
n500x8192-coef-inner, 8192, 29, 10751, 4986, 1, 0, 15767, 6.82667e+06
n500x8192-coef-inner, 8192, 29, 10275, 4164, 0, 0, 14468, 6.82667e+06
n500x8192-coef-inner, 8192, 30, 10266, 4167, 0, 0, 14463, 6.82667e+06
n500x8192-coef-inner, 8192, 29, 10268, 4186, 0, 0, 14483, 6.82667e+06
n500x8192-coef-inner, 8192, 30, 10269, 4987, 1, 0, 15287, 6.82667e+06
n500x8192-coef-inner, 8192, 29, 10264, 4154, 0, 0, 14447, 6.82667e+06
n500x8192-coef-inner, 8192, 29, 10268, 4162, 0, 0, 14459, 6.82667e+06
n500x8192-coef-inner, 8192, 30, 10256, 4161, 0, 0, 14447, 6.82667e+06
n500x8192-coef-inner, 8192, 29, 10292, 4193, 0, 0, 14514, 6.82667e+06
n500x8192-coef-inner, 8192, 29, 10261, 4175, 0, 0, 14465, 6.82667e+06
n500x8192-coef-inner, 8192, 30, 10274, 4149, 0, 0, 14453, 6.82667e+06
n500x8192-coef-inner, 8192, 29, 10241, 4175, 0, 0, 14445, 6.82667e+06
n500x8192-coef-inner, 8192, 29, 10268, 4181, 0, 0, 14478, 6.82667e+06
n500x8192-coef-inner, 8192, 30, 10253, 4166, 0, 0, 14449, 6.82667e+06
n500x8192-coef-inner, 8192, 29, 10236, 4183, 0, 0, 14448, 6.82667e+06
n500x8192-coef-inner, 8192, 30, 10274, 4176, 0, 0, 14480, 6.82667e+06
n500x8192-coef-inner, 8192, 29, 10292, 4321, 1, 0, 14643, 6.82667e+06
n500x8192-coef-inner, 8192, 29, 10254, 4178, 0, 0, 14461, 6.82667e+06
n500x8192-coef-inner, 8192, 29, 10250, 4174, 0, 0, 14453, 6.82667e+06
n500x8192-coef-inner, 8192, 29, 10280, 4176, 0, 0, 14485, 6.82667e+06
n500x8192-coef-inner, 8192, 29, 10275, 4363, 1, 0, 14668, 6.82667e+06
n500x8192-coef-inner, 8192, 30, 10273, 4155, 0, 0, 14458, 6.82667e+06
n500x8192-coef-inner, 8192, 30, 10248, 4167, 0, 0, 14445, 6.82667e+06
n500x8192-coef-inner, 8192, 29, 10256, 4187, 0, 0, 14472, 6.82667e+06
n500x8192-coef-inner, 8192, 29, 11752, 4379, 0, 0, 16160, 6.82667e+06
n500x8192-coef-inner, 8192, 29, 10540, 4347, 0, 0, 14916, 6.82667e+06
n500x8192-coef-inner, 8192, 30, 10495, 4359, 0, 0, 14884, 6.82667e+06
n500x8192-coef-inner, 8192, 30, 10964, 5115, 1, 0, 16110, 6.82667e+06
n500x8192-coef-inner, 8192, 30, 10887, 5136, 1, 0, 16054, 6.82667e+06
n500x8192-coef-inner, 8192, 29, 10312, 4259, 0, 0, 14600, 6.82667e+06
n500x8192-coef-inner, 8192, 29, 10313, 4251, 1, 0, 14594, 6.82667e+06
n500x8192-coef-inner, 8192, 30, 10339, 4251, 0, 0, 14620, 6.82667e+06
n500x8192-coef-inner, 8192, 29, 10330, 4263, 0, 0, 14622, 6.82667e+06
n500x8192-coef-inner, 8192, 29, 10326, 4296, 0, 0, 14651, 6.82667e+06
n500x8192-coef-inner, 8192, 29, 10327, 4281, 0, 0, 14637, 6.82667e+06
n500x8192-coef-inner, 8192, 29, 10336, 4262, 0, 0, 14627, 6.82667e+06
n500x8192-coef-inner, 8192, 30, 10947, 5109, 1, 0, 16087, 6.82667e+06
n500x8192-coef-inner, 8192, 30, 11062, 5078, 1, 0, 16171, 6.82667e+06
n500x8192-coef-inner, 8192, 30, 10276, 4246, 0, 0, 14552, 6.82667e+06
n500x8192-coef-inner, 8192, 30, 10596, 5072, 1, 0, 15699, 6.82667e+06
n500x8192-coef-inner, 8192, 30, 10399, 4279, 0, 0, 14708, 6.82667e+06
n500x8192-coef-inner, 8192, 30, 10302, 4265, 0, 0, 14597, 6.82667e+06
n500x8192-coef-inner, 8192, 30, 10305, 4266, 0, 0, 14601, 6.82667e+06
n500x8192-coef-inner, 8192, 29, 10337, 4291, 0, 0, 14657, 6.82667e+06
n500x8192-coef-inner, 8192, 30, 10591, 5059, 1, 0, 15681, 6.82667e+06
n500x8192-coef-inner, 8192, 29, 10375, 4257, 0, 0, 14661, 6.82667e+06
n500x8192-coef-inner, 8192, 29, 10326, 4268, 0, 0, 14623, 6.82667e+06
n500x8192-coef-inner, 8192, 30, 10922, 5072, 1, 0, 16025, 6.82667e+06
n500x8192-coef-inner, 8192, 29, 10361, 4245, 0, 0, 14635, 6.82667e+06
n500x8192-coef-inner, 8192, 30, 10432, 4263, 0, 0, 14725, 6.82667e+06
n500x8192-coef-inner, 8192, 30, 10317, 4251, 0, 0, 14598, 6.82667e+06
n500x8192-coef-inner, 8192, 30, 10443, 4312, 0, 0, 14785, 6.82667e+06
n500x8192-coef-inner, 8192, 30, 10434, 4280, 0, 0, 14744, 6.82667e+06
n500x8192-coef-inner, 8192, 29, 10347, 4264, 0, 0, 14640, 6.82667e+06
n500x8192-coef-inner, 8192, 30, 10344, 4243, 0, 0, 14617, 6.82667e+06
n500x8192-coef-inner, 8192, 29, 10314, 4301, 0, 0, 14644, 6.82667e+06
n500x8192-coef-inner, 8192, 29, 10376, 4273, 0, 0, 14678, 6.82667e+06
n500x8192-coef-inner, 8192, 29, 10308, 4270, 0, 0, 14607, 6.82667e+06
n500x8192-coef-inner, 8192, 30, 10463, 4272, 1, 0, 14766, 6.82667e+06
n500x8192-coef-inner, 8192, 29, 10358, 4825, 1, 0, 15213, 6.82667e+06
n500x8192-coef-inner, 8192, 30, 10382, 4262, 0, 0, 14674, 6.82667e+06
n500x8192-coef-inner, 8192, 29, 10340, 4245, 0, 0, 14614, 6.82667e+06
n500x8192-coef-inner, 8192, 29, 10344, 4259, 1, 0, 14633, 6.82667e+06
n500x8192-coef-inner, 4096, 16, 10374, 4226, 0, 0, 14616, 6.82667e+06
n500x8192-coef-inner, 4096, 16, 10368, 4201, 0, 0, 14585, 6.82667e+06
n500x8192-coef-inner, 4096, 16, 10228, 4231, 0, 0, 14475, 6.82667e+06
n500x8192-coef-inner, 4096, 16, 10341, 4219, 0, 0, 14576, 6.82667e+06
n500x8192-coef-inner, 4096, 16, 10184, 4209, 0, 0, 14409, 6.82667e+06
n500x8192-coef-inner, 4096, 16, 10309, 4197, 0, 0, 14522, 6.82667e+06
n500x8192-coef-inner, 4096, 16, 10201, 4212, 0, 0, 14429, 6.82667e+06
n500x8192-coef-inner, 4096, 16, 10205, 4204, 0, 0, 14425, 6.82667e+06
n500x8192-coef-inner, 4096, 16, 10351, 4245, 0, 0, 14612, 6.82667e+06
n500x8192-coef-inner, 4096, 16, 10340, 4201, 0, 0, 14557, 6.82667e+06
n500x8192-coef-inner, 4096, 16, 10210, 4213, 0, 0, 14439, 6.82667e+06
n500x8192-coef-inner, 4096, 17, 10269, 4197, 0, 0, 14483, 6.82667e+06
n500x8192-coef-inner, 4096, 16, 10395, 4256, 0, 0, 14667, 6.82667e+06
n500x8192-coef-inner, 4096, 16, 10322, 4204, 0, 0, 14542, 6.82667e+06
n500x8192-coef-inner, 4096, 16, 10209, 4238, 0, 0, 14463, 6.82667e+06
n500x8192-coef-inner, 4096, 16, 10178, 4176, 0, 0, 14370, 6.82667e+06
n500x8192-coef-inner, 4096, 16, 10285, 4153, 0, 0, 14454, 6.82667e+06
n500x8192-coef-inner, 4096, 16, 10294, 4176, 0, 0, 14486, 6.82667e+06
n500x8192-coef-inner, 4096, 17, 10223, 4181, 0, 0, 14421, 6.82667e+06
n500x8192-coef-inner, 4096, 16, 10247, 4191, 0, 0, 14454, 6.82667e+06
n500x8192-coef-inner, 4096, 16, 10260, 4193, 0, 0, 14469, 6.82667e+06
n500x8192-coef-inner, 4096, 16, 10363, 4213, 0, 0, 14592, 6.82667e+06
n500x8192-coef-inner, 4096, 16, 10344, 4194, 0, 0, 14554, 6.82667e+06
n500x8192-coef-inner, 4096, 16, 10293, 4172, 0, 0, 14481, 6.82667e+06
n500x8192-coef-inner, 4096, 16, 10214, 4188, 0, 0, 14418, 6.82667e+06
n500x8192-coef-inner, 4096, 17, 10265, 4732, 0, 0, 15014, 6.82667e+06
n500x8192-coef-inner, 4096, 16, 10249, 4183, 0, 0, 14448, 6.82667e+06
n500x8192-coef-inner, 4096, 16, 10271, 4220, 0, 0, 14507, 6.82667e+06
n500x8192-coef-inner, 4096, 16, 10253, 4188, 0, 0, 14457, 6.82667e+06
n500x8192-coef-inner, 4096, 17, 10337, 4891, 0, 0, 15245, 6.82667e+06
n500x8192-coef-inner, 4096, 16, 10206, 4212, 0, 0, 14434, 6.82667e+06
n500x8192-coef-inner, 4096, 16, 10203, 4177, 0, 0, 14396, 6.82667e+06
n500x8192-coef-inner, 4096, 16, 10212, 4186, 0, 0, 14414, 6.82667e+06
n500x8192-coef-inner, 4096, 16, 10428, 4213, 0, 0, 14657, 6.82667e+06
n500x8192-coef-inner, 4096, 16, 10297, 4216, 0, 0, 14529, 6.82667e+06
n500x8192-coef-inner, 4096, 16, 10361, 4220, 0, 0, 14597, 6.82667e+06
n500x8192-coef-inner, 4096, 16, 10223, 4181, 0, 0, 14420, 6.82667e+06
n500x8192-coef-inner, 4096, 16, 10255, 4553, 0, 0, 14824, 6.82667e+06
n500x8192-coef-inner, 4096, 16, 11854, 4240, 0, 0, 16110, 6.82667e+06
n500x8192-coef-inner, 4096, 17, 10722, 4809, 0, 0, 15548, 6.82667e+06
n500x8192-coef-inner, 4096, 16, 12357, 5083, 0, 0, 17456, 6.82667e+06
n500x8192-coef-inner, 4096, 16, 10768, 4153, 0, 0, 14937, 6.82667e+06
n500x8192-coef-inner, 4096, 16, 10161, 4121, 0, 0, 14298, 6.82667e+06
n500x8192-coef-inner, 4096, 16, 10188, 4135, 0, 0, 14339, 6.82667e+06
n500x8192-coef-inner, 4096, 16, 10139, 4129, 0, 0, 14284, 6.82667e+06
n500x8192-coef-inner, 4096, 16, 10150, 4101, 0, 0, 14267, 6.82667e+06
n500x8192-coef-inner, 4096, 16, 10133, 4111, 0, 0, 14260, 6.82667e+06
n500x8192-coef-inner, 4096, 16, 10161, 4085, 0, 0, 14262, 6.82667e+06
n500x8192-coef-inner, 4096, 16, 10152, 4098, 0, 0, 14266, 6.82667e+06
n500x8192-coef-inner, 4096, 16, 10183, 4100, 0, 0, 14299, 6.82667e+06
n500x8192-coef-inner, 4096, 16, 10136, 4095, 0, 0, 14247, 6.82667e+06
n500x8192-coef-inner, 4096, 17, 10201, 4112, 0, 0, 14330, 6.82667e+06
n500x8192-coef-inner, 4096, 16, 10148, 4088, 0, 0, 14252, 6.82667e+06
n500x8192-coef-inner, 4096, 16, 10173, 4100, 0, 0, 14289, 6.82667e+06
n500x8192-coef-inner, 4096, 16, 10132, 4090, 0, 0, 14238, 6.82667e+06
n500x8192-coef-inner, 4096, 16, 10160, 4091, 0, 0, 14267, 6.82667e+06
n500x8192-coef-inner, 4096, 16, 10163, 4086, 0, 0, 14265, 6.82667e+06
n500x8192-coef-inner, 4096, 16, 10496, 4833, 0, 0, 15345, 6.82667e+06
n500x8192-coef-inner, 4096, 17, 10150, 4109, 0, 0, 14276, 6.82667e+06
n500x8192-coef-inner, 4096, 16, 10155, 4090, 0, 0, 14261, 6.82667e+06
n500x8192-coef-inner, 4096, 16, 10155, 4099, 0, 0, 14270, 6.82667e+06
n500x8192-coef-inner, 4096, 16, 10177, 4107, 0, 0, 14300, 6.82667e+06
n500x8192-coef-inner, 4096, 17, 10178, 4109, 0, 0, 14304, 6.82667e+06
n500x8192-coef-inner, 4096, 16, 10164, 4084, 0, 0, 14264, 6.82667e+06
n500x8192-coef-inner, 4096, 16, 10155, 4098, 0, 0, 14269, 6.82667e+06
n500x8192-coef-inner, 4096, 16, 10246, 4095, 0, 0, 14357, 6.82667e+06
n500x8192-coef-inner, 4096, 17, 10135, 4101, 0, 0, 14253, 6.82667e+06
n500x8192-coef-inner, 4096, 16, 10153, 4090, 0, 0, 14259, 6.82667e+06
n500x8192-coef-inner, 4096, 16, 10148, 4113, 0, 0, 14277, 6.82667e+06
n500x8192-coef-inner, 4096, 16, 10152, 4100, 0, 0, 14268, 6.82667e+06
n500x8192-coef-inner, 4096, 16, 10662, 4855, 0, 0, 15533, 6.82667e+06
n500x8192-coef-inner, 4096, 16, 10143, 4105, 0, 0, 14264, 6.82667e+06
n500x8192-coef-inner, 4096, 16, 10141, 4097, 0, 0, 14254, 6.82667e+06
n500x8192-coef-inner, 4096, 16, 10174, 4087, 0, 0, 14277, 6.82667e+06
n500x8192-coef-inner, 4096, 16, 10140, 4089, 0, 0, 14245, 6.82667e+06
n500x8192-coef-inner, 4096, 16, 10165, 4089, 0, 0, 14270, 6.82667e+06
n500x8192-coef-inner, 4096, 16, 10144, 4081, 0, 0, 14241, 6.82667e+06
n500x8192-coef-inner, 4096, 16, 10144, 4112, 0, 0, 14272, 6.82667e+06
n500x8192-coef-inner, 4096, 16, 10142, 4085, 0, 0, 14243, 6.82667e+06
n500x8192-coef-inner, 4096, 16, 10133, 4097, 0, 0, 14246, 6.82667e+06
n500x8192-coef-inner, 4096, 16, 10143, 4095, 0, 0, 14254, 6.82667e+06
n500x8192-coef-inner, 4096, 16, 10140, 4099, 0, 0, 14255, 6.82667e+06
n500x8192-coef-inner, 4096, 16, 10160, 4118, 0, 0, 14294, 6.82667e+06
n500x8192-coef-inner, 4096, 16, 10140, 4100, 0, 0, 14256, 6.82667e+06
n500x8192-coef-inner, 4096, 16, 10144, 4099, 0, 0, 14259, 6.82667e+06
n500x8192-coef-inner, 4096, 16, 10134, 4108, 0, 0, 14258, 6.82667e+06
n500x8192-coef-inner, 4096, 16, 10148, 4095, 0, 0, 14259, 6.82667e+06
n500x8192-coef-inner, 4096, 16, 10198, 4100, 0, 0, 14314, 6.82667e+06
n500x8192-coef-inner, 4096, 16, 10139, 4104, 0, 0, 14259, 6.82667e+06
n500x8192-coef-inner, 4096, 16, 10153, 4106, 0, 0, 14275, 6.82667e+06
n500x8192-coef-inner, 4096, 17, 10154, 4078, 0, 0, 14249, 6.82667e+06
n500x8192-coef-inner, 4096, 16, 10148, 4111, 0, 0, 14275, 6.82667e+06
n500x8192-coef-inner, 4096, 16, 10159, 4089, 0, 0, 14264, 6.82667e+06
n500x8192-coef-inner, 4096, 16, 10242, 4083, 0, 0, 14341, 6.82667e+06
n500x8192-coef-inner, 4096, 16, 10169, 4498, 0, 0, 14683, 6.82667e+06
n500x8192-coef-inner, 4096, 16, 10150, 4111, 0, 0, 14277, 6.82667e+06
n500x8192-coef-inner, 4096, 17, 10152, 4088, 0, 0, 14257, 6.82667e+06
n500x8192-coef-inner, 4096, 16, 10154, 4075, 0, 0, 14245, 6.82667e+06
n500x8192-coef-inner, 4096, 16, 10482, 4849, 0, 0, 15347, 6.82667e+06
n500x8192-coef-inner, 4096, 16, 10149, 4092, 0, 0, 14257, 6.82667e+06
n500x8192-coef-inner, 2048, 10, 11687, 5600, 0, 0, 17297, 6.82667e+06
n500x8192-coef-inner, 2048, 10, 10569, 4191, 0, 0, 14770, 6.82667e+06
n500x8192-coef-inner, 2048, 10, 10180, 4782, 0, 0, 14972, 6.82667e+06
n500x8192-coef-inner, 2048, 10, 10173, 4162, 0, 0, 14345, 6.82667e+06
n500x8192-coef-inner, 2048, 10, 10147, 4133, 0, 0, 14290, 6.82667e+06
n500x8192-coef-inner, 2048, 10, 10159, 4145, 0, 0, 14314, 6.82667e+06
n500x8192-coef-inner, 2048, 10, 10189, 4150, 0, 0, 14349, 6.82667e+06
n500x8192-coef-inner, 2048, 10, 10133, 4130, 0, 0, 14273, 6.82667e+06
n500x8192-coef-inner, 2048, 10, 10151, 4129, 0, 0, 14290, 6.82667e+06
n500x8192-coef-inner, 2048, 10, 10177, 4146, 0, 0, 14333, 6.82667e+06
n500x8192-coef-inner, 2048, 10, 10469, 4811, 0, 0, 15290, 6.82667e+06
n500x8192-coef-inner, 2048, 10, 10146, 4154, 0, 0, 14310, 6.82667e+06
n500x8192-coef-inner, 2048, 10, 10187, 4181, 0, 0, 14378, 6.82667e+06
n500x8192-coef-inner, 2048, 10, 10156, 4148, 0, 0, 14314, 6.82667e+06
n500x8192-coef-inner, 2048, 10, 10164, 4140, 0, 0, 14314, 6.82667e+06
n500x8192-coef-inner, 2048, 10, 10660, 4804, 0, 0, 15474, 6.82667e+06
n500x8192-coef-inner, 2048, 10, 10142, 4154, 0, 0, 14306, 6.82667e+06
n500x8192-coef-inner, 2048, 10, 10162, 4146, 0, 0, 14318, 6.82667e+06
n500x8192-coef-inner, 2048, 10, 10140, 4144, 0, 0, 14294, 6.82667e+06
n500x8192-coef-inner, 2048, 10, 10099, 4136, 0, 0, 14245, 6.82667e+06
n500x8192-coef-inner, 2048, 10, 10155, 4145, 0, 0, 14310, 6.82667e+06
n500x8192-coef-inner, 2048, 10, 10161, 4142, 0, 0, 14313, 6.82667e+06
n500x8192-coef-inner, 2048, 10, 10158, 4149, 0, 0, 14317, 6.82667e+06
n500x8192-coef-inner, 2048, 10, 10152, 4147, 0, 0, 14309, 6.82667e+06
n500x8192-coef-inner, 2048, 10, 10147, 4124, 0, 0, 14281, 6.82667e+06
n500x8192-coef-inner, 2048, 10, 10136, 4162, 0, 0, 14308, 6.82667e+06
n500x8192-coef-inner, 2048, 10, 10160, 4144, 0, 0, 14314, 6.82667e+06
n500x8192-coef-inner, 2048, 10, 10166, 4147, 0, 0, 14323, 6.82667e+06
n500x8192-coef-inner, 2048, 10, 10127, 4138, 0, 0, 14275, 6.82667e+06
n500x8192-coef-inner, 2048, 10, 10151, 4166, 0, 0, 14327, 6.82667e+06
n500x8192-coef-inner, 2048, 10, 10160, 4135, 0, 0, 14305, 6.82667e+06
n500x8192-coef-inner, 2048, 10, 10162, 4146, 0, 0, 14318, 6.82667e+06
n500x8192-coef-inner, 2048, 10, 10150, 4128, 0, 0, 14288, 6.82667e+06
n500x8192-coef-inner, 2048, 10, 10137, 4151, 0, 0, 14298, 6.82667e+06
n500x8192-coef-inner, 2048, 10, 10160, 4168, 0, 0, 14338, 6.82667e+06
n500x8192-coef-inner, 2048, 10, 10154, 4143, 0, 0, 14307, 6.82667e+06
n500x8192-coef-inner, 2048, 10, 10127, 4142, 0, 0, 14279, 6.82667e+06
n500x8192-coef-inner, 2048, 10, 10120, 4143, 0, 0, 14273, 6.82667e+06
n500x8192-coef-inner, 2048, 10, 10137, 4164, 0, 0, 14311, 6.82667e+06
n500x8192-coef-inner, 2048, 10, 10178, 4144, 0, 0, 14332, 6.82667e+06
n500x8192-coef-inner, 2048, 10, 10157, 4146, 0, 0, 14313, 6.82667e+06
n500x8192-coef-inner, 2048, 10, 10127, 4143, 0, 0, 14280, 6.82667e+06
n500x8192-coef-inner, 2048, 10, 10165, 4129, 0, 0, 14304, 6.82667e+06
n500x8192-coef-inner, 2048, 10, 10670, 4808, 0, 0, 15488, 6.82667e+06
n500x8192-coef-inner, 2048, 10, 10136, 4162, 0, 0, 14308, 6.82667e+06
n500x8192-coef-inner, 2048, 10, 10142, 4126, 0, 0, 14278, 6.82667e+06
n500x8192-coef-inner, 2048, 10, 10162, 4141, 0, 0, 14313, 6.82667e+06
n500x8192-coef-inner, 2048, 10, 10166, 4132, 0, 0, 14308, 6.82667e+06
n500x8192-coef-inner, 2048, 10, 10164, 4147, 0, 0, 14321, 6.82667e+06
n500x8192-coef-inner, 2048, 10, 10138, 4154, 0, 0, 14302, 6.82667e+06
n500x8192-coef-inner, 2048, 10, 10124, 4142, 0, 0, 14276, 6.82667e+06
n500x8192-coef-inner, 2048, 10, 10189, 4132, 0, 0, 14331, 6.82667e+06
n500x8192-coef-inner, 2048, 10, 11853, 4962, 0, 0, 16825, 6.82667e+06
n500x8192-coef-inner, 2048, 10, 10611, 4995, 0, 0, 15616, 6.82667e+06
n500x8192-coef-inner, 2048, 10, 10605, 5007, 0, 0, 15622, 6.82667e+06
n500x8192-coef-inner, 2048, 10, 10455, 4318, 0, 0, 14783, 6.82667e+06
n500x8192-coef-inner, 2048, 10, 10497, 4691, 0, 0, 15198, 6.82667e+06
n500x8192-coef-inner, 2048, 10, 10297, 4313, 0, 0, 14620, 6.82667e+06
n500x8192-coef-inner, 2048, 10, 10456, 4320, 0, 0, 14786, 6.82667e+06
n500x8192-coef-inner, 2048, 10, 10347, 4904, 0, 0, 15261, 6.82667e+06
n500x8192-coef-inner, 2048, 10, 10178, 4158, 0, 0, 14346, 6.82667e+06
n500x8192-coef-inner, 2048, 10, 10141, 4146, 0, 0, 14297, 6.82667e+06
n500x8192-coef-inner, 2048, 10, 10171, 4332, 0, 0, 14513, 6.82667e+06
n500x8192-coef-inner, 2048, 10, 10136, 4148, 0, 0, 14294, 6.82667e+06
n500x8192-coef-inner, 2048, 10, 10143, 4154, 0, 0, 14307, 6.82667e+06
n500x8192-coef-inner, 2048, 10, 10189, 4126, 0, 0, 14325, 6.82667e+06
n500x8192-coef-inner, 2048, 10, 10134, 4133, 0, 0, 14277, 6.82667e+06
n500x8192-coef-inner, 2048, 11, 10139, 4123, 0, 0, 14273, 6.82667e+06
n500x8192-coef-inner, 2048, 10, 10158, 4136, 0, 0, 14304, 6.82667e+06
n500x8192-coef-inner, 2048, 10, 10232, 4139, 0, 0, 14381, 6.82667e+06
n500x8192-coef-inner, 2048, 10, 10178, 4142, 0, 0, 14330, 6.82667e+06
n500x8192-coef-inner, 2048, 10, 10169, 4137, 0, 0, 14316, 6.82667e+06
n500x8192-coef-inner, 2048, 10, 10159, 4144, 0, 0, 14313, 6.82667e+06
n500x8192-coef-inner, 2048, 10, 10144, 4127, 0, 0, 14281, 6.82667e+06
n500x8192-coef-inner, 2048, 10, 10466, 4827, 0, 0, 15303, 6.82667e+06
n500x8192-coef-inner, 2048, 10, 10629, 4827, 0, 0, 15466, 6.82667e+06
n500x8192-coef-inner, 2048, 10, 10152, 4139, 0, 0, 14301, 6.82667e+06
n500x8192-coef-inner, 2048, 10, 10147, 4138, 0, 0, 14295, 6.82667e+06
n500x8192-coef-inner, 2048, 10, 10151, 4147, 0, 0, 14308, 6.82667e+06
n500x8192-coef-inner, 2048, 10, 10153, 4150, 0, 0, 14313, 6.82667e+06
n500x8192-coef-inner, 2048, 10, 10128, 4161, 0, 0, 14299, 6.82667e+06
n500x8192-coef-inner, 2048, 10, 10164, 4150, 0, 0, 14324, 6.82667e+06
n500x8192-coef-inner, 2048, 10, 10148, 4138, 0, 0, 14296, 6.82667e+06
n500x8192-coef-inner, 2048, 10, 10167, 4163, 0, 0, 14340, 6.82667e+06
n500x8192-coef-inner, 2048, 10, 10232, 4164, 0, 0, 14406, 6.82667e+06
n500x8192-coef-inner, 2048, 10, 10149, 4133, 0, 0, 14292, 6.82667e+06
n500x8192-coef-inner, 2048, 10, 10139, 4159, 0, 0, 14308, 6.82667e+06
n500x8192-coef-inner, 2048, 10, 10416, 4842, 0, 0, 15268, 6.82667e+06
n500x8192-coef-inner, 2048, 10, 10153, 4154, 0, 0, 14317, 6.82667e+06
n500x8192-coef-inner, 2048, 10, 10154, 4153, 0, 0, 14317, 6.82667e+06
n500x8192-coef-inner, 2048, 10, 10131, 4163, 0, 0, 14304, 6.82667e+06
n500x8192-coef-inner, 2048, 10, 10145, 4154, 0, 0, 14309, 6.82667e+06
n500x8192-coef-inner, 2048, 10, 10177, 4128, 0, 0, 14315, 6.82667e+06
n500x8192-coef-inner, 2048, 10, 10157, 4129, 0, 0, 14296, 6.82667e+06
n500x8192-coef-inner, 2048, 10, 10149, 4138, 0, 0, 14297, 6.82667e+06
n500x8192-coef-inner, 2048, 10, 10145, 4143, 0, 0, 14298, 6.82667e+06
n500x8192-coef-inner, 2048, 10, 10176, 4144, 0, 0, 14330, 6.82667e+06
n500x8192-coef-inner, 2048, 10, 10159, 4145, 0, 0, 14314, 6.82667e+06
n500x8192-coef-inner, 2048, 10, 10136, 4139, 0, 0, 14285, 6.82667e+06
n500x8192-coef-inner, 2048, 10, 10207, 4804, 0, 0, 15021, 6.82667e+06
n500x8192-coef-inner, 1024, 12, 13177, 6916, 0, 0, 20105, 6.82667e+06
n500x8192-coef-inner, 1024, 12, 13136, 6706, 0, 0, 19854, 6.82667e+06
n500x8192-coef-inner, 1024, 12, 13140, 6747, 0, 0, 19899, 6.82667e+06
n500x8192-coef-inner, 1024, 15, 13134, 6916, 0, 0, 20065, 6.82667e+06
n500x8192-coef-inner, 1024, 12, 13130, 6690, 0, 0, 19832, 6.82667e+06
n500x8192-coef-inner, 1024, 12, 13161, 6680, 0, 0, 19853, 6.82667e+06
n500x8192-coef-inner, 1024, 12, 13198, 6756, 0, 0, 19966, 6.82667e+06
n500x8192-coef-inner, 1024, 12, 13143, 6700, 0, 0, 19855, 6.82667e+06
n500x8192-coef-inner, 1024, 11, 13225, 6954, 0, 0, 20190, 6.82667e+06
n500x8192-coef-inner, 1024, 12, 13200, 6686, 0, 0, 19898, 6.82667e+06
n500x8192-coef-inner, 1024, 11, 13139, 6707, 0, 0, 19857, 6.82667e+06
n500x8192-coef-inner, 1024, 12, 13232, 6673, 0, 0, 19917, 6.82667e+06
n500x8192-coef-inner, 1024, 13, 13173, 6937, 0, 0, 20123, 6.82667e+06
n500x8192-coef-inner, 1024, 12, 13159, 6704, 0, 0, 19875, 6.82667e+06
n500x8192-coef-inner, 1024, 12, 13185, 6733, 0, 0, 19930, 6.82667e+06
n500x8192-coef-inner, 1024, 11, 13174, 6685, 0, 0, 19870, 6.82667e+06
n500x8192-coef-inner, 1024, 12, 13216, 6698, 0, 0, 19926, 6.82667e+06
n500x8192-coef-inner, 1024, 12, 13196, 6707, 0, 0, 19915, 6.82667e+06
n500x8192-coef-inner, 1024, 13, 13149, 6708, 0, 0, 19870, 6.82667e+06
n500x8192-coef-inner, 1024, 12, 13130, 6696, 0, 0, 19838, 6.82667e+06
n500x8192-coef-inner, 1024, 12, 13209, 6936, 0, 0, 20157, 6.82667e+06
n500x8192-coef-inner, 1024, 12, 13166, 6685, 0, 0, 19863, 6.82667e+06
n500x8192-coef-inner, 1024, 13, 13129, 6692, 0, 0, 19834, 6.82667e+06
n500x8192-coef-inner, 1024, 12, 13170, 6710, 0, 0, 19892, 6.82667e+06
n500x8192-coef-inner, 1024, 12, 13184, 6722, 0, 0, 19918, 6.82667e+06
n500x8192-coef-inner, 1024, 12, 13167, 6685, 0, 0, 19864, 6.82667e+06
n500x8192-coef-inner, 1024, 12, 13179, 6727, 0, 0, 19918, 6.82667e+06
n500x8192-coef-inner, 1024, 11, 13144, 6721, 0, 0, 19876, 6.82667e+06
n500x8192-coef-inner, 1024, 12, 13224, 6685, 0, 0, 19921, 6.82667e+06
n500x8192-coef-inner, 1024, 11, 13156, 6704, 0, 0, 19871, 6.82667e+06
n500x8192-coef-inner, 1024, 12, 13154, 6692, 0, 0, 19858, 6.82667e+06
n500x8192-coef-inner, 1024, 12, 13152, 6723, 0, 0, 19887, 6.82667e+06
n500x8192-coef-inner, 1024, 12, 13192, 6932, 0, 0, 20136, 6.82667e+06
n500x8192-coef-inner, 1024, 12, 13170, 6711, 0, 0, 19893, 6.82667e+06
n500x8192-coef-inner, 1024, 11, 13166, 6688, 0, 0, 19865, 6.82667e+06
n500x8192-coef-inner, 1024, 12, 13227, 6692, 0, 0, 19931, 6.82667e+06
n500x8192-coef-inner, 1024, 12, 13150, 6684, 0, 0, 19846, 6.82667e+06
n500x8192-coef-inner, 1024, 12, 13169, 6701, 0, 0, 19882, 6.82667e+06
n500x8192-coef-inner, 1024, 12, 13178, 6931, 0, 0, 20121, 6.82667e+06
n500x8192-coef-inner, 1024, 12, 13186, 6685, 0, 0, 19883, 6.82667e+06
n500x8192-coef-inner, 1024, 13, 13217, 6683, 0, 0, 19913, 6.82667e+06
n500x8192-coef-inner, 1024, 12, 13186, 6706, 0, 0, 19904, 6.82667e+06
n500x8192-coef-inner, 1024, 13, 13144, 6701, 0, 0, 19858, 6.82667e+06
n500x8192-coef-inner, 1024, 11, 13203, 6701, 0, 0, 19915, 6.82667e+06
n500x8192-coef-inner, 1024, 12, 13188, 6700, 0, 0, 19900, 6.82667e+06
n500x8192-coef-inner, 1024, 13, 13117, 6688, 0, 0, 19818, 6.82667e+06
n500x8192-coef-inner, 1024, 12, 13233, 6713, 0, 0, 19958, 6.82667e+06
n500x8192-coef-inner, 1024, 12, 13198, 6719, 0, 0, 19929, 6.82667e+06
n500x8192-coef-inner, 1024, 12, 13177, 6701, 0, 0, 19890, 6.82667e+06
n500x8192-coef-inner, 1024, 12, 13175, 6698, 0, 0, 19885, 6.82667e+06
n500x8192-coef-inner, 1024, 15, 20202, 6727, 0, 0, 26944, 6.82667e+06
n500x8192-coef-inner, 1024, 12, 13233, 6715, 0, 0, 19960, 6.82667e+06
n500x8192-coef-inner, 1024, 12, 13171, 6743, 0, 0, 19926, 6.82667e+06
n500x8192-coef-inner, 1024, 12, 13211, 6706, 0, 0, 19929, 6.82667e+06
n500x8192-coef-inner, 1024, 12, 13210, 6710, 0, 0, 19932, 6.82667e+06
n500x8192-coef-inner, 1024, 12, 13216, 6753, 0, 0, 19981, 6.82667e+06
n500x8192-coef-inner, 1024, 13, 13190, 6700, 0, 0, 19903, 6.82667e+06
n500x8192-coef-inner, 1024, 12, 13241, 6701, 0, 0, 19954, 6.82667e+06
n500x8192-coef-inner, 1024, 13, 13232, 6940, 0, 0, 20185, 6.82667e+06
n500x8192-coef-inner, 1024, 12, 13202, 6935, 0, 0, 20149, 6.82667e+06
n500x8192-coef-inner, 1024, 13, 13208, 6713, 0, 0, 19934, 6.82667e+06
n500x8192-coef-inner, 1024, 12, 13213, 6736, 0, 0, 19961, 6.82667e+06
n500x8192-coef-inner, 1024, 12, 13205, 6703, 0, 0, 19920, 6.82667e+06
n500x8192-coef-inner, 1024, 12, 13180, 6901, 0, 0, 20093, 6.82667e+06
n500x8192-coef-inner, 1024, 12, 13218, 6666, 0, 0, 19896, 6.82667e+06
n500x8192-coef-inner, 1024, 12, 13216, 6700, 0, 0, 19928, 6.82667e+06
n500x8192-coef-inner, 1024, 12, 13231, 6693, 0, 0, 19936, 6.82667e+06
n500x8192-coef-inner, 1024, 12, 13235, 6693, 0, 0, 19940, 6.82667e+06
n500x8192-coef-inner, 1024, 12, 13195, 6712, 0, 0, 19919, 6.82667e+06
n500x8192-coef-inner, 1024, 13, 13270, 6680, 0, 0, 19963, 6.82667e+06
n500x8192-coef-inner, 1024, 12, 13267, 6948, 0, 0, 20227, 6.82667e+06
n500x8192-coef-inner, 1024, 12, 13225, 6687, 0, 0, 19924, 6.82667e+06
n500x8192-coef-inner, 1024, 12, 13182, 6726, 0, 0, 19920, 6.82667e+06
n500x8192-coef-inner, 1024, 12, 13223, 6795, 0, 0, 20030, 6.82667e+06
n500x8192-coef-inner, 1024, 12, 13213, 6717, 0, 0, 19942, 6.82667e+06
n500x8192-coef-inner, 1024, 12, 13188, 6707, 0, 0, 19907, 6.82667e+06
n500x8192-coef-inner, 1024, 12, 13210, 6708, 0, 0, 19930, 6.82667e+06
n500x8192-coef-inner, 1024, 13, 13197, 6714, 0, 0, 19924, 6.82667e+06
n500x8192-coef-inner, 1024, 12, 13198, 6724, 0, 0, 19934, 6.82667e+06
n500x8192-coef-inner, 1024, 12, 13215, 6712, 0, 0, 19939, 6.82667e+06
n500x8192-coef-inner, 1024, 12, 13200, 6697, 0, 0, 19909, 6.82667e+06
n500x8192-coef-inner, 1024, 12, 13178, 6686, 0, 0, 19876, 6.82667e+06
n500x8192-coef-inner, 1024, 12, 13226, 6688, 0, 0, 19926, 6.82667e+06
n500x8192-coef-inner, 1024, 12, 13185, 6726, 0, 0, 19923, 6.82667e+06
n500x8192-coef-inner, 1024, 13, 13207, 6697, 0, 0, 19917, 6.82667e+06
n500x8192-coef-inner, 1024, 12, 13227, 6989, 0, 0, 20228, 6.82667e+06
n500x8192-coef-inner, 1024, 12, 13198, 6725, 0, 0, 19935, 6.82667e+06
n500x8192-coef-inner, 1024, 13, 13220, 6711, 0, 0, 19944, 6.82667e+06
n500x8192-coef-inner, 1024, 12, 13195, 6795, 0, 0, 20002, 6.82667e+06
n500x8192-coef-inner, 1024, 12, 13249, 6734, 0, 0, 19995, 6.82667e+06
n500x8192-coef-inner, 1024, 12, 13181, 6703, 0, 0, 19896, 6.82667e+06
n500x8192-coef-inner, 1024, 12, 13239, 6736, 0, 0, 19987, 6.82667e+06
n500x8192-coef-inner, 1024, 12, 13197, 6703, 0, 0, 19912, 6.82667e+06
n500x8192-coef-inner, 1024, 11, 13199, 6696, 0, 0, 19906, 6.82667e+06
n500x8192-coef-inner, 1024, 11, 13281, 6726, 0, 0, 20018, 6.82667e+06
n500x8192-coef-inner, 1024, 12, 13196, 6735, 0, 0, 19943, 6.82667e+06
n500x8192-coef-inner, 1024, 12, 13199, 6705, 0, 0, 19916, 6.82667e+06
n500x8192-coef-inner, 1024, 11, 13178, 6729, 0, 0, 19918, 6.82667e+06
n500x8192-coef-inner, 1024, 12, 13238, 6735, 0, 0, 19985, 6.82667e+06
n500x8192-coef-inner, 1024, 12, 13203, 6710, 0, 0, 19925, 6.82667e+06
n1000x8192-coef-sum, 8192, 34, 10229, 254, 0, 0, 10517, 1
n1000x8192-coef-sum, 8192, 34, 10226, 250, 0, 0, 10510, 1
n1000x8192-coef-sum, 8192, 35, 10261, 257, 0, 0, 10553, 1
n1000x8192-coef-sum, 8192, 34, 10224, 248, 0, 0, 10506, 1
n1000x8192-coef-sum, 8192, 35, 10234, 255, 0, 0, 10524, 1
n1000x8192-coef-sum, 8192, 34, 10746, 252, 0, 0, 11032, 1
n1000x8192-coef-sum, 8192, 35, 10258, 252, 0, 0, 10545, 1
n1000x8192-coef-sum, 8192, 34, 10254, 248, 0, 0, 10536, 1
n1000x8192-coef-sum, 8192, 34, 10233, 253, 0, 0, 10520, 1
n1000x8192-coef-sum, 8192, 34, 10229, 248, 0, 0, 10511, 1
n1000x8192-coef-sum, 8192, 34, 10226, 244, 0, 0, 10504, 1
n1000x8192-coef-sum, 8192, 34, 10223, 248, 0, 0, 10505, 1
n1000x8192-coef-sum, 8192, 34, 10216, 249, 0, 0, 10499, 1
n1000x8192-coef-sum, 8192, 35, 10228, 249, 0, 0, 10512, 1
n1000x8192-coef-sum, 8192, 35, 10215, 250, 0, 0, 10500, 1
n1000x8192-coef-sum, 8192, 35, 10243, 247, 0, 0, 10525, 1
n1000x8192-coef-sum, 8192, 35, 10234, 249, 0, 0, 10518, 1
n1000x8192-coef-sum, 8192, 34, 10251, 246, 0, 0, 10531, 1
n1000x8192-coef-sum, 8192, 34, 10237, 247, 0, 0, 10518, 1
n1000x8192-coef-sum, 8192, 35, 10236, 248, 0, 0, 10519, 1
n1000x8192-coef-sum, 8192, 35, 10231, 249, 0, 0, 10515, 1
n1000x8192-coef-sum, 8192, 35, 10232, 247, 0, 0, 10514, 1
n1000x8192-coef-sum, 8192, 34, 10250, 248, 0, 0, 10532, 1
n1000x8192-coef-sum, 8192, 35, 10211, 250, 0, 0, 10496, 1
n1000x8192-coef-sum, 8192, 35, 10240, 249, 0, 0, 10524, 1
n1000x8192-coef-sum, 8192, 35, 10223, 248, 0, 0, 10506, 1
n1000x8192-coef-sum, 8192, 34, 10265, 248, 0, 0, 10547, 1
n1000x8192-coef-sum, 8192, 34, 10232, 250, 0, 0, 10516, 1
n1000x8192-coef-sum, 8192, 34, 10235, 249, 0, 0, 10518, 1
n1000x8192-coef-sum, 8192, 34, 10238, 252, 0, 0, 10524, 1
n1000x8192-coef-sum, 8192, 35, 10235, 248, 0, 0, 10518, 1
n1000x8192-coef-sum, 8192, 35, 10225, 249, 0, 0, 10509, 1
n1000x8192-coef-sum, 8192, 34, 10260, 245, 0, 0, 10539, 1
n1000x8192-coef-sum, 8192, 35, 10232, 248, 0, 0, 10515, 1
n1000x8192-coef-sum, 8192, 35, 10225, 251, 0, 0, 10511, 1
n1000x8192-coef-sum, 8192, 34, 10822, 253, 0, 0, 11109, 1
n1000x8192-coef-sum, 8192, 34, 10230, 249, 0, 0, 10513, 1
n1000x8192-coef-sum, 8192, 34, 10245, 247, 0, 0, 10526, 1
n1000x8192-coef-sum, 8192, 35, 10227, 248, 0, 0, 10510, 1
n1000x8192-coef-sum, 8192, 34, 10217, 248, 0, 0, 10499, 1
n1000x8192-coef-sum, 8192, 35, 10244, 246, 0, 0, 10525, 1
n1000x8192-coef-sum, 8192, 35, 10237, 246, 0, 0, 10518, 1
n1000x8192-coef-sum, 8192, 35, 10237, 247, 0, 0, 10519, 1
n1000x8192-coef-sum, 8192, 34, 10865, 255, 0, 0, 11154, 1
n1000x8192-coef-sum, 8192, 35, 10211, 249, 0, 0, 10495, 1
n1000x8192-coef-sum, 8192, 35, 10246, 246, 0, 0, 10527, 1
n1000x8192-coef-sum, 8192, 34, 10231, 250, 0, 0, 10515, 1
n1000x8192-coef-sum, 8192, 34, 10231, 247, 0, 0, 10512, 1
n1000x8192-coef-sum, 8192, 34, 10264, 251, 0, 0, 10549, 1
n1000x8192-coef-sum, 8192, 34, 10241, 245, 0, 0, 10520, 1
n1000x8192-coef-sum, 8192, 35, 10217, 253, 0, 0, 10505, 1
n1000x8192-coef-sum, 8192, 34, 10226, 246, 0, 0, 10506, 1
n1000x8192-coef-sum, 8192, 34, 10218, 248, 0, 0, 10500, 1
n1000x8192-coef-sum, 8192, 35, 10272, 250, 0, 0, 10557, 1
n1000x8192-coef-sum, 8192, 34, 10235, 248, 0, 0, 10517, 1
n1000x8192-coef-sum, 8192, 34, 10210, 246, 0, 0, 10490, 1
n1000x8192-coef-sum, 8192, 35, 10241, 245, 0, 0, 10521, 1
n1000x8192-coef-sum, 8192, 34, 10236, 249, 0, 0, 10519, 1
n1000x8192-coef-sum, 8192, 35, 10227, 246, 0, 0, 10508, 1
n1000x8192-coef-sum, 8192, 35, 10271, 246, 0, 0, 10552, 1
n1000x8192-coef-sum, 8192, 35, 10252, 249, 0, 0, 10536, 1
n1000x8192-coef-sum, 8192, 34, 10220, 249, 0, 0, 10503, 1
n1000x8192-coef-sum, 8192, 35, 10216, 246, 0, 0, 10497, 1
n1000x8192-coef-sum, 8192, 35, 10262, 245, 0, 0, 10542, 1
n1000x8192-coef-sum, 8192, 34, 10252, 248, 0, 0, 10534, 1
n1000x8192-coef-sum, 8192, 34, 10240, 247, 0, 0, 10521, 1
n1000x8192-coef-sum, 8192, 34, 10215, 248, 0, 0, 10497, 1
n1000x8192-coef-sum, 8192, 34, 10247, 249, 0, 0, 10530, 1
n1000x8192-coef-sum, 8192, 34, 10230, 248, 0, 0, 10512, 1
n1000x8192-coef-sum, 8192, 35, 10242, 250, 0, 0, 10527, 1
n1000x8192-coef-sum, 8192, 34, 10242, 245, 0, 0, 10521, 1
n1000x8192-coef-sum, 8192, 35, 10228, 248, 0, 0, 10511, 1
n1000x8192-coef-sum, 8192, 34, 10231, 247, 0, 0, 10512, 1
n1000x8192-coef-sum, 8192, 34, 10210, 247, 0, 0, 10491, 1
n1000x8192-coef-sum, 8192, 35, 10241, 246, 0, 0, 10522, 1
n1000x8192-coef-sum, 8192, 35, 10266, 250, 0, 0, 10551, 1
n1000x8192-coef-sum, 8192, 34, 10226, 245, 0, 0, 10505, 1
n1000x8192-coef-sum, 8192, 35, 10234, 246, 0, 0, 10515, 1
n1000x8192-coef-sum, 8192, 35, 10230, 246, 0, 0, 10511, 1
n1000x8192-coef-sum, 8192, 35, 10235, 253, 0, 0, 10523, 1
n1000x8192-coef-sum, 8192, 35, 10250, 246, 0, 0, 10531, 1
n1000x8192-coef-sum, 8192, 34, 10268, 246, 0, 0, 10548, 1
n1000x8192-coef-sum, 8192, 35, 10220, 252, 0, 0, 10507, 1
n1000x8192-coef-sum, 8192, 34, 10239, 246, 0, 0, 10519, 1
n1000x8192-coef-sum, 8192, 35, 10227, 248, 0, 0, 10510, 1
n1000x8192-coef-sum, 8192, 34, 10234, 247, 0, 0, 10515, 1
n1000x8192-coef-sum, 8192, 34, 10675, 256, 0, 0, 10965, 1
n1000x8192-coef-sum, 8192, 34, 10250, 246, 0, 0, 10530, 1
n1000x8192-coef-sum, 8192, 35, 10217, 246, 0, 0, 10498, 1
n1000x8192-coef-sum, 8192, 34, 10236, 248, 0, 0, 10518, 1
n1000x8192-coef-sum, 8192, 35, 10233, 249, 0, 0, 10517, 1
n1000x8192-coef-sum, 8192, 35, 10289, 247, 0, 0, 10571, 1
n1000x8192-coef-sum, 8192, 35, 10231, 246, 0, 0, 10512, 1
n1000x8192-coef-sum, 8192, 34, 10213, 245, 0, 0, 10492, 1
n1000x8192-coef-sum, 8192, 34, 10243, 248, 0, 0, 10525, 1
n1000x8192-coef-sum, 8192, 34, 10253, 246, 0, 0, 10533, 1
n1000x8192-coef-sum, 8192, 35, 10228, 248, 0, 0, 10511, 1
n1000x8192-coef-sum, 8192, 34, 10257, 248, 0, 0, 10539, 1
n1000x8192-coef-sum, 8192, 34, 10242, 247, 0, 0, 10523, 1
n1000x8192-coef-sum, 8192, 35, 10201, 248, 0, 0, 10484, 1
n1000x8192-coef-sum, 4096, 19, 10097, 270, 0, 0, 10386, 1
n1000x8192-coef-sum, 4096, 19, 10256, 276, 0, 0, 10551, 1
n1000x8192-coef-sum, 4096, 19, 10348, 275, 0, 0, 10642, 1
n1000x8192-coef-sum, 4096, 18, 10132, 269, 0, 0, 10419, 1
n1000x8192-coef-sum, 4096, 19, 10136, 269, 0, 0, 10424, 1
n1000x8192-coef-sum, 4096, 19, 10115, 271, 0, 0, 10405, 1
n1000x8192-coef-sum, 4096, 19, 10116, 269, 0, 0, 10404, 1
n1000x8192-coef-sum, 4096, 19, 10111, 270, 0, 0, 10400, 1
n1000x8192-coef-sum, 4096, 19, 10153, 271, 0, 0, 10443, 1
n1000x8192-coef-sum, 4096, 19, 10130, 271, 0, 0, 10420, 1
n1000x8192-coef-sum, 4096, 19, 10110, 269, 0, 0, 10398, 1
n1000x8192-coef-sum, 4096, 19, 10115, 269, 0, 0, 10403, 1
n1000x8192-coef-sum, 4096, 19, 10118, 269, 0, 0, 10406, 1
n1000x8192-coef-sum, 4096, 19, 10145, 268, 0, 0, 10432, 1
n1000x8192-coef-sum, 4096, 19, 10108, 270, 0, 0, 10397, 1
n1000x8192-coef-sum, 4096, 19, 10119, 271, 0, 0, 10409, 1
n1000x8192-coef-sum, 4096, 19, 10127, 268, 0, 0, 10414, 1
n1000x8192-coef-sum, 4096, 19, 10131, 270, 0, 0, 10420, 1
n1000x8192-coef-sum, 4096, 19, 10109, 270, 0, 0, 10398, 1
n1000x8192-coef-sum, 4096, 19, 10144, 271, 0, 0, 10434, 1
n1000x8192-coef-sum, 4096, 19, 10129, 272, 0, 0, 10420, 1
n1000x8192-coef-sum, 4096, 19, 10116, 266, 0, 0, 10401, 1
n1000x8192-coef-sum, 4096, 19, 10398, 275, 0, 0, 10692, 1
n1000x8192-coef-sum, 4096, 19, 10128, 270, 0, 0, 10417, 1
n1000x8192-coef-sum, 4096, 19, 10148, 266, 0, 0, 10433, 1
n1000x8192-coef-sum, 4096, 19, 10146, 268, 0, 0, 10433, 1
n1000x8192-coef-sum, 4096, 19, 10102, 268, 0, 0, 10389, 1
n1000x8192-coef-sum, 4096, 19, 10148, 270, 0, 0, 10437, 1
n1000x8192-coef-sum, 4096, 19, 10113, 268, 0, 0, 10400, 1
n1000x8192-coef-sum, 4096, 19, 10132, 269, 0, 0, 10420, 1
n1000x8192-coef-sum, 4096, 19, 10195, 274, 0, 0, 10488, 1
n1000x8192-coef-sum, 4096, 19, 10119, 272, 0, 0, 10410, 1
n1000x8192-coef-sum, 4096, 19, 10122, 268, 0, 0, 10409, 1
n1000x8192-coef-sum, 4096, 19, 11407, 277, 0, 0, 11703, 1
n1000x8192-coef-sum, 4096, 19, 10123, 276, 0, 0, 10418, 1
n1000x8192-coef-sum, 4096, 19, 10128, 269, 0, 0, 10416, 1
n1000x8192-coef-sum, 4096, 19, 10110, 275, 0, 0, 10404, 1
n1000x8192-coef-sum, 4096, 19, 10117, 268, 0, 0, 10404, 1
n1000x8192-coef-sum, 4096, 19, 10119, 278, 0, 0, 10416, 1
n1000x8192-coef-sum, 4096, 19, 10101, 270, 0, 0, 10390, 1
n1000x8192-coef-sum, 4096, 19, 10117, 279, 0, 0, 10415, 1
n1000x8192-coef-sum, 4096, 19, 10113, 268, 0, 0, 10400, 1
n1000x8192-coef-sum, 4096, 19, 10122, 277, 0, 0, 10418, 1
n1000x8192-coef-sum, 4096, 19, 10121, 268, 0, 0, 10408, 1
n1000x8192-coef-sum, 4096, 19, 10122, 279, 0, 0, 10420, 1
n1000x8192-coef-sum, 4096, 19, 10115, 268, 0, 0, 10402, 1
n1000x8192-coef-sum, 4096, 19, 10642, 279, 0, 0, 10940, 1
n1000x8192-coef-sum, 4096, 19, 10611, 277, 0, 0, 10907, 1
n1000x8192-coef-sum, 4096, 19, 10120, 276, 0, 0, 10415, 1
n1000x8192-coef-sum, 4096, 19, 10097, 269, 0, 0, 10385, 1
n1000x8192-coef-sum, 4096, 19, 10126, 277, 0, 0, 10422, 1
n1000x8192-coef-sum, 4096, 19, 10354, 273, 0, 0, 10646, 1
n1000x8192-coef-sum, 4096, 19, 10122, 277, 0, 0, 10418, 1
n1000x8192-coef-sum, 4096, 19, 10135, 268, 0, 0, 10422, 1
n1000x8192-coef-sum, 4096, 19, 10095, 274, 0, 0, 10388, 1
n1000x8192-coef-sum, 4096, 19, 10103, 269, 0, 0, 10391, 1
n1000x8192-coef-sum, 4096, 19, 10140, 275, 0, 0, 10434, 1
n1000x8192-coef-sum, 4096, 19, 10127, 269, 0, 0, 10415, 1
n1000x8192-coef-sum, 4096, 19, 10122, 276, 0, 0, 10417, 1
n1000x8192-coef-sum, 4096, 19, 10131, 267, 0, 0, 10417, 1
n1000x8192-coef-sum, 4096, 19, 10114, 276, 0, 0, 10409, 1
n1000x8192-coef-sum, 4096, 19, 10117, 268, 0, 0, 10404, 1
n1000x8192-coef-sum, 4096, 19, 10408, 282, 0, 0, 10709, 1
n1000x8192-coef-sum, 4096, 19, 10221, 271, 0, 0, 10511, 1
n1000x8192-coef-sum, 4096, 19, 10096, 279, 0, 0, 10394, 1
n1000x8192-coef-sum, 4096, 19, 10119, 268, 0, 0, 10406, 1
n1000x8192-coef-sum, 4096, 19, 10130, 281, 0, 0, 10430, 1
n1000x8192-coef-sum, 4096, 19, 10109, 268, 0, 0, 10396, 1
n1000x8192-coef-sum, 4096, 19, 10146, 278, 0, 0, 10443, 1
n1000x8192-coef-sum, 4096, 19, 10118, 268, 0, 0, 10405, 1
n1000x8192-coef-sum, 4096, 19, 11647, 299, 0, 0, 11965, 1
n1000x8192-coef-sum, 4096, 19, 11492, 286, 0, 0, 11797, 1
n1000x8192-coef-sum, 4096, 19, 10317, 293, 0, 0, 10629, 1
n1000x8192-coef-sum, 4096, 19, 10383, 282, 0, 0, 10684, 1
n1000x8192-coef-sum, 4096, 19, 10577, 285, 0, 0, 10881, 1
n1000x8192-coef-sum, 4096, 19, 11028, 276, 0, 0, 11323, 1
n1000x8192-coef-sum, 4096, 19, 10147, 270, 0, 0, 10436, 1
n1000x8192-coef-sum, 4096, 19, 10130, 274, 0, 0, 10423, 1
n1000x8192-coef-sum, 4096, 19, 10136, 276, 0, 0, 10431, 1
n1000x8192-coef-sum, 4096, 19, 10122, 270, 0, 0, 10411, 1
n1000x8192-coef-sum, 4096, 19, 10108, 270, 0, 0, 10397, 1
n1000x8192-coef-sum, 4096, 19, 10134, 268, 0, 0, 10421, 1
n1000x8192-coef-sum, 4096, 19, 10113, 274, 0, 0, 10406, 1
n1000x8192-coef-sum, 4096, 19, 10136, 271, 0, 0, 10426, 1
n1000x8192-coef-sum, 4096, 19, 10182, 277, 0, 0, 10478, 1
n1000x8192-coef-sum, 4096, 19, 10115, 269, 0, 0, 10403, 1
n1000x8192-coef-sum, 4096, 19, 10166, 270, 0, 0, 10455, 1
n1000x8192-coef-sum, 4096, 19, 10127, 269, 0, 0, 10415, 1
n1000x8192-coef-sum, 4096, 19, 10130, 269, 0, 0, 10418, 1
n1000x8192-coef-sum, 4096, 18, 10498, 275, 0, 0, 10791, 1
n1000x8192-coef-sum, 4096, 18, 10179, 270, 0, 0, 10467, 1
n1000x8192-coef-sum, 4096, 19, 10119, 270, 0, 0, 10408, 1
n1000x8192-coef-sum, 4096, 19, 10123, 267, 0, 0, 10409, 1
n1000x8192-coef-sum, 4096, 19, 10131, 268, 0, 0, 10418, 1
n1000x8192-coef-sum, 4096, 19, 10137, 272, 0, 0, 10428, 1
n1000x8192-coef-sum, 4096, 19, 10132, 268, 0, 0, 10419, 1
n1000x8192-coef-sum, 4096, 19, 10131, 269, 0, 0, 10419, 1
n1000x8192-coef-sum, 4096, 19, 10138, 271, 0, 0, 10428, 1
n1000x8192-coef-sum, 4096, 19, 10129, 269, 0, 0, 10417, 1
n1000x8192-coef-sum, 4096, 19, 10137, 268, 0, 0, 10424, 1
n1000x8192-coef-sum, 2048, 18, 12915, 451, 0, 0, 13384, 1
n1000x8192-coef-sum, 2048, 17, 12880, 409, 0, 0, 13306, 1
n1000x8192-coef-sum, 2048, 17, 12920, 413, 0, 0, 13350, 1
n1000x8192-coef-sum, 2048, 18, 12910, 411, 0, 0, 13339, 1
n1000x8192-coef-sum, 2048, 17, 12886, 408, 0, 0, 13311, 1
n1000x8192-coef-sum, 2048, 17, 12899, 405, 0, 0, 13321, 1
n1000x8192-coef-sum, 2048, 17, 12905, 412, 0, 0, 13334, 1
n1000x8192-coef-sum, 2048, 17, 12875, 407, 0, 0, 13299, 1
n1000x8192-coef-sum, 2048, 20, 12921, 410, 0, 0, 13351, 1
n1000x8192-coef-sum, 2048, 18, 12891, 408, 0, 0, 13317, 1
n1000x8192-coef-sum, 2048, 17, 12898, 411, 0, 0, 13326, 1
n1000x8192-coef-sum, 2048, 18, 12883, 409, 0, 0, 13310, 1
n1000x8192-coef-sum, 2048, 17, 12879, 406, 0, 0, 13302, 1
n1000x8192-coef-sum, 2048, 17, 12915, 412, 0, 0, 13344, 1
n1000x8192-coef-sum, 2048, 17, 12890, 411, 0, 0, 13318, 1
n1000x8192-coef-sum, 2048, 17, 12888, 407, 0, 0, 13312, 1
n1000x8192-coef-sum, 2048, 17, 12895, 407, 0, 0, 13319, 1
n1000x8192-coef-sum, 2048, 17, 12923, 408, 0, 0, 13348, 1
n1000x8192-coef-sum, 2048, 17, 12896, 417, 0, 0, 13330, 1
n1000x8192-coef-sum, 2048, 18, 12918, 409, 0, 0, 13345, 1
n1000x8192-coef-sum, 2048, 18, 12897, 406, 0, 0, 13321, 1
n1000x8192-coef-sum, 2048, 17, 12933, 414, 0, 0, 13364, 1
n1000x8192-coef-sum, 2048, 17, 12908, 416, 0, 0, 13341, 1
n1000x8192-coef-sum, 2048, 17, 12890, 410, 0, 0, 13317, 1
n1000x8192-coef-sum, 2048, 18, 12888, 410, 0, 0, 13316, 1
n1000x8192-coef-sum, 2048, 17, 12908, 408, 0, 0, 13333, 1
n1000x8192-coef-sum, 2048, 18, 12927, 412, 0, 0, 13357, 1
n1000x8192-coef-sum, 2048, 17, 12913, 408, 0, 0, 13338, 1
n1000x8192-coef-sum, 2048, 18, 12892, 412, 0, 0, 13322, 1
n1000x8192-coef-sum, 2048, 17, 12916, 407, 0, 0, 13340, 1
n1000x8192-coef-sum, 2048, 17, 12946, 413, 0, 0, 13376, 1
n1000x8192-coef-sum, 2048, 17, 12899, 407, 0, 0, 13323, 1
n1000x8192-coef-sum, 2048, 17, 12917, 409, 0, 0, 13343, 1
n1000x8192-coef-sum, 2048, 18, 12884, 410, 0, 0, 13312, 1
n1000x8192-coef-sum, 2048, 17, 12908, 408, 0, 0, 13333, 1
n1000x8192-coef-sum, 2048, 18, 12927, 410, 0, 0, 13355, 1
n1000x8192-coef-sum, 2048, 17, 12898, 411, 0, 0, 13326, 1
n1000x8192-coef-sum, 2048, 17, 12857, 409, 0, 0, 13283, 1
n1000x8192-coef-sum, 2048, 17, 12881, 407, 0, 0, 13305, 1
n1000x8192-coef-sum, 2048, 17, 12945, 410, 0, 0, 13372, 1
n1000x8192-coef-sum, 2048, 21, 12905, 412, 0, 0, 13338, 1
n1000x8192-coef-sum, 2048, 17, 12908, 406, 0, 0, 13331, 1
n1000x8192-coef-sum, 2048, 17, 12905, 407, 0, 0, 13329, 1
n1000x8192-coef-sum, 2048, 17, 12915, 408, 0, 0, 13340, 1
n1000x8192-coef-sum, 2048, 17, 12911, 406, 0, 0, 13334, 1
n1000x8192-coef-sum, 2048, 17, 12909, 405, 0, 0, 13331, 1
n1000x8192-coef-sum, 2048, 17, 12887, 411, 0, 0, 13315, 1
n1000x8192-coef-sum, 2048, 18, 12910, 413, 1, 0, 13342, 1
n1000x8192-coef-sum, 2048, 17, 12916, 411, 0, 0, 13344, 1
n1000x8192-coef-sum, 2048, 24, 12932, 412, 0, 0, 13368, 1
n1000x8192-coef-sum, 2048, 17, 12870, 410, 0, 0, 13297, 1
n1000x8192-coef-sum, 2048, 17, 13267, 416, 0, 0, 13700, 1
n1000x8192-coef-sum, 2048, 17, 12905, 408, 0, 0, 13330, 1
n1000x8192-coef-sum, 2048, 18, 12944, 409, 0, 0, 13371, 1
n1000x8192-coef-sum, 2048, 17, 12891, 409, 0, 0, 13317, 1
n1000x8192-coef-sum, 2048, 17, 12870, 406, 0, 0, 13293, 1
n1000x8192-coef-sum, 2048, 22, 12919, 419, 0, 0, 13360, 1
n1000x8192-coef-sum, 2048, 17, 12918, 413, 0, 0, 13348, 1
n1000x8192-coef-sum, 2048, 17, 12869, 410, 0, 0, 13296, 1
n1000x8192-coef-sum, 2048, 17, 12881, 407, 0, 0, 13305, 1
n1000x8192-coef-sum, 2048, 17, 12878, 412, 0, 0, 13307, 1
n1000x8192-coef-sum, 2048, 28, 12894, 406, 0, 0, 13328, 1
n1000x8192-coef-sum, 2048, 19, 12868, 409, 0, 0, 13296, 1
n1000x8192-coef-sum, 2048, 17, 12859, 407, 0, 0, 13283, 1
n1000x8192-coef-sum, 2048, 17, 12871, 410, 0, 0, 13298, 1
n1000x8192-coef-sum, 2048, 17, 12887, 412, 0, 0, 13316, 1
n1000x8192-coef-sum, 2048, 18, 12873, 409, 0, 0, 13300, 1
n1000x8192-coef-sum, 2048, 17, 12885, 408, 0, 0, 13310, 1
n1000x8192-coef-sum, 2048, 17, 12867, 405, 0, 0, 13289, 1
n1000x8192-coef-sum, 2048, 17, 12916, 416, 0, 0, 13349, 1
n1000x8192-coef-sum, 2048, 18, 12909, 403, 0, 0, 13330, 1
n1000x8192-coef-sum, 2048, 17, 12880, 407, 0, 0, 13304, 1
n1000x8192-coef-sum, 2048, 17, 12898, 412, 0, 0, 13327, 1
n1000x8192-coef-sum, 2048, 17, 12903, 415, 0, 0, 13335, 1
n1000x8192-coef-sum, 2048, 18, 12885, 407, 0, 0, 13310, 1
n1000x8192-coef-sum, 2048, 17, 12881, 407, 0, 0, 13305, 1
n1000x8192-coef-sum, 2048, 17, 12865, 406, 0, 0, 13288, 1
n1000x8192-coef-sum, 2048, 17, 12877, 420, 0, 0, 13314, 1
n1000x8192-coef-sum, 2048, 17, 12933, 414, 0, 0, 13364, 1
n1000x8192-coef-sum, 2048, 17, 12882, 402, 0, 0, 13301, 1
n1000x8192-coef-sum, 2048, 17, 12907, 407, 0, 0, 13331, 1
n1000x8192-coef-sum, 2048, 17, 12861, 407, 0, 0, 13285, 1
n1000x8192-coef-sum, 2048, 17, 12909, 407, 0, 0, 13333, 1
n1000x8192-coef-sum, 2048, 17, 12873, 417, 0, 0, 13307, 1
n1000x8192-coef-sum, 2048, 17, 12881, 407, 0, 0, 13305, 1
n1000x8192-coef-sum, 2048, 17, 12854, 419, 0, 0, 13290, 1
n1000x8192-coef-sum, 2048, 17, 12898, 406, 0, 0, 13321, 1
n1000x8192-coef-sum, 2048, 21, 12881, 426, 0, 0, 13328, 1
n1000x8192-coef-sum, 2048, 18, 12905, 409, 0, 0, 13332, 1
n1000x8192-coef-sum, 2048, 17, 12862, 412, 0, 0, 13291, 1
n1000x8192-coef-sum, 2048, 18, 12909, 415, 0, 0, 13342, 1
n1000x8192-coef-sum, 2048, 20, 12914, 420, 0, 0, 13354, 1
n1000x8192-coef-sum, 2048, 17, 12910, 410, 0, 0, 13337, 1
n1000x8192-coef-sum, 2048, 18, 12893, 417, 0, 0, 13328, 1
n1000x8192-coef-sum, 2048, 17, 12981, 410, 0, 0, 13408, 1
n1000x8192-coef-sum, 2048, 17, 12940, 423, 0, 0, 13380, 1
n1000x8192-coef-sum, 2048, 17, 12914, 413, 0, 0, 13344, 1
n1000x8192-coef-sum, 2048, 17, 12871, 417, 0, 0, 13305, 1
n1000x8192-coef-sum, 2048, 18, 12918, 415, 0, 0, 13351, 1
n1000x8192-coef-sum, 2048, 17, 12937, 409, 0, 0, 13363, 1
n1000x8192-coef-sum, 1024, 13, 13401, 459, 0, 0, 13873, 1
n1000x8192-coef-sum, 1024, 12, 13313, 455, 0, 0, 13780, 1
n1000x8192-coef-sum, 1024, 13, 13361, 458, 0, 0, 13832, 1
n1000x8192-coef-sum, 1024, 12, 13373, 455, 0, 0, 13840, 1
n1000x8192-coef-sum, 1024, 12, 13363, 460, 0, 0, 13835, 1
n1000x8192-coef-sum, 1024, 13, 13323, 455, 0, 0, 13791, 1
n1000x8192-coef-sum, 1024, 12, 13346, 457, 0, 0, 13815, 1
n1000x8192-coef-sum, 1024, 13, 13384, 450, 0, 0, 13847, 1
n1000x8192-coef-sum, 1024, 12, 13337, 463, 0, 0, 13812, 1
n1000x8192-coef-sum, 1024, 12, 13319, 449, 0, 0, 13780, 1
n1000x8192-coef-sum, 1024, 12, 13345, 455, 0, 0, 13812, 1
n1000x8192-coef-sum, 1024, 12, 13368, 455, 0, 0, 13835, 1
n1000x8192-coef-sum, 1024, 13, 13349, 460, 0, 0, 13822, 1
n1000x8192-coef-sum, 1024, 14, 13333, 453, 0, 0, 13800, 1
n1000x8192-coef-sum, 1024, 12, 13334, 454, 0, 0, 13800, 1
n1000x8192-coef-sum, 1024, 13, 13369, 452, 0, 0, 13834, 1
n1000x8192-coef-sum, 1024, 12, 13372, 457, 0, 0, 13841, 1
n1000x8192-coef-sum, 1024, 13, 13327, 453, 0, 0, 13793, 1
n1000x8192-coef-sum, 1024, 13, 13334, 458, 0, 0, 13805, 1
n1000x8192-coef-sum, 1024, 12, 13362, 455, 0, 0, 13829, 1
n1000x8192-coef-sum, 1024, 12, 13352, 455, 0, 0, 13819, 1
n1000x8192-coef-sum, 1024, 12, 13360, 453, 0, 0, 13825, 1
n1000x8192-coef-sum, 1024, 12, 13363, 453, 0, 0, 13828, 1
n1000x8192-coef-sum, 1024, 14, 13333, 450, 0, 0, 13797, 1
n1000x8192-coef-sum, 1024, 13, 13345, 459, 0, 0, 13817, 1
n1000x8192-coef-sum, 1024, 12, 13327, 454, 0, 0, 13793, 1
n1000x8192-coef-sum, 1024, 13, 13352, 460, 0, 0, 13825, 1
n1000x8192-coef-sum, 1024, 15, 13347, 451, 0, 0, 13813, 1
n1000x8192-coef-sum, 1024, 12, 13411, 454, 0, 0, 13877, 1
n1000x8192-coef-sum, 1024, 13, 13361, 454, 0, 0, 13828, 1
n1000x8192-coef-sum, 1024, 12, 13383, 457, 0, 0, 13852, 1
n1000x8192-coef-sum, 1024, 13, 13335, 452, 0, 0, 13800, 1
n1000x8192-coef-sum, 1024, 13, 13357, 458, 0, 0, 13828, 1
n1000x8192-coef-sum, 1024, 12, 13350, 456, 0, 0, 13818, 1
n1000x8192-coef-sum, 1024, 13, 13320, 460, 0, 0, 13793, 1
n1000x8192-coef-sum, 1024, 13, 13391, 453, 0, 0, 13857, 1
n1000x8192-coef-sum, 1024, 12, 13435, 458, 0, 0, 13905, 1
n1000x8192-coef-sum, 1024, 13, 13328, 455, 0, 0, 13796, 1
n1000x8192-coef-sum, 1024, 13, 13322, 459, 0, 0, 13794, 1
n1000x8192-coef-sum, 1024, 13, 13336, 455, 0, 0, 13804, 1
n1000x8192-coef-sum, 1024, 13, 13345, 460, 0, 0, 13818, 1
n1000x8192-coef-sum, 1024, 14, 13357, 456, 0, 0, 13827, 1
n1000x8192-coef-sum, 1024, 13, 13351, 459, 0, 0, 13823, 1
n1000x8192-coef-sum, 1024, 12, 13361, 453, 0, 0, 13826, 1
n1000x8192-coef-sum, 1024, 13, 13305, 453, 0, 0, 13771, 1
n1000x8192-coef-sum, 1024, 12, 32988, 453, 0, 0, 33453, 1
n1000x8192-coef-sum, 1024, 12, 13367, 448, 0, 0, 13827, 1
n1000x8192-coef-sum, 1024, 12, 13414, 457, 0, 0, 13883, 1
n1000x8192-coef-sum, 1024, 13, 13388, 455, 0, 0, 13856, 1
n1000x8192-coef-sum, 1024, 12, 13357, 450, 0, 0, 13819, 1
n1000x8192-coef-sum, 1024, 12, 13308, 454, 0, 0, 13774, 1
n1000x8192-coef-sum, 1024, 12, 13333, 453, 0, 0, 13798, 1
n1000x8192-coef-sum, 1024, 13, 13413, 452, 0, 0, 13878, 1
n1000x8192-coef-sum, 1024, 13, 13361, 453, 0, 0, 13827, 1
n1000x8192-coef-sum, 1024, 13, 13358, 453, 0, 0, 13824, 1
n1000x8192-coef-sum, 1024, 13, 13343, 454, 0, 0, 13810, 1
n1000x8192-coef-sum, 1024, 12, 13337, 456, 0, 0, 13805, 1
n1000x8192-coef-sum, 1024, 13, 13331, 456, 0, 0, 13800, 1
n1000x8192-coef-sum, 1024, 13, 13333, 455, 0, 0, 13801, 1
n1000x8192-coef-sum, 1024, 12, 13339, 453, 0, 0, 13804, 1
n1000x8192-coef-sum, 1024, 12, 13361, 454, 0, 0, 13827, 1
n1000x8192-coef-sum, 1024, 13, 13355, 454, 0, 0, 13822, 1
n1000x8192-coef-sum, 1024, 12, 13352, 450, 0, 0, 13814, 1
n1000x8192-coef-sum, 1024, 13, 13346, 457, 0, 0, 13816, 1
n1000x8192-coef-sum, 1024, 13, 13340, 451, 0, 0, 13804, 1
n1000x8192-coef-sum, 1024, 13, 13331, 454, 0, 0, 13798, 1
n1000x8192-coef-sum, 1024, 12, 13341, 451, 0, 0, 13804, 1
n1000x8192-coef-sum, 1024, 12, 13329, 451, 0, 0, 13792, 1
n1000x8192-coef-sum, 1024, 13, 13369, 456, 0, 0, 13838, 1
n1000x8192-coef-sum, 1024, 13, 13330, 451, 0, 0, 13794, 1
n1000x8192-coef-sum, 1024, 13, 13339, 452, 0, 0, 13804, 1
n1000x8192-coef-sum, 1024, 13, 13335, 449, 0, 0, 13797, 1
n1000x8192-coef-sum, 1024, 12, 13312, 452, 0, 0, 13776, 1
n1000x8192-coef-sum, 1024, 13, 13318, 450, 0, 0, 13781, 1
n1000x8192-coef-sum, 1024, 13, 13339, 460, 0, 0, 13812, 1
n1000x8192-coef-sum, 1024, 13, 13307, 456, 0, 0, 13776, 1
n1000x8192-coef-sum, 1024, 12, 13329, 457, 0, 0, 13798, 1
n1000x8192-coef-sum, 1024, 13, 13384, 460, 0, 0, 13857, 1
n1000x8192-coef-sum, 1024, 13, 13339, 449, 0, 0, 13801, 1
n1000x8192-coef-sum, 1024, 13, 13340, 455, 0, 0, 13808, 1
n1000x8192-coef-sum, 1024, 12, 13327, 452, 0, 0, 13791, 1
n1000x8192-coef-sum, 1024, 13, 13405, 458, 0, 0, 13876, 1
n1000x8192-coef-sum, 1024, 13, 13342, 455, 0, 0, 13810, 1
n1000x8192-coef-sum, 1024, 13, 13315, 455, 0, 0, 13783, 1
n1000x8192-coef-sum, 1024, 13, 13318, 451, 0, 0, 13782, 1
n1000x8192-coef-sum, 1024, 12, 13381, 454, 0, 0, 13847, 1
n1000x8192-coef-sum, 1024, 13, 13344, 451, 0, 0, 13808, 1
n1000x8192-coef-sum, 1024, 12, 13383, 455, 0, 0, 13850, 1
n1000x8192-coef-sum, 1024, 12, 13386, 453, 0, 0, 13851, 1
n1000x8192-coef-sum, 1024, 12, 13377, 454, 0, 0, 13843, 1
n1000x8192-coef-sum, 1024, 13, 13358, 454, 0, 0, 13825, 1
n1000x8192-coef-sum, 1024, 12, 13349, 461, 0, 0, 13822, 1
n1000x8192-coef-sum, 1024, 13, 13370, 451, 0, 0, 13834, 1
n1000x8192-coef-sum, 1024, 13, 13373, 454, 0, 0, 13840, 1
n1000x8192-coef-sum, 1024, 12, 13360, 456, 0, 0, 13828, 1
n1000x8192-coef-sum, 1024, 13, 13328, 451, 0, 0, 13792, 1
n1000x8192-coef-sum, 1024, 13, 13360, 451, 0, 0, 13824, 1
n1000x8192-coef-sum, 1024, 12, 13434, 454, 0, 0, 13900, 1
n1000x8192-coef-sum, 1024, 13, 13381, 449, 0, 0, 13843, 1
n1000x8192-coef-sum, 1024, 48, 13367, 457, 0, 0, 13872, 1
n1000x8192-slot-sum, 8192, 126, 5623, 270, 0, 0, 6019, 1
n1000x8192-slot-sum, 8192, 126, 5630, 269, 0, 0, 6025, 1
n1000x8192-slot-sum, 8192, 125, 5628, 278, 0, 0, 6031, 1
n1000x8192-slot-sum, 8192, 126, 5640, 276, 0, 0, 6042, 1
n1000x8192-slot-sum, 8192, 125, 5624, 279, 0, 0, 6028, 1
n1000x8192-slot-sum, 8192, 126, 5637, 273, 0, 0, 6036, 1
n1000x8192-slot-sum, 8192, 125, 5682, 281, 0, 0, 6088, 1
n1000x8192-slot-sum, 8192, 126, 5645, 273, 0, 0, 6044, 1
n1000x8192-slot-sum, 8192, 125, 5628, 272, 0, 0, 6025, 1
n1000x8192-slot-sum, 8192, 126, 5631, 273, 0, 0, 6030, 1
n1000x8192-slot-sum, 8192, 127, 5620, 269, 0, 0, 6016, 1
n1000x8192-slot-sum, 8192, 126, 5622, 272, 0, 0, 6020, 1
n1000x8192-slot-sum, 8192, 126, 5624, 274, 0, 0, 6024, 1
n1000x8192-slot-sum, 8192, 126, 5623, 272, 0, 0, 6021, 1
n1000x8192-slot-sum, 8192, 125, 6002, 283, 1, 0, 6411, 1
n1000x8192-slot-sum, 8192, 126, 5621, 271, 0, 0, 6018, 1
n1000x8192-slot-sum, 8192, 127, 6229, 290, 1, 0, 6647, 1
n1000x8192-slot-sum, 8192, 126, 5635, 277, 0, 0, 6038, 1
n1000x8192-slot-sum, 8192, 125, 5640, 274, 0, 0, 6039, 1
n1000x8192-slot-sum, 8192, 125, 5604, 272, 0, 0, 6001, 1
n1000x8192-slot-sum, 8192, 126, 5619, 273, 0, 0, 6018, 1
n1000x8192-slot-sum, 8192, 126, 5615, 273, 0, 0, 6014, 1
n1000x8192-slot-sum, 8192, 126, 5617, 270, 0, 0, 6013, 1
n1000x8192-slot-sum, 8192, 125, 6030, 286, 1, 0, 6442, 1
n1000x8192-slot-sum, 8192, 125, 5617, 273, 0, 0, 6015, 1
n1000x8192-slot-sum, 8192, 126, 5627, 272, 0, 0, 6025, 1
n1000x8192-slot-sum, 8192, 125, 5624, 271, 0, 0, 6020, 1
n1000x8192-slot-sum, 8192, 125, 5626, 272, 0, 0, 6023, 1
n1000x8192-slot-sum, 8192, 126, 5633, 270, 0, 0, 6029, 1
n1000x8192-slot-sum, 8192, 126, 5619, 270, 0, 0, 6015, 1
n1000x8192-slot-sum, 8192, 127, 5619, 270, 0, 0, 6016, 1
n1000x8192-slot-sum, 8192, 125, 5632, 270, 0, 0, 6027, 1
n1000x8192-slot-sum, 8192, 126, 5646, 270, 0, 0, 6042, 1
n1000x8192-slot-sum, 8192, 125, 5638, 271, 0, 0, 6034, 1
n1000x8192-slot-sum, 8192, 126, 5637, 273, 0, 0, 6036, 1
n1000x8192-slot-sum, 8192, 125, 5620, 271, 0, 0, 6016, 1
n1000x8192-slot-sum, 8192, 126, 5634, 271, 0, 0, 6031, 1
n1000x8192-slot-sum, 8192, 126, 5633, 270, 0, 0, 6029, 1
n1000x8192-slot-sum, 8192, 125, 5628, 272, 0, 0, 6025, 1
n1000x8192-slot-sum, 8192, 124, 5613, 277, 0, 0, 6014, 1
n1000x8192-slot-sum, 8192, 125, 5621, 271, 0, 0, 6017, 1
n1000x8192-slot-sum, 8192, 125, 5644, 272, 0, 0, 6041, 1
n1000x8192-slot-sum, 8192, 126, 5609, 269, 0, 0, 6004, 1
n1000x8192-slot-sum, 8192, 127, 5643, 276, 0, 0, 6046, 1
n1000x8192-slot-sum, 8192, 126, 5628, 271, 0, 0, 6025, 1
n1000x8192-slot-sum, 8192, 125, 5649, 274, 0, 0, 6048, 1
n1000x8192-slot-sum, 8192, 126, 5630, 273, 0, 0, 6029, 1
n1000x8192-slot-sum, 8192, 125, 5621, 268, 0, 0, 6014, 1
n1000x8192-slot-sum, 8192, 126, 5642, 272, 0, 0, 6040, 1
n1000x8192-slot-sum, 8192, 127, 5620, 270, 0, 0, 6017, 1
n1000x8192-slot-sum, 8192, 125, 5656, 270, 0, 0, 6051, 1
n1000x8192-slot-sum, 8192, 125, 5633, 272, 0, 0, 6030, 1
n1000x8192-slot-sum, 8192, 126, 5631, 276, 0, 0, 6033, 1
n1000x8192-slot-sum, 8192, 126, 5616, 278, 0, 0, 6020, 1
n1000x8192-slot-sum, 8192, 125, 5612, 270, 0, 0, 6007, 1
n1000x8192-slot-sum, 8192, 127, 5641, 279, 0, 0, 6047, 1
n1000x8192-slot-sum, 8192, 126, 5873, 273, 0, 0, 6272, 1
n1000x8192-slot-sum, 8192, 127, 5651, 274, 0, 0, 6052, 1
n1000x8192-slot-sum, 8192, 126, 5628, 275, 0, 0, 6029, 1
n1000x8192-slot-sum, 8192, 126, 5646, 274, 0, 0, 6046, 1
n1000x8192-slot-sum, 8192, 126, 5613, 279, 0, 0, 6018, 1
n1000x8192-slot-sum, 8192, 126, 5613, 273, 0, 0, 6012, 1
n1000x8192-slot-sum, 8192, 126, 5675, 270, 0, 0, 6071, 1
n1000x8192-slot-sum, 8192, 125, 5620, 269, 0, 0, 6014, 1
n1000x8192-slot-sum, 8192, 125, 5640, 272, 0, 0, 6037, 1
n1000x8192-slot-sum, 8192, 125, 5615, 270, 0, 0, 6010, 1
n1000x8192-slot-sum, 8192, 125, 5632, 271, 0, 0, 6028, 1
n1000x8192-slot-sum, 8192, 126, 5615, 270, 0, 0, 6011, 1
n1000x8192-slot-sum, 8192, 127, 5635, 272, 0, 0, 6034, 1
n1000x8192-slot-sum, 8192, 126, 5617, 270, 0, 0, 6013, 1
n1000x8192-slot-sum, 8192, 126, 5631, 273, 0, 0, 6030, 1
n1000x8192-slot-sum, 8192, 126, 5637, 272, 0, 0, 6035, 1
n1000x8192-slot-sum, 8192, 126, 5616, 270, 0, 0, 6012, 1
n1000x8192-slot-sum, 8192, 126, 5629, 272, 0, 0, 6027, 1
n1000x8192-slot-sum, 8192, 126, 5630, 271, 0, 0, 6027, 1
n1000x8192-slot-sum, 8192, 125, 5621, 270, 0, 0, 6016, 1
n1000x8192-slot-sum, 8192, 126, 5624, 271, 0, 0, 6021, 1
n1000x8192-slot-sum, 8192, 125, 5646, 272, 0, 0, 6043, 1
n1000x8192-slot-sum, 8192, 127, 5633, 271, 0, 0, 6031, 1
n1000x8192-slot-sum, 8192, 126, 5621, 273, 0, 0, 6020, 1
n1000x8192-slot-sum, 8192, 127, 5626, 270, 0, 0, 6023, 1
n1000x8192-slot-sum, 8192, 125, 5620, 271, 0, 0, 6016, 1
n1000x8192-slot-sum, 8192, 127, 5637, 271, 0, 0, 6035, 1
n1000x8192-slot-sum, 8192, 127, 5629, 273, 0, 0, 6029, 1
n1000x8192-slot-sum, 8192, 126, 5626, 271, 0, 0, 6023, 1
n1000x8192-slot-sum, 8192, 125, 5619, 270, 0, 0, 6014, 1
n1000x8192-slot-sum, 8192, 127, 5622, 272, 0, 0, 6021, 1
n1000x8192-slot-sum, 8192, 126, 5635, 271, 0, 0, 6032, 1
n1000x8192-slot-sum, 8192, 126, 5628, 270, 0, 0, 6024, 1
n1000x8192-slot-sum, 8192, 126, 5626, 274, 0, 0, 6026, 1
n1000x8192-slot-sum, 8192, 125, 5626, 273, 0, 0, 6024, 1
n1000x8192-slot-sum, 8192, 125, 5656, 272, 0, 0, 6053, 1
n1000x8192-slot-sum, 8192, 125, 5645, 272, 0, 0, 6042, 1
n1000x8192-slot-sum, 8192, 126, 5622, 272, 0, 0, 6020, 1
n1000x8192-slot-sum, 8192, 126, 5630, 270, 0, 0, 6026, 1
n1000x8192-slot-sum, 8192, 126, 5611, 274, 0, 0, 6011, 1
n1000x8192-slot-sum, 8192, 126, 5646, 270, 0, 0, 6042, 1
n1000x8192-slot-sum, 8192, 125, 5646, 272, 0, 0, 6043, 1
n1000x8192-slot-sum, 8192, 126, 5627, 272, 0, 0, 6025, 1
n1000x8192-slot-sum, 8192, 126, 5636, 285, 0, 0, 6047, 1
n1000x8192-slot-sum, 4096, 60, 5479, 275, 0, 0, 5814, 1
n1000x8192-slot-sum, 4096, 60, 5474, 273, 0, 0, 5807, 1
n1000x8192-slot-sum, 4096, 60, 5481, 275, 0, 0, 5816, 1
n1000x8192-slot-sum, 4096, 60, 5496, 270, 0, 0, 5826, 1
n1000x8192-slot-sum, 4096, 60, 5478, 270, 0, 0, 5808, 1
n1000x8192-slot-sum, 4096, 60, 5481, 271, 0, 0, 5812, 1
n1000x8192-slot-sum, 4096, 59, 5458, 271, 0, 0, 5788, 1
n1000x8192-slot-sum, 4096, 59, 5464, 273, 0, 0, 5796, 1
n1000x8192-slot-sum, 4096, 61, 5465, 269, 0, 0, 5795, 1
n1000x8192-slot-sum, 4096, 60, 5448, 269, 0, 0, 5777, 1
n1000x8192-slot-sum, 4096, 60, 5474, 270, 0, 0, 5804, 1
n1000x8192-slot-sum, 4096, 60, 5457, 269, 0, 0, 5786, 1
n1000x8192-slot-sum, 4096, 60, 5462, 269, 0, 0, 5791, 1
n1000x8192-slot-sum, 4096, 59, 5474, 273, 0, 0, 5806, 1
n1000x8192-slot-sum, 4096, 59, 5473, 286, 0, 0, 5818, 1
n1000x8192-slot-sum, 4096, 60, 5474, 272, 0, 0, 5806, 1
n1000x8192-slot-sum, 4096, 60, 5460, 276, 0, 0, 5796, 1
n1000x8192-slot-sum, 4096, 60, 5484, 270, 0, 0, 5814, 1
n1000x8192-slot-sum, 4096, 60, 5471, 276, 0, 0, 5807, 1
n1000x8192-slot-sum, 4096, 60, 5477, 275, 0, 0, 5812, 1
n1000x8192-slot-sum, 4096, 59, 5459, 275, 0, 0, 5793, 1
n1000x8192-slot-sum, 4096, 60, 5472, 270, 0, 0, 5802, 1
n1000x8192-slot-sum, 4096, 60, 5464, 277, 0, 0, 5801, 1
n1000x8192-slot-sum, 4096, 59, 5469, 272, 0, 0, 5800, 1
n1000x8192-slot-sum, 4096, 59, 5855, 287, 0, 0, 6201, 1
n1000x8192-slot-sum, 4096, 60, 5467, 272, 0, 0, 5799, 1
n1000x8192-slot-sum, 4096, 59, 5987, 287, 0, 0, 6333, 1
n1000x8192-slot-sum, 4096, 60, 5467, 269, 0, 0, 5796, 1
n1000x8192-slot-sum, 4096, 60, 5460, 276, 0, 0, 5796, 1
n1000x8192-slot-sum, 4096, 60, 5469, 273, 0, 0, 5802, 1
n1000x8192-slot-sum, 4096, 60, 5470, 277, 0, 0, 5807, 1
n1000x8192-slot-sum, 4096, 59, 5475, 270, 0, 0, 5804, 1
n1000x8192-slot-sum, 4096, 60, 5471, 278, 0, 0, 5809, 1
n1000x8192-slot-sum, 4096, 60, 5487, 268, 0, 0, 5815, 1
n1000x8192-slot-sum, 4096, 60, 5469, 270, 0, 0, 5799, 1
n1000x8192-slot-sum, 4096, 60, 5457, 270, 0, 0, 5787, 1
n1000x8192-slot-sum, 4096, 60, 5470, 271, 0, 0, 5801, 1
n1000x8192-slot-sum, 4096, 60, 5462, 272, 0, 0, 5794, 1
n1000x8192-slot-sum, 4096, 60, 5472, 269, 0, 0, 5801, 1
n1000x8192-slot-sum, 4096, 61, 5475, 267, 0, 0, 5803, 1
n1000x8192-slot-sum, 4096, 59, 5491, 273, 0, 0, 5823, 1
n1000x8192-slot-sum, 4096, 60, 5474, 268, 0, 0, 5802, 1
n1000x8192-slot-sum, 4096, 59, 5455, 269, 0, 0, 5783, 1
n1000x8192-slot-sum, 4096, 60, 5480, 271, 0, 0, 5811, 1
n1000x8192-slot-sum, 4096, 59, 5479, 271, 0, 0, 5809, 1
n1000x8192-slot-sum, 4096, 60, 5464, 272, 0, 0, 5796, 1
n1000x8192-slot-sum, 4096, 60, 5473, 271, 0, 0, 5804, 1
n1000x8192-slot-sum, 4096, 60, 5465, 270, 0, 0, 5795, 1
n1000x8192-slot-sum, 4096, 59, 5456, 271, 0, 0, 5786, 1
n1000x8192-slot-sum, 4096, 60, 5458, 271, 0, 0, 5789, 1
n1000x8192-slot-sum, 4096, 59, 5480, 271, 0, 0, 5810, 1
n1000x8192-slot-sum, 4096, 60, 5463, 272, 0, 0, 5795, 1
n1000x8192-slot-sum, 4096, 60, 5741, 277, 0, 0, 6078, 1
n1000x8192-slot-sum, 4096, 59, 5460, 271, 0, 0, 5790, 1
n1000x8192-slot-sum, 4096, 60, 5466, 275, 0, 0, 5801, 1
n1000x8192-slot-sum, 4096, 61, 5463, 272, 0, 0, 5796, 1
n1000x8192-slot-sum, 4096, 59, 5463, 272, 0, 0, 5794, 1
n1000x8192-slot-sum, 4096, 60, 5488, 272, 0, 0, 5820, 1
n1000x8192-slot-sum, 4096, 60, 5480, 269, 0, 0, 5809, 1
n1000x8192-slot-sum, 4096, 59, 5469, 270, 0, 0, 5798, 1
n1000x8192-slot-sum, 4096, 59, 5463, 271, 0, 0, 5793, 1
n1000x8192-slot-sum, 4096, 59, 5476, 279, 0, 0, 5814, 1
n1000x8192-slot-sum, 4096, 60, 5474, 270, 0, 0, 5804, 1
n1000x8192-slot-sum, 4096, 60, 5490, 273, 0, 0, 5823, 1
n1000x8192-slot-sum, 4096, 59, 5462, 271, 0, 0, 5792, 1
n1000x8192-slot-sum, 4096, 60, 5460, 279, 0, 0, 5799, 1
n1000x8192-slot-sum, 4096, 60, 5473, 273, 0, 0, 5806, 1
n1000x8192-slot-sum, 4096, 59, 5455, 277, 0, 0, 5791, 1
n1000x8192-slot-sum, 4096, 59, 5465, 267, 0, 0, 5791, 1
n1000x8192-slot-sum, 4096, 60, 5468, 276, 0, 0, 5804, 1
n1000x8192-slot-sum, 4096, 59, 5453, 272, 0, 0, 5784, 1
n1000x8192-slot-sum, 4096, 59, 5481, 271, 0, 0, 5811, 1
n1000x8192-slot-sum, 4096, 60, 5908, 277, 0, 0, 6245, 1
n1000x8192-slot-sum, 4096, 60, 5478, 279, 0, 0, 5817, 1
n1000x8192-slot-sum, 4096, 60, 5485, 273, 0, 0, 5818, 1
n1000x8192-slot-sum, 4096, 60, 5468, 275, 0, 0, 5803, 1
n1000x8192-slot-sum, 4096, 61, 5469, 269, 0, 0, 5799, 1
n1000x8192-slot-sum, 4096, 59, 5462, 276, 0, 0, 5797, 1
n1000x8192-slot-sum, 4096, 60, 5472, 270, 0, 0, 5802, 1
n1000x8192-slot-sum, 4096, 60, 5489, 274, 0, 0, 5823, 1
n1000x8192-slot-sum, 4096, 59, 5632, 278, 0, 0, 5969, 1
n1000x8192-slot-sum, 4096, 60, 5455, 277, 0, 0, 5792, 1
n1000x8192-slot-sum, 4096, 60, 5745, 278, 0, 0, 6083, 1
n1000x8192-slot-sum, 4096, 60, 5468, 279, 0, 0, 5807, 1
n1000x8192-slot-sum, 4096, 59, 5458, 271, 0, 0, 5788, 1
n1000x8192-slot-sum, 4096, 60, 5480, 276, 0, 0, 5816, 1
n1000x8192-slot-sum, 4096, 60, 5458, 269, 0, 0, 5787, 1
n1000x8192-slot-sum, 4096, 59, 5488, 276, 0, 0, 5823, 1
n1000x8192-slot-sum, 4096, 60, 5476, 272, 0, 0, 5808, 1
n1000x8192-slot-sum, 4096, 59, 5484, 278, 0, 0, 5821, 1
n1000x8192-slot-sum, 4096, 60, 5477, 278, 0, 0, 5815, 1
n1000x8192-slot-sum, 4096, 61, 5530, 276, 0, 0, 5867, 1
n1000x8192-slot-sum, 4096, 60, 5520, 272, 0, 0, 5852, 1
n1000x8192-slot-sum, 4096, 60, 5463, 269, 0, 0, 5792, 1
n1000x8192-slot-sum, 4096, 60, 5469, 279, 0, 0, 5808, 1
n1000x8192-slot-sum, 4096, 59, 5483, 272, 0, 0, 5814, 1
n1000x8192-slot-sum, 4096, 59, 5472, 272, 0, 0, 5803, 1
n1000x8192-slot-sum, 4096, 59, 5482, 270, 0, 0, 5811, 1
n1000x8192-slot-sum, 4096, 60, 5466, 276, 0, 0, 5802, 1
n1000x8192-slot-sum, 4096, 60, 5759, 279, 0, 0, 6098, 1
n1000x8192-slot-sum, 2048, 56, 6931, 412, 0, 0, 7399, 1
n1000x8192-slot-sum, 2048, 56, 6926, 405, 0, 0, 7387, 1
n1000x8192-slot-sum, 2048, 57, 6933, 414, 0, 0, 7404, 1
n1000x8192-slot-sum, 2048, 57, 6929, 406, 0, 0, 7392, 1
n1000x8192-slot-sum, 2048, 56, 6931, 415, 0, 0, 7402, 1
n1000x8192-slot-sum, 2048, 57, 6929, 406, 0, 0, 7392, 1
n1000x8192-slot-sum, 2048, 57, 6923, 411, 0, 0, 7391, 1
n1000x8192-slot-sum, 2048, 56, 6944, 403, 0, 0, 7403, 1
n1000x8192-slot-sum, 2048, 58, 6929, 413, 0, 0, 7400, 1
n1000x8192-slot-sum, 2048, 57, 6941, 401, 0, 0, 7399, 1
n1000x8192-slot-sum, 2048, 57, 6935, 414, 0, 0, 7406, 1
n1000x8192-slot-sum, 2048, 58, 6937, 403, 0, 0, 7398, 1
n1000x8192-slot-sum, 2048, 56, 6938, 413, 0, 0, 7407, 1
n1000x8192-slot-sum, 2048, 57, 6934, 402, 0, 0, 7393, 1
n1000x8192-slot-sum, 2048, 57, 6938, 410, 0, 0, 7405, 1
n1000x8192-slot-sum, 2048, 56, 6921, 405, 0, 0, 7382, 1
n1000x8192-slot-sum, 2048, 58, 6937, 413, 0, 0, 7408, 1
n1000x8192-slot-sum, 2048, 60, 6920, 407, 0, 0, 7387, 1
n1000x8192-slot-sum, 2048, 56, 6928, 413, 0, 0, 7397, 1
n1000x8192-slot-sum, 2048, 57, 6938, 404, 0, 0, 7399, 1
n1000x8192-slot-sum, 2048, 57, 6946, 407, 0, 0, 7410, 1
n1000x8192-slot-sum, 2048, 57, 6927, 404, 0, 0, 7388, 1
n1000x8192-slot-sum, 2048, 56, 6944, 414, 0, 0, 7414, 1
n1000x8192-slot-sum, 2048, 57, 6948, 418, 0, 0, 7423, 1
n1000x8192-slot-sum, 2048, 56, 6938, 414, 0, 0, 7408, 1
n1000x8192-slot-sum, 2048, 57, 6918, 401, 0, 0, 7376, 1
n1000x8192-slot-sum, 2048, 61, 6930, 411, 0, 0, 7402, 1
n1000x8192-slot-sum, 2048, 56, 6925, 405, 0, 0, 7386, 1
n1000x8192-slot-sum, 2048, 57, 6929, 413, 0, 0, 7399, 1
n1000x8192-slot-sum, 2048, 58, 6960, 406, 0, 0, 7424, 1
n1000x8192-slot-sum, 2048, 56, 6943, 418, 0, 0, 7417, 1
n1000x8192-slot-sum, 2048, 58, 6934, 404, 0, 0, 7396, 1
n1000x8192-slot-sum, 2048, 57, 6932, 415, 0, 0, 7404, 1
n1000x8192-slot-sum, 2048, 56, 6934, 406, 0, 0, 7396, 1
n1000x8192-slot-sum, 2048, 57, 6919, 413, 0, 0, 7389, 1
n1000x8192-slot-sum, 2048, 57, 6927, 404, 0, 0, 7388, 1
n1000x8192-slot-sum, 2048, 56, 6924, 418, 0, 0, 7398, 1
n1000x8192-slot-sum, 2048, 57, 6967, 407, 0, 0, 7431, 1
n1000x8192-slot-sum, 2048, 58, 6909, 408, 0, 0, 7375, 1
n1000x8192-slot-sum, 2048, 57, 6917, 401, 0, 0, 7375, 1
n1000x8192-slot-sum, 2048, 57, 6937, 414, 0, 0, 7408, 1
n1000x8192-slot-sum, 2048, 57, 6931, 401, 0, 0, 7389, 1
n1000x8192-slot-sum, 2048, 57, 6936, 414, 0, 0, 7407, 1
n1000x8192-slot-sum, 2048, 56, 6939, 402, 0, 0, 7397, 1
n1000x8192-slot-sum, 2048, 57, 6951, 413, 0, 0, 7421, 1
n1000x8192-slot-sum, 2048, 57, 6931, 405, 0, 0, 7393, 1
n1000x8192-slot-sum, 2048, 57, 6937, 418, 0, 0, 7412, 1
n1000x8192-slot-sum, 2048, 56, 6933, 405, 0, 0, 7394, 1
n1000x8192-slot-sum, 2048, 57, 6938, 411, 0, 0, 7406, 1
n1000x8192-slot-sum, 2048, 57, 6922, 405, 0, 0, 7384, 1
n1000x8192-slot-sum, 2048, 57, 6944, 413, 0, 0, 7414, 1
n1000x8192-slot-sum, 2048, 56, 6934, 407, 0, 0, 7397, 1
n1000x8192-slot-sum, 2048, 57, 6948, 405, 0, 0, 7410, 1
n1000x8192-slot-sum, 2048, 57, 6927, 405, 0, 0, 7389, 1
n1000x8192-slot-sum, 2048, 58, 6942, 403, 0, 0, 7403, 1
n1000x8192-slot-sum, 2048, 57, 6912, 404, 0, 0, 7373, 1
n1000x8192-slot-sum, 2048, 57, 6924, 404, 0, 0, 7385, 1
n1000x8192-slot-sum, 2048, 61, 6958, 417, 0, 0, 7436, 1
n1000x8192-slot-sum, 2048, 57, 6954, 402, 0, 0, 7413, 1
n1000x8192-slot-sum, 2048, 57, 6944, 409, 0, 0, 7410, 1
n1000x8192-slot-sum, 2048, 68, 6927, 408, 0, 0, 7403, 1
n1000x8192-slot-sum, 2048, 57, 6927, 408, 0, 0, 7392, 1
n1000x8192-slot-sum, 2048, 57, 6917, 408, 0, 0, 7382, 1
n1000x8192-slot-sum, 2048, 56, 6952, 410, 0, 0, 7418, 1
n1000x8192-slot-sum, 2048, 56, 6922, 404, 0, 0, 7382, 1
n1000x8192-slot-sum, 2048, 56, 6947, 413, 0, 0, 7416, 1
n1000x8192-slot-sum, 2048, 57, 6914, 408, 0, 0, 7379, 1
n1000x8192-slot-sum, 2048, 57, 6970, 406, 0, 0, 7433, 1
n1000x8192-slot-sum, 2048, 56, 6950, 401, 0, 0, 7407, 1
n1000x8192-slot-sum, 2048, 57, 6951, 401, 0, 0, 7409, 1
n1000x8192-slot-sum, 2048, 57, 6921, 405, 0, 0, 7383, 1
n1000x8192-slot-sum, 2048, 56, 6921, 405, 0, 0, 7382, 1
n1000x8192-slot-sum, 2048, 56, 6935, 404, 0, 0, 7395, 1
n1000x8192-slot-sum, 2048, 57, 6913, 403, 0, 0, 7373, 1
n1000x8192-slot-sum, 2048, 57, 6924, 403, 0, 0, 7384, 1
n1000x8192-slot-sum, 2048, 57, 6952, 406, 0, 0, 7415, 1
n1000x8192-slot-sum, 2048, 57, 6943, 408, 0, 0, 7408, 1
n1000x8192-slot-sum, 2048, 57, 6924, 403, 0, 0, 7384, 1
n1000x8192-slot-sum, 2048, 60, 6938, 407, 0, 0, 7405, 1
n1000x8192-slot-sum, 2048, 57, 6940, 405, 0, 0, 7402, 1
n1000x8192-slot-sum, 2048, 57, 6946, 407, 0, 0, 7410, 1
n1000x8192-slot-sum, 2048, 57, 6936, 409, 0, 0, 7402, 1
n1000x8192-slot-sum, 2048, 56, 6969, 415, 0, 0, 7440, 1
n1000x8192-slot-sum, 2048, 56, 6930, 404, 0, 0, 7390, 1
n1000x8192-slot-sum, 2048, 57, 6931, 404, 0, 0, 7392, 1
n1000x8192-slot-sum, 2048, 56, 6922, 406, 0, 0, 7384, 1
n1000x8192-slot-sum, 2048, 57, 6924, 400, 0, 0, 7381, 1
n1000x8192-slot-sum, 2048, 56, 6934, 405, 0, 0, 7395, 1
n1000x8192-slot-sum, 2048, 57, 6920, 406, 0, 0, 7383, 1
n1000x8192-slot-sum, 2048, 57, 6944, 405, 0, 0, 7406, 1
n1000x8192-slot-sum, 2048, 57, 6930, 409, 0, 0, 7396, 1
n1000x8192-slot-sum, 2048, 57, 6929, 405, 0, 0, 7391, 1
n1000x8192-slot-sum, 2048, 57, 6932, 405, 0, 0, 7394, 1
n1000x8192-slot-sum, 2048, 56, 6921, 404, 0, 0, 7381, 1
n1000x8192-slot-sum, 2048, 57, 6929, 405, 0, 0, 7391, 1
n1000x8192-slot-sum, 2048, 59, 6913, 408, 0, 0, 7380, 1
n1000x8192-slot-sum, 2048, 57, 6942, 406, 0, 0, 7405, 1
n1000x8192-slot-sum, 2048, 56, 6952, 406, 0, 0, 7414, 1
n1000x8192-slot-sum, 2048, 57, 6952, 407, 0, 0, 7416, 1
n1000x8192-slot-sum, 2048, 56, 6945, 404, 0, 0, 7405, 1
n1000x8192-slot-sum, 1024, 31, 6927, 452, 0, 0, 7410, 1
n1000x8192-slot-sum, 1024, 30, 6945, 449, 0, 0, 7424, 1
n1000x8192-slot-sum, 1024, 30, 6928, 451, 0, 0, 7409, 1
n1000x8192-slot-sum, 1024, 30, 6974, 452, 0, 0, 7456, 1
n1000x8192-slot-sum, 1024, 31, 6954, 451, 0, 0, 7436, 1
n1000x8192-slot-sum, 1024, 30, 6940, 451, 0, 0, 7421, 1
n1000x8192-slot-sum, 1024, 31, 6959, 456, 0, 0, 7446, 1
n1000x8192-slot-sum, 1024, 30, 6952, 461, 0, 0, 7443, 1
n1000x8192-slot-sum, 1024, 30, 6967, 449, 0, 0, 7446, 1
n1000x8192-slot-sum, 1024, 31, 6945, 451, 0, 0, 7427, 1
n1000x8192-slot-sum, 1024, 31, 7014, 448, 0, 0, 7493, 1
n1000x8192-slot-sum, 1024, 30, 6937, 452, 0, 0, 7419, 1
n1000x8192-slot-sum, 1024, 31, 6980, 452, 0, 0, 7463, 1
n1000x8192-slot-sum, 1024, 31, 6939, 454, 0, 0, 7424, 1
n1000x8192-slot-sum, 1024, 30, 6925, 447, 0, 0, 7402, 1
n1000x8192-slot-sum, 1024, 31, 6943, 454, 0, 0, 7428, 1
n1000x8192-slot-sum, 1024, 30, 6936, 448, 0, 0, 7414, 1
n1000x8192-slot-sum, 1024, 30, 6954, 451, 0, 0, 7435, 1
n1000x8192-slot-sum, 1024, 30, 6928, 453, 0, 0, 7411, 1
n1000x8192-slot-sum, 1024, 30, 6948, 453, 0, 0, 7431, 1
n1000x8192-slot-sum, 1024, 30, 6932, 452, 0, 0, 7414, 1
n1000x8192-slot-sum, 1024, 31, 6933, 456, 0, 0, 7420, 1
n1000x8192-slot-sum, 1024, 31, 6940, 449, 0, 0, 7420, 1
n1000x8192-slot-sum, 1024, 32, 6923, 453, 0, 0, 7408, 1
n1000x8192-slot-sum, 1024, 30, 6921, 451, 0, 0, 7402, 1
n1000x8192-slot-sum, 1024, 31, 6952, 447, 0, 0, 7430, 1
n1000x8192-slot-sum, 1024, 31, 6932, 445, 0, 0, 7408, 1
n1000x8192-slot-sum, 1024, 31, 6941, 453, 0, 0, 7425, 1
n1000x8192-slot-sum, 1024, 30, 6938, 452, 0, 0, 7420, 1
n1000x8192-slot-sum, 1024, 31, 6944, 451, 0, 0, 7426, 1
n1000x8192-slot-sum, 1024, 30, 6924, 454, 0, 0, 7408, 1
n1000x8192-slot-sum, 1024, 30, 6927, 448, 0, 0, 7405, 1
n1000x8192-slot-sum, 1024, 30, 6926, 449, 0, 0, 7405, 1
n1000x8192-slot-sum, 1024, 31, 6937, 453, 0, 0, 7421, 1
n1000x8192-slot-sum, 1024, 30, 6952, 447, 0, 0, 7429, 1
n1000x8192-slot-sum, 1024, 31, 6937, 451, 0, 0, 7419, 1
n1000x8192-slot-sum, 1024, 30, 6931, 454, 0, 0, 7415, 1
n1000x8192-slot-sum, 1024, 31, 6947, 454, 0, 0, 7432, 1
n1000x8192-slot-sum, 1024, 31, 6950, 451, 0, 0, 7432, 1
n1000x8192-slot-sum, 1024, 30, 6935, 450, 0, 0, 7415, 1
n1000x8192-slot-sum, 1024, 31, 6934, 452, 0, 0, 7417, 1
n1000x8192-slot-sum, 1024, 30, 6939, 450, 0, 0, 7419, 1
n1000x8192-slot-sum, 1024, 30, 6940, 451, 0, 0, 7421, 1
n1000x8192-slot-sum, 1024, 35, 6952, 452, 0, 0, 7439, 1
n1000x8192-slot-sum, 1024, 30, 6947, 450, 0, 0, 7427, 1
n1000x8192-slot-sum, 1024, 31, 6937, 449, 0, 0, 7417, 1
n1000x8192-slot-sum, 1024, 30, 6959, 456, 0, 0, 7445, 1
n1000x8192-slot-sum, 1024, 31, 6963, 451, 0, 0, 7445, 1
n1000x8192-slot-sum, 1024, 30, 6946, 448, 0, 0, 7424, 1
n1000x8192-slot-sum, 1024, 30, 6934, 451, 0, 0, 7415, 1
n1000x8192-slot-sum, 1024, 30, 6925, 455, 0, 0, 7410, 1
n1000x8192-slot-sum, 1024, 33, 6929, 452, 0, 0, 7414, 1
n1000x8192-slot-sum, 1024, 32, 6930, 446, 0, 0, 7408, 1
n1000x8192-slot-sum, 1024, 30, 6929, 450, 0, 0, 7409, 1
n1000x8192-slot-sum, 1024, 30, 6917, 448, 0, 0, 7395, 1
n1000x8192-slot-sum, 1024, 30, 6942, 451, 0, 0, 7423, 1
n1000x8192-slot-sum, 1024, 34, 6913, 451, 0, 0, 7398, 1
n1000x8192-slot-sum, 1024, 30, 6986, 452, 0, 0, 7468, 1
n1000x8192-slot-sum, 1024, 30, 6935, 448, 0, 0, 7413, 1
n1000x8192-slot-sum, 1024, 31, 6942, 449, 0, 0, 7422, 1
n1000x8192-slot-sum, 1024, 31, 6936, 454, 0, 0, 7421, 1
n1000x8192-slot-sum, 1024, 31, 6933, 452, 0, 0, 7416, 1
n1000x8192-slot-sum, 1024, 31, 6983, 455, 0, 0, 7469, 1
n1000x8192-slot-sum, 1024, 30, 6929, 455, 0, 0, 7414, 1
n1000x8192-slot-sum, 1024, 30, 6935, 451, 0, 0, 7416, 1
n1000x8192-slot-sum, 1024, 30, 6931, 455, 0, 0, 7416, 1
n1000x8192-slot-sum, 1024, 30, 6977, 452, 0, 0, 7459, 1
n1000x8192-slot-sum, 1024, 31, 6936, 451, 0, 0, 7418, 1
n1000x8192-slot-sum, 1024, 30, 6935, 453, 0, 0, 7418, 1
n1000x8192-slot-sum, 1024, 31, 6924, 448, 0, 0, 7403, 1
n1000x8192-slot-sum, 1024, 30, 6940, 459, 0, 0, 7429, 1
n1000x8192-slot-sum, 1024, 32, 6952, 449, 0, 0, 7433, 1
n1000x8192-slot-sum, 1024, 30, 6965, 454, 0, 0, 7449, 1
n1000x8192-slot-sum, 1024, 30, 6938, 454, 0, 0, 7422, 1
n1000x8192-slot-sum, 1024, 31, 6927, 445, 0, 0, 7403, 1
n1000x8192-slot-sum, 1024, 37, 6905, 458, 0, 0, 7400, 1
n1000x8192-slot-sum, 1024, 31, 6940, 444, 0, 0, 7415, 1
n1000x8192-slot-sum, 1024, 30, 6934, 453, 0, 0, 7417, 1
n1000x8192-slot-sum, 1024, 30, 6940, 453, 0, 0, 7423, 1
n1000x8192-slot-sum, 1024, 30, 6964, 449, 0, 0, 7443, 1
n1000x8192-slot-sum, 1024, 30, 6934, 454, 0, 0, 7418, 1
n1000x8192-slot-sum, 1024, 31, 6950, 453, 0, 0, 7434, 1
n1000x8192-slot-sum, 1024, 30, 6940, 454, 0, 0, 7424, 1
n1000x8192-slot-sum, 1024, 31, 6930, 447, 0, 0, 7408, 1
n1000x8192-slot-sum, 1024, 30, 6940, 451, 0, 0, 7421, 1
n1000x8192-slot-sum, 1024, 30, 6955, 452, 0, 0, 7437, 1
n1000x8192-slot-sum, 1024, 32, 6945, 451, 0, 0, 7428, 1
n1000x8192-slot-sum, 1024, 30, 6958, 446, 0, 0, 7434, 1
n1000x8192-slot-sum, 1024, 30, 6937, 450, 0, 0, 7417, 1
n1000x8192-slot-sum, 1024, 31, 6926, 448, 0, 0, 7405, 1
n1000x8192-slot-sum, 1024, 30, 6924, 453, 0, 0, 7407, 1
n1000x8192-slot-sum, 1024, 31, 6928, 456, 0, 0, 7415, 1
n1000x8192-slot-sum, 1024, 31, 6953, 449, 0, 0, 7433, 1
n1000x8192-slot-sum, 1024, 30, 6937, 452, 0, 0, 7419, 1
n1000x8192-slot-sum, 1024, 30, 6937, 449, 0, 0, 7416, 1
n1000x8192-slot-sum, 1024, 31, 6954, 450, 0, 0, 7435, 1
n1000x8192-slot-sum, 1024, 31, 6956, 452, 0, 0, 7439, 1
n1000x8192-slot-sum, 1024, 30, 6944, 454, 0, 0, 7428, 1
n1000x8192-slot-sum, 1024, 30, 6942, 451, 0, 0, 7423, 1
n1000x8192-slot-sum, 1024, 31, 6938, 453, 0, 0, 7422, 1
n1000x8192-slot-inner, 8192, 134, 5637, 8367, 0, 0, 14138, 1.36533e+07
n1000x8192-slot-inner, 8192, 135, 5637, 8371, 0, 0, 14143, 1.36533e+07
n1000x8192-slot-inner, 8192, 135, 6045, 9959, 1, 0, 16140, 1.36533e+07
n1000x8192-slot-inner, 8192, 133, 5637, 8329, 0, 0, 14099, 1.36533e+07
n1000x8192-slot-inner, 8192, 133, 5627, 8318, 0, 0, 14078, 1.36533e+07
n1000x8192-slot-inner, 8192, 134, 5634, 8333, 0, 0, 14101, 1.36533e+07
n1000x8192-slot-inner, 8192, 133, 5622, 8344, 0, 0, 14099, 1.36533e+07
n1000x8192-slot-inner, 8192, 133, 5619, 8365, 0, 0, 14117, 1.36533e+07
n1000x8192-slot-inner, 8192, 135, 5626, 8387, 0, 0, 14148, 1.36533e+07
n1000x8192-slot-inner, 8192, 133, 5657, 8348, 0, 0, 14138, 1.36533e+07
n1000x8192-slot-inner, 8192, 135, 5614, 8342, 0, 0, 14091, 1.36533e+07
n1000x8192-slot-inner, 8192, 135, 5615, 8344, 1, 0, 14095, 1.36533e+07
n1000x8192-slot-inner, 8192, 133, 5624, 8351, 0, 0, 14108, 1.36533e+07
n1000x8192-slot-inner, 8192, 133, 5650, 8377, 0, 0, 14160, 1.36533e+07
n1000x8192-slot-inner, 8192, 134, 5620, 8331, 0, 0, 14085, 1.36533e+07
n1000x8192-slot-inner, 8192, 133, 5624, 8343, 0, 0, 14100, 1.36533e+07
n1000x8192-slot-inner, 8192, 133, 5623, 8364, 0, 0, 14120, 1.36533e+07
n1000x8192-slot-inner, 8192, 133, 5629, 8349, 0, 0, 14111, 1.36533e+07
n1000x8192-slot-inner, 8192, 134, 5625, 8373, 0, 0, 14132, 1.36533e+07
n1000x8192-slot-inner, 8192, 133, 5612, 9938, 1, 0, 15684, 1.36533e+07
n1000x8192-slot-inner, 8192, 133, 5617, 8340, 0, 0, 14090, 1.36533e+07
n1000x8192-slot-inner, 8192, 134, 5622, 9871, 1, 0, 15628, 1.36533e+07
n1000x8192-slot-inner, 8192, 133, 5623, 8326, 0, 0, 14082, 1.36533e+07
n1000x8192-slot-inner, 8192, 133, 5623, 8383, 0, 0, 14139, 1.36533e+07
n1000x8192-slot-inner, 8192, 134, 5619, 8336, 0, 0, 14089, 1.36533e+07
n1000x8192-slot-inner, 8192, 133, 5630, 8498, 0, 0, 14261, 1.36533e+07
n1000x8192-slot-inner, 8192, 134, 5664, 8723, 1, 0, 14522, 1.36533e+07
n1000x8192-slot-inner, 8192, 134, 5650, 8689, 1, 0, 14474, 1.36533e+07
n1000x8192-slot-inner, 8192, 133, 5875, 9295, 0, 0, 15303, 1.36533e+07
n1000x8192-slot-inner, 8192, 133, 5656, 8468, 0, 0, 14257, 1.36533e+07
n1000x8192-slot-inner, 8192, 135, 5651, 9136, 1, 0, 14923, 1.36533e+07
n1000x8192-slot-inner, 8192, 134, 5644, 9274, 1, 0, 15053, 1.36533e+07
n1000x8192-slot-inner, 8192, 134, 5659, 8374, 0, 0, 14167, 1.36533e+07
n1000x8192-slot-inner, 8192, 134, 5736, 9451, 1, 0, 15322, 1.36533e+07
n1000x8192-slot-inner, 8192, 133, 6023, 8673, 0, 0, 14829, 1.36533e+07
n1000x8192-slot-inner, 8192, 134, 5642, 9608, 0, 0, 15384, 1.36533e+07
n1000x8192-slot-inner, 8192, 134, 5641, 9602, 0, 0, 15377, 1.36533e+07
n1000x8192-slot-inner, 8192, 135, 5714, 8492, 0, 0, 14341, 1.36533e+07
n1000x8192-slot-inner, 8192, 134, 5706, 8387, 1, 0, 14228, 1.36533e+07
n1000x8192-slot-inner, 8192, 135, 5693, 8761, 1, 0, 14590, 1.36533e+07
n1000x8192-slot-inner, 8192, 141, 5647, 8824, 1, 0, 14613, 1.36533e+07
n1000x8192-slot-inner, 8192, 134, 5922, 9266, 0, 0, 15322, 1.36533e+07
n1000x8192-slot-inner, 8192, 132, 5712, 9150, 1, 0, 14995, 1.36533e+07
n1000x8192-slot-inner, 8192, 134, 6104, 8897, 0, 0, 15135, 1.36533e+07
n1000x8192-slot-inner, 8192, 134, 5647, 8381, 0, 0, 14162, 1.36533e+07
n1000x8192-slot-inner, 8192, 134, 6151, 8799, 0, 0, 15084, 1.36533e+07
n1000x8192-slot-inner, 8192, 133, 5615, 9623, 0, 0, 15371, 1.36533e+07
n1000x8192-slot-inner, 8192, 135, 5609, 9634, 0, 0, 15378, 1.36533e+07
n1000x8192-slot-inner, 8192, 133, 5640, 8614, 1, 0, 14388, 1.36533e+07
n1000x8192-slot-inner, 8192, 135, 5636, 8723, 1, 0, 14495, 1.36533e+07
n1000x8192-slot-inner, 8192, 133, 5697, 8785, 1, 0, 14616, 1.36533e+07
n1000x8192-slot-inner, 8192, 134, 5637, 8365, 0, 0, 14136, 1.36533e+07
n1000x8192-slot-inner, 8192, 133, 5755, 9474, 0, 0, 15362, 1.36533e+07
n1000x8192-slot-inner, 8192, 133, 5645, 8410, 0, 0, 14188, 1.36533e+07
n1000x8192-slot-inner, 8192, 134, 5870, 9276, 0, 0, 15280, 1.36533e+07
n1000x8192-slot-inner, 8192, 133, 5632, 9124, 1, 0, 14890, 1.36533e+07
n1000x8192-slot-inner, 8192, 135, 6043, 8973, 0, 0, 15151, 1.36533e+07
n1000x8192-slot-inner, 8192, 134, 5637, 9455, 1, 0, 15227, 1.36533e+07
n1000x8192-slot-inner, 8192, 133, 6231, 8620, 0, 0, 14984, 1.36533e+07
n1000x8192-slot-inner, 8192, 134, 5627, 8382, 0, 0, 14143, 1.36533e+07
n1000x8192-slot-inner, 8192, 135, 5627, 8475, 0, 0, 14237, 1.36533e+07
n1000x8192-slot-inner, 8192, 140, 5637, 8384, 0, 0, 14161, 1.36533e+07
n1000x8192-slot-inner, 8192, 140, 5619, 9635, 0, 0, 15394, 1.36533e+07
n1000x8192-slot-inner, 8192, 134, 5625, 9595, 0, 0, 15354, 1.36533e+07
n1000x8192-slot-inner, 8192, 133, 5646, 8518, 0, 0, 14297, 1.36533e+07
n1000x8192-slot-inner, 8192, 134, 5623, 9554, 0, 0, 15311, 1.36533e+07
n1000x8192-slot-inner, 8192, 133, 5716, 9481, 0, 0, 15330, 1.36533e+07
n1000x8192-slot-inner, 8192, 133, 5649, 8403, 0, 0, 14185, 1.36533e+07
n1000x8192-slot-inner, 8192, 134, 5640, 9853, 1, 0, 15628, 1.36533e+07
n1000x8192-slot-inner, 8192, 133, 5984, 9120, 0, 0, 15237, 1.36533e+07
n1000x8192-slot-inner, 8192, 134, 6040, 9864, 1, 0, 16039, 1.36533e+07
n1000x8192-slot-inner, 8192, 133, 5636, 8337, 0, 0, 14106, 1.36533e+07
n1000x8192-slot-inner, 8192, 134, 5644, 8342, 0, 0, 14120, 1.36533e+07
n1000x8192-slot-inner, 8192, 135, 5631, 8347, 0, 0, 14113, 1.36533e+07
n1000x8192-slot-inner, 8192, 133, 5645, 8355, 0, 0, 14133, 1.36533e+07
n1000x8192-slot-inner, 8192, 133, 5619, 8330, 0, 0, 14082, 1.36533e+07
n1000x8192-slot-inner, 8192, 135, 5813, 10001, 1, 0, 15950, 1.36533e+07
n1000x8192-slot-inner, 8192, 141, 5620, 8360, 0, 0, 14121, 1.36533e+07
n1000x8192-slot-inner, 8192, 133, 5627, 8341, 0, 0, 14101, 1.36533e+07
n1000x8192-slot-inner, 8192, 134, 5613, 8361, 0, 0, 14108, 1.36533e+07
n1000x8192-slot-inner, 8192, 135, 5634, 8310, 0, 0, 14079, 1.36533e+07
n1000x8192-slot-inner, 8192, 135, 5606, 8334, 0, 0, 14075, 1.36533e+07
n1000x8192-slot-inner, 8192, 134, 5620, 8333, 1, 0, 14088, 1.36533e+07
n1000x8192-slot-inner, 8192, 135, 5618, 8337, 0, 0, 14090, 1.36533e+07
n1000x8192-slot-inner, 8192, 133, 5636, 8331, 0, 0, 14100, 1.36533e+07
n1000x8192-slot-inner, 8192, 133, 5941, 9970, 1, 0, 16045, 1.36533e+07
n1000x8192-slot-inner, 8192, 134, 5629, 8339, 0, 0, 14102, 1.36533e+07
n1000x8192-slot-inner, 8192, 135, 5639, 8375, 0, 0, 14149, 1.36533e+07
n1000x8192-slot-inner, 8192, 133, 5786, 9985, 1, 0, 15905, 1.36533e+07
n1000x8192-slot-inner, 8192, 133, 6087, 9976, 1, 0, 16197, 1.36533e+07
n1000x8192-slot-inner, 8192, 133, 5628, 8364, 0, 0, 14125, 1.36533e+07
n1000x8192-slot-inner, 8192, 133, 5626, 8334, 0, 0, 14093, 1.36533e+07
n1000x8192-slot-inner, 8192, 134, 6058, 9681, 0, 0, 15873, 1.36533e+07
n1000x8192-slot-inner, 8192, 135, 5631, 8339, 0, 0, 14105, 1.36533e+07
n1000x8192-slot-inner, 8192, 134, 5629, 8346, 0, 0, 14109, 1.36533e+07
n1000x8192-slot-inner, 8192, 134, 5625, 8399, 0, 0, 14158, 1.36533e+07
n1000x8192-slot-inner, 8192, 133, 5648, 8344, 0, 0, 14125, 1.36533e+07
n1000x8192-slot-inner, 8192, 134, 6219, 10030, 1, 0, 16384, 1.36533e+07
n1000x8192-slot-inner, 8192, 133, 5609, 8348, 0, 0, 14090, 1.36533e+07
n1000x8192-slot-inner, 8192, 134, 5627, 8319, 0, 0, 14080, 1.36533e+07
n1000x8192-slot-inner, 4096, 64, 5497, 8281, 0, 0, 13842, 1.36533e+07
n1000x8192-slot-inner, 4096, 63, 5465, 8178, 0, 0, 13706, 1.36533e+07
n1000x8192-slot-inner, 4096, 64, 5481, 8141, 0, 0, 13686, 1.36533e+07
n1000x8192-slot-inner, 4096, 64, 5479, 8320, 0, 0, 13863, 1.36533e+07
n1000x8192-slot-inner, 4096, 64, 5495, 8150, 0, 0, 13709, 1.36533e+07
n1000x8192-slot-inner, 4096, 64, 5466, 8155, 0, 0, 13685, 1.36533e+07
n1000x8192-slot-inner, 4096, 64, 5458, 8161, 0, 0, 13683, 1.36533e+07
n1000x8192-slot-inner, 4096, 63, 5458, 8175, 0, 0, 13696, 1.36533e+07
n1000x8192-slot-inner, 4096, 64, 5452, 8191, 0, 0, 13707, 1.36533e+07
n1000x8192-slot-inner, 4096, 63, 5581, 9635, 0, 0, 15279, 1.36533e+07
n1000x8192-slot-inner, 4096, 64, 5473, 8222, 0, 0, 13759, 1.36533e+07
n1000x8192-slot-inner, 4096, 63, 5456, 8185, 0, 0, 13704, 1.36533e+07
n1000x8192-slot-inner, 4096, 63, 5468, 9273, 0, 0, 14804, 1.36533e+07
n1000x8192-slot-inner, 4096, 64, 5463, 8179, 0, 0, 13706, 1.36533e+07
n1000x8192-slot-inner, 4096, 64, 5456, 8177, 0, 0, 13697, 1.36533e+07
n1000x8192-slot-inner, 4096, 63, 5464, 8192, 0, 0, 13719, 1.36533e+07
n1000x8192-slot-inner, 4096, 65, 5477, 8157, 0, 0, 13699, 1.36533e+07
n1000x8192-slot-inner, 4096, 63, 5458, 8185, 0, 0, 13706, 1.36533e+07
n1000x8192-slot-inner, 4096, 64, 5454, 8191, 0, 0, 13709, 1.36533e+07
n1000x8192-slot-inner, 4096, 64, 5467, 8168, 0, 0, 13699, 1.36533e+07
n1000x8192-slot-inner, 4096, 64, 5474, 8201, 0, 0, 13739, 1.36533e+07
n1000x8192-slot-inner, 4096, 64, 5466, 8172, 0, 0, 13702, 1.36533e+07
n1000x8192-slot-inner, 4096, 63, 5463, 8177, 0, 0, 13703, 1.36533e+07
n1000x8192-slot-inner, 4096, 64, 5736, 8587, 0, 0, 14387, 1.36533e+07
n1000x8192-slot-inner, 4096, 64, 5468, 8173, 0, 0, 13705, 1.36533e+07
n1000x8192-slot-inner, 4096, 64, 6017, 9290, 0, 0, 15371, 1.36533e+07
n1000x8192-slot-inner, 4096, 65, 5464, 8148, 0, 0, 13677, 1.36533e+07
n1000x8192-slot-inner, 4096, 63, 5466, 8144, 0, 0, 13673, 1.36533e+07
n1000x8192-slot-inner, 4096, 63, 5483, 8154, 0, 0, 13700, 1.36533e+07
n1000x8192-slot-inner, 4096, 65, 5477, 8172, 0, 0, 13714, 1.36533e+07
n1000x8192-slot-inner, 4096, 65, 5473, 8190, 0, 0, 13728, 1.36533e+07
n1000x8192-slot-inner, 4096, 64, 5461, 9610, 0, 0, 15135, 1.36533e+07
n1000x8192-slot-inner, 4096, 64, 5473, 8151, 0, 0, 13688, 1.36533e+07
n1000x8192-slot-inner, 4096, 64, 5476, 8165, 0, 0, 13705, 1.36533e+07
n1000x8192-slot-inner, 4096, 64, 5882, 9634, 0, 0, 15580, 1.36533e+07
n1000x8192-slot-inner, 4096, 64, 5473, 8184, 0, 0, 13721, 1.36533e+07
n1000x8192-slot-inner, 4096, 63, 5473, 8202, 0, 0, 13738, 1.36533e+07
n1000x8192-slot-inner, 4096, 64, 5495, 8218, 0, 0, 13777, 1.36533e+07
n1000x8192-slot-inner, 4096, 64, 5473, 8131, 0, 0, 13668, 1.36533e+07
n1000x8192-slot-inner, 4096, 64, 5474, 8171, 0, 0, 13709, 1.36533e+07
n1000x8192-slot-inner, 4096, 64, 5464, 8172, 0, 0, 13700, 1.36533e+07
n1000x8192-slot-inner, 4096, 63, 5464, 8208, 0, 0, 13735, 1.36533e+07
n1000x8192-slot-inner, 4096, 64, 5489, 9619, 0, 0, 15172, 1.36533e+07
n1000x8192-slot-inner, 4096, 64, 5470, 8189, 0, 0, 13723, 1.36533e+07
n1000x8192-slot-inner, 4096, 64, 5461, 8173, 0, 0, 13698, 1.36533e+07
n1000x8192-slot-inner, 4096, 63, 5476, 8184, 0, 0, 13723, 1.36533e+07
n1000x8192-slot-inner, 4096, 63, 5471, 8173, 0, 0, 13707, 1.36533e+07
n1000x8192-slot-inner, 4096, 63, 5485, 8379, 0, 0, 13927, 1.36533e+07
n1000x8192-slot-inner, 4096, 64, 5456, 8177, 0, 0, 13697, 1.36533e+07
n1000x8192-slot-inner, 4096, 65, 5465, 8189, 0, 0, 13719, 1.36533e+07
n1000x8192-slot-inner, 4096, 63, 5465, 8917, 0, 0, 14445, 1.36533e+07
n1000x8192-slot-inner, 4096, 64, 5471, 8151, 0, 0, 13686, 1.36533e+07
n1000x8192-slot-inner, 4096, 64, 5462, 8173, 0, 0, 13699, 1.36533e+07
n1000x8192-slot-inner, 4096, 63, 5468, 8168, 0, 0, 13699, 1.36533e+07
n1000x8192-slot-inner, 4096, 64, 5466, 8193, 0, 0, 13723, 1.36533e+07
n1000x8192-slot-inner, 4096, 64, 5458, 8150, 0, 0, 13672, 1.36533e+07
n1000x8192-slot-inner, 4096, 64, 5471, 8147, 0, 0, 13682, 1.36533e+07
n1000x8192-slot-inner, 4096, 64, 5472, 8144, 0, 0, 13680, 1.36533e+07
n1000x8192-slot-inner, 4096, 63, 5499, 8221, 0, 0, 13783, 1.36533e+07
n1000x8192-slot-inner, 4096, 63, 5982, 9621, 0, 0, 15666, 1.36533e+07
n1000x8192-slot-inner, 4096, 63, 5490, 8182, 0, 0, 13735, 1.36533e+07
n1000x8192-slot-inner, 4096, 64, 5472, 8174, 0, 0, 13710, 1.36533e+07
n1000x8192-slot-inner, 4096, 64, 5483, 8181, 0, 0, 13728, 1.36533e+07
n1000x8192-slot-inner, 4096, 64, 5467, 8184, 0, 0, 13715, 1.36533e+07
n1000x8192-slot-inner, 4096, 63, 5479, 9362, 0, 0, 14904, 1.36533e+07
n1000x8192-slot-inner, 4096, 64, 5474, 8173, 0, 0, 13711, 1.36533e+07
n1000x8192-slot-inner, 4096, 63, 5567, 9653, 0, 0, 15283, 1.36533e+07
n1000x8192-slot-inner, 4096, 64, 5469, 8154, 0, 0, 13687, 1.36533e+07
n1000x8192-slot-inner, 4096, 64, 5475, 8172, 0, 0, 13711, 1.36533e+07
n1000x8192-slot-inner, 4096, 63, 5453, 8171, 0, 0, 13687, 1.36533e+07
n1000x8192-slot-inner, 4096, 64, 5458, 8172, 0, 0, 13694, 1.36533e+07
n1000x8192-slot-inner, 4096, 63, 5472, 8198, 0, 0, 13733, 1.36533e+07
n1000x8192-slot-inner, 4096, 64, 5453, 8169, 0, 0, 13686, 1.36533e+07
n1000x8192-slot-inner, 4096, 63, 5475, 8173, 0, 0, 13711, 1.36533e+07
n1000x8192-slot-inner, 4096, 64, 5471, 9040, 0, 0, 14575, 1.36533e+07
n1000x8192-slot-inner, 4096, 63, 5472, 9389, 0, 0, 14924, 1.36533e+07
n1000x8192-slot-inner, 4096, 63, 5466, 8168, 0, 0, 13697, 1.36533e+07
n1000x8192-slot-inner, 4096, 63, 5457, 8187, 0, 0, 13707, 1.36533e+07
n1000x8192-slot-inner, 4096, 63, 5459, 8833, 0, 0, 14355, 1.36533e+07
n1000x8192-slot-inner, 4096, 64, 5477, 8178, 0, 0, 13719, 1.36533e+07
n1000x8192-slot-inner, 4096, 64, 5475, 8206, 0, 0, 13745, 1.36533e+07
n1000x8192-slot-inner, 4096, 64, 5466, 8167, 0, 0, 13697, 1.36533e+07
n1000x8192-slot-inner, 4096, 64, 5538, 8185, 0, 0, 13787, 1.36533e+07
n1000x8192-slot-inner, 4096, 64, 5463, 8197, 0, 0, 13724, 1.36533e+07
n1000x8192-slot-inner, 4096, 64, 5469, 8225, 0, 0, 13758, 1.36533e+07
n1000x8192-slot-inner, 4096, 64, 5463, 8165, 0, 0, 13692, 1.36533e+07
n1000x8192-slot-inner, 4096, 64, 5474, 8157, 0, 0, 13695, 1.36533e+07
n1000x8192-slot-inner, 4096, 64, 5981, 9652, 0, 0, 15697, 1.36533e+07
n1000x8192-slot-inner, 4096, 64, 5462, 8164, 0, 0, 13690, 1.36533e+07
n1000x8192-slot-inner, 4096, 64, 5468, 8167, 0, 0, 13699, 1.36533e+07
n1000x8192-slot-inner, 4096, 63, 5489, 8154, 0, 0, 13706, 1.36533e+07
n1000x8192-slot-inner, 4096, 64, 5905, 9700, 0, 0, 15669, 1.36533e+07
n1000x8192-slot-inner, 4096, 63, 5474, 8172, 0, 0, 13709, 1.36533e+07
n1000x8192-slot-inner, 4096, 64, 5473, 8170, 0, 0, 13707, 1.36533e+07
n1000x8192-slot-inner, 4096, 63, 5469, 8177, 0, 0, 13709, 1.36533e+07
n1000x8192-slot-inner, 4096, 64, 5771, 9625, 0, 0, 15460, 1.36533e+07
n1000x8192-slot-inner, 4096, 63, 5468, 8176, 0, 0, 13707, 1.36533e+07
n1000x8192-slot-inner, 4096, 64, 5476, 8138, 0, 0, 13678, 1.36533e+07
n1000x8192-slot-inner, 4096, 64, 5483, 8189, 0, 0, 13736, 1.36533e+07
n1000x8192-slot-inner, 4096, 64, 5487, 8145, 0, 0, 13696, 1.36533e+07
n1000x8192-slot-inner, 2048, 61, 6931, 12862, 0, 0, 19854, 1.36533e+07
n1000x8192-slot-inner, 2048, 62, 6930, 12859, 0, 0, 19851, 1.36533e+07
n1000x8192-slot-inner, 2048, 61, 6929, 12927, 0, 0, 19917, 1.36533e+07
n1000x8192-slot-inner, 2048, 64, 6942, 13385, 0, 0, 20391, 1.36533e+07
n1000x8192-slot-inner, 2048, 60, 6921, 12835, 0, 0, 19816, 1.36533e+07
n1000x8192-slot-inner, 2048, 61, 6953, 12851, 0, 0, 19865, 1.36533e+07
n1000x8192-slot-inner, 2048, 62, 6943, 12878, 0, 0, 19883, 1.36533e+07
n1000x8192-slot-inner, 2048, 60, 6925, 12890, 0, 0, 19875, 1.36533e+07
n1000x8192-slot-inner, 2048, 62, 6953, 12871, 0, 0, 19886, 1.36533e+07
n1000x8192-slot-inner, 2048, 67, 6933, 12857, 0, 0, 19857, 1.36533e+07
n1000x8192-slot-inner, 2048, 61, 6911, 12822, 0, 0, 19794, 1.36533e+07
n1000x8192-slot-inner, 2048, 60, 6949, 13332, 0, 0, 20341, 1.36533e+07
n1000x8192-slot-inner, 2048, 61, 6924, 12835, 0, 0, 19820, 1.36533e+07
n1000x8192-slot-inner, 2048, 61, 6926, 12907, 0, 0, 19894, 1.36533e+07
n1000x8192-slot-inner, 2048, 61, 6946, 12952, 0, 0, 19959, 1.36533e+07
n1000x8192-slot-inner, 2048, 60, 6913, 12830, 0, 0, 19803, 1.36533e+07
n1000x8192-slot-inner, 2048, 61, 6960, 12878, 0, 0, 19899, 1.36533e+07
n1000x8192-slot-inner, 2048, 61, 6987, 12936, 0, 0, 19984, 1.36533e+07
n1000x8192-slot-inner, 2048, 61, 6936, 12939, 0, 0, 19936, 1.36533e+07
n1000x8192-slot-inner, 2048, 61, 6938, 12898, 0, 0, 19897, 1.36533e+07
n1000x8192-slot-inner, 2048, 64, 6932, 12871, 0, 0, 19867, 1.36533e+07
n1000x8192-slot-inner, 2048, 61, 6937, 12874, 0, 0, 19872, 1.36533e+07
n1000x8192-slot-inner, 2048, 62, 6953, 12905, 0, 0, 19920, 1.36533e+07
n1000x8192-slot-inner, 2048, 61, 6953, 12950, 0, 0, 19964, 1.36533e+07
n1000x8192-slot-inner, 2048, 62, 6943, 12826, 0, 0, 19831, 1.36533e+07
n1000x8192-slot-inner, 2048, 61, 6955, 12887, 0, 0, 19903, 1.36533e+07
n1000x8192-slot-inner, 2048, 61, 6942, 12859, 0, 0, 19862, 1.36533e+07
n1000x8192-slot-inner, 2048, 61, 6934, 12828, 0, 0, 19823, 1.36533e+07
n1000x8192-slot-inner, 2048, 61, 6938, 12852, 0, 0, 19851, 1.36533e+07
n1000x8192-slot-inner, 2048, 60, 6936, 12856, 0, 0, 19852, 1.36533e+07
n1000x8192-slot-inner, 2048, 61, 6934, 12850, 0, 0, 19845, 1.36533e+07
n1000x8192-slot-inner, 2048, 61, 6958, 12896, 0, 0, 19915, 1.36533e+07
n1000x8192-slot-inner, 2048, 61, 6928, 12845, 0, 0, 19834, 1.36533e+07
n1000x8192-slot-inner, 2048, 64, 6940, 12856, 0, 0, 19860, 1.36533e+07
n1000x8192-slot-inner, 2048, 61, 6924, 12887, 0, 0, 19872, 1.36533e+07
n1000x8192-slot-inner, 2048, 61, 6937, 12797, 0, 0, 19795, 1.36533e+07
n1000x8192-slot-inner, 2048, 61, 6930, 12896, 0, 0, 19887, 1.36533e+07
n1000x8192-slot-inner, 2048, 60, 6938, 12810, 0, 0, 19808, 1.36533e+07
n1000x8192-slot-inner, 2048, 62, 6963, 12811, 0, 0, 19836, 1.36533e+07
n1000x8192-slot-inner, 2048, 61, 7009, 12902, 0, 0, 19972, 1.36533e+07
n1000x8192-slot-inner, 2048, 61, 6930, 13225, 0, 0, 20216, 1.36533e+07
n1000x8192-slot-inner, 2048, 63, 6939, 12848, 0, 0, 19850, 1.36533e+07
n1000x8192-slot-inner, 2048, 63, 6948, 12886, 0, 0, 19897, 1.36533e+07
n1000x8192-slot-inner, 2048, 61, 6934, 12865, 0, 0, 19860, 1.36533e+07
n1000x8192-slot-inner, 2048, 62, 6929, 13054, 0, 0, 20045, 1.36533e+07
n1000x8192-slot-inner, 2048, 63, 6916, 12803, 0, 0, 19782, 1.36533e+07
n1000x8192-slot-inner, 2048, 62, 6932, 12858, 0, 0, 19852, 1.36533e+07
n1000x8192-slot-inner, 2048, 61, 6936, 13361, 0, 0, 20358, 1.36533e+07
n1000x8192-slot-inner, 2048, 61, 6930, 12852, 0, 0, 19843, 1.36533e+07
n1000x8192-slot-inner, 2048, 61, 6950, 13434, 0, 0, 20445, 1.36533e+07
n1000x8192-slot-inner, 2048, 61, 6943, 12880, 0, 0, 19884, 1.36533e+07
n1000x8192-slot-inner, 2048, 60, 6923, 12827, 0, 0, 19810, 1.36533e+07
n1000x8192-slot-inner, 2048, 61, 6976, 12908, 0, 0, 19945, 1.36533e+07
n1000x8192-slot-inner, 2048, 61, 6935, 12885, 0, 0, 19881, 1.36533e+07
n1000x8192-slot-inner, 2048, 61, 6928, 12843, 0, 0, 19832, 1.36533e+07
n1000x8192-slot-inner, 2048, 64, 6951, 13416, 0, 0, 20431, 1.36533e+07
n1000x8192-slot-inner, 2048, 60, 6945, 12846, 0, 0, 19851, 1.36533e+07
n1000x8192-slot-inner, 2048, 61, 6950, 12866, 0, 0, 19877, 1.36533e+07
n1000x8192-slot-inner, 2048, 62, 6939, 13118, 0, 0, 20119, 1.36533e+07
n1000x8192-slot-inner, 2048, 60, 6934, 12909, 0, 0, 19903, 1.36533e+07
n1000x8192-slot-inner, 2048, 61, 6954, 12873, 0, 0, 19888, 1.36533e+07
n1000x8192-slot-inner, 2048, 60, 6939, 12834, 0, 0, 19833, 1.36533e+07
n1000x8192-slot-inner, 2048, 64, 6926, 13353, 0, 0, 20343, 1.36533e+07
n1000x8192-slot-inner, 2048, 61, 6932, 12826, 0, 0, 19819, 1.36533e+07
n1000x8192-slot-inner, 2048, 60, 6923, 12878, 0, 0, 19861, 1.36533e+07
n1000x8192-slot-inner, 2048, 65, 6936, 12824, 0, 0, 19825, 1.36533e+07
n1000x8192-slot-inner, 2048, 61, 6936, 12866, 0, 0, 19863, 1.36533e+07
n1000x8192-slot-inner, 2048, 60, 6956, 12826, 0, 0, 19842, 1.36533e+07
n1000x8192-slot-inner, 2048, 62, 6934, 12841, 0, 0, 19837, 1.36533e+07
n1000x8192-slot-inner, 2048, 61, 6935, 13010, 0, 0, 20006, 1.36533e+07
n1000x8192-slot-inner, 2048, 60, 6931, 12853, 0, 0, 19844, 1.36533e+07
n1000x8192-slot-inner, 2048, 61, 6926, 12819, 0, 0, 19806, 1.36533e+07
n1000x8192-slot-inner, 2048, 61, 6926, 12841, 0, 0, 19828, 1.36533e+07
n1000x8192-slot-inner, 2048, 60, 6943, 12830, 0, 0, 19833, 1.36533e+07
n1000x8192-slot-inner, 2048, 61, 6921, 12862, 0, 0, 19844, 1.36533e+07
n1000x8192-slot-inner, 2048, 61, 6934, 12871, 0, 0, 19866, 1.36533e+07
n1000x8192-slot-inner, 2048, 61, 6967, 12997, 0, 0, 20025, 1.36533e+07
n1000x8192-slot-inner, 2048, 62, 6933, 12807, 0, 0, 19802, 1.36533e+07
n1000x8192-slot-inner, 2048, 61, 6943, 12898, 0, 0, 19902, 1.36533e+07
n1000x8192-slot-inner, 2048, 61, 6956, 12812, 0, 0, 19829, 1.36533e+07
n1000x8192-slot-inner, 2048, 61, 6939, 12856, 0, 0, 19856, 1.36533e+07
n1000x8192-slot-inner, 2048, 61, 6935, 12881, 0, 0, 19877, 1.36533e+07
n1000x8192-slot-inner, 2048, 62, 6941, 12932, 0, 0, 19935, 1.36533e+07
n1000x8192-slot-inner, 2048, 64, 6957, 12892, 0, 0, 19913, 1.36533e+07
n1000x8192-slot-inner, 2048, 62, 6942, 13312, 0, 0, 20316, 1.36533e+07
n1000x8192-slot-inner, 2048, 61, 6955, 12829, 0, 0, 19845, 1.36533e+07
n1000x8192-slot-inner, 2048, 61, 6932, 12890, 0, 0, 19883, 1.36533e+07
n1000x8192-slot-inner, 2048, 62, 6938, 12859, 0, 0, 19859, 1.36533e+07
n1000x8192-slot-inner, 2048, 60, 6936, 12855, 0, 0, 19851, 1.36533e+07
n1000x8192-slot-inner, 2048, 61, 6927, 12899, 0, 0, 19887, 1.36533e+07
n1000x8192-slot-inner, 2048, 61, 6948, 12861, 0, 0, 19870, 1.36533e+07
n1000x8192-slot-inner, 2048, 62, 6941, 12949, 0, 0, 19952, 1.36533e+07
n1000x8192-slot-inner, 2048, 61, 6933, 12832, 0, 0, 19826, 1.36533e+07
n1000x8192-slot-inner, 2048, 60, 6953, 12839, 0, 0, 19852, 1.36533e+07
n1000x8192-slot-inner, 2048, 61, 6941, 12829, 0, 0, 19831, 1.36533e+07
n1000x8192-slot-inner, 2048, 61, 6917, 12830, 0, 0, 19808, 1.36533e+07
n1000x8192-slot-inner, 2048, 61, 6952, 12851, 0, 0, 19864, 1.36533e+07
n1000x8192-slot-inner, 2048, 61, 6915, 12818, 0, 0, 19794, 1.36533e+07
n1000x8192-slot-inner, 2048, 60, 6927, 12813, 0, 0, 19800, 1.36533e+07
n1000x8192-slot-inner, 2048, 61, 6925, 12983, 0, 0, 19969, 1.36533e+07
n1000x8192-slot-inner, 1024, 33, 6926, 13365, 0, 0, 20324, 1.36533e+07
n1000x8192-slot-inner, 1024, 32, 6933, 13335, 0, 0, 20300, 1.36533e+07
n1000x8192-slot-inner, 1024, 32, 6935, 13334, 0, 0, 20301, 1.36533e+07
n1000x8192-slot-inner, 1024, 32, 6924, 13408, 0, 0, 20364, 1.36533e+07
n1000x8192-slot-inner, 1024, 32, 6953, 13453, 0, 0, 20438, 1.36533e+07
n1000x8192-slot-inner, 1024, 33, 6934, 13360, 0, 0, 20327, 1.36533e+07
n1000x8192-slot-inner, 1024, 32, 6955, 13381, 0, 0, 20368, 1.36533e+07
n1000x8192-slot-inner, 1024, 33, 6948, 13567, 0, 0, 20548, 1.36533e+07
n1000x8192-slot-inner, 1024, 32, 6942, 13322, 0, 0, 20296, 1.36533e+07
n1000x8192-slot-inner, 1024, 32, 6950, 13348, 0, 0, 20330, 1.36533e+07
n1000x8192-slot-inner, 1024, 32, 6941, 13720, 0, 0, 20693, 1.36533e+07
n1000x8192-slot-inner, 1024, 34, 6988, 13380, 0, 0, 20402, 1.36533e+07
n1000x8192-slot-inner, 1024, 33, 6939, 13343, 0, 0, 20315, 1.36533e+07
n1000x8192-slot-inner, 1024, 32, 6943, 13363, 0, 0, 20338, 1.36533e+07
n1000x8192-slot-inner, 1024, 32, 6957, 13366, 0, 0, 20355, 1.36533e+07
n1000x8192-slot-inner, 1024, 32, 6941, 13361, 0, 0, 20334, 1.36533e+07
n1000x8192-slot-inner, 1024, 35, 6981, 13374, 0, 0, 20390, 1.36533e+07
n1000x8192-slot-inner, 1024, 32, 6935, 13336, 0, 0, 20303, 1.36533e+07
n1000x8192-slot-inner, 1024, 34, 6933, 13341, 0, 0, 20308, 1.36533e+07
n1000x8192-slot-inner, 1024, 33, 6964, 13393, 0, 0, 20390, 1.36533e+07
n1000x8192-slot-inner, 1024, 33, 6940, 13351, 0, 0, 20324, 1.36533e+07
n1000x8192-slot-inner, 1024, 33, 6950, 13403, 0, 0, 20386, 1.36533e+07
n1000x8192-slot-inner, 1024, 32, 6937, 13396, 0, 0, 20365, 1.36533e+07
n1000x8192-slot-inner, 1024, 32, 6929, 13378, 0, 0, 20339, 1.36533e+07
n1000x8192-slot-inner, 1024, 32, 6939, 13431, 0, 0, 20402, 1.36533e+07
n1000x8192-slot-inner, 1024, 33, 6942, 13394, 0, 0, 20369, 1.36533e+07
n1000x8192-slot-inner, 1024, 32, 7241, 13729, 0, 0, 21002, 1.36533e+07
n1000x8192-slot-inner, 1024, 33, 6945, 13539, 0, 0, 20517, 1.36533e+07
n1000x8192-slot-inner, 1024, 32, 6950, 13440, 0, 0, 20422, 1.36533e+07
n1000x8192-slot-inner, 1024, 32, 6936, 13339, 0, 0, 20307, 1.36533e+07
n1000x8192-slot-inner, 1024, 33, 6940, 13652, 0, 0, 20625, 1.36533e+07
n1000x8192-slot-inner, 1024, 37, 6946, 13835, 0, 0, 20818, 1.36533e+07
n1000x8192-slot-inner, 1024, 32, 6935, 13379, 0, 0, 20346, 1.36533e+07
n1000x8192-slot-inner, 1024, 32, 6926, 13391, 0, 0, 20349, 1.36533e+07
n1000x8192-slot-inner, 1024, 33, 6983, 13390, 0, 0, 20406, 1.36533e+07
n1000x8192-slot-inner, 1024, 32, 6929, 13345, 0, 0, 20306, 1.36533e+07
n1000x8192-slot-inner, 1024, 33, 6974, 13370, 0, 0, 20377, 1.36533e+07
n1000x8192-slot-inner, 1024, 33, 6937, 13347, 0, 0, 20317, 1.36533e+07
n1000x8192-slot-inner, 1024, 32, 6939, 13348, 0, 0, 20319, 1.36533e+07
n1000x8192-slot-inner, 1024, 32, 6957, 13469, 0, 0, 20458, 1.36533e+07
n1000x8192-slot-inner, 1024, 32, 6942, 13349, 0, 0, 20323, 1.36533e+07
n1000x8192-slot-inner, 1024, 32, 6927, 13420, 0, 0, 20379, 1.36533e+07
n1000x8192-slot-inner, 1024, 32, 6928, 13348, 0, 0, 20308, 1.36533e+07
n1000x8192-slot-inner, 1024, 33, 6945, 13391, 0, 0, 20369, 1.36533e+07
n1000x8192-slot-inner, 1024, 33, 6942, 13399, 0, 0, 20374, 1.36533e+07
n1000x8192-slot-inner, 1024, 33, 6938, 13690, 0, 0, 20661, 1.36533e+07
n1000x8192-slot-inner, 1024, 33, 6923, 13385, 0, 0, 20341, 1.36533e+07
n1000x8192-slot-inner, 1024, 33, 6950, 13397, 0, 0, 20380, 1.36533e+07
n1000x8192-slot-inner, 1024, 33, 6946, 13432, 0, 0, 20411, 1.36533e+07
n1000x8192-slot-inner, 1024, 33, 6943, 13330, 0, 0, 20306, 1.36533e+07
n1000x8192-slot-inner, 1024, 32, 6950, 13390, 0, 0, 20372, 1.36533e+07
n1000x8192-slot-inner, 1024, 34, 6982, 13468, 0, 0, 20484, 1.36533e+07
n1000x8192-slot-inner, 1024, 33, 6938, 13342, 0, 0, 20313, 1.36533e+07
n1000x8192-slot-inner, 1024, 33, 6953, 13433, 0, 0, 20419, 1.36533e+07
n1000x8192-slot-inner, 1024, 33, 7022, 13899, 0, 0, 20954, 1.36533e+07
n1000x8192-slot-inner, 1024, 34, 6994, 13351, 0, 0, 20379, 1.36533e+07
n1000x8192-slot-inner, 1024, 34, 6949, 13438, 0, 0, 20421, 1.36533e+07
n1000x8192-slot-inner, 1024, 34, 6938, 13409, 0, 0, 20381, 1.36533e+07
n1000x8192-slot-inner, 1024, 33, 6940, 13377, 0, 0, 20350, 1.36533e+07
n1000x8192-slot-inner, 1024, 36, 6963, 13441, 0, 0, 20440, 1.36533e+07
n1000x8192-slot-inner, 1024, 33, 6946, 13373, 0, 0, 20352, 1.36533e+07
n1000x8192-slot-inner, 1024, 32, 6954, 13415, 0, 0, 20401, 1.36533e+07
n1000x8192-slot-inner, 1024, 33, 6945, 13675, 0, 0, 20653, 1.36533e+07
n1000x8192-slot-inner, 1024, 32, 6939, 13370, 0, 0, 20341, 1.36533e+07
n1000x8192-slot-inner, 1024, 37, 6944, 13807, 0, 0, 20788, 1.36533e+07
n1000x8192-slot-inner, 1024, 34, 6947, 13418, 0, 0, 20399, 1.36533e+07
n1000x8192-slot-inner, 1024, 32, 6970, 13339, 0, 0, 20341, 1.36533e+07
n1000x8192-slot-inner, 1024, 33, 6951, 13578, 0, 0, 20562, 1.36533e+07
n1000x8192-slot-inner, 1024, 32, 7022, 13396, 0, 0, 20450, 1.36533e+07
n1000x8192-slot-inner, 1024, 32, 6945, 13336, 0, 0, 20313, 1.36533e+07
n1000x8192-slot-inner, 1024, 37, 6930, 13826, 0, 0, 20793, 1.36533e+07
n1000x8192-slot-inner, 1024, 33, 6938, 13418, 0, 0, 20389, 1.36533e+07
n1000x8192-slot-inner, 1024, 32, 6922, 13370, 0, 0, 20324, 1.36533e+07
n1000x8192-slot-inner, 1024, 33, 6937, 13351, 0, 0, 20321, 1.36533e+07
n1000x8192-slot-inner, 1024, 33, 6986, 13407, 0, 0, 20426, 1.36533e+07
n1000x8192-slot-inner, 1024, 32, 6934, 13339, 0, 0, 20305, 1.36533e+07
n1000x8192-slot-inner, 1024, 32, 6948, 13329, 0, 0, 20309, 1.36533e+07
n1000x8192-slot-inner, 1024, 33, 6954, 13340, 0, 0, 20327, 1.36533e+07
n1000x8192-slot-inner, 1024, 33, 6939, 13407, 0, 0, 20379, 1.36533e+07
n1000x8192-slot-inner, 1024, 32, 6979, 13564, 0, 0, 20575, 1.36533e+07
n1000x8192-slot-inner, 1024, 32, 7003, 13394, 0, 0, 20429, 1.36533e+07
n1000x8192-slot-inner, 1024, 33, 6948, 13414, 0, 0, 20395, 1.36533e+07
n1000x8192-slot-inner, 1024, 33, 6928, 13412, 0, 0, 20373, 1.36533e+07
n1000x8192-slot-inner, 1024, 32, 6957, 13374, 0, 0, 20363, 1.36533e+07
n1000x8192-slot-inner, 1024, 32, 6952, 13435, 0, 0, 20419, 1.36533e+07
n1000x8192-slot-inner, 1024, 33, 6941, 13332, 0, 0, 20306, 1.36533e+07
n1000x8192-slot-inner, 1024, 32, 6933, 13840, 0, 0, 20805, 1.36533e+07
n1000x8192-slot-inner, 1024, 33, 6953, 13604, 0, 0, 20590, 1.36533e+07
n1000x8192-slot-inner, 1024, 33, 6945, 13389, 0, 0, 20367, 1.36533e+07
n1000x8192-slot-inner, 1024, 32, 6950, 13355, 0, 0, 20337, 1.36533e+07
n1000x8192-slot-inner, 1024, 34, 6932, 13372, 0, 0, 20338, 1.36533e+07
n1000x8192-slot-inner, 1024, 32, 6936, 13431, 0, 0, 20399, 1.36533e+07
n1000x8192-slot-inner, 1024, 33, 6929, 13359, 0, 0, 20321, 1.36533e+07
n1000x8192-slot-inner, 1024, 33, 6953, 13414, 0, 0, 20400, 1.36533e+07
n1000x8192-slot-inner, 1024, 32, 6950, 13360, 0, 0, 20342, 1.36533e+07
n1000x8192-slot-inner, 1024, 36, 6935, 13872, 0, 0, 20843, 1.36533e+07
n1000x8192-slot-inner, 1024, 32, 6965, 13392, 0, 0, 20389, 1.36533e+07
n1000x8192-slot-inner, 1024, 33, 6930, 13374, 0, 0, 20337, 1.36533e+07
n1000x8192-slot-inner, 1024, 37, 6911, 13819, 0, 0, 20767, 1.36533e+07
n1000x8192-slot-inner, 1024, 32, 6983, 13443, 0, 0, 20458, 1.36533e+07
n1000x8192-coef-inner, 8192, 30, 21848, 10006, 1, 0, 31885, 1.36533e+07
n1000x8192-coef-inner, 8192, 30, 21371, 8475, 0, 0, 29876, 1.36533e+07
n1000x8192-coef-inner, 8192, 30, 20857, 9998, 1, 0, 30886, 1.36533e+07
n1000x8192-coef-inner, 8192, 30, 22260, 8353, 0, 0, 30643, 1.36533e+07
n1000x8192-coef-inner, 8192, 30, 20572, 8361, 0, 0, 28963, 1.36533e+07
n1000x8192-coef-inner, 8192, 29, 20642, 9969, 1, 0, 30641, 1.36533e+07
n1000x8192-coef-inner, 8192, 30, 20576, 8358, 0, 0, 28964, 1.36533e+07
n1000x8192-coef-inner, 8192, 29, 20575, 8364, 0, 0, 28968, 1.36533e+07
n1000x8192-coef-inner, 8192, 29, 20555, 8346, 0, 0, 28930, 1.36533e+07
n1000x8192-coef-inner, 8192, 29, 21391, 8324, 0, 0, 29744, 1.36533e+07
n1000x8192-coef-inner, 8192, 29, 20532, 8380, 0, 0, 28941, 1.36533e+07
n1000x8192-coef-inner, 8192, 30, 20603, 8410, 0, 0, 29043, 1.36533e+07
n1000x8192-coef-inner, 8192, 29, 20548, 8343, 0, 0, 28920, 1.36533e+07
n1000x8192-coef-inner, 8192, 30, 20556, 9939, 1, 0, 30526, 1.36533e+07
n1000x8192-coef-inner, 8192, 29, 20553, 8345, 0, 0, 28927, 1.36533e+07
n1000x8192-coef-inner, 8192, 29, 21471, 9977, 1, 0, 31478, 1.36533e+07
n1000x8192-coef-inner, 8192, 29, 20560, 8340, 0, 0, 28929, 1.36533e+07
n1000x8192-coef-inner, 8192, 29, 20638, 8343, 0, 0, 29010, 1.36533e+07
n1000x8192-coef-inner, 8192, 29, 20557, 8370, 0, 0, 28956, 1.36533e+07
n1000x8192-coef-inner, 8192, 29, 20571, 8361, 0, 0, 28961, 1.36533e+07
n1000x8192-coef-inner, 8192, 29, 20542, 8344, 0, 0, 28915, 1.36533e+07
n1000x8192-coef-inner, 8192, 29, 20536, 8341, 0, 0, 28906, 1.36533e+07
n1000x8192-coef-inner, 8192, 29, 20544, 8345, 0, 0, 28918, 1.36533e+07
n1000x8192-coef-inner, 8192, 30, 20613, 9576, 1, 0, 30220, 1.36533e+07
n1000x8192-coef-inner, 8192, 29, 20522, 8342, 0, 0, 28893, 1.36533e+07
n1000x8192-coef-inner, 8192, 30, 20555, 8347, 0, 0, 28932, 1.36533e+07
n1000x8192-coef-inner, 8192, 29, 20563, 8327, 0, 0, 28919, 1.36533e+07
n1000x8192-coef-inner, 8192, 29, 20564, 8353, 0, 0, 28946, 1.36533e+07
n1000x8192-coef-inner, 8192, 29, 20543, 8344, 0, 0, 28916, 1.36533e+07
n1000x8192-coef-inner, 8192, 30, 20579, 8346, 0, 0, 28955, 1.36533e+07
n1000x8192-coef-inner, 8192, 29, 20555, 8343, 0, 0, 28927, 1.36533e+07
n1000x8192-coef-inner, 8192, 29, 20583, 8351, 0, 0, 28963, 1.36533e+07
n1000x8192-coef-inner, 8192, 30, 20556, 8324, 0, 0, 28910, 1.36533e+07
n1000x8192-coef-inner, 8192, 29, 20550, 9005, 1, 0, 29585, 1.36533e+07
n1000x8192-coef-inner, 8192, 29, 20547, 8358, 0, 0, 28934, 1.36533e+07
n1000x8192-coef-inner, 8192, 29, 20545, 8372, 0, 0, 28946, 1.36533e+07
n1000x8192-coef-inner, 8192, 30, 20551, 8333, 0, 0, 28914, 1.36533e+07
n1000x8192-coef-inner, 8192, 29, 21076, 9355, 0, 0, 30460, 1.36533e+07
n1000x8192-coef-inner, 8192, 29, 20582, 8387, 0, 0, 28998, 1.36533e+07
n1000x8192-coef-inner, 8192, 30, 20559, 8349, 0, 0, 28938, 1.36533e+07
n1000x8192-coef-inner, 8192, 30, 20528, 8339, 0, 0, 28897, 1.36533e+07
n1000x8192-coef-inner, 8192, 30, 20734, 8374, 0, 0, 29138, 1.36533e+07
n1000x8192-coef-inner, 8192, 29, 20550, 8352, 0, 0, 28931, 1.36533e+07
n1000x8192-coef-inner, 8192, 30, 20982, 8327, 0, 0, 29339, 1.36533e+07
n1000x8192-coef-inner, 8192, 29, 20534, 8329, 0, 0, 28892, 1.36533e+07
n1000x8192-coef-inner, 8192, 29, 20569, 8359, 0, 0, 28957, 1.36533e+07
n1000x8192-coef-inner, 8192, 30, 20590, 8359, 0, 0, 28979, 1.36533e+07
n1000x8192-coef-inner, 8192, 29, 20577, 8337, 0, 0, 28943, 1.36533e+07
n1000x8192-coef-inner, 8192, 29, 20586, 8399, 0, 0, 29014, 1.36533e+07
n1000x8192-coef-inner, 8192, 29, 20567, 8377, 0, 0, 28973, 1.36533e+07
n1000x8192-coef-inner, 8192, 29, 20808, 8367, 0, 0, 29204, 1.36533e+07
n1000x8192-coef-inner, 8192, 30, 20575, 8326, 0, 0, 28931, 1.36533e+07
n1000x8192-coef-inner, 8192, 29, 20566, 8330, 0, 0, 28925, 1.36533e+07
n1000x8192-coef-inner, 8192, 29, 20580, 8329, 0, 0, 28938, 1.36533e+07
n1000x8192-coef-inner, 8192, 29, 20576, 8345, 0, 0, 28950, 1.36533e+07
n1000x8192-coef-inner, 8192, 29, 20685, 9976, 1, 0, 30691, 1.36533e+07
n1000x8192-coef-inner, 8192, 29, 20541, 8362, 0, 0, 28932, 1.36533e+07
n1000x8192-coef-inner, 8192, 30, 21356, 9988, 1, 0, 31375, 1.36533e+07
n1000x8192-coef-inner, 8192, 29, 21819, 9995, 1, 0, 31844, 1.36533e+07
n1000x8192-coef-inner, 8192, 30, 20615, 8323, 0, 0, 28968, 1.36533e+07
n1000x8192-coef-inner, 8192, 29, 20574, 8369, 0, 0, 28972, 1.36533e+07
n1000x8192-coef-inner, 8192, 30, 20572, 8350, 0, 0, 28952, 1.36533e+07
n1000x8192-coef-inner, 8192, 29, 20524, 8354, 0, 0, 28907, 1.36533e+07
n1000x8192-coef-inner, 8192, 29, 20609, 8360, 0, 0, 28998, 1.36533e+07
n1000x8192-coef-inner, 8192, 29, 20546, 8327, 0, 0, 28902, 1.36533e+07
n1000x8192-coef-inner, 8192, 29, 20572, 8345, 0, 0, 28946, 1.36533e+07
n1000x8192-coef-inner, 8192, 29, 21735, 9967, 1, 0, 31732, 1.36533e+07
n1000x8192-coef-inner, 8192, 30, 20613, 8343, 0, 0, 28986, 1.36533e+07
n1000x8192-coef-inner, 8192, 30, 20561, 8348, 0, 0, 28939, 1.36533e+07
n1000x8192-coef-inner, 8192, 29, 20565, 8346, 0, 0, 28940, 1.36533e+07
n1000x8192-coef-inner, 8192, 29, 20550, 8371, 0, 0, 28950, 1.36533e+07
n1000x8192-coef-inner, 8192, 29, 20807, 9974, 1, 0, 30811, 1.36533e+07
n1000x8192-coef-inner, 8192, 29, 20557, 8347, 0, 0, 28933, 1.36533e+07
n1000x8192-coef-inner, 8192, 30, 20563, 8340, 0, 0, 28933, 1.36533e+07
n1000x8192-coef-inner, 8192, 30, 20557, 8351, 0, 0, 28938, 1.36533e+07
n1000x8192-coef-inner, 8192, 30, 20591, 8395, 0, 0, 29016, 1.36533e+07
n1000x8192-coef-inner, 8192, 29, 20578, 8342, 0, 0, 28949, 1.36533e+07
n1000x8192-coef-inner, 8192, 29, 20584, 8373, 0, 0, 28986, 1.36533e+07
n1000x8192-coef-inner, 8192, 29, 21693, 9982, 1, 0, 31705, 1.36533e+07
n1000x8192-coef-inner, 8192, 30, 20597, 8370, 0, 0, 28997, 1.36533e+07
n1000x8192-coef-inner, 8192, 30, 20569, 8352, 0, 0, 28951, 1.36533e+07
n1000x8192-coef-inner, 8192, 30, 20561, 8332, 0, 0, 28923, 1.36533e+07
n1000x8192-coef-inner, 8192, 29, 20556, 8346, 0, 0, 28931, 1.36533e+07
n1000x8192-coef-inner, 8192, 29, 20574, 8367, 0, 0, 28970, 1.36533e+07
n1000x8192-coef-inner, 8192, 29, 20547, 8361, 0, 0, 28937, 1.36533e+07
n1000x8192-coef-inner, 8192, 29, 20552, 8345, 0, 0, 28926, 1.36533e+07
n1000x8192-coef-inner, 8192, 30, 20528, 8333, 0, 0, 28891, 1.36533e+07
n1000x8192-coef-inner, 8192, 30, 20563, 8347, 0, 0, 28940, 1.36533e+07
n1000x8192-coef-inner, 8192, 30, 20567, 8355, 0, 0, 28952, 1.36533e+07
n1000x8192-coef-inner, 8192, 29, 20538, 8380, 0, 0, 28947, 1.36533e+07
n1000x8192-coef-inner, 8192, 30, 20582, 8361, 0, 0, 28973, 1.36533e+07
n1000x8192-coef-inner, 8192, 29, 20564, 9771, 1, 0, 30365, 1.36533e+07
n1000x8192-coef-inner, 8192, 30, 20563, 8349, 0, 0, 28942, 1.36533e+07
n1000x8192-coef-inner, 8192, 30, 20554, 8380, 0, 0, 28964, 1.36533e+07
n1000x8192-coef-inner, 8192, 30, 20569, 8373, 0, 0, 28972, 1.36533e+07
n1000x8192-coef-inner, 8192, 29, 20554, 8366, 0, 0, 28949, 1.36533e+07
n1000x8192-coef-inner, 8192, 29, 20584, 8339, 0, 0, 28952, 1.36533e+07
n1000x8192-coef-inner, 8192, 30, 20566, 9515, 1, 0, 30112, 1.36533e+07
n1000x8192-coef-inner, 8192, 29, 20551, 8355, 0, 0, 28935, 1.36533e+07
n1000x8192-coef-inner, 8192, 29, 20584, 8369, 0, 0, 28982, 1.36533e+07
n1000x8192-coef-inner, 4096, 16, 21005, 9709, 0, 0, 30730, 1.36533e+07
n1000x8192-coef-inner, 4096, 16, 20363, 8230, 0, 0, 28609, 1.36533e+07
n1000x8192-coef-inner, 4096, 16, 20344, 8182, 0, 0, 28542, 1.36533e+07
n1000x8192-coef-inner, 4096, 16, 20360, 8235, 0, 0, 28611, 1.36533e+07
n1000x8192-coef-inner, 4096, 17, 20394, 8190, 0, 0, 28601, 1.36533e+07
n1000x8192-coef-inner, 4096, 16, 20340, 8738, 0, 0, 29094, 1.36533e+07
n1000x8192-coef-inner, 4096, 17, 20357, 8223, 0, 0, 28597, 1.36533e+07
n1000x8192-coef-inner, 4096, 16, 20361, 8232, 0, 0, 28609, 1.36533e+07
n1000x8192-coef-inner, 4096, 16, 20371, 8208, 0, 0, 28595, 1.36533e+07
n1000x8192-coef-inner, 4096, 16, 20367, 8220, 0, 0, 28603, 1.36533e+07
n1000x8192-coef-inner, 4096, 16, 20696, 9693, 0, 0, 30405, 1.36533e+07
n1000x8192-coef-inner, 4096, 16, 20407, 8229, 0, 0, 28652, 1.36533e+07
n1000x8192-coef-inner, 4096, 16, 20683, 9656, 0, 0, 30355, 1.36533e+07
n1000x8192-coef-inner, 4096, 17, 20345, 8242, 0, 0, 28604, 1.36533e+07
n1000x8192-coef-inner, 4096, 16, 20346, 8213, 0, 0, 28575, 1.36533e+07
n1000x8192-coef-inner, 4096, 16, 20390, 8215, 0, 0, 28621, 1.36533e+07
n1000x8192-coef-inner, 4096, 16, 20364, 8218, 0, 0, 28598, 1.36533e+07
n1000x8192-coef-inner, 4096, 16, 20350, 8196, 0, 0, 28562, 1.36533e+07
n1000x8192-coef-inner, 4096, 16, 21237, 8215, 0, 0, 29468, 1.36533e+07
n1000x8192-coef-inner, 4096, 16, 20371, 8232, 0, 0, 28619, 1.36533e+07
n1000x8192-coef-inner, 4096, 16, 21397, 9708, 0, 0, 31121, 1.36533e+07
n1000x8192-coef-inner, 4096, 17, 20427, 8246, 0, 0, 28690, 1.36533e+07
n1000x8192-coef-inner, 4096, 16, 20448, 8206, 0, 0, 28670, 1.36533e+07
n1000x8192-coef-inner, 4096, 16, 20369, 8229, 0, 0, 28614, 1.36533e+07
n1000x8192-coef-inner, 4096, 16, 21334, 9647, 0, 0, 30997, 1.36533e+07
n1000x8192-coef-inner, 4096, 16, 20387, 8188, 0, 0, 28591, 1.36533e+07
n1000x8192-coef-inner, 4096, 16, 20395, 8181, 0, 0, 28592, 1.36533e+07
n1000x8192-coef-inner, 4096, 16, 20386, 8203, 0, 0, 28605, 1.36533e+07
n1000x8192-coef-inner, 4096, 16, 21225, 9656, 0, 0, 30897, 1.36533e+07
n1000x8192-coef-inner, 4096, 16, 20390, 8212, 0, 0, 28618, 1.36533e+07
n1000x8192-coef-inner, 4096, 17, 20362, 8170, 0, 0, 28549, 1.36533e+07
n1000x8192-coef-inner, 4096, 17, 20350, 8242, 0, 0, 28609, 1.36533e+07
n1000x8192-coef-inner, 4096, 16, 21264, 9699, 0, 0, 30979, 1.36533e+07
n1000x8192-coef-inner, 4096, 16, 20391, 8240, 0, 0, 28647, 1.36533e+07
n1000x8192-coef-inner, 4096, 16, 20352, 8216, 0, 0, 28584, 1.36533e+07
n1000x8192-coef-inner, 4096, 17, 20351, 8238, 0, 0, 28606, 1.36533e+07
n1000x8192-coef-inner, 4096, 16, 21199, 8464, 0, 0, 29679, 1.36533e+07
n1000x8192-coef-inner, 4096, 16, 20398, 8220, 0, 0, 28634, 1.36533e+07
n1000x8192-coef-inner, 4096, 16, 20366, 8211, 0, 0, 28593, 1.36533e+07
n1000x8192-coef-inner, 4096, 16, 20350, 8246, 0, 0, 28612, 1.36533e+07
n1000x8192-coef-inner, 4096, 16, 21052, 8804, 0, 0, 29872, 1.36533e+07
n1000x8192-coef-inner, 4096, 16, 20353, 8204, 0, 0, 28573, 1.36533e+07
n1000x8192-coef-inner, 4096, 16, 20417, 8987, 0, 0, 29420, 1.36533e+07
n1000x8192-coef-inner, 4096, 16, 20352, 8233, 0, 0, 28601, 1.36533e+07
n1000x8192-coef-inner, 4096, 17, 20982, 9673, 0, 0, 30672, 1.36533e+07
n1000x8192-coef-inner, 4096, 16, 20340, 8185, 0, 0, 28541, 1.36533e+07
n1000x8192-coef-inner, 4096, 16, 20373, 8191, 0, 0, 28580, 1.36533e+07
n1000x8192-coef-inner, 4096, 16, 20455, 8183, 0, 0, 28654, 1.36533e+07
n1000x8192-coef-inner, 4096, 16, 20385, 8222, 0, 0, 28623, 1.36533e+07
n1000x8192-coef-inner, 4096, 16, 21234, 9653, 0, 0, 30903, 1.36533e+07
n1000x8192-coef-inner, 4096, 16, 20943, 8967, 0, 0, 29926, 1.36533e+07
n1000x8192-coef-inner, 4096, 16, 20324, 8219, 0, 0, 28559, 1.36533e+07
n1000x8192-coef-inner, 4096, 19, 20381, 8236, 0, 0, 28636, 1.36533e+07
n1000x8192-coef-inner, 4096, 16, 20356, 8195, 0, 0, 28567, 1.36533e+07
n1000x8192-coef-inner, 4096, 16, 20371, 8203, 0, 0, 28590, 1.36533e+07
n1000x8192-coef-inner, 4096, 16, 20356, 8195, 0, 0, 28567, 1.36533e+07
n1000x8192-coef-inner, 4096, 16, 20409, 8200, 0, 0, 28625, 1.36533e+07
n1000x8192-coef-inner, 4096, 16, 20374, 8198, 0, 0, 28588, 1.36533e+07
n1000x8192-coef-inner, 4096, 16, 20421, 8238, 0, 0, 28675, 1.36533e+07
n1000x8192-coef-inner, 4096, 16, 20334, 8162, 0, 0, 28512, 1.36533e+07
n1000x8192-coef-inner, 4096, 16, 20396, 8187, 0, 0, 28599, 1.36533e+07
n1000x8192-coef-inner, 4096, 16, 20365, 8194, 0, 0, 28575, 1.36533e+07
n1000x8192-coef-inner, 4096, 16, 20493, 9691, 0, 0, 30200, 1.36533e+07
n1000x8192-coef-inner, 4096, 16, 20368, 8218, 0, 0, 28602, 1.36533e+07
n1000x8192-coef-inner, 4096, 16, 20503, 9670, 0, 0, 30189, 1.36533e+07
n1000x8192-coef-inner, 4096, 16, 20375, 8221, 0, 0, 28612, 1.36533e+07
n1000x8192-coef-inner, 4096, 16, 20367, 8200, 0, 0, 28583, 1.36533e+07
n1000x8192-coef-inner, 4096, 16, 20361, 8227, 0, 0, 28604, 1.36533e+07
n1000x8192-coef-inner, 4096, 16, 20380, 8229, 0, 0, 28625, 1.36533e+07
n1000x8192-coef-inner, 4096, 16, 20350, 8197, 0, 0, 28563, 1.36533e+07
n1000x8192-coef-inner, 4096, 16, 20384, 8225, 0, 0, 28625, 1.36533e+07
n1000x8192-coef-inner, 4096, 16, 21392, 9696, 0, 0, 31104, 1.36533e+07
n1000x8192-coef-inner, 4096, 16, 20379, 9488, 0, 0, 29883, 1.36533e+07
n1000x8192-coef-inner, 4096, 16, 20373, 8219, 0, 0, 28608, 1.36533e+07
n1000x8192-coef-inner, 4096, 16, 20414, 8252, 0, 0, 28682, 1.36533e+07
n1000x8192-coef-inner, 4096, 16, 21054, 9648, 0, 0, 30718, 1.36533e+07
n1000x8192-coef-inner, 4096, 16, 20455, 8221, 0, 0, 28692, 1.36533e+07
n1000x8192-coef-inner, 4096, 16, 20370, 8227, 0, 0, 28613, 1.36533e+07
n1000x8192-coef-inner, 4096, 16, 20378, 9248, 0, 0, 29642, 1.36533e+07
n1000x8192-coef-inner, 4096, 16, 21026, 9660, 0, 0, 30702, 1.36533e+07
n1000x8192-coef-inner, 4096, 17, 20356, 8222, 0, 0, 28595, 1.36533e+07
n1000x8192-coef-inner, 4096, 16, 20337, 8229, 0, 0, 28582, 1.36533e+07
n1000x8192-coef-inner, 4096, 16, 20819, 8587, 0, 0, 29422, 1.36533e+07
n1000x8192-coef-inner, 4096, 16, 21028, 9684, 0, 0, 30728, 1.36533e+07
n1000x8192-coef-inner, 4096, 17, 20417, 8205, 0, 0, 28639, 1.36533e+07
n1000x8192-coef-inner, 4096, 16, 20345, 8231, 0, 0, 28592, 1.36533e+07
n1000x8192-coef-inner, 4096, 16, 20353, 8203, 0, 0, 28572, 1.36533e+07
n1000x8192-coef-inner, 4096, 16, 20360, 8187, 0, 0, 28563, 1.36533e+07
n1000x8192-coef-inner, 4096, 16, 20358, 8248, 0, 0, 28622, 1.36533e+07
n1000x8192-coef-inner, 4096, 16, 20337, 8195, 0, 0, 28548, 1.36533e+07
n1000x8192-coef-inner, 4096, 16, 20404, 8262, 0, 0, 28682, 1.36533e+07
n1000x8192-coef-inner, 4096, 16, 20781, 9733, 0, 0, 30530, 1.36533e+07
n1000x8192-coef-inner, 4096, 16, 20467, 8234, 0, 0, 28717, 1.36533e+07
n1000x8192-coef-inner, 4096, 16, 20392, 8234, 0, 0, 28642, 1.36533e+07
n1000x8192-coef-inner, 4096, 16, 20388, 8327, 0, 0, 28731, 1.36533e+07
n1000x8192-coef-inner, 4096, 16, 20413, 8235, 0, 0, 28664, 1.36533e+07
n1000x8192-coef-inner, 4096, 16, 20373, 8185, 0, 0, 28574, 1.36533e+07
n1000x8192-coef-inner, 4096, 16, 20391, 8224, 0, 0, 28631, 1.36533e+07
n1000x8192-coef-inner, 4096, 16, 20373, 8208, 0, 0, 28597, 1.36533e+07
n1000x8192-coef-inner, 4096, 16, 20401, 8195, 0, 0, 28612, 1.36533e+07
n1000x8192-coef-inner, 2048, 16, 26216, 13020, 0, 0, 39252, 1.36533e+07
n1000x8192-coef-inner, 2048, 16, 26209, 12931, 0, 0, 39156, 1.36533e+07
n1000x8192-coef-inner, 2048, 16, 26241, 12906, 0, 0, 39163, 1.36533e+07
n1000x8192-coef-inner, 2048, 16, 26215, 13007, 0, 0, 39238, 1.36533e+07
n1000x8192-coef-inner, 2048, 16, 26277, 12935, 0, 0, 39228, 1.36533e+07
n1000x8192-coef-inner, 2048, 16, 26272, 12949, 0, 0, 39237, 1.36533e+07
n1000x8192-coef-inner, 2048, 16, 26198, 12998, 0, 0, 39212, 1.36533e+07
n1000x8192-coef-inner, 2048, 16, 26221, 12892, 0, 0, 39129, 1.36533e+07
n1000x8192-coef-inner, 2048, 16, 26256, 13116, 4, 0, 39392, 1.36533e+07
n1000x8192-coef-inner, 2048, 16, 26263, 13132, 0, 0, 39411, 1.36533e+07
n1000x8192-coef-inner, 2048, 16, 26284, 12939, 0, 0, 39239, 1.36533e+07
n1000x8192-coef-inner, 2048, 16, 26216, 12984, 0, 0, 39216, 1.36533e+07
n1000x8192-coef-inner, 2048, 16, 26288, 13116, 0, 0, 39420, 1.36533e+07
n1000x8192-coef-inner, 2048, 16, 26216, 12950, 0, 0, 39182, 1.36533e+07
n1000x8192-coef-inner, 2048, 16, 26256, 12916, 0, 0, 39188, 1.36533e+07
n1000x8192-coef-inner, 2048, 16, 26285, 12970, 0, 0, 39271, 1.36533e+07
n1000x8192-coef-inner, 2048, 23, 26238, 12918, 0, 0, 39179, 1.36533e+07
n1000x8192-coef-inner, 2048, 18, 26189, 13471, 0, 0, 39678, 1.36533e+07
n1000x8192-coef-inner, 2048, 16, 26241, 13193, 0, 0, 39450, 1.36533e+07
n1000x8192-coef-inner, 2048, 16, 26280, 12974, 0, 0, 39270, 1.36533e+07
n1000x8192-coef-inner, 2048, 16, 26260, 12972, 0, 0, 39248, 1.36533e+07
n1000x8192-coef-inner, 2048, 16, 26217, 12962, 0, 0, 39195, 1.36533e+07
n1000x8192-coef-inner, 2048, 16, 26255, 13059, 0, 0, 39330, 1.36533e+07
n1000x8192-coef-inner, 2048, 16, 26297, 13235, 0, 0, 39548, 1.36533e+07
n1000x8192-coef-inner, 2048, 18, 26229, 12999, 0, 0, 39246, 1.36533e+07
n1000x8192-coef-inner, 2048, 16, 26258, 12962, 0, 0, 39236, 1.36533e+07
n1000x8192-coef-inner, 2048, 16, 26313, 13272, 0, 0, 39601, 1.36533e+07
n1000x8192-coef-inner, 2048, 16, 26291, 13013, 0, 0, 39320, 1.36533e+07
n1000x8192-coef-inner, 2048, 16, 26250, 12913, 0, 0, 39179, 1.36533e+07
n1000x8192-coef-inner, 2048, 16, 26232, 13465, 0, 0, 39713, 1.36533e+07
n1000x8192-coef-inner, 2048, 16, 26246, 12959, 0, 0, 39221, 1.36533e+07
n1000x8192-coef-inner, 2048, 16, 26261, 12900, 0, 0, 39177, 1.36533e+07
n1000x8192-coef-inner, 2048, 16, 26287, 13060, 0, 0, 39363, 1.36533e+07
n1000x8192-coef-inner, 2048, 16, 26237, 12983, 0, 0, 39236, 1.36533e+07
n1000x8192-coef-inner, 2048, 16, 26285, 12946, 0, 0, 39247, 1.36533e+07
n1000x8192-coef-inner, 2048, 16, 26285, 13218, 0, 0, 39519, 1.36533e+07
n1000x8192-coef-inner, 2048, 19, 26261, 13504, 0, 0, 39784, 1.36533e+07
n1000x8192-coef-inner, 2048, 16, 26303, 12921, 0, 0, 39240, 1.36533e+07
n1000x8192-coef-inner, 2048, 16, 26233, 13205, 0, 0, 39454, 1.36533e+07
n1000x8192-coef-inner, 2048, 18, 26258, 13147, 0, 0, 39423, 1.36533e+07
n1000x8192-coef-inner, 2048, 16, 26295, 13480, 0, 0, 39791, 1.36533e+07
n1000x8192-coef-inner, 2048, 16, 26257, 12920, 0, 0, 39193, 1.36533e+07
n1000x8192-coef-inner, 2048, 16, 26254, 13117, 0, 0, 39387, 1.36533e+07
n1000x8192-coef-inner, 2048, 16, 26249, 13467, 0, 0, 39732, 1.36533e+07
n1000x8192-coef-inner, 2048, 16, 26292, 13251, 0, 0, 39559, 1.36533e+07
n1000x8192-coef-inner, 2048, 16, 26291, 12963, 0, 0, 39270, 1.36533e+07
n1000x8192-coef-inner, 2048, 16, 26264, 13413, 0, 0, 39693, 1.36533e+07
n1000x8192-coef-inner, 2048, 16, 26292, 12940, 0, 0, 39248, 1.36533e+07
n1000x8192-coef-inner, 2048, 16, 26234, 13092, 0, 0, 39342, 1.36533e+07
n1000x8192-coef-inner, 2048, 16, 26276, 12960, 0, 0, 39252, 1.36533e+07
n1000x8192-coef-inner, 2048, 16, 26299, 12998, 0, 0, 39313, 1.36533e+07
n1000x8192-coef-inner, 2048, 16, 26278, 13102, 0, 0, 39396, 1.36533e+07
n1000x8192-coef-inner, 2048, 16, 26233, 13424, 0, 0, 39673, 1.36533e+07
n1000x8192-coef-inner, 2048, 16, 26269, 12995, 0, 0, 39280, 1.36533e+07
n1000x8192-coef-inner, 2048, 16, 26205, 13103, 0, 0, 39324, 1.36533e+07
n1000x8192-coef-inner, 2048, 16, 26258, 13426, 0, 0, 39700, 1.36533e+07
n1000x8192-coef-inner, 2048, 16, 26218, 12959, 0, 0, 39193, 1.36533e+07
n1000x8192-coef-inner, 2048, 19, 26215, 13471, 0, 0, 39705, 1.36533e+07
n1000x8192-coef-inner, 2048, 16, 26342, 12957, 0, 0, 39315, 1.36533e+07
n1000x8192-coef-inner, 2048, 16, 26299, 12982, 0, 0, 39297, 1.36533e+07
n1000x8192-coef-inner, 2048, 16, 26203, 12978, 0, 0, 39197, 1.36533e+07
n1000x8192-coef-inner, 2048, 16, 26297, 12985, 0, 0, 39298, 1.36533e+07
n1000x8192-coef-inner, 2048, 16, 26205, 13472, 0, 0, 39693, 1.36533e+07
n1000x8192-coef-inner, 2048, 17, 26182, 13295, 0, 0, 39494, 1.36533e+07
n1000x8192-coef-inner, 2048, 16, 26288, 12930, 0, 0, 39234, 1.36533e+07
n1000x8192-coef-inner, 2048, 16, 26237, 13018, 0, 0, 39271, 1.36533e+07
n1000x8192-coef-inner, 2048, 16, 26286, 13143, 0, 0, 39445, 1.36533e+07
n1000x8192-coef-inner, 2048, 16, 26274, 12929, 0, 0, 39219, 1.36533e+07
n1000x8192-coef-inner, 2048, 16, 26251, 13230, 0, 0, 39497, 1.36533e+07
n1000x8192-coef-inner, 2048, 16, 26317, 12961, 0, 0, 39294, 1.36533e+07
n1000x8192-coef-inner, 2048, 16, 26247, 12968, 0, 0, 39231, 1.36533e+07
n1000x8192-coef-inner, 2048, 20, 26185, 13463, 0, 0, 39668, 1.36533e+07
n1000x8192-coef-inner, 2048, 15, 26284, 13010, 0, 0, 39309, 1.36533e+07
n1000x8192-coef-inner, 2048, 16, 26315, 12929, 0, 0, 39260, 1.36533e+07
n1000x8192-coef-inner, 2048, 24, 26258, 12938, 0, 0, 39220, 1.36533e+07
n1000x8192-coef-inner, 2048, 16, 26226, 13022, 0, 0, 39264, 1.36533e+07
n1000x8192-coef-inner, 2048, 16, 26255, 13453, 0, 0, 39724, 1.36533e+07
n1000x8192-coef-inner, 2048, 16, 26228, 12967, 0, 0, 39211, 1.36533e+07
n1000x8192-coef-inner, 2048, 16, 26287, 13072, 0, 0, 39375, 1.36533e+07
n1000x8192-coef-inner, 2048, 16, 26212, 12927, 0, 0, 39155, 1.36533e+07
n1000x8192-coef-inner, 2048, 17, 26229, 12961, 0, 0, 39207, 1.36533e+07
n1000x8192-coef-inner, 2048, 16, 26193, 12971, 0, 0, 39180, 1.36533e+07
n1000x8192-coef-inner, 2048, 16, 26244, 12954, 0, 0, 39214, 1.36533e+07
n1000x8192-coef-inner, 2048, 16, 26278, 13196, 0, 0, 39490, 1.36533e+07
n1000x8192-coef-inner, 2048, 16, 26240, 12940, 0, 0, 39196, 1.36533e+07
n1000x8192-coef-inner, 2048, 16, 26274, 12922, 0, 0, 39212, 1.36533e+07
n1000x8192-coef-inner, 2048, 23, 26252, 13523, 0, 0, 39798, 1.36533e+07
n1000x8192-coef-inner, 2048, 16, 26589, 13081, 0, 0, 39686, 1.36533e+07
n1000x8192-coef-inner, 2048, 16, 32451, 13006, 0, 0, 45473, 1.36533e+07
n1000x8192-coef-inner, 2048, 27, 26328, 12968, 0, 0, 39323, 1.36533e+07
n1000x8192-coef-inner, 2048, 16, 26191, 12944, 0, 0, 39151, 1.36533e+07
n1000x8192-coef-inner, 2048, 16, 26251, 12971, 0, 0, 39238, 1.36533e+07
n1000x8192-coef-inner, 2048, 16, 26256, 12952, 0, 0, 39224, 1.36533e+07
n1000x8192-coef-inner, 2048, 18, 26263, 13309, 0, 0, 39590, 1.36533e+07
n1000x8192-coef-inner, 2048, 16, 26278, 12978, 0, 0, 39272, 1.36533e+07
n1000x8192-coef-inner, 2048, 16, 26245, 13557, 0, 0, 39818, 1.36533e+07
n1000x8192-coef-inner, 2048, 16, 26174, 13111, 0, 0, 39301, 1.36533e+07
n1000x8192-coef-inner, 2048, 16, 26248, 12913, 0, 0, 39177, 1.36533e+07
n1000x8192-coef-inner, 2048, 16, 26237, 13465, 0, 0, 39718, 1.36533e+07
n1000x8192-coef-inner, 2048, 16, 26278, 12965, 0, 0, 39259, 1.36533e+07
n1000x8192-coef-inner, 1024, 12, 27195, 13450, 0, 0, 40657, 1.36533e+07
n1000x8192-coef-inner, 1024, 12, 27232, 13910, 0, 0, 41154, 1.36533e+07
n1000x8192-coef-inner, 1024, 12, 27143, 13951, 0, 0, 41106, 1.36533e+07
n1000x8192-coef-inner, 1024, 12, 27254, 13416, 0, 0, 40682, 1.36533e+07
n1000x8192-coef-inner, 1024, 12, 27163, 13441, 0, 0, 40616, 1.36533e+07
n1000x8192-coef-inner, 1024, 12, 27201, 13451, 0, 0, 40664, 1.36533e+07
n1000x8192-coef-inner, 1024, 11, 27065, 13408, 0, 0, 40484, 1.36533e+07
n1000x8192-coef-inner, 1024, 13, 27184, 13463, 0, 0, 40660, 1.36533e+07
n1000x8192-coef-inner, 1024, 11, 27177, 13566, 0, 0, 40754, 1.36533e+07
n1000x8192-coef-inner, 1024, 12, 27247, 13423, 0, 0, 40682, 1.36533e+07
n1000x8192-coef-inner, 1024, 12, 27239, 13416, 0, 0, 40667, 1.36533e+07
n1000x8192-coef-inner, 1024, 12, 27129, 13426, 0, 0, 40567, 1.36533e+07
n1000x8192-coef-inner, 1024, 12, 27220, 13715, 0, 0, 40947, 1.36533e+07
n1000x8192-coef-inner, 1024, 11, 27128, 13391, 0, 0, 40530, 1.36533e+07
n1000x8192-coef-inner, 1024, 12, 27155, 13420, 0, 0, 40587, 1.36533e+07
n1000x8192-coef-inner, 1024, 12, 27120, 13745, 0, 0, 40877, 1.36533e+07
n1000x8192-coef-inner, 1024, 12, 27285, 13420, 0, 0, 40717, 1.36533e+07
n1000x8192-coef-inner, 1024, 12, 27117, 13398, 0, 0, 40527, 1.36533e+07
n1000x8192-coef-inner, 1024, 12, 27180, 13463, 0, 0, 40655, 1.36533e+07
n1000x8192-coef-inner, 1024, 12, 27161, 13449, 0, 0, 40622, 1.36533e+07
n1000x8192-coef-inner, 1024, 12, 27129, 13855, 0, 0, 40996, 1.36533e+07
n1000x8192-coef-inner, 1024, 12, 27239, 13484, 0, 0, 40735, 1.36533e+07
n1000x8192-coef-inner, 1024, 12, 27226, 13427, 0, 0, 40665, 1.36533e+07
n1000x8192-coef-inner, 1024, 12, 27129, 13425, 0, 0, 40566, 1.36533e+07
n1000x8192-coef-inner, 1024, 12, 27135, 13622, 0, 0, 40769, 1.36533e+07
n1000x8192-coef-inner, 1024, 11, 27263, 13443, 0, 0, 40717, 1.36533e+07
n1000x8192-coef-inner, 1024, 12, 27249, 13441, 0, 0, 40702, 1.36533e+07
n1000x8192-coef-inner, 1024, 12, 27230, 13780, 0, 0, 41022, 1.36533e+07
n1000x8192-coef-inner, 1024, 12, 27195, 13401, 0, 0, 40608, 1.36533e+07
n1000x8192-coef-inner, 1024, 11, 27203, 13375, 0, 0, 40589, 1.36533e+07
n1000x8192-coef-inner, 1024, 13, 27149, 13449, 0, 0, 40611, 1.36533e+07
n1000x8192-coef-inner, 1024, 13, 27105, 13850, 0, 0, 40968, 1.36533e+07
n1000x8192-coef-inner, 1024, 12, 27128, 13877, 0, 0, 41017, 1.36533e+07
n1000x8192-coef-inner, 1024, 12, 27326, 13963, 0, 0, 41301, 1.36533e+07
n1000x8192-coef-inner, 1024, 12, 27303, 13944, 0, 0, 41259, 1.36533e+07
n1000x8192-coef-inner, 1024, 12, 27142, 13396, 0, 0, 40550, 1.36533e+07
n1000x8192-coef-inner, 1024, 13, 27156, 13951, 0, 0, 41120, 1.36533e+07
n1000x8192-coef-inner, 1024, 11, 27221, 13902, 0, 0, 41134, 1.36533e+07
n1000x8192-coef-inner, 1024, 12, 27208, 13424, 0, 0, 40644, 1.36533e+07
n1000x8192-coef-inner, 1024, 12, 27179, 13449, 0, 0, 40640, 1.36533e+07
n1000x8192-coef-inner, 1024, 12, 27280, 13411, 0, 0, 40703, 1.36533e+07
n1000x8192-coef-inner, 1024, 12, 27210, 13393, 0, 0, 40615, 1.36533e+07
n1000x8192-coef-inner, 1024, 13, 27192, 13438, 0, 0, 40643, 1.36533e+07
n1000x8192-coef-inner, 1024, 12, 27236, 13406, 0, 0, 40654, 1.36533e+07
n1000x8192-coef-inner, 1024, 13, 27109, 13400, 0, 0, 40522, 1.36533e+07
n1000x8192-coef-inner, 1024, 11, 27184, 13431, 0, 0, 40626, 1.36533e+07
n1000x8192-coef-inner, 1024, 12, 27235, 13424, 0, 0, 40671, 1.36533e+07
n1000x8192-coef-inner, 1024, 12, 27159, 13918, 0, 0, 41089, 1.36533e+07
n1000x8192-coef-inner, 1024, 12, 27179, 13887, 0, 0, 41078, 1.36533e+07
n1000x8192-coef-inner, 1024, 13, 27165, 13955, 0, 0, 41133, 1.36533e+07
n1000x8192-coef-inner, 1024, 12, 27238, 13466, 0, 0, 40716, 1.36533e+07
n1000x8192-coef-inner, 1024, 13, 27118, 13465, 0, 0, 40596, 1.36533e+07
n1000x8192-coef-inner, 1024, 12, 27202, 13431, 0, 0, 40645, 1.36533e+07
n1000x8192-coef-inner, 1024, 12, 27219, 13911, 0, 0, 41142, 1.36533e+07
n1000x8192-coef-inner, 1024, 12, 27152, 13429, 0, 0, 40593, 1.36533e+07
n1000x8192-coef-inner, 1024, 12, 27183, 13415, 0, 0, 40610, 1.36533e+07
n1000x8192-coef-inner, 1024, 12, 27194, 13433, 0, 0, 40639, 1.36533e+07
n1000x8192-coef-inner, 1024, 12, 27192, 13426, 0, 0, 40630, 1.36533e+07
n1000x8192-coef-inner, 1024, 12, 27094, 13436, 0, 0, 40542, 1.36533e+07
n1000x8192-coef-inner, 1024, 12, 27184, 13430, 0, 0, 40626, 1.36533e+07
n1000x8192-coef-inner, 1024, 12, 27338, 13876, 0, 0, 41226, 1.36533e+07
n1000x8192-coef-inner, 1024, 12, 27266, 13895, 0, 0, 41173, 1.36533e+07
n1000x8192-coef-inner, 1024, 11, 27179, 13445, 0, 0, 40635, 1.36533e+07
n1000x8192-coef-inner, 1024, 12, 27211, 13861, 0, 0, 41084, 1.36533e+07
n1000x8192-coef-inner, 1024, 12, 27223, 13454, 0, 0, 40689, 1.36533e+07
n1000x8192-coef-inner, 1024, 12, 27171, 13464, 0, 0, 40647, 1.36533e+07
n1000x8192-coef-inner, 1024, 13, 27255, 13499, 0, 0, 40767, 1.36533e+07
n1000x8192-coef-inner, 1024, 12, 27277, 13433, 0, 0, 40722, 1.36533e+07
n1000x8192-coef-inner, 1024, 12, 27267, 13967, 0, 0, 41246, 1.36533e+07
n1000x8192-coef-inner, 1024, 12, 27178, 14010, 0, 0, 41200, 1.36533e+07
n1000x8192-coef-inner, 1024, 12, 27112, 13410, 0, 0, 40534, 1.36533e+07
n1000x8192-coef-inner, 1024, 14, 27059, 13907, 0, 0, 40980, 1.36533e+07
n1000x8192-coef-inner, 1024, 11, 27232, 13405, 0, 0, 40648, 1.36533e+07
n1000x8192-coef-inner, 1024, 12, 27223, 13504, 0, 0, 40739, 1.36533e+07
n1000x8192-coef-inner, 1024, 12, 27177, 13458, 0, 0, 40647, 1.36533e+07
n1000x8192-coef-inner, 1024, 12, 27190, 13914, 0, 0, 41116, 1.36533e+07
n1000x8192-coef-inner, 1024, 15, 27178, 13910, 0, 0, 41103, 1.36533e+07
n1000x8192-coef-inner, 1024, 12, 27150, 13431, 0, 0, 40593, 1.36533e+07
n1000x8192-coef-inner, 1024, 11, 27138, 13412, 0, 0, 40561, 1.36533e+07
n1000x8192-coef-inner, 1024, 12, 27275, 13484, 0, 0, 40771, 1.36533e+07
n1000x8192-coef-inner, 1024, 11, 27205, 13428, 0, 0, 40644, 1.36533e+07
n1000x8192-coef-inner, 1024, 13, 27163, 13882, 0, 0, 41058, 1.36533e+07
n1000x8192-coef-inner, 1024, 13, 27169, 13415, 0, 0, 40597, 1.36533e+07
n1000x8192-coef-inner, 1024, 12, 27264, 13698, 0, 0, 40974, 1.36533e+07
n1000x8192-coef-inner, 1024, 12, 27246, 13415, 0, 0, 40673, 1.36533e+07
n1000x8192-coef-inner, 1024, 12, 27205, 13444, 0, 0, 40661, 1.36533e+07
n1000x8192-coef-inner, 1024, 11, 27183, 13851, 0, 0, 41045, 1.36533e+07
n1000x8192-coef-inner, 1024, 11, 27179, 13901, 0, 0, 41091, 1.36533e+07
n1000x8192-coef-inner, 1024, 11, 27092, 13875, 0, 0, 40978, 1.36533e+07
n1000x8192-coef-inner, 1024, 12, 27303, 13458, 0, 0, 40773, 1.36533e+07
n1000x8192-coef-inner, 1024, 12, 27157, 13425, 0, 0, 40594, 1.36533e+07
n1000x8192-coef-inner, 1024, 12, 27332, 13908, 0, 0, 41252, 1.36533e+07
n1000x8192-coef-inner, 1024, 12, 27183, 13453, 0, 0, 40648, 1.36533e+07
n1000x8192-coef-inner, 1024, 12, 27334, 13503, 0, 0, 40849, 1.36533e+07
n1000x8192-coef-inner, 1024, 12, 27298, 13557, 0, 0, 40867, 1.36533e+07
n1000x8192-coef-inner, 1024, 12, 27194, 13735, 0, 0, 40941, 1.36533e+07
n1000x8192-coef-inner, 1024, 11, 27218, 13706, 0, 0, 40935, 1.36533e+07
n1000x8192-coef-inner, 1024, 11, 27247, 13972, 0, 0, 41230, 1.36533e+07
n1000x8192-coef-inner, 1024, 12, 27262, 13490, 0, 0, 40764, 1.36533e+07
n1000x8192-coef-inner, 1024, 13, 27234, 13486, 0, 0, 40733, 1.36533e+07
