type, ringDim, setup, encryption, homomorphic, decryption, plaintext, total, value

n8192-coef-sum, 8192, 95, 16, 0, 1, 0, 112, 1.00012
n8192-coef-sum, 8192, 62, 15, 0, 1, 0, 78, 1.00012
n8192-coef-sum, 8192, 60, 15, 0, 1, 0, 76, 1.00012
n8192-coef-sum, 8192, 60, 16, 0, 1, 0, 77, 1.00012
n8192-coef-sum, 8192, 57, 15, 0, 1, 0, 73, 1.00012
n8192-coef-sum, 8192, 59, 14, 0, 1, 0, 74, 1.00012
n8192-coef-sum, 8192, 62, 15, 0, 1, 0, 78, 1.00012
n8192-coef-sum, 8192, 57, 15, 0, 1, 0, 73, 1.00012
n8192-coef-sum, 8192, 57, 15, 0, 1, 0, 73, 1.00012
n8192-coef-sum, 8192, 59, 15, 0, 1, 0, 75, 1.00012
n8192-coef-sum, 8192, 59, 15, 0, 1, 0, 75, 1.00012
n8192-coef-sum, 8192, 60, 15, 0, 1, 0, 76, 1.00012
n8192-coef-sum, 8192, 59, 15, 0, 1, 0, 75, 1.00012
n8192-coef-sum, 8192, 64, 15, 0, 1, 0, 80, 1.00012
n8192-coef-sum, 8192, 59, 15, 0, 1, 0, 75, 1.00012
n8192-coef-sum, 8192, 61, 15, 0, 1, 0, 77, 1.00012
n8192-coef-sum, 8192, 59, 15, 0, 1, 0, 75, 1.00012
n8192-coef-sum, 8192, 62, 15, 0, 1, 0, 78, 1.00012
n8192-coef-sum, 8192, 60, 15, 0, 1, 0, 76, 1.00012
n8192-coef-sum, 8192, 63, 15, 0, 1, 0, 79, 1.00012
n8192-coef-sum, 8192, 60, 19, 0, 1, 0, 80, 1.00012
n8192-coef-sum, 8192, 56, 15, 0, 1, 0, 72, 1.00012
n8192-coef-sum, 8192, 63, 15, 0, 1, 0, 79, 1.00012
n8192-coef-sum, 8192, 59, 15, 0, 1, 0, 75, 1.00012
n8192-coef-sum, 8192, 61, 15, 0, 1, 0, 77, 1.00012
n8192-coef-sum, 8192, 62, 15, 0, 1, 0, 78, 1.00012
n8192-coef-sum, 8192, 59, 15, 0, 1, 0, 75, 1.00012
n8192-coef-sum, 8192, 62, 15, 0, 1, 0, 78, 1.00012
n8192-coef-sum, 8192, 62, 18, 0, 1, 0, 81, 1.00012
n8192-coef-sum, 8192, 60, 15, 0, 1, 0, 76, 1.00012
n8192-coef-sum, 8192, 59, 15, 0, 1, 0, 75, 1.00012
n8192-coef-sum, 8192, 59, 14, 0, 1, 0, 74, 1.00012
n8192-coef-sum, 8192, 60, 15, 0, 1, 0, 76, 1.00012
n8192-coef-sum, 8192, 58, 15, 0, 1, 0, 74, 1.00012
n8192-coef-sum, 8192, 78, 19, 1, 1, 0, 99, 1.00012
n8192-coef-sum, 8192, 59, 15, 0, 1, 0, 75, 1.00012
n8192-coef-sum, 8192, 59, 15, 0, 1, 0, 75, 1.00012
n8192-coef-sum, 8192, 61, 15, 0, 1, 0, 77, 1.00012
n8192-coef-sum, 8192, 62, 15, 0, 1, 0, 78, 1.00012
n8192-coef-sum, 8192, 59, 15, 0, 1, 0, 75, 1.00012
n8192-coef-sum, 8192, 60, 17, 0, 1, 0, 78, 1.00012
n8192-coef-sum, 8192, 60, 15, 0, 1, 0, 76, 1.00012
n8192-coef-sum, 8192, 58, 14, 0, 1, 0, 73, 1.00012
n8192-coef-sum, 8192, 74, 15, 0, 1, 0, 90, 1.00012
n8192-coef-sum, 8192, 58, 15, 0, 1, 0, 74, 1.00012
n8192-coef-sum, 8192, 59, 15, 0, 1, 0, 75, 1.00012
n8192-coef-sum, 8192, 61, 15, 0, 1, 0, 77, 1.00012
n8192-coef-sum, 8192, 58, 18, 0, 1, 0, 77, 1.00012
n8192-coef-sum, 8192, 56, 15, 0, 1, 0, 72, 1.00012
n8192-coef-sum, 8192, 60, 15, 0, 1, 0, 76, 1.00012
n8192-coef-sum, 8192, 62, 15, 0, 1, 0, 78, 1.00012
n8192-coef-sum, 8192, 58, 15, 0, 1, 0, 74, 1.00012
n8192-coef-sum, 8192, 57, 15, 0, 1, 0, 73, 1.00012
n8192-coef-sum, 8192, 63, 16, 0, 1, 0, 80, 1.00012
n8192-coef-sum, 8192, 68, 15, 0, 1, 0, 84, 1.00012
n8192-coef-sum, 8192, 60, 16, 0, 1, 0, 77, 1.00012
n8192-coef-sum, 8192, 64, 15, 0, 1, 0, 80, 1.00012
n8192-coef-sum, 8192, 57, 15, 0, 1, 0, 73, 1.00012
n8192-coef-sum, 8192, 64, 15, 0, 1, 0, 80, 1.00012
n8192-coef-sum, 8192, 65, 15, 0, 1, 0, 81, 1.00012
n8192-coef-sum, 8192, 64, 15, 0, 1, 0, 80, 1.00012
n8192-coef-sum, 8192, 66, 17, 0, 1, 0, 84, 1.00012
n8192-coef-sum, 8192, 60, 15, 0, 1, 0, 76, 1.00012
n8192-coef-sum, 8192, 57, 15, 0, 1, 0, 73, 1.00012
n8192-coef-sum, 8192, 58, 16, 0, 1, 0, 75, 1.00012
n8192-coef-sum, 8192, 58, 15, 0, 1, 0, 74, 1.00012
n8192-coef-sum, 8192, 60, 14, 0, 1, 0, 75, 1.00012
n8192-coef-sum, 8192, 60, 16, 0, 1, 0, 77, 1.00012
n8192-coef-sum, 8192, 64, 14, 0, 1, 0, 79, 1.00012
n8192-coef-sum, 8192, 59, 15, 0, 1, 0, 75, 1.00012
n8192-coef-sum, 8192, 60, 16, 0, 1, 0, 77, 1.00012
n8192-coef-sum, 8192, 57, 14, 0, 1, 0, 72, 1.00012
n8192-coef-sum, 8192, 60, 15, 0, 1, 0, 76, 1.00012
n8192-coef-sum, 8192, 59, 14, 0, 1, 0, 74, 1.00012
n8192-coef-sum, 8192, 60, 14, 0, 1, 0, 75, 1.00012
n8192-coef-sum, 8192, 63, 15, 1, 1, 0, 80, 1.00012
n8192-coef-sum, 8192, 58, 15, 0, 1, 0, 74, 1.00012
n8192-coef-sum, 8192, 59, 15, 0, 1, 0, 75, 1.00012
n8192-coef-sum, 8192, 56, 15, 0, 1, 0, 72, 1.00012
n8192-coef-sum, 8192, 57, 15, 0, 1, 0, 73, 1.00012
n8192-coef-sum, 8192, 63, 15, 0, 1, 0, 79, 1.00012
n8192-coef-sum, 8192, 59, 14, 0, 1, 0, 74, 1.00012
n8192-coef-sum, 8192, 61, 19, 1, 1, 0, 82, 1.00012
n8192-coef-sum, 8192, 61, 15, 0, 1, 0, 77, 1.00012
n8192-coef-sum, 8192, 60, 15, 0, 1, 0, 76, 1.00012
n8192-coef-sum, 8192, 58, 15, 0, 1, 0, 74, 1.00012
n8192-coef-sum, 8192, 60, 15, 0, 1, 0, 76, 1.00012
n8192-coef-sum, 8192, 59, 15, 0, 1, 0, 75, 1.00012
n8192-coef-sum, 8192, 64, 15, 0, 1, 0, 80, 1.00012
n8192-coef-sum, 8192, 59, 16, 0, 1, 0, 76, 1.00012
n8192-coef-sum, 8192, 57, 15, 0, 1, 0, 73, 1.00012
n8192-coef-sum, 8192, 56, 15, 0, 1, 0, 72, 1.00012
n8192-coef-sum, 8192, 59, 15, 0, 1, 0, 75, 1.00012
n8192-coef-sum, 8192, 58, 15, 0, 1, 0, 74, 1.00012
n8192-coef-sum, 8192, 57, 15, 0, 1, 0, 73, 1.00012
n8192-coef-sum, 8192, 60, 15, 0, 1, 0, 76, 1.00012
n8192-coef-sum, 8192, 62, 17, 0, 1, 0, 80, 1.00012
n8192-coef-sum, 8192, 60, 15, 0, 1, 0, 76, 1.00012
n8192-coef-sum, 8192, 60, 15, 0, 1, 0, 76, 1.00012
n8192-coef-sum, 8192, 63, 15, 0, 1, 0, 79, 1.00012
n8192-coef-sum, 8192, 59, 15, 0, 1, 0, 75, 1.00012
n8192-coef-sum, 8192, 57, 15, 0, 1, 0, 73, 1.00012
n8192-coef-sum, 8192, 61, 15, 0, 1, 0, 77, 1.00012
n8192-coef-sum, 8192, 57, 14, 0, 1, 0, 72, 1.00012
n8192-coef-sum, 8192, 62, 15, 0, 1, 0, 78, 1.00012
n8192-coef-sum, 8192, 60, 15, 0, 1, 0, 76, 1.00012
n8192-coef-sum, 8192, 57, 15, 0, 1, 0, 73, 1.00012
n8192-coef-sum, 8192, 62, 15, 0, 1, 0, 78, 1.00012
n8192-coef-sum, 8192, 59, 15, 0, 1, 0, 75, 1.00012
n8192-coef-sum, 8192, 58, 15, 0, 1, 0, 74, 1.00012
n8192-coef-sum, 8192, 58, 15, 0, 1, 0, 74, 1.00012
n8192-coef-sum, 8192, 64, 15, 0, 1, 0, 80, 1.00012
n8192-coef-sum, 8192, 65, 15, 0, 1, 0, 81, 1.00012
n8192-coef-sum, 8192, 61, 15, 0, 1, 0, 77, 1.00012
n8192-coef-sum, 8192, 58, 15, 0, 1, 0, 74, 1.00012
n8192-coef-sum, 8192, 59, 15, 0, 1, 0, 75, 1.00012
n8192-coef-sum, 8192, 61, 14, 0, 1, 0, 76, 1.00012
n8192-coef-sum, 8192, 61, 15, 1, 1, 0, 78, 1.00012
n8192-coef-sum, 8192, 77, 15, 0, 1, 0, 93, 1.00012
n8192-coef-sum, 8192, 56, 14, 0, 1, 0, 71, 1.00012
n8192-coef-sum, 8192, 62, 15, 0, 1, 0, 78, 1.00012
n8192-coef-sum, 8192, 59, 15, 0, 1, 0, 75, 1.00012
n8192-coef-sum, 8192, 59, 15, 0, 1, 0, 75, 1.00012
n8192-coef-sum, 8192, 60, 15, 0, 1, 0, 76, 1.00012
n8192-coef-sum, 8192, 59, 15, 0, 1, 0, 75, 1.00012
n8192-coef-sum, 8192, 61, 15, 0, 1, 0, 77, 1.00012
n8192-coef-sum, 8192, 59, 15, 0, 1, 0, 75, 1.00012
n8192-coef-sum, 8192, 58, 15, 0, 1, 0, 74, 1.00012
n8192-coef-sum, 8192, 62, 15, 0, 1, 0, 78, 1.00012
n8192-coef-sum, 8192, 63, 15, 0, 1, 0, 79, 1.00012
n8192-coef-sum, 8192, 59, 15, 0, 1, 0, 75, 1.00012
n8192-coef-sum, 8192, 60, 15, 0, 1, 0, 76, 1.00012
n8192-coef-sum, 8192, 63, 15, 0, 1, 0, 79, 1.00012
n8192-coef-sum, 8192, 60, 15, 0, 1, 0, 76, 1.00012
n8192-coef-sum, 4096, 31, 15, 0, 0, 0, 46, 1.00012
n8192-coef-sum, 4096, 41, 14, 0, 0, 0, 55, 1.00012
n8192-coef-sum, 4096, 34, 14, 0, 0, 0, 48, 1.00012
n8192-coef-sum, 4096, 31, 14, 0, 0, 0, 45, 1.00012
n8192-coef-sum, 4096, 31, 14, 0, 0, 0, 45, 1.00012
n8192-coef-sum, 4096, 30, 14, 0, 0, 0, 44, 1.00012
n8192-coef-sum, 4096, 34, 14, 0, 0, 0, 48, 1.00012
n8192-coef-sum, 4096, 34, 15, 0, 0, 0, 49, 1.00012
n8192-coef-sum, 4096, 36, 15, 0, 0, 0, 51, 1.00012
n8192-coef-sum, 4096, 34, 14, 0, 0, 0, 48, 1.00012
n8192-coef-sum, 4096, 32, 14, 0, 0, 0, 46, 1.00012
n8192-coef-sum, 4096, 30, 14, 0, 0, 0, 44, 1.00012
n8192-coef-sum, 4096, 33, 14, 0, 0, 0, 47, 1.00012
n8192-coef-sum, 4096, 33, 14, 0, 0, 0, 47, 1.00012
n8192-coef-sum, 4096, 31, 14, 0, 0, 0, 45, 1.00012
n8192-coef-sum, 4096, 30, 15, 0, 0, 0, 45, 1.00012
n8192-coef-sum, 4096, 35, 15, 0, 0, 0, 50, 1.00012
n8192-coef-sum, 4096, 31, 14, 0, 0, 0, 45, 1.00012
n8192-coef-sum, 4096, 31, 18, 0, 0, 0, 49, 1.00012
n8192-coef-sum, 4096, 37, 15, 0, 0, 0, 52, 1.00012
n8192-coef-sum, 4096, 33, 14, 0, 0, 0, 47, 1.00012
n8192-coef-sum, 4096, 31, 14, 0, 0, 0, 45, 1.00012
n8192-coef-sum, 4096, 32, 14, 0, 0, 0, 46, 1.00012
n8192-coef-sum, 4096, 35, 16, 0, 0, 0, 51, 1.00012
n8192-coef-sum, 4096, 31, 15, 0, 0, 0, 46, 1.00012
n8192-coef-sum, 4096, 31, 15, 0, 0, 0, 46, 1.00012
n8192-coef-sum, 4096, 32, 15, 0, 0, 0, 47, 1.00012
n8192-coef-sum, 4096, 31, 15, 0, 0, 0, 46, 1.00012
n8192-coef-sum, 4096, 31, 15, 0, 0, 0, 46, 1.00012
n8192-coef-sum, 4096, 34, 18, 0, 0, 0, 52, 1.00012
n8192-coef-sum, 4096, 31, 14, 0, 0, 0, 45, 1.00012
n8192-coef-sum, 4096, 32, 15, 0, 0, 0, 47, 1.00012
n8192-coef-sum, 4096, 33, 14, 0, 0, 0, 47, 1.00012
n8192-coef-sum, 4096, 38, 14, 0, 0, 0, 52, 1.00012
n8192-coef-sum, 4096, 33, 14, 0, 0, 0, 47, 1.00012
n8192-coef-sum, 4096, 31, 14, 0, 0, 0, 45, 1.00012
n8192-coef-sum, 4096, 32, 14, 0, 0, 0, 46, 1.00012
n8192-coef-sum, 4096, 33, 14, 0, 0, 0, 47, 1.00012
n8192-coef-sum, 4096, 33, 15, 0, 0, 0, 48, 1.00012
n8192-coef-sum, 4096, 33, 15, 0, 0, 0, 48, 1.00012
n8192-coef-sum, 4096, 32, 21, 0, 0, 0, 53, 1.00012
n8192-coef-sum, 4096, 36, 15, 0, 0, 0, 51, 1.00012
n8192-coef-sum, 4096, 32, 14, 0, 0, 0, 46, 1.00012
n8192-coef-sum, 4096, 34, 14, 0, 0, 0, 48, 1.00012
n8192-coef-sum, 4096, 34, 15, 0, 0, 0, 49, 1.00012
n8192-coef-sum, 4096, 31, 15, 0, 0, 0, 46, 1.00012
n8192-coef-sum, 4096, 35, 15, 0, 0, 0, 50, 1.00012
n8192-coef-sum, 4096, 33, 15, 0, 0, 0, 48, 1.00012
n8192-coef-sum, 4096, 36, 14, 0, 0, 0, 50, 1.00012
n8192-coef-sum, 4096, 31, 14, 0, 0, 0, 45, 1.00012
n8192-coef-sum, 4096, 32, 14, 0, 0, 0, 46, 1.00012
n8192-coef-sum, 4096, 40, 15, 0, 0, 0, 55, 1.00012
n8192-coef-sum, 4096, 31, 15, 0, 0, 0, 46, 1.00012
n8192-coef-sum, 4096, 31, 15, 0, 0, 0, 46, 1.00012
n8192-coef-sum, 4096, 34, 14, 0, 0, 0, 48, 1.00012
n8192-coef-sum, 4096, 30, 14, 0, 0, 0, 44, 1.00012
n8192-coef-sum, 4096, 33, 14, 0, 0, 0, 47, 1.00012
n8192-coef-sum, 4096, 30, 14, 0, 0, 0, 44, 1.00012
n8192-coef-sum, 4096, 33, 15, 0, 0, 0, 48, 1.00012
n8192-coef-sum, 4096, 31, 14, 0, 0, 0, 45, 1.00012
n8192-coef-sum, 4096, 34, 14, 0, 0, 0, 48, 1.00012
n8192-coef-sum, 4096, 31, 20, 0, 0, 0, 51, 1.00012
n8192-coef-sum, 4096, 33, 15, 0, 0, 0, 48, 1.00012
n8192-coef-sum, 4096, 33, 15, 0, 0, 0, 48, 1.00012
n8192-coef-sum, 4096, 31, 14, 0, 0, 0, 45, 1.00012
n8192-coef-sum, 4096, 31, 15, 0, 0, 0, 46, 1.00012
n8192-coef-sum, 4096, 31, 14, 0, 0, 0, 45, 1.00012
n8192-coef-sum, 4096, 33, 14, 0, 0, 0, 47, 1.00012
n8192-coef-sum, 4096, 31, 14, 0, 0, 0, 45, 1.00012
n8192-coef-sum, 4096, 32, 15, 0, 0, 0, 47, 1.00012
n8192-coef-sum, 4096, 38, 14, 0, 0, 0, 52, 1.00012
n8192-coef-sum, 4096, 32, 14, 0, 0, 0, 46, 1.00012
n8192-coef-sum, 4096, 34, 24, 0, 0, 0, 58, 1.00012
n8192-coef-sum, 4096, 31, 14, 0, 0, 0, 45, 1.00012
n8192-coef-sum, 4096, 34, 15, 0, 0, 0, 49, 1.00012
n8192-coef-sum, 4096, 33, 14, 0, 0, 0, 47, 1.00012
n8192-coef-sum, 4096, 31, 14, 0, 0, 0, 45, 1.00012
n8192-coef-sum, 4096, 31, 14, 0, 0, 0, 45, 1.00012
n8192-coef-sum, 4096, 32, 14, 0, 0, 0, 46, 1.00012
n8192-coef-sum, 4096, 34, 15, 0, 0, 0, 49, 1.00012
n8192-coef-sum, 4096, 33, 14, 0, 0, 0, 47, 1.00012
n8192-coef-sum, 4096, 33, 14, 0, 0, 0, 47, 1.00012
n8192-coef-sum, 4096, 34, 14, 0, 0, 0, 48, 1.00012
n8192-coef-sum, 4096, 41, 15, 0, 0, 0, 56, 1.00012
n8192-coef-sum, 4096, 31, 14, 0, 0, 0, 45, 1.00012
n8192-coef-sum, 4096, 33, 14, 0, 0, 0, 47, 1.00012
n8192-coef-sum, 4096, 37, 14, 0, 0, 0, 51, 1.00012
n8192-coef-sum, 4096, 34, 15, 0, 0, 0, 49, 1.00012
n8192-coef-sum, 4096, 32, 14, 0, 0, 0, 46, 1.00012
n8192-coef-sum, 4096, 42, 15, 0, 0, 0, 57, 1.00012
n8192-coef-sum, 4096, 45, 14, 0, 0, 0, 59, 1.00012
n8192-coef-sum, 4096, 30, 14, 0, 0, 0, 44, 1.00012
n8192-coef-sum, 4096, 33, 14, 0, 0, 0, 47, 1.00012
n8192-coef-sum, 4096, 36, 14, 4, 0, 0, 54, 1.00012
n8192-coef-sum, 4096, 31, 15, 0, 0, 0, 46, 1.00012
n8192-coef-sum, 4096, 40, 14, 0, 0, 0, 54, 1.00012
n8192-coef-sum, 4096, 31, 15, 0, 0, 0, 46, 1.00012
n8192-coef-sum, 4096, 32, 14, 0, 0, 0, 46, 1.00012
n8192-coef-sum, 4096, 31, 14, 0, 0, 0, 45, 1.00012
n8192-coef-sum, 4096, 33, 14, 0, 0, 0, 47, 1.00012
n8192-coef-sum, 2048, 12, 11, 0, 0, 0, 23, 1.00012
n8192-coef-sum, 2048, 11, 11, 0, 0, 0, 22, 1.00012
n8192-coef-sum, 2048, 11, 11, 0, 0, 0, 22, 1.00012
n8192-coef-sum, 2048, 12, 11, 0, 0, 0, 23, 1.00012
n8192-coef-sum, 2048, 11, 11, 0, 0, 0, 22, 1.00012
n8192-coef-sum, 2048, 12, 11, 0, 0, 0, 23, 1.00012
n8192-coef-sum, 2048, 12, 11, 0, 0, 0, 23, 1.00012
n8192-coef-sum, 2048, 12, 15, 0, 0, 0, 27, 1.00012
n8192-coef-sum, 2048, 12, 15, 0, 0, 0, 27, 1.00012
n8192-coef-sum, 2048, 11, 11, 0, 0, 0, 22, 1.00012
n8192-coef-sum, 2048, 12, 11, 0, 0, 0, 23, 1.00012
n8192-coef-sum, 2048, 12, 12, 0, 0, 0, 24, 1.00012
n8192-coef-sum, 2048, 12, 11, 0, 0, 0, 23, 1.00012
n8192-coef-sum, 2048, 12, 11, 0, 0, 0, 23, 1.00012
n8192-coef-sum, 2048, 12, 11, 0, 0, 0, 23, 1.00012
n8192-coef-sum, 2048, 12, 11, 0, 0, 0, 23, 1.00012
n8192-coef-sum, 2048, 12, 12, 0, 0, 0, 24, 1.00012
n8192-coef-sum, 2048, 12, 11, 0, 0, 0, 23, 1.00012
n8192-coef-sum, 2048, 12, 11, 0, 0, 0, 23, 1.00012
n8192-coef-sum, 2048, 13, 11, 0, 0, 0, 24, 1.00012
n8192-coef-sum, 2048, 11, 11, 0, 0, 0, 22, 1.00012
n8192-coef-sum, 2048, 12, 11, 0, 0, 0, 23, 1.00012
n8192-coef-sum, 2048, 12, 11, 0, 0, 0, 23, 1.00012
n8192-coef-sum, 2048, 11, 11, 0, 0, 0, 22, 1.00012
n8192-coef-sum, 2048, 12, 11, 0, 0, 0, 23, 1.00012
n8192-coef-sum, 2048, 11, 11, 0, 0, 0, 22, 1.00012
n8192-coef-sum, 2048, 12, 11, 0, 0, 0, 23, 1.00012
n8192-coef-sum, 2048, 14, 11, 0, 0, 0, 25, 1.00012
n8192-coef-sum, 2048, 14, 11, 0, 0, 0, 25, 1.00012
n8192-coef-sum, 2048, 12, 11, 0, 0, 0, 23, 1.00012
n8192-coef-sum, 2048, 12, 11, 0, 0, 0, 23, 1.00012
n8192-coef-sum, 2048, 12, 11, 0, 0, 0, 23, 1.00012
n8192-coef-sum, 2048, 11, 12, 0, 0, 0, 23, 1.00012
n8192-coef-sum, 2048, 12, 11, 0, 0, 0, 23, 1.00012
n8192-coef-sum, 2048, 11, 12, 0, 0, 0, 23, 1.00012
n8192-coef-sum, 2048, 12, 11, 0, 0, 0, 23, 1.00012
n8192-coef-sum, 2048, 12, 12, 0, 0, 0, 24, 1.00012
n8192-coef-sum, 2048, 12, 11, 0, 0, 0, 23, 1.00012
n8192-coef-sum, 2048, 12, 12, 0, 0, 0, 24, 1.00012
n8192-coef-sum, 2048, 12, 12, 0, 0, 0, 24, 1.00012
n8192-coef-sum, 2048, 11, 12, 0, 0, 0, 23, 1.00012
n8192-coef-sum, 2048, 12, 11, 0, 0, 0, 23, 1.00012
n8192-coef-sum, 2048, 12, 11, 0, 0, 0, 23, 1.00012
n8192-coef-sum, 2048, 12, 11, 0, 0, 0, 23, 1.00012
n8192-coef-sum, 2048, 12, 11, 0, 0, 0, 23, 1.00012
n8192-coef-sum, 2048, 11, 11, 0, 0, 0, 22, 1.00012
n8192-coef-sum, 2048, 12, 12, 0, 0, 0, 24, 1.00012
n8192-coef-sum, 2048, 12, 11, 0, 0, 0, 23, 1.00012
n8192-coef-sum, 2048, 15, 12, 0, 0, 0, 27, 1.00012
n8192-coef-sum, 2048, 12, 11, 0, 0, 0, 23, 1.00012
n8192-coef-sum, 2048, 12, 11, 0, 0, 0, 23, 1.00012
n8192-coef-sum, 2048, 13, 12, 0, 0, 0, 25, 1.00012
n8192-coef-sum, 2048, 12, 11, 0, 0, 0, 23, 1.00012
n8192-coef-sum, 2048, 12, 11, 0, 0, 0, 23, 1.00012
n8192-coef-sum, 2048, 12, 11, 0, 0, 0, 23, 1.00012
n8192-coef-sum, 2048, 12, 11, 0, 0, 0, 23, 1.00012
n8192-coef-sum, 2048, 12, 11, 0, 0, 0, 23, 1.00012
n8192-coef-sum, 2048, 12, 11, 0, 0, 0, 23, 1.00012
n8192-coef-sum, 2048, 12, 11, 0, 0, 0, 23, 1.00012
n8192-coef-sum, 2048, 12, 11, 0, 0, 0, 23, 1.00012
n8192-coef-sum, 2048, 11, 12, 0, 0, 0, 23, 1.00012
n8192-coef-sum, 2048, 11, 11, 0, 0, 0, 22, 1.00012
n8192-coef-sum, 2048, 12, 11, 0, 0, 0, 23, 1.00012
n8192-coef-sum, 2048, 12, 12, 0, 0, 0, 24, 1.00012
n8192-coef-sum, 2048, 12, 11, 0, 0, 0, 23, 1.00012
n8192-coef-sum, 2048, 12, 12, 0, 0, 0, 24, 1.00012
n8192-coef-sum, 2048, 14, 15, 0, 0, 0, 29, 1.00012
n8192-coef-sum, 2048, 12, 11, 0, 0, 0, 23, 1.00012
n8192-coef-sum, 2048, 11, 15, 0, 0, 0, 26, 1.00012
n8192-coef-sum, 2048, 11, 11, 0, 0, 0, 22, 1.00012
n8192-coef-sum, 2048, 11, 12, 0, 0, 0, 23, 1.00012
n8192-coef-sum, 2048, 12, 11, 0, 0, 0, 23, 1.00012
n8192-coef-sum, 2048, 12, 11, 0, 0, 0, 23, 1.00012
n8192-coef-sum, 2048, 12, 11, 0, 0, 0, 23, 1.00012
n8192-coef-sum, 2048, 11, 11, 0, 0, 0, 22, 1.00012
n8192-coef-sum, 2048, 12, 11, 0, 0, 0, 23, 1.00012
n8192-coef-sum, 2048, 11, 11, 0, 0, 0, 22, 1.00012
n8192-coef-sum, 2048, 11, 11, 0, 0, 0, 22, 1.00012
n8192-coef-sum, 2048, 12, 11, 0, 0, 0, 23, 1.00012
n8192-coef-sum, 2048, 12, 11, 0, 0, 0, 23, 1.00012
n8192-coef-sum, 2048, 12, 11, 0, 0, 0, 23, 1.00012
n8192-coef-sum, 2048, 12, 11, 0, 0, 0, 23, 1.00012
n8192-coef-sum, 2048, 12, 12, 0, 0, 0, 24, 1.00012
n8192-coef-sum, 2048, 12, 11, 0, 0, 0, 23, 1.00012
n8192-coef-sum, 2048, 11, 11, 0, 0, 0, 22, 1.00012
n8192-coef-sum, 2048, 12, 11, 0, 0, 0, 23, 1.00012
n8192-coef-sum, 2048, 43, 12, 0, 0, 0, 55, 1.00012
n8192-coef-sum, 2048, 12, 11, 0, 0, 0, 23, 1.00012
n8192-coef-sum, 2048, 11, 11, 0, 0, 0, 22, 1.00012
n8192-coef-sum, 2048, 11, 11, 0, 0, 0, 22, 1.00012
n8192-coef-sum, 2048, 11, 11, 0, 0, 0, 22, 1.00012
n8192-coef-sum, 2048, 12, 11, 0, 0, 0, 23, 1.00012
n8192-coef-sum, 2048, 12, 11, 0, 0, 0, 23, 1.00012
n8192-coef-sum, 2048, 12, 11, 0, 0, 0, 23, 1.00012
n8192-coef-sum, 2048, 63, 106, 14, 0, 0, 183, 1.00012
n8192-coef-sum, 2048, 208, 127, 0, 0, 0, 335, 1.00012
n8192-coef-sum, 2048, 18, 11, 0, 0, 0, 29, 1.00012
n8192-coef-sum, 2048, 11, 11, 0, 0, 0, 22, 1.00012
n8192-coef-sum, 2048, 11, 11, 0, 0, 0, 22, 1.00012
n8192-coef-sum, 2048, 11, 11, 0, 0, 0, 22, 1.00012
n8192-coef-sum, 1024, 8, 11, 0, 0, 0, 19, 1.00012
n8192-coef-sum, 1024, 8, 11, 0, 0, 0, 19, 1.00012
n8192-coef-sum, 1024, 8, 11, 0, 0, 0, 19, 1.00012
n8192-coef-sum, 1024, 8, 11, 0, 0, 0, 19, 1.00012
n8192-coef-sum, 1024, 8, 11, 0, 0, 0, 19, 1.00012
n8192-coef-sum, 1024, 8, 11, 0, 0, 0, 19, 1.00012
n8192-coef-sum, 1024, 8, 11, 0, 0, 0, 19, 1.00012
n8192-coef-sum, 1024, 8, 11, 0, 0, 0, 19, 1.00012
n8192-coef-sum, 1024, 8, 11, 0, 0, 0, 19, 1.00012
n8192-coef-sum, 1024, 8, 11, 0, 0, 0, 19, 1.00012
n8192-coef-sum, 1024, 37, 11, 0, 0, 0, 48, 1.00012
n8192-coef-sum, 1024, 8, 11, 0, 0, 0, 19, 1.00012
n8192-coef-sum, 1024, 8, 11, 0, 0, 0, 19, 1.00012
n8192-coef-sum, 1024, 8, 11, 0, 0, 0, 19, 1.00012
n8192-coef-sum, 1024, 8, 11, 0, 0, 0, 19, 1.00012
n8192-coef-sum, 1024, 8, 11, 0, 0, 0, 19, 1.00012
n8192-coef-sum, 1024, 8, 11, 0, 0, 0, 19, 1.00012
n8192-coef-sum, 1024, 8, 11, 0, 0, 0, 19, 1.00012
n8192-coef-sum, 1024, 8, 11, 0, 0, 0, 19, 1.00012
n8192-coef-sum, 1024, 8, 11, 0, 0, 0, 19, 1.00012
n8192-coef-sum, 1024, 8, 10, 0, 0, 0, 18, 1.00012
n8192-coef-sum, 1024, 8, 11, 0, 0, 0, 19, 1.00012
n8192-coef-sum, 1024, 8, 11, 0, 0, 0, 19, 1.00012
n8192-coef-sum, 1024, 8, 10, 0, 0, 0, 18, 1.00012
n8192-coef-sum, 1024, 8, 11, 0, 0, 0, 19, 1.00012
n8192-coef-sum, 1024, 8, 11, 0, 0, 0, 19, 1.00012
n8192-coef-sum, 1024, 8, 11, 0, 0, 0, 19, 1.00012
n8192-coef-sum, 1024, 8, 11, 0, 0, 0, 19, 1.00012
n8192-coef-sum, 1024, 8, 11, 0, 0, 0, 19, 1.00012
n8192-coef-sum, 1024, 8, 11, 0, 0, 0, 19, 1.00012
n8192-coef-sum, 1024, 8, 11, 0, 0, 0, 19, 1.00012
n8192-coef-sum, 1024, 8, 11, 0, 0, 0, 19, 1.00012
n8192-coef-sum, 1024, 12, 11, 0, 0, 0, 23, 1.00012
n8192-coef-sum, 1024, 8, 11, 0, 0, 0, 19, 1.00012
n8192-coef-sum, 1024, 8, 11, 0, 0, 0, 19, 1.00012
n8192-coef-sum, 1024, 8, 11, 0, 0, 0, 19, 1.00012
n8192-coef-sum, 1024, 8, 11, 0, 0, 0, 19, 1.00012
n8192-coef-sum, 1024, 8, 11, 0, 0, 0, 19, 1.00012
n8192-coef-sum, 1024, 8, 11, 0, 0, 0, 19, 1.00012
n8192-coef-sum, 1024, 8, 11, 0, 0, 0, 19, 1.00012
n8192-coef-sum, 1024, 8, 11, 0, 0, 0, 19, 1.00012
n8192-coef-sum, 1024, 8, 11, 0, 0, 0, 19, 1.00012
n8192-coef-sum, 1024, 8, 11, 0, 0, 0, 19, 1.00012
n8192-coef-sum, 1024, 8, 11, 0, 0, 0, 19, 1.00012
n8192-coef-sum, 1024, 8, 11, 0, 0, 0, 19, 1.00012
n8192-coef-sum, 1024, 8, 11, 0, 0, 0, 19, 1.00012
n8192-coef-sum, 1024, 8, 11, 0, 0, 0, 19, 1.00012
n8192-coef-sum, 1024, 8, 11, 0, 0, 0, 19, 1.00012
n8192-coef-sum, 1024, 8, 11, 0, 0, 0, 19, 1.00012
n8192-coef-sum, 1024, 8, 11, 0, 0, 0, 19, 1.00012
n8192-coef-sum, 1024, 8, 11, 0, 0, 0, 19, 1.00012
n8192-coef-sum, 1024, 8, 11, 0, 0, 0, 19, 1.00012
n8192-coef-sum, 1024, 8, 11, 0, 0, 0, 19, 1.00012
n8192-coef-sum, 1024, 8, 11, 0, 0, 0, 19, 1.00012
n8192-coef-sum, 1024, 8, 11, 0, 0, 0, 19, 1.00012
n8192-coef-sum, 1024, 8, 14, 0, 0, 0, 22, 1.00012
n8192-coef-sum, 1024, 8, 11, 0, 0, 0, 19, 1.00012
n8192-coef-sum, 1024, 8, 11, 0, 0, 0, 19, 1.00012
n8192-coef-sum, 1024, 8, 11, 0, 0, 0, 19, 1.00012
n8192-coef-sum, 1024, 8, 11, 0, 0, 0, 19, 1.00012
n8192-coef-sum, 1024, 8, 11, 0, 0, 0, 19, 1.00012
n8192-coef-sum, 1024, 8, 11, 0, 0, 0, 19, 1.00012
n8192-coef-sum, 1024, 8, 11, 0, 0, 0, 19, 1.00012
n8192-coef-sum, 1024, 8, 11, 0, 0, 0, 19, 1.00012
n8192-coef-sum, 1024, 8, 11, 0, 0, 0, 19, 1.00012
n8192-coef-sum, 1024, 8, 11, 0, 0, 0, 19, 1.00012
n8192-coef-sum, 1024, 8, 11, 0, 0, 0, 19, 1.00012
n8192-coef-sum, 1024, 8, 11, 0, 0, 0, 19, 1.00012
n8192-coef-sum, 1024, 8, 11, 0, 0, 0, 19, 1.00012
n8192-coef-sum, 1024, 8, 11, 0, 0, 0, 19, 1.00012
n8192-coef-sum, 1024, 8, 11, 0, 0, 0, 19, 1.00012
n8192-coef-sum, 1024, 12, 11, 0, 0, 0, 23, 1.00012
n8192-coef-sum, 1024, 8, 11, 0, 0, 0, 19, 1.00012
n8192-coef-sum, 1024, 8, 11, 0, 0, 0, 19, 1.00012
n8192-coef-sum, 1024, 8, 11, 0, 0, 0, 19, 1.00012
n8192-coef-sum, 1024, 8, 11, 0, 0, 0, 19, 1.00012
n8192-coef-sum, 1024, 8, 11, 0, 0, 0, 19, 1.00012
n8192-coef-sum, 1024, 8, 11, 0, 0, 0, 19, 1.00012
n8192-coef-sum, 1024, 8, 14, 0, 0, 0, 22, 1.00012
n8192-coef-sum, 1024, 8, 11, 0, 0, 0, 19, 1.00012
n8192-coef-sum, 1024, 8, 11, 0, 0, 0, 19, 1.00012
n8192-coef-sum, 1024, 8, 11, 0, 0, 0, 19, 1.00012
n8192-coef-sum, 1024, 8, 11, 0, 0, 0, 19, 1.00012
n8192-coef-sum, 1024, 8, 11, 0, 0, 0, 19, 1.00012
n8192-coef-sum, 1024, 8, 11, 0, 0, 0, 19, 1.00012
n8192-coef-sum, 1024, 8, 12, 0, 0, 0, 20, 1.00012
n8192-coef-sum, 1024, 8, 11, 0, 0, 0, 19, 1.00012
n8192-coef-sum, 1024, 8, 11, 0, 0, 0, 19, 1.00012
n8192-coef-sum, 1024, 8, 11, 0, 0, 0, 19, 1.00012
n8192-coef-sum, 1024, 8, 11, 0, 0, 0, 19, 1.00012
n8192-coef-sum, 1024, 8, 11, 0, 0, 0, 19, 1.00012
n8192-coef-sum, 1024, 8, 11, 0, 0, 0, 19, 1.00012
n8192-coef-sum, 1024, 8, 11, 0, 0, 0, 19, 1.00012
n8192-coef-sum, 1024, 8, 11, 0, 0, 0, 19, 1.00012
n8192-coef-sum, 1024, 8, 11, 0, 0, 0, 19, 1.00012
n8192-coef-sum, 1024, 8, 11, 0, 0, 0, 19, 1.00012
n8192-coef-sum, 1024, 8, 11, 0, 0, 0, 19, 1.00012
n8192-coef-sum, 1024, 8, 11, 0, 0, 0, 19, 1.00012
n8192-coef-sum, 1024, 8, 11, 0, 0, 0, 19, 1.00012
n8192-coef-sum, 1024, 8, 11, 0, 0, 0, 19, 1.00012
n8192-slot-sum, 8192, 276, 11, 69, 1, 0, 357, 1.00012
n8192-slot-sum, 8192, 276, 11, 69, 1, 0, 357, 1.00012
n8192-slot-sum, 8192, 268, 11, 71, 1, 0, 351, 1.00012
n8192-slot-sum, 8192, 273, 11, 71, 1, 0, 356, 1.00012
n8192-slot-sum, 8192, 271, 11, 70, 1, 0, 353, 1.00012
n8192-slot-sum, 8192, 271, 11, 69, 1, 0, 352, 1.00012
n8192-slot-sum, 8192, 268, 11, 69, 1, 0, 349, 1.00012
n8192-slot-sum, 8192, 271, 11, 69, 1, 0, 352, 1.00012
n8192-slot-sum, 8192, 272, 11, 70, 1, 0, 354, 1.00012
n8192-slot-sum, 8192, 271, 11, 68, 1, 0, 351, 1.00012
n8192-slot-sum, 8192, 270, 11, 69, 1, 0, 351, 1.00012
n8192-slot-sum, 8192, 274, 11, 70, 1, 0, 356, 1.00012
n8192-slot-sum, 8192, 272, 11, 70, 1, 0, 354, 1.00012
n8192-slot-sum, 8192, 265, 11, 66, 1, 0, 343, 1.00012
n8192-slot-sum, 8192, 269, 12, 68, 1, 0, 350, 1.00012
n8192-slot-sum, 8192, 268, 11, 67, 1, 0, 347, 1.00012
n8192-slot-sum, 8192, 270, 11, 69, 1, 0, 351, 1.00012
n8192-slot-sum, 8192, 283, 11, 68, 1, 0, 363, 1.00012
n8192-slot-sum, 8192, 277, 11, 68, 1, 0, 357, 1.00012
n8192-slot-sum, 8192, 273, 11, 68, 1, 0, 353, 1.00012
n8192-slot-sum, 8192, 270, 11, 69, 1, 0, 351, 1.00012
n8192-slot-sum, 8192, 272, 11, 68, 1, 0, 352, 1.00012
n8192-slot-sum, 8192, 274, 11, 68, 1, 0, 354, 1.00012
n8192-slot-sum, 8192, 267, 11, 70, 1, 0, 349, 1.00012
n8192-slot-sum, 8192, 273, 11, 72, 1, 0, 357, 1.00012
n8192-slot-sum, 8192, 272, 11, 70, 1, 0, 354, 1.00012
n8192-slot-sum, 8192, 270, 11, 68, 1, 0, 350, 1.00012
n8192-slot-sum, 8192, 271, 11, 68, 1, 0, 351, 1.00012
n8192-slot-sum, 8192, 274, 11, 71, 1, 0, 357, 1.00012
n8192-slot-sum, 8192, 272, 13, 76, 1, 0, 362, 1.00012
n8192-slot-sum, 8192, 276, 11, 71, 1, 0, 359, 1.00012
n8192-slot-sum, 8192, 268, 11, 70, 1, 0, 350, 1.00012
n8192-slot-sum, 8192, 271, 11, 68, 1, 0, 351, 1.00012
n8192-slot-sum, 8192, 274, 11, 69, 1, 0, 355, 1.00012
n8192-slot-sum, 8192, 272, 11, 73, 1, 0, 357, 1.00012
n8192-slot-sum, 8192, 266, 11, 67, 1, 0, 345, 1.00012
n8192-slot-sum, 8192, 271, 11, 71, 1, 0, 354, 1.00012
n8192-slot-sum, 8192, 270, 11, 69, 1, 0, 351, 1.00012
n8192-slot-sum, 8192, 272, 11, 68, 1, 0, 352, 1.00012
n8192-slot-sum, 8192, 273, 11, 72, 1, 0, 357, 1.00012
n8192-slot-sum, 8192, 269, 11, 69, 1, 0, 350, 1.00012
n8192-slot-sum, 8192, 268, 11, 70, 1, 0, 350, 1.00012
n8192-slot-sum, 8192, 272, 11, 68, 1, 0, 352, 1.00012
n8192-slot-sum, 8192, 272, 11, 68, 1, 0, 352, 1.00012
n8192-slot-sum, 8192, 271, 11, 72, 1, 0, 355, 1.00012
n8192-slot-sum, 8192, 269, 11, 69, 1, 0, 350, 1.00012
n8192-slot-sum, 8192, 274, 11, 66, 1, 0, 352, 1.00012
n8192-slot-sum, 8192, 271, 11, 69, 1, 0, 352, 1.00012
n8192-slot-sum, 8192, 270, 11, 70, 1, 0, 352, 1.00012
n8192-slot-sum, 8192, 269, 11, 72, 1, 0, 353, 1.00012
n8192-slot-sum, 8192, 269, 11, 68, 1, 0, 349, 1.00012
n8192-slot-sum, 8192, 278, 11, 69, 1, 0, 359, 1.00012
n8192-slot-sum, 8192, 273, 11, 72, 1, 0, 357, 1.00012
n8192-slot-sum, 8192, 276, 11, 70, 1, 0, 358, 1.00012
n8192-slot-sum, 8192, 270, 11, 68, 1, 0, 350, 1.00012
n8192-slot-sum, 8192, 268, 11, 70, 1, 0, 350, 1.00012
n8192-slot-sum, 8192, 277, 12, 67, 1, 0, 357, 1.00012
n8192-slot-sum, 8192, 273, 11, 67, 1, 0, 352, 1.00012
n8192-slot-sum, 8192, 282, 12, 69, 1, 0, 364, 1.00012
n8192-slot-sum, 8192, 270, 11, 70, 1, 0, 352, 1.00012
n8192-slot-sum, 8192, 278, 11, 69, 1, 0, 359, 1.00012
n8192-slot-sum, 8192, 272, 11, 69, 1, 0, 353, 1.00012
n8192-slot-sum, 8192, 269, 11, 69, 1, 0, 350, 1.00012
n8192-slot-sum, 8192, 268, 11, 73, 1, 0, 353, 1.00012
n8192-slot-sum, 8192, 269, 11, 68, 1, 0, 349, 1.00012
n8192-slot-sum, 8192, 273, 11, 68, 1, 0, 353, 1.00012
n8192-slot-sum, 8192, 276, 11, 71, 1, 0, 359, 1.00012
n8192-slot-sum, 8192, 272, 11, 73, 1, 0, 357, 1.00012
n8192-slot-sum, 8192, 271, 11, 67, 1, 0, 350, 1.00012
n8192-slot-sum, 8192, 279, 11, 69, 1, 0, 360, 1.00012
n8192-slot-sum, 8192, 272, 11, 71, 1, 0, 355, 1.00012
n8192-slot-sum, 8192, 272, 11, 69, 1, 0, 353, 1.00012
n8192-slot-sum, 8192, 275, 11, 75, 1, 0, 362, 1.00012
n8192-slot-sum, 8192, 275, 11, 70, 1, 0, 357, 1.00012
n8192-slot-sum, 8192, 270, 11, 73, 1, 0, 355, 1.00012
n8192-slot-sum, 8192, 273, 11, 70, 1, 0, 355, 1.00012
n8192-slot-sum, 8192, 276, 11, 68, 1, 0, 356, 1.00012
n8192-slot-sum, 8192, 272, 11, 77, 1, 0, 361, 1.00012
n8192-slot-sum, 8192, 271, 11, 71, 1, 0, 354, 1.00012
n8192-slot-sum, 8192, 276, 11, 68, 1, 0, 356, 1.00012
n8192-slot-sum, 8192, 272, 11, 69, 1, 0, 353, 1.00012
n8192-slot-sum, 8192, 267, 11, 72, 1, 0, 351, 1.00012
n8192-slot-sum, 8192, 272, 12, 69, 1, 0, 354, 1.00012
n8192-slot-sum, 8192, 269, 11, 70, 1, 0, 351, 1.00012
n8192-slot-sum, 8192, 274, 11, 67, 1, 0, 353, 1.00012
n8192-slot-sum, 8192, 270, 11, 70, 1, 0, 352, 1.00012
n8192-slot-sum, 8192, 272, 11, 68, 1, 0, 352, 1.00012
n8192-slot-sum, 8192, 276, 11, 68, 1, 0, 356, 1.00012
n8192-slot-sum, 8192, 269, 11, 72, 1, 0, 353, 1.00012
n8192-slot-sum, 8192, 267, 11, 69, 1, 0, 348, 1.00012
n8192-slot-sum, 8192, 272, 11, 68, 1, 0, 352, 1.00012
n8192-slot-sum, 8192, 269, 11, 70, 1, 0, 351, 1.00012
n8192-slot-sum, 8192, 265, 11, 68, 1, 0, 345, 1.00012
n8192-slot-sum, 8192, 268, 11, 68, 1, 0, 348, 1.00012
n8192-slot-sum, 8192, 271, 11, 67, 1, 0, 350, 1.00012
n8192-slot-sum, 8192, 273, 11, 69, 1, 0, 354, 1.00012
n8192-slot-sum, 8192, 269, 11, 68, 1, 0, 349, 1.00012
n8192-slot-sum, 8192, 269, 11, 72, 1, 0, 353, 1.00012
n8192-slot-sum, 8192, 277, 11, 68, 1, 0, 357, 1.00012
n8192-slot-sum, 8192, 269, 11, 68, 1, 0, 349, 1.00012
n8192-slot-sum, 4096, 127, 10, 30, 0, 0, 167, 1.00012
n8192-slot-sum, 4096, 127, 10, 30, 0, 0, 167, 1.00012
n8192-slot-sum, 4096, 135, 10, 31, 0, 0, 176, 1.00012
n8192-slot-sum, 4096, 124, 10, 29, 0, 0, 163, 1.00012
n8192-slot-sum, 4096, 129, 10, 32, 0, 0, 171, 1.00012
n8192-slot-sum, 4096, 129, 10, 43, 0, 0, 182, 1.00012
n8192-slot-sum, 4096, 131, 10, 30, 0, 0, 171, 1.00012
n8192-slot-sum, 4096, 127, 10, 30, 0, 0, 167, 1.00012
n8192-slot-sum, 4096, 129, 10, 31, 0, 0, 170, 1.00012
n8192-slot-sum, 4096, 127, 10, 30, 0, 0, 167, 1.00012
n8192-slot-sum, 4096, 127, 10, 30, 0, 0, 167, 1.00012
n8192-slot-sum, 4096, 132, 10, 30, 0, 0, 172, 1.00012
n8192-slot-sum, 4096, 128, 10, 31, 0, 0, 169, 1.00012
n8192-slot-sum, 4096, 127, 10, 31, 0, 0, 168, 1.00012
n8192-slot-sum, 4096, 126, 10, 30, 0, 0, 166, 1.00012
n8192-slot-sum, 4096, 125, 10, 30, 0, 0, 165, 1.00012
n8192-slot-sum, 4096, 127, 10, 31, 0, 0, 168, 1.00012
n8192-slot-sum, 4096, 126, 10, 30, 0, 0, 166, 1.00012
n8192-slot-sum, 4096, 128, 10, 30, 0, 0, 168, 1.00012
n8192-slot-sum, 4096, 127, 10, 30, 0, 0, 167, 1.00012
n8192-slot-sum, 4096, 125, 10, 30, 0, 0, 165, 1.00012
n8192-slot-sum, 4096, 127, 10, 31, 0, 0, 168, 1.00012
n8192-slot-sum, 4096, 125, 10, 30, 0, 0, 165, 1.00012
n8192-slot-sum, 4096, 128, 9, 30, 0, 0, 167, 1.00012
n8192-slot-sum, 4096, 127, 9, 30, 0, 0, 166, 1.00012
n8192-slot-sum, 4096, 125, 10, 30, 0, 0, 165, 1.00012
n8192-slot-sum, 4096, 124, 10, 30, 0, 0, 164, 1.00012
n8192-slot-sum, 4096, 127, 10, 32, 0, 0, 169, 1.00012
n8192-slot-sum, 4096, 125, 10, 30, 0, 0, 165, 1.00012
n8192-slot-sum, 4096, 128, 10, 30, 0, 0, 168, 1.00012
n8192-slot-sum, 4096, 126, 10, 31, 0, 0, 167, 1.00012
n8192-slot-sum, 4096, 126, 10, 30, 0, 0, 166, 1.00012
n8192-slot-sum, 4096, 125, 10, 31, 0, 0, 166, 1.00012
n8192-slot-sum, 4096, 127, 10, 30, 0, 0, 167, 1.00012
n8192-slot-sum, 4096, 128, 10, 30, 0, 0, 168, 1.00012
n8192-slot-sum, 4096, 126, 10, 30, 0, 0, 166, 1.00012
n8192-slot-sum, 4096, 128, 9, 30, 0, 0, 167, 1.00012
n8192-slot-sum, 4096, 124, 10, 30, 0, 0, 164, 1.00012
n8192-slot-sum, 4096, 128, 10, 30, 0, 0, 168, 1.00012
n8192-slot-sum, 4096, 126, 10, 30, 0, 0, 166, 1.00012
n8192-slot-sum, 4096, 125, 10, 30, 0, 0, 165, 1.00012
n8192-slot-sum, 4096, 128, 10, 30, 0, 0, 168, 1.00012
n8192-slot-sum, 4096, 125, 10, 31, 0, 0, 166, 1.00012
n8192-slot-sum, 4096, 125, 10, 31, 0, 0, 166, 1.00012
n8192-slot-sum, 4096, 127, 10, 31, 0, 0, 168, 1.00012
n8192-slot-sum, 4096, 128, 10, 30, 0, 0, 168, 1.00012
n8192-slot-sum, 4096, 129, 10, 30, 0, 0, 169, 1.00012
n8192-slot-sum, 4096, 136, 10, 34, 0, 0, 180, 1.00012
n8192-slot-sum, 4096, 129, 10, 30, 0, 0, 169, 1.00012
n8192-slot-sum, 4096, 134, 9, 30, 0, 0, 173, 1.00012
n8192-slot-sum, 4096, 130, 10, 31, 0, 0, 171, 1.00012
n8192-slot-sum, 4096, 128, 10, 30, 0, 0, 168, 1.00012
n8192-slot-sum, 4096, 127, 10, 30, 0, 0, 167, 1.00012
n8192-slot-sum, 4096, 126, 10, 30, 0, 0, 166, 1.00012
n8192-slot-sum, 4096, 125, 10, 29, 0, 0, 164, 1.00012
n8192-slot-sum, 4096, 124, 10, 31, 0, 0, 165, 1.00012
n8192-slot-sum, 4096, 127, 10, 31, 0, 0, 168, 1.00012
n8192-slot-sum, 4096, 126, 10, 31, 0, 0, 167, 1.00012
n8192-slot-sum, 4096, 132, 10, 30, 0, 0, 172, 1.00012
n8192-slot-sum, 4096, 128, 10, 30, 0, 0, 168, 1.00012
n8192-slot-sum, 4096, 126, 9, 30, 0, 0, 165, 1.00012
n8192-slot-sum, 4096, 126, 10, 31, 0, 0, 167, 1.00012
n8192-slot-sum, 4096, 126, 9, 29, 0, 0, 164, 1.00012
n8192-slot-sum, 4096, 124, 10, 30, 0, 0, 164, 1.00012
n8192-slot-sum, 4096, 125, 9, 30, 0, 0, 164, 1.00012
n8192-slot-sum, 4096, 125, 10, 31, 0, 0, 166, 1.00012
n8192-slot-sum, 4096, 124, 10, 31, 0, 0, 165, 1.00012
n8192-slot-sum, 4096, 129, 10, 30, 0, 0, 169, 1.00012
n8192-slot-sum, 4096, 126, 10, 30, 0, 0, 166, 1.00012
n8192-slot-sum, 4096, 124, 10, 30, 0, 0, 164, 1.00012
n8192-slot-sum, 4096, 125, 10, 30, 0, 0, 165, 1.00012
n8192-slot-sum, 4096, 127, 10, 29, 0, 0, 166, 1.00012
n8192-slot-sum, 4096, 124, 10, 30, 0, 0, 164, 1.00012
n8192-slot-sum, 4096, 126, 10, 30, 0, 0, 166, 1.00012
n8192-slot-sum, 4096, 125, 10, 30, 0, 0, 165, 1.00012
n8192-slot-sum, 4096, 130, 10, 31, 0, 0, 171, 1.00012
n8192-slot-sum, 4096, 124, 10, 30, 0, 0, 164, 1.00012
n8192-slot-sum, 4096, 125, 9, 29, 0, 0, 163, 1.00012
n8192-slot-sum, 4096, 128, 10, 31, 0, 0, 169, 1.00012
n8192-slot-sum, 4096, 132, 10, 30, 0, 0, 172, 1.00012
n8192-slot-sum, 4096, 130, 10, 29, 0, 0, 169, 1.00012
n8192-slot-sum, 4096, 137, 10, 30, 0, 0, 177, 1.00012
n8192-slot-sum, 4096, 124, 10, 30, 0, 0, 164, 1.00012
n8192-slot-sum, 4096, 138, 10, 30, 0, 0, 178, 1.00012
n8192-slot-sum, 4096, 128, 10, 31, 0, 0, 169, 1.00012
n8192-slot-sum, 4096, 125, 9, 30, 0, 0, 164, 1.00012
n8192-slot-sum, 4096, 126, 10, 31, 0, 0, 167, 1.00012
n8192-slot-sum, 4096, 127, 10, 31, 0, 0, 168, 1.00012
n8192-slot-sum, 4096, 124, 10, 31, 0, 0, 165, 1.00012
n8192-slot-sum, 4096, 131, 10, 30, 0, 0, 171, 1.00012
n8192-slot-sum, 4096, 125, 10, 30, 0, 0, 165, 1.00012
n8192-slot-sum, 4096, 125, 10, 31, 0, 0, 166, 1.00012
n8192-slot-sum, 4096, 125, 9, 30, 0, 0, 164, 1.00012
n8192-slot-sum, 4096, 124, 10, 30, 0, 0, 164, 1.00012
n8192-slot-sum, 4096, 127, 10, 30, 0, 0, 167, 1.00012
n8192-slot-sum, 4096, 128, 10, 30, 0, 0, 168, 1.00012
n8192-slot-sum, 4096, 127, 10, 30, 0, 0, 167, 1.00012
n8192-slot-sum, 4096, 125, 9, 30, 0, 0, 164, 1.00012
n8192-slot-sum, 4096, 125, 10, 31, 0, 0, 166, 1.00012
n8192-slot-sum, 4096, 126, 10, 30, 0, 0, 166, 1.00012
n8192-slot-sum, 2048, 31, 7, 8, 0, 0, 46, 1.00012
n8192-slot-sum, 2048, 31, 7, 7, 0, 0, 45, 1.00012
n8192-slot-sum, 2048, 31, 7, 8, 0, 0, 46, 1.00012
n8192-slot-sum, 2048, 32, 7, 7, 0, 0, 46, 1.00012
n8192-slot-sum, 2048, 31, 7, 7, 0, 0, 45, 1.00012
n8192-slot-sum, 2048, 32, 7, 8, 0, 0, 47, 1.00012
n8192-slot-sum, 2048, 32, 7, 8, 0, 0, 47, 1.00012
n8192-slot-sum, 2048, 32, 7, 7, 0, 0, 46, 1.00012
n8192-slot-sum, 2048, 32, 7, 7, 0, 0, 46, 1.00012
n8192-slot-sum, 2048, 32, 7, 7, 0, 0, 46, 1.00012
n8192-slot-sum, 2048, 31, 7, 7, 0, 0, 45, 1.00012
n8192-slot-sum, 2048, 32, 7, 7, 0, 0, 46, 1.00012
n8192-slot-sum, 2048, 31, 7, 7, 0, 0, 45, 1.00012
n8192-slot-sum, 2048, 31, 7, 7, 0, 0, 45, 1.00012
n8192-slot-sum, 2048, 31, 7, 7, 0, 0, 45, 1.00012
n8192-slot-sum, 2048, 32, 7, 7, 0, 0, 46, 1.00012
n8192-slot-sum, 2048, 31, 7, 7, 0, 0, 45, 1.00012
n8192-slot-sum, 2048, 31, 7, 7, 0, 0, 45, 1.00012
n8192-slot-sum, 2048, 32, 7, 7, 0, 0, 46, 1.00012
n8192-slot-sum, 2048, 32, 7, 7, 0, 0, 46, 1.00012
n8192-slot-sum, 2048, 31, 7, 8, 0, 0, 46, 1.00012
n8192-slot-sum, 2048, 31, 7, 7, 0, 0, 45, 1.00012
n8192-slot-sum, 2048, 31, 7, 8, 0, 0, 46, 1.00012
n8192-slot-sum, 2048, 31, 7, 8, 0, 0, 46, 1.00012
n8192-slot-sum, 2048, 32, 7, 7, 0, 0, 46, 1.00012
n8192-slot-sum, 2048, 31, 7, 8, 0, 0, 46, 1.00012
n8192-slot-sum, 2048, 31, 8, 9, 0, 0, 48, 1.00012
n8192-slot-sum, 2048, 31, 7, 7, 0, 0, 45, 1.00012
n8192-slot-sum, 2048, 31, 7, 7, 0, 0, 45, 1.00012
n8192-slot-sum, 2048, 32, 7, 7, 0, 0, 46, 1.00012
n8192-slot-sum, 2048, 31, 7, 7, 0, 0, 45, 1.00012
n8192-slot-sum, 2048, 32, 7, 7, 0, 0, 46, 1.00012
n8192-slot-sum, 2048, 32, 7, 7, 0, 0, 46, 1.00012
n8192-slot-sum, 2048, 31, 7, 7, 0, 0, 45, 1.00012
n8192-slot-sum, 2048, 32, 7, 7, 0, 0, 46, 1.00012
n8192-slot-sum, 2048, 31, 7, 8, 0, 0, 46, 1.00012
n8192-slot-sum, 2048, 32, 7, 7, 0, 0, 46, 1.00012
n8192-slot-sum, 2048, 31, 7, 7, 0, 0, 45, 1.00012
n8192-slot-sum, 2048, 31, 7, 7, 0, 0, 45, 1.00012
n8192-slot-sum, 2048, 32, 7, 8, 0, 0, 47, 1.00012
n8192-slot-sum, 2048, 31, 7, 7, 0, 0, 45, 1.00012
n8192-slot-sum, 2048, 32, 7, 7, 0, 0, 46, 1.00012
n8192-slot-sum, 2048, 32, 7, 7, 0, 0, 46, 1.00012
n8192-slot-sum, 2048, 32, 7, 7, 0, 0, 46, 1.00012
n8192-slot-sum, 2048, 31, 7, 7, 0, 0, 45, 1.00012
n8192-slot-sum, 2048, 32, 7, 7, 0, 0, 46, 1.00012
n8192-slot-sum, 2048, 32, 7, 7, 0, 0, 46, 1.00012
n8192-slot-sum, 2048, 32, 7, 7, 0, 0, 46, 1.00012
n8192-slot-sum, 2048, 31, 7, 8, 0, 0, 46, 1.00012
n8192-slot-sum, 2048, 32, 7, 7, 0, 0, 46, 1.00012
n8192-slot-sum, 2048, 32, 7, 7, 0, 0, 46, 1.00012
n8192-slot-sum, 2048, 32, 7, 8, 0, 0, 47, 1.00012
n8192-slot-sum, 2048, 32, 7, 7, 0, 0, 46, 1.00012
n8192-slot-sum, 2048, 31, 7, 7, 0, 0, 45, 1.00012
n8192-slot-sum, 2048, 31, 7, 7, 0, 0, 45, 1.00012
n8192-slot-sum, 2048, 31, 7, 7, 0, 0, 45, 1.00012
n8192-slot-sum, 2048, 32, 7, 7, 0, 0, 46, 1.00012
n8192-slot-sum, 2048, 32, 7, 7, 0, 0, 46, 1.00012
n8192-slot-sum, 2048, 31, 7, 7, 0, 0, 45, 1.00012
n8192-slot-sum, 2048, 31, 7, 7, 0, 0, 45, 1.00012
n8192-slot-sum, 2048, 32, 7, 7, 0, 0, 46, 1.00012
n8192-slot-sum, 2048, 31, 7, 7, 0, 0, 45, 1.00012
n8192-slot-sum, 2048, 31, 7, 7, 0, 0, 45, 1.00012
n8192-slot-sum, 2048, 32, 7, 7, 0, 0, 46, 1.00012
n8192-slot-sum, 2048, 32, 7, 7, 0, 0, 46, 1.00012
n8192-slot-sum, 2048, 32, 7, 7, 0, 0, 46, 1.00012
n8192-slot-sum, 2048, 31, 7, 7, 0, 0, 45, 1.00012
n8192-slot-sum, 2048, 32, 7, 7, 0, 0, 46, 1.00012
n8192-slot-sum, 2048, 32, 7, 7, 0, 0, 46, 1.00012
n8192-slot-sum, 2048, 32, 7, 7, 0, 0, 46, 1.00012
n8192-slot-sum, 2048, 31, 7, 7, 0, 0, 45, 1.00012
n8192-slot-sum, 2048, 31, 7, 7, 0, 0, 45, 1.00012
n8192-slot-sum, 2048, 32, 7, 7, 0, 0, 46, 1.00012
n8192-slot-sum, 2048, 32, 7, 7, 0, 0, 46, 1.00012
n8192-slot-sum, 2048, 31, 7, 7, 0, 0, 45, 1.00012
n8192-slot-sum, 2048, 32, 7, 7, 0, 0, 46, 1.00012
n8192-slot-sum, 2048, 32, 7, 7, 0, 0, 46, 1.00012
n8192-slot-sum, 2048, 31, 7, 7, 0, 0, 45, 1.00012
n8192-slot-sum, 2048, 32, 7, 7, 0, 0, 46, 1.00012
n8192-slot-sum, 2048, 31, 7, 8, 0, 0, 46, 1.00012
n8192-slot-sum, 2048, 31, 7, 7, 0, 0, 45, 1.00012
n8192-slot-sum, 2048, 31, 7, 7, 0, 0, 45, 1.00012
n8192-slot-sum, 2048, 32, 7, 7, 0, 0, 46, 1.00012
n8192-slot-sum, 2048, 31, 7, 7, 0, 0, 45, 1.00012
n8192-slot-sum, 2048, 32, 7, 7, 0, 0, 46, 1.00012
n8192-slot-sum, 2048, 31, 7, 7, 0, 0, 45, 1.00012
n8192-slot-sum, 2048, 32, 7, 7, 0, 0, 46, 1.00012
n8192-slot-sum, 2048, 32, 7, 8, 0, 0, 47, 1.00012
n8192-slot-sum, 2048, 31, 7, 7, 0, 0, 45, 1.00012
n8192-slot-sum, 2048, 32, 7, 7, 0, 0, 46, 1.00012
n8192-slot-sum, 2048, 31, 7, 7, 0, 0, 45, 1.00012
n8192-slot-sum, 2048, 31, 7, 7, 0, 0, 45, 1.00012
n8192-slot-sum, 2048, 32, 7, 7, 0, 0, 46, 1.00012
n8192-slot-sum, 2048, 32, 7, 7, 0, 0, 46, 1.00012
n8192-slot-sum, 2048, 31, 7, 7, 0, 0, 45, 1.00012
n8192-slot-sum, 2048, 31, 7, 7, 0, 0, 45, 1.00012
n8192-slot-sum, 2048, 32, 7, 7, 0, 0, 46, 1.00012
n8192-slot-sum, 2048, 31, 7, 7, 0, 0, 45, 1.00012
n8192-slot-sum, 2048, 31, 7, 7, 0, 0, 45, 1.00012
n8192-slot-sum, 2048, 32, 7, 8, 0, 0, 47, 1.00012
n8192-slot-sum, 1024, 17, 7, 3, 0, 0, 27, 1.00012
n8192-slot-sum, 1024, 17, 6, 3, 0, 0, 26, 1.00012
n8192-slot-sum, 1024, 17, 6, 3, 0, 0, 26, 1.00012
n8192-slot-sum, 1024, 17, 6, 3, 0, 0, 26, 1.00012
n8192-slot-sum, 1024, 17, 6, 3, 0, 0, 26, 1.00012
n8192-slot-sum, 1024, 17, 6, 3, 0, 0, 26, 1.00012
n8192-slot-sum, 1024, 17, 6, 3, 0, 0, 26, 1.00012
n8192-slot-sum, 1024, 16, 6, 3, 0, 0, 25, 1.00012
n8192-slot-sum, 1024, 17, 6, 3, 0, 0, 26, 1.00012
n8192-slot-sum, 1024, 17, 6, 3, 0, 0, 26, 1.00012
n8192-slot-sum, 1024, 17, 6, 3, 0, 0, 26, 1.00012
n8192-slot-sum, 1024, 17, 6, 3, 0, 0, 26, 1.00012
n8192-slot-sum, 1024, 17, 6, 3, 0, 0, 26, 1.00012
n8192-slot-sum, 1024, 17, 6, 3, 0, 0, 26, 1.00012
n8192-slot-sum, 1024, 17, 6, 3, 0, 0, 26, 1.00012
n8192-slot-sum, 1024, 17, 6, 3, 0, 0, 26, 1.00012
n8192-slot-sum, 1024, 17, 6, 3, 0, 0, 26, 1.00012
n8192-slot-sum, 1024, 17, 6, 3, 0, 0, 26, 1.00012
n8192-slot-sum, 1024, 17, 6, 3, 0, 0, 26, 1.00012
n8192-slot-sum, 1024, 17, 6, 3, 0, 0, 26, 1.00012
n8192-slot-sum, 1024, 17, 6, 3, 0, 0, 26, 1.00012
n8192-slot-sum, 1024, 17, 6, 3, 0, 0, 26, 1.00012
n8192-slot-sum, 1024, 17, 6, 3, 0, 0, 26, 1.00012
n8192-slot-sum, 1024, 17, 6, 3, 0, 0, 26, 1.00012
n8192-slot-sum, 1024, 17, 6, 3, 0, 0, 26, 1.00012
n8192-slot-sum, 1024, 17, 7, 3, 0, 0, 27, 1.00012
n8192-slot-sum, 1024, 17, 6, 3, 0, 0, 26, 1.00012
n8192-slot-sum, 1024, 18, 7, 3, 0, 0, 28, 1.00012
n8192-slot-sum, 1024, 18, 7, 3, 0, 0, 28, 1.00012
n8192-slot-sum, 1024, 17, 6, 4, 0, 0, 27, 1.00012
n8192-slot-sum, 1024, 17, 6, 3, 0, 0, 26, 1.00012
n8192-slot-sum, 1024, 17, 6, 3, 0, 0, 26, 1.00012
n8192-slot-sum, 1024, 17, 6, 3, 0, 0, 26, 1.00012
n8192-slot-sum, 1024, 17, 6, 3, 0, 0, 26, 1.00012
n8192-slot-sum, 1024, 17, 6, 3, 0, 0, 26, 1.00012
n8192-slot-sum, 1024, 17, 6, 3, 0, 0, 26, 1.00012
n8192-slot-sum, 1024, 17, 6, 3, 0, 0, 26, 1.00012
n8192-slot-sum, 1024, 17, 6, 3, 0, 0, 26, 1.00012
n8192-slot-sum, 1024, 17, 6, 3, 0, 0, 26, 1.00012
n8192-slot-sum, 1024, 18, 6, 3, 0, 0, 27, 1.00012
n8192-slot-sum, 1024, 17, 6, 3, 0, 0, 26, 1.00012
n8192-slot-sum, 1024, 17, 6, 3, 0, 0, 26, 1.00012
n8192-slot-sum, 1024, 17, 6, 3, 0, 0, 26, 1.00012
n8192-slot-sum, 1024, 17, 6, 3, 0, 0, 26, 1.00012
n8192-slot-sum, 1024, 17, 7, 3, 0, 0, 27, 1.00012
n8192-slot-sum, 1024, 17, 6, 3, 0, 0, 26, 1.00012
n8192-slot-sum, 1024, 17, 6, 3, 0, 0, 26, 1.00012
n8192-slot-sum, 1024, 17, 6, 3, 0, 0, 26, 1.00012
n8192-slot-sum, 1024, 17, 6, 3, 0, 0, 26, 1.00012
n8192-slot-sum, 1024, 17, 7, 3, 0, 0, 27, 1.00012
n8192-slot-sum, 1024, 17, 6, 3, 0, 0, 26, 1.00012
n8192-slot-sum, 1024, 17, 6, 3, 0, 0, 26, 1.00012
n8192-slot-sum, 1024, 17, 6, 3, 0, 0, 26, 1.00012
n8192-slot-sum, 1024, 17, 6, 3, 0, 0, 26, 1.00012
n8192-slot-sum, 1024, 17, 6, 3, 0, 0, 26, 1.00012
n8192-slot-sum, 1024, 17, 6, 3, 0, 0, 26, 1.00012
n8192-slot-sum, 1024, 17, 7, 3, 0, 0, 27, 1.00012
n8192-slot-sum, 1024, 17, 7, 3, 0, 0, 27, 1.00012
n8192-slot-sum, 1024, 17, 6, 3, 0, 0, 26, 1.00012
n8192-slot-sum, 1024, 17, 6, 3, 0, 0, 26, 1.00012
n8192-slot-sum, 1024, 18, 6, 3, 0, 0, 27, 1.00012
n8192-slot-sum, 1024, 17, 6, 3, 0, 0, 26, 1.00012
n8192-slot-sum, 1024, 17, 6, 3, 0, 0, 26, 1.00012
n8192-slot-sum, 1024, 17, 6, 3, 0, 0, 26, 1.00012
n8192-slot-sum, 1024, 17, 6, 3, 0, 0, 26, 1.00012
n8192-slot-sum, 1024, 17, 6, 3, 0, 0, 26, 1.00012
n8192-slot-sum, 1024, 17, 6, 3, 0, 0, 26, 1.00012
n8192-slot-sum, 1024, 17, 6, 3, 0, 0, 26, 1.00012
n8192-slot-sum, 1024, 17, 6, 4, 0, 0, 27, 1.00012
n8192-slot-sum, 1024, 17, 6, 3, 0, 0, 26, 1.00012
n8192-slot-sum, 1024, 17, 6, 3, 0, 0, 26, 1.00012
n8192-slot-sum, 1024, 17, 6, 3, 0, 0, 26, 1.00012
n8192-slot-sum, 1024, 17, 7, 3, 0, 0, 27, 1.00012
n8192-slot-sum, 1024, 18, 6, 3, 0, 0, 27, 1.00012
n8192-slot-sum, 1024, 17, 6, 3, 0, 0, 26, 1.00012
n8192-slot-sum, 1024, 20, 7, 4, 0, 0, 31, 1.00012
n8192-slot-sum, 1024, 17, 6, 3, 0, 0, 26, 1.00012
n8192-slot-sum, 1024, 17, 6, 3, 0, 0, 26, 1.00012
n8192-slot-sum, 1024, 17, 6, 3, 0, 0, 26, 1.00012
n8192-slot-sum, 1024, 17, 6, 3, 0, 0, 26, 1.00012
n8192-slot-sum, 1024, 18, 6, 3, 0, 0, 27, 1.00012
n8192-slot-sum, 1024, 17, 6, 3, 0, 0, 26, 1.00012
n8192-slot-sum, 1024, 17, 6, 3, 0, 0, 26, 1.00012
n8192-slot-sum, 1024, 17, 6, 3, 0, 0, 26, 1.00012
n8192-slot-sum, 1024, 17, 6, 3, 0, 0, 26, 1.00012
n8192-slot-sum, 1024, 17, 6, 3, 0, 0, 26, 1.00012
n8192-slot-sum, 1024, 17, 6, 3, 0, 0, 26, 1.00012
n8192-slot-sum, 1024, 17, 6, 3, 0, 0, 26, 1.00012
n8192-slot-sum, 1024, 17, 6, 3, 0, 0, 26, 1.00012
n8192-slot-sum, 1024, 17, 6, 3, 0, 0, 26, 1.00012
n8192-slot-sum, 1024, 17, 6, 3, 0, 0, 26, 1.00012
n8192-slot-sum, 1024, 17, 6, 3, 0, 0, 26, 1.00012
n8192-slot-sum, 1024, 17, 6, 3, 0, 0, 26, 1.00012
n8192-slot-sum, 1024, 17, 6, 3, 0, 0, 26, 1.00012
n8192-slot-sum, 1024, 17, 6, 3, 0, 0, 26, 1.00012
n8192-slot-sum, 1024, 17, 7, 3, 0, 0, 27, 1.00012
n8192-slot-sum, 1024, 17, 6, 3, 0, 0, 26, 1.00012
n8192-slot-sum, 1024, 17, 6, 3, 0, 0, 26, 1.00012
n8192-slot-sum, 1024, 17, 6, 3, 0, 0, 26, 1.00012
n8192-slot-sum, 1024, 17, 6, 3, 0, 0, 26, 1.00012
n8192-slot-inner, 8192, 282, 11, 85, 1, 0, 379, 13655
n8192-slot-inner, 8192, 290, 11, 85, 1, 0, 387, 13655
n8192-slot-inner, 8192, 287, 11, 84, 1, 0, 383, 13655
n8192-slot-inner, 8192, 286, 11, 85, 1, 0, 383, 13655
n8192-slot-inner, 8192, 290, 11, 91, 1, 0, 393, 13655
n8192-slot-inner, 8192, 288, 11, 83, 1, 0, 383, 13655
n8192-slot-inner, 8192, 292, 11, 86, 1, 0, 390, 13655
n8192-slot-inner, 8192, 290, 11, 86, 1, 0, 388, 13655
n8192-slot-inner, 8192, 286, 11, 85, 1, 0, 383, 13655
n8192-slot-inner, 8192, 284, 11, 87, 1, 0, 383, 13655
n8192-slot-inner, 8192, 289, 11, 84, 1, 0, 385, 13655
n8192-slot-inner, 8192, 288, 11, 84, 1, 0, 384, 13655
n8192-slot-inner, 8192, 284, 11, 85, 1, 0, 381, 13655
n8192-slot-inner, 8192, 289, 11, 85, 1, 0, 386, 13655
n8192-slot-inner, 8192, 284, 11, 82, 1, 0, 378, 13655
n8192-slot-inner, 8192, 290, 11, 84, 1, 0, 386, 13655
n8192-slot-inner, 8192, 286, 11, 86, 1, 0, 384, 13655
n8192-slot-inner, 8192, 285, 11, 84, 1, 0, 381, 13655
n8192-slot-inner, 8192, 286, 11, 88, 1, 0, 386, 13655
n8192-slot-inner, 8192, 293, 11, 83, 1, 0, 388, 13655
n8192-slot-inner, 8192, 288, 11, 85, 1, 0, 385, 13655
n8192-slot-inner, 8192, 288, 11, 85, 1, 0, 385, 13655
n8192-slot-inner, 8192, 286, 11, 84, 1, 0, 382, 13655
n8192-slot-inner, 8192, 288, 11, 87, 1, 0, 387, 13655
n8192-slot-inner, 8192, 287, 11, 85, 1, 0, 384, 13655
n8192-slot-inner, 8192, 289, 11, 84, 1, 0, 385, 13655
n8192-slot-inner, 8192, 287, 11, 85, 1, 0, 384, 13655
n8192-slot-inner, 8192, 287, 11, 84, 1, 0, 383, 13655
n8192-slot-inner, 8192, 291, 11, 84, 1, 0, 387, 13655
n8192-slot-inner, 8192, 291, 11, 85, 1, 0, 388, 13655
n8192-slot-inner, 8192, 288, 11, 84, 1, 0, 384, 13655
n8192-slot-inner, 8192, 288, 11, 88, 1, 0, 388, 13655
n8192-slot-inner, 8192, 292, 11, 83, 1, 0, 387, 13655
n8192-slot-inner, 8192, 283, 11, 84, 1, 0, 379, 13655
n8192-slot-inner, 8192, 285, 11, 84, 1, 0, 381, 13655
n8192-slot-inner, 8192, 285, 11, 84, 1, 0, 381, 13655
n8192-slot-inner, 8192, 287, 11, 83, 1, 0, 382, 13655
n8192-slot-inner, 8192, 289, 11, 83, 1, 0, 384, 13655
n8192-slot-inner, 8192, 286, 11, 86, 1, 0, 384, 13655
n8192-slot-inner, 8192, 290, 11, 82, 1, 0, 384, 13655
n8192-slot-inner, 8192, 292, 11, 87, 1, 0, 391, 13655
n8192-slot-inner, 8192, 287, 11, 85, 1, 0, 384, 13655
n8192-slot-inner, 8192, 290, 11, 86, 1, 0, 388, 13655
n8192-slot-inner, 8192, 292, 11, 83, 1, 0, 387, 13655
n8192-slot-inner, 8192, 291, 11, 85, 1, 0, 388, 13655
n8192-slot-inner, 8192, 288, 11, 86, 1, 0, 386, 13655
n8192-slot-inner, 8192, 288, 11, 84, 1, 0, 384, 13655
n8192-slot-inner, 8192, 285, 11, 84, 1, 0, 381, 13655
n8192-slot-inner, 8192, 288, 11, 84, 1, 0, 384, 13655
n8192-slot-inner, 8192, 287, 11, 87, 1, 0, 386, 13655
n8192-slot-inner, 8192, 290, 12, 86, 1, 0, 389, 13655
n8192-slot-inner, 8192, 287, 11, 83, 1, 0, 382, 13655
n8192-slot-inner, 8192, 291, 11, 84, 1, 0, 387, 13655
n8192-slot-inner, 8192, 286, 11, 83, 1, 0, 381, 13655
n8192-slot-inner, 8192, 286, 11, 85, 1, 0, 383, 13655
n8192-slot-inner, 8192, 284, 11, 83, 1, 0, 379, 13655
n8192-slot-inner, 8192, 288, 11, 83, 1, 0, 383, 13655
n8192-slot-inner, 8192, 290, 11, 85, 1, 0, 387, 13655
n8192-slot-inner, 8192, 292, 11, 83, 1, 0, 387, 13655
n8192-slot-inner, 8192, 292, 11, 85, 1, 0, 389, 13655
n8192-slot-inner, 8192, 286, 11, 83, 1, 0, 381, 13655
n8192-slot-inner, 8192, 291, 11, 84, 1, 0, 387, 13655
n8192-slot-inner, 8192, 287, 11, 85, 1, 0, 384, 13655
n8192-slot-inner, 8192, 283, 11, 81, 1, 0, 376, 13655
n8192-slot-inner, 8192, 292, 11, 88, 1, 0, 392, 13655
n8192-slot-inner, 8192, 287, 11, 86, 1, 0, 385, 13655
n8192-slot-inner, 8192, 293, 11, 85, 1, 0, 390, 13655
n8192-slot-inner, 8192, 288, 11, 84, 1, 0, 384, 13655
n8192-slot-inner, 8192, 286, 11, 84, 1, 0, 382, 13655
n8192-slot-inner, 8192, 288, 11, 88, 1, 0, 388, 13655
n8192-slot-inner, 8192, 292, 11, 83, 1, 0, 387, 13655
n8192-slot-inner, 8192, 291, 11, 84, 1, 0, 387, 13655
n8192-slot-inner, 8192, 286, 11, 85, 1, 0, 383, 13655
n8192-slot-inner, 8192, 285, 11, 86, 1, 0, 383, 13655
n8192-slot-inner, 8192, 292, 11, 89, 1, 0, 393, 13655
n8192-slot-inner, 8192, 290, 11, 86, 1, 0, 388, 13655
n8192-slot-inner, 8192, 298, 11, 86, 1, 0, 396, 13655
n8192-slot-inner, 8192, 287, 11, 87, 1, 0, 386, 13655
n8192-slot-inner, 8192, 287, 11, 84, 1, 0, 383, 13655
n8192-slot-inner, 8192, 287, 11, 85, 1, 0, 384, 13655
n8192-slot-inner, 8192, 284, 11, 90, 1, 0, 386, 13655
n8192-slot-inner, 8192, 288, 11, 82, 1, 0, 382, 13655
n8192-slot-inner, 8192, 287, 11, 85, 1, 0, 384, 13655
n8192-slot-inner, 8192, 289, 11, 85, 1, 0, 386, 13655
n8192-slot-inner, 8192, 286, 11, 85, 1, 0, 383, 13655
n8192-slot-inner, 8192, 291, 11, 83, 1, 0, 386, 13655
n8192-slot-inner, 8192, 287, 11, 84, 1, 0, 383, 13655
n8192-slot-inner, 8192, 289, 12, 98, 1, 0, 400, 13655
n8192-slot-inner, 8192, 286, 11, 85, 1, 0, 383, 13655
n8192-slot-inner, 8192, 287, 11, 84, 1, 0, 383, 13655
n8192-slot-inner, 8192, 293, 11, 83, 1, 0, 388, 13655
n8192-slot-inner, 8192, 289, 11, 85, 1, 0, 386, 13655
n8192-slot-inner, 8192, 290, 11, 83, 1, 0, 385, 13655
n8192-slot-inner, 8192, 289, 11, 84, 1, 0, 385, 13655
n8192-slot-inner, 8192, 285, 11, 84, 1, 0, 381, 13655
n8192-slot-inner, 8192, 285, 11, 85, 1, 0, 382, 13655
n8192-slot-inner, 8192, 282, 11, 84, 1, 0, 378, 13655
n8192-slot-inner, 8192, 292, 11, 82, 1, 0, 386, 13655
n8192-slot-inner, 8192, 286, 11, 83, 1, 0, 381, 13655
n8192-slot-inner, 8192, 292, 11, 85, 1, 0, 389, 13655
n8192-slot-inner, 4096, 138, 10, 46, 0, 0, 194, 13655
n8192-slot-inner, 4096, 135, 9, 45, 0, 0, 189, 13655
n8192-slot-inner, 4096, 133, 10, 45, 0, 0, 188, 13655
n8192-slot-inner, 4096, 134, 10, 46, 0, 0, 190, 13655
n8192-slot-inner, 4096, 135, 10, 46, 0, 0, 191, 13655
n8192-slot-inner, 4096, 136, 10, 45, 0, 0, 191, 13655
n8192-slot-inner, 4096, 136, 10, 46, 0, 0, 192, 13655
n8192-slot-inner, 4096, 134, 10, 45, 0, 0, 189, 13655
n8192-slot-inner, 4096, 133, 10, 44, 0, 0, 187, 13655
n8192-slot-inner, 4096, 137, 10, 44, 0, 0, 191, 13655
n8192-slot-inner, 4096, 135, 10, 45, 0, 0, 190, 13655
n8192-slot-inner, 4096, 136, 10, 45, 0, 0, 191, 13655
n8192-slot-inner, 4096, 135, 10, 44, 0, 0, 189, 13655
n8192-slot-inner, 4096, 133, 10, 44, 0, 0, 187, 13655
n8192-slot-inner, 4096, 136, 10, 45, 0, 0, 191, 13655
n8192-slot-inner, 4096, 137, 10, 45, 0, 0, 192, 13655
n8192-slot-inner, 4096, 134, 10, 46, 0, 0, 190, 13655
n8192-slot-inner, 4096, 135, 10, 45, 0, 0, 190, 13655
n8192-slot-inner, 4096, 134, 10, 45, 0, 0, 189, 13655
n8192-slot-inner, 4096, 134, 10, 45, 0, 0, 189, 13655
n8192-slot-inner, 4096, 137, 10, 45, 0, 0, 192, 13655
n8192-slot-inner, 4096, 135, 10, 45, 0, 0, 190, 13655
n8192-slot-inner, 4096, 136, 9, 44, 0, 0, 189, 13655
n8192-slot-inner, 4096, 139, 9, 45, 0, 0, 193, 13655
n8192-slot-inner, 4096, 133, 10, 46, 0, 0, 189, 13655
n8192-slot-inner, 4096, 137, 10, 45, 0, 0, 192, 13655
n8192-slot-inner, 4096, 133, 10, 44, 0, 0, 187, 13655
n8192-slot-inner, 4096, 140, 10, 45, 0, 0, 195, 13655
n8192-slot-inner, 4096, 141, 10, 45, 0, 0, 196, 13655
n8192-slot-inner, 4096, 135, 10, 44, 0, 0, 189, 13655
n8192-slot-inner, 4096, 136, 10, 46, 0, 0, 192, 13655
n8192-slot-inner, 4096, 135, 10, 44, 0, 0, 189, 13655
n8192-slot-inner, 4096, 136, 9, 44, 0, 0, 189, 13655
n8192-slot-inner, 4096, 134, 9, 44, 0, 0, 187, 13655
n8192-slot-inner, 4096, 136, 10, 45, 0, 0, 191, 13655
n8192-slot-inner, 4096, 142, 10, 45, 0, 0, 197, 13655
n8192-slot-inner, 4096, 135, 10, 44, 0, 0, 189, 13655
n8192-slot-inner, 4096, 138, 10, 47, 0, 0, 195, 13655
n8192-slot-inner, 4096, 133, 9, 45, 0, 0, 187, 13655
n8192-slot-inner, 4096, 133, 10, 44, 0, 0, 187, 13655
n8192-slot-inner, 4096, 138, 10, 46, 0, 0, 194, 13655
n8192-slot-inner, 4096, 145, 10, 46, 0, 0, 201, 13655
n8192-slot-inner, 4096, 136, 9, 44, 0, 0, 189, 13655
n8192-slot-inner, 4096, 136, 10, 45, 0, 0, 191, 13655
n8192-slot-inner, 4096, 135, 10, 46, 0, 0, 191, 13655
n8192-slot-inner, 4096, 140, 10, 48, 0, 0, 198, 13655
n8192-slot-inner, 4096, 133, 10, 44, 0, 0, 187, 13655
n8192-slot-inner, 4096, 137, 10, 45, 0, 0, 192, 13655
n8192-slot-inner, 4096, 135, 10, 46, 0, 0, 191, 13655
n8192-slot-inner, 4096, 133, 10, 45, 0, 0, 188, 13655
n8192-slot-inner, 4096, 135, 10, 45, 0, 0, 190, 13655
n8192-slot-inner, 4096, 135, 10, 45, 0, 0, 190, 13655
n8192-slot-inner, 4096, 133, 9, 44, 0, 0, 186, 13655
n8192-slot-inner, 4096, 135, 9, 44, 0, 0, 188, 13655
n8192-slot-inner, 4096, 134, 10, 44, 0, 0, 188, 13655
n8192-slot-inner, 4096, 133, 10, 46, 0, 0, 189, 13655
n8192-slot-inner, 4096, 141, 10, 45, 0, 0, 196, 13655
n8192-slot-inner, 4096, 135, 10, 44, 0, 0, 189, 13655
n8192-slot-inner, 4096, 133, 9, 44, 0, 0, 186, 13655
n8192-slot-inner, 4096, 142, 10, 45, 0, 0, 197, 13655
n8192-slot-inner, 4096, 134, 10, 46, 0, 0, 190, 13655
n8192-slot-inner, 4096, 135, 10, 44, 0, 0, 189, 13655
n8192-slot-inner, 4096, 137, 10, 44, 0, 0, 191, 13655
n8192-slot-inner, 4096, 133, 9, 45, 0, 0, 187, 13655
n8192-slot-inner, 4096, 134, 10, 44, 0, 0, 188, 13655
n8192-slot-inner, 4096, 135, 10, 46, 0, 0, 191, 13655
n8192-slot-inner, 4096, 135, 10, 45, 0, 0, 190, 13655
n8192-slot-inner, 4096, 137, 10, 46, 0, 0, 193, 13655
n8192-slot-inner, 4096, 137, 10, 46, 0, 0, 193, 13655
n8192-slot-inner, 4096, 134, 10, 45, 0, 0, 189, 13655
n8192-slot-inner, 4096, 138, 10, 45, 0, 0, 193, 13655
n8192-slot-inner, 4096, 136, 10, 45, 0, 0, 191, 13655
n8192-slot-inner, 4096, 139, 10, 44, 0, 0, 193, 13655
n8192-slot-inner, 4096, 135, 10, 45, 0, 0, 190, 13655
n8192-slot-inner, 4096, 135, 10, 45, 0, 0, 190, 13655
n8192-slot-inner, 4096, 140, 10, 45, 0, 0, 195, 13655
n8192-slot-inner, 4096, 134, 10, 44, 0, 0, 188, 13655
n8192-slot-inner, 4096, 132, 10, 44, 0, 0, 186, 13655
n8192-slot-inner, 4096, 137, 10, 44, 0, 0, 191, 13655
n8192-slot-inner, 4096, 134, 10, 44, 0, 0, 188, 13655
n8192-slot-inner, 4096, 132, 10, 44, 0, 0, 186, 13655
n8192-slot-inner, 4096, 133, 10, 46, 0, 0, 189, 13655
n8192-slot-inner, 4096, 133, 9, 44, 0, 0, 186, 13655
n8192-slot-inner, 4096, 142, 10, 46, 0, 0, 198, 13655
n8192-slot-inner, 4096, 143, 10, 46, 0, 0, 199, 13655
n8192-slot-inner, 4096, 132, 10, 46, 0, 0, 188, 13655
n8192-slot-inner, 4096, 140, 9, 44, 0, 0, 193, 13655
n8192-slot-inner, 4096, 138, 10, 46, 0, 0, 194, 13655
n8192-slot-inner, 4096, 136, 10, 44, 0, 0, 190, 13655
n8192-slot-inner, 4096, 133, 10, 44, 0, 0, 187, 13655
n8192-slot-inner, 4096, 134, 10, 46, 0, 0, 190, 13655
n8192-slot-inner, 4096, 135, 10, 46, 0, 0, 191, 13655
n8192-slot-inner, 4096, 136, 10, 44, 0, 0, 190, 13655
n8192-slot-inner, 4096, 133, 10, 45, 0, 0, 188, 13655
n8192-slot-inner, 4096, 136, 10, 44, 0, 0, 190, 13655
n8192-slot-inner, 4096, 134, 10, 45, 0, 0, 189, 13655
n8192-slot-inner, 4096, 137, 10, 46, 0, 0, 193, 13655
n8192-slot-inner, 4096, 136, 10, 46, 0, 0, 192, 13655
n8192-slot-inner, 4096, 135, 10, 45, 0, 0, 190, 13655
n8192-slot-inner, 4096, 139, 10, 44, 0, 0, 193, 13655
n8192-slot-inner, 2048, 33, 7, 15, 0, 0, 55, 13655
n8192-slot-inner, 2048, 33, 7, 15, 0, 0, 55, 13655
n8192-slot-inner, 2048, 33, 7, 16, 0, 0, 56, 13655
n8192-slot-inner, 2048, 34, 7, 16, 0, 0, 57, 13655
n8192-slot-inner, 2048, 34, 7, 16, 0, 0, 57, 13655
n8192-slot-inner, 2048, 34, 7, 16, 0, 0, 57, 13655
n8192-slot-inner, 2048, 35, 7, 16, 0, 0, 58, 13655
n8192-slot-inner, 2048, 33, 7, 16, 0, 0, 56, 13655
n8192-slot-inner, 2048, 34, 7, 16, 0, 0, 57, 13655
n8192-slot-inner, 2048, 33, 7, 15, 0, 0, 55, 13655
n8192-slot-inner, 2048, 33, 7, 15, 0, 0, 55, 13655
n8192-slot-inner, 2048, 34, 7, 15, 0, 0, 56, 13655
n8192-slot-inner, 2048, 34, 7, 16, 0, 0, 57, 13655
n8192-slot-inner, 2048, 34, 7, 15, 0, 0, 56, 13655
n8192-slot-inner, 2048, 33, 7, 16, 0, 0, 56, 13655
n8192-slot-inner, 2048, 33, 7, 16, 0, 0, 56, 13655
n8192-slot-inner, 2048, 34, 7, 15, 0, 0, 56, 13655
n8192-slot-inner, 2048, 34, 7, 15, 0, 0, 56, 13655
n8192-slot-inner, 2048, 33, 7, 16, 0, 0, 56, 13655
n8192-slot-inner, 2048, 33, 7, 15, 0, 0, 55, 13655
n8192-slot-inner, 2048, 33, 7, 15, 0, 0, 55, 13655
n8192-slot-inner, 2048, 33, 7, 15, 0, 0, 55, 13655
n8192-slot-inner, 2048, 33, 7, 16, 0, 0, 56, 13655
n8192-slot-inner, 2048, 34, 7, 16, 0, 0, 57, 13655
n8192-slot-inner, 2048, 33, 7, 15, 0, 0, 55, 13655
n8192-slot-inner, 2048, 33, 7, 16, 0, 0, 56, 13655
n8192-slot-inner, 2048, 33, 7, 16, 0, 0, 56, 13655
n8192-slot-inner, 2048, 34, 7, 16, 0, 0, 57, 13655
n8192-slot-inner, 2048, 33, 7, 15, 0, 0, 55, 13655
n8192-slot-inner, 2048, 34, 7, 15, 0, 0, 56, 13655
n8192-slot-inner, 2048, 34, 7, 15, 0, 0, 56, 13655
n8192-slot-inner, 2048, 33, 7, 16, 0, 0, 56, 13655
n8192-slot-inner, 2048, 33, 7, 16, 0, 0, 56, 13655
n8192-slot-inner, 2048, 33, 7, 16, 0, 0, 56, 13655
n8192-slot-inner, 2048, 34, 7, 16, 0, 0, 57, 13655
n8192-slot-inner, 2048, 33, 7, 16, 0, 0, 56, 13655
n8192-slot-inner, 2048, 34, 7, 16, 0, 0, 57, 13655
n8192-slot-inner, 2048, 33, 7, 15, 0, 0, 55, 13655
n8192-slot-inner, 2048, 34, 7, 15, 0, 0, 56, 13655
n8192-slot-inner, 2048, 33, 7, 16, 0, 0, 56, 13655
n8192-slot-inner, 2048, 35, 7, 16, 0, 0, 58, 13655
n8192-slot-inner, 2048, 34, 7, 15, 0, 0, 56, 13655
n8192-slot-inner, 2048, 33, 7, 16, 0, 0, 56, 13655
n8192-slot-inner, 2048, 34, 7, 16, 0, 0, 57, 13655
n8192-slot-inner, 2048, 34, 7, 15, 0, 0, 56, 13655
n8192-slot-inner, 2048, 34, 7, 15, 0, 0, 56, 13655
n8192-slot-inner, 2048, 33, 7, 15, 0, 0, 55, 13655
n8192-slot-inner, 2048, 34, 7, 16, 0, 0, 57, 13655
n8192-slot-inner, 2048, 35, 7, 16, 0, 0, 58, 13655
n8192-slot-inner, 2048, 34, 7, 16, 0, 0, 57, 13655
n8192-slot-inner, 2048, 34, 7, 16, 0, 0, 57, 13655
n8192-slot-inner, 2048, 34, 7, 15, 0, 0, 56, 13655
n8192-slot-inner, 2048, 34, 7, 16, 0, 0, 57, 13655
n8192-slot-inner, 2048, 35, 7, 16, 0, 0, 58, 13655
n8192-slot-inner, 2048, 34, 7, 15, 0, 0, 56, 13655
n8192-slot-inner, 2048, 33, 7, 16, 0, 0, 56, 13655
n8192-slot-inner, 2048, 34, 7, 15, 0, 0, 56, 13655
n8192-slot-inner, 2048, 33, 7, 16, 0, 0, 56, 13655
n8192-slot-inner, 2048, 34, 7, 16, 0, 0, 57, 13655
n8192-slot-inner, 2048, 33, 7, 16, 0, 0, 56, 13655
n8192-slot-inner, 2048, 34, 7, 16, 0, 0, 57, 13655
n8192-slot-inner, 2048, 34, 7, 16, 0, 0, 57, 13655
n8192-slot-inner, 2048, 33, 7, 15, 0, 0, 55, 13655
n8192-slot-inner, 2048, 33, 7, 16, 0, 0, 56, 13655
n8192-slot-inner, 2048, 34, 7, 15, 0, 0, 56, 13655
n8192-slot-inner, 2048, 34, 7, 16, 0, 0, 57, 13655
n8192-slot-inner, 2048, 34, 7, 15, 0, 0, 56, 13655
n8192-slot-inner, 2048, 34, 7, 15, 0, 0, 56, 13655
n8192-slot-inner, 2048, 33, 7, 15, 0, 0, 55, 13655
n8192-slot-inner, 2048, 34, 7, 16, 0, 0, 57, 13655
n8192-slot-inner, 2048, 33, 7, 15, 0, 0, 55, 13655
n8192-slot-inner, 2048, 34, 7, 15, 0, 0, 56, 13655
n8192-slot-inner, 2048, 33, 7, 15, 0, 0, 55, 13655
n8192-slot-inner, 2048, 33, 7, 16, 0, 0, 56, 13655
n8192-slot-inner, 2048, 34, 7, 16, 0, 0, 57, 13655
n8192-slot-inner, 2048, 34, 7, 16, 0, 0, 57, 13655
n8192-slot-inner, 2048, 33, 7, 16, 0, 0, 56, 13655
n8192-slot-inner, 2048, 33, 7, 16, 0, 0, 56, 13655
n8192-slot-inner, 2048, 34, 7, 16, 0, 0, 57, 13655
n8192-slot-inner, 2048, 34, 7, 16, 0, 0, 57, 13655
n8192-slot-inner, 2048, 34, 7, 15, 0, 0, 56, 13655
n8192-slot-inner, 2048, 34, 7, 16, 0, 0, 57, 13655
n8192-slot-inner, 2048, 34, 7, 15, 0, 0, 56, 13655
n8192-slot-inner, 2048, 33, 7, 15, 0, 0, 55, 13655
n8192-slot-inner, 2048, 33, 7, 16, 0, 0, 56, 13655
n8192-slot-inner, 2048, 34, 7, 15, 0, 0, 56, 13655
n8192-slot-inner, 2048, 33, 7, 15, 0, 0, 55, 13655
n8192-slot-inner, 2048, 34, 7, 16, 0, 0, 57, 13655
n8192-slot-inner, 2048, 34, 7, 15, 0, 0, 56, 13655
n8192-slot-inner, 2048, 34, 7, 16, 0, 0, 57, 13655
n8192-slot-inner, 2048, 34, 7, 15, 0, 0, 56, 13655
n8192-slot-inner, 2048, 33, 7, 15, 0, 0, 55, 13655
n8192-slot-inner, 2048, 34, 7, 16, 0, 0, 57, 13655
n8192-slot-inner, 2048, 34, 7, 16, 0, 0, 57, 13655
n8192-slot-inner, 2048, 33, 7, 15, 0, 0, 55, 13655
n8192-slot-inner, 2048, 33, 7, 15, 0, 0, 55, 13655
n8192-slot-inner, 2048, 33, 7, 15, 0, 0, 55, 13655
n8192-slot-inner, 2048, 34, 7, 16, 0, 0, 57, 13655
n8192-slot-inner, 2048, 34, 7, 16, 0, 0, 57, 13655
n8192-slot-inner, 2048, 34, 7, 17, 0, 0, 58, 13655
n8192-slot-inner, 1024, 18, 7, 12, 0, 0, 37, 13655
n8192-slot-inner, 1024, 18, 6, 12, 0, 0, 36, 13655
n8192-slot-inner, 1024, 18, 6, 12, 0, 0, 36, 13655
n8192-slot-inner, 1024, 18, 6, 12, 0, 0, 36, 13655
n8192-slot-inner, 1024, 18, 6, 12, 0, 0, 36, 13655
n8192-slot-inner, 1024, 18, 6, 12, 0, 0, 36, 13655
n8192-slot-inner, 1024, 18, 6, 12, 0, 0, 36, 13655
n8192-slot-inner, 1024, 19, 6, 12, 0, 0, 37, 13655
n8192-slot-inner, 1024, 19, 6, 13, 0, 0, 38, 13655
n8192-slot-inner, 1024, 18, 6, 12, 0, 0, 36, 13655
n8192-slot-inner, 1024, 18, 6, 12, 0, 0, 36, 13655
n8192-slot-inner, 1024, 18, 6, 12, 0, 0, 36, 13655
n8192-slot-inner, 1024, 18, 6, 12, 0, 0, 36, 13655
n8192-slot-inner, 1024, 18, 6, 12, 0, 0, 36, 13655
n8192-slot-inner, 1024, 18, 6, 12, 0, 0, 36, 13655
n8192-slot-inner, 1024, 18, 6, 13, 0, 0, 37, 13655
n8192-slot-inner, 1024, 18, 6, 12, 0, 0, 36, 13655
n8192-slot-inner, 1024, 18, 6, 12, 0, 0, 36, 13655
n8192-slot-inner, 1024, 18, 6, 13, 0, 0, 37, 13655
n8192-slot-inner, 1024, 18, 6, 12, 0, 0, 36, 13655
n8192-slot-inner, 1024, 18, 6, 12, 0, 0, 36, 13655
n8192-slot-inner, 1024, 19, 6, 12, 0, 0, 37, 13655
n8192-slot-inner, 1024, 18, 6, 12, 0, 0, 36, 13655
n8192-slot-inner, 1024, 18, 6, 12, 0, 0, 36, 13655
n8192-slot-inner, 1024, 18, 6, 12, 0, 0, 36, 13655
n8192-slot-inner, 1024, 18, 6, 12, 0, 0, 36, 13655
n8192-slot-inner, 1024, 18, 6, 12, 0, 0, 36, 13655
n8192-slot-inner, 1024, 18, 6, 12, 0, 0, 36, 13655
n8192-slot-inner, 1024, 18, 6, 12, 0, 0, 36, 13655
n8192-slot-inner, 1024, 18, 6, 12, 0, 0, 36, 13655
n8192-slot-inner, 1024, 18, 6, 12, 0, 0, 36, 13655
n8192-slot-inner, 1024, 18, 6, 12, 0, 0, 36, 13655
n8192-slot-inner, 1024, 18, 6, 12, 0, 0, 36, 13655
n8192-slot-inner, 1024, 18, 6, 12, 0, 0, 36, 13655
n8192-slot-inner, 1024, 18, 6, 12, 0, 0, 36, 13655
n8192-slot-inner, 1024, 18, 6, 12, 0, 0, 36, 13655
n8192-slot-inner, 1024, 18, 6, 12, 0, 0, 36, 13655
n8192-slot-inner, 1024, 18, 6, 12, 0, 0, 36, 13655
n8192-slot-inner, 1024, 18, 7, 12, 0, 0, 37, 13655
n8192-slot-inner, 1024, 18, 7, 13, 0, 0, 38, 13655
n8192-slot-inner, 1024, 18, 6, 12, 0, 0, 36, 13655
n8192-slot-inner, 1024, 18, 6, 12, 0, 0, 36, 13655
n8192-slot-inner, 1024, 18, 6, 13, 0, 0, 37, 13655
n8192-slot-inner, 1024, 18, 6, 12, 0, 0, 36, 13655
n8192-slot-inner, 1024, 18, 6, 12, 0, 0, 36, 13655
n8192-slot-inner, 1024, 18, 6, 12, 0, 0, 36, 13655
n8192-slot-inner, 1024, 18, 7, 12, 0, 0, 37, 13655
n8192-slot-inner, 1024, 18, 6, 13, 0, 0, 37, 13655
n8192-slot-inner, 1024, 18, 6, 12, 0, 0, 36, 13655
n8192-slot-inner, 1024, 18, 6, 12, 0, 0, 36, 13655
n8192-slot-inner, 1024, 18, 6, 12, 0, 0, 36, 13655
n8192-slot-inner, 1024, 18, 6, 12, 0, 0, 36, 13655
n8192-slot-inner, 1024, 18, 6, 12, 0, 0, 36, 13655
n8192-slot-inner, 1024, 18, 6, 12, 0, 0, 36, 13655
n8192-slot-inner, 1024, 18, 6, 12, 0, 0, 36, 13655
n8192-slot-inner, 1024, 18, 6, 12, 0, 0, 36, 13655
n8192-slot-inner, 1024, 18, 6, 12, 0, 0, 36, 13655
n8192-slot-inner, 1024, 18, 6, 12, 0, 0, 36, 13655
n8192-slot-inner, 1024, 18, 6, 12, 0, 0, 36, 13655
n8192-slot-inner, 1024, 18, 6, 12, 0, 0, 36, 13655
n8192-slot-inner, 1024, 18, 6, 12, 0, 0, 36, 13655
n8192-slot-inner, 1024, 18, 6, 12, 0, 0, 36, 13655
n8192-slot-inner, 1024, 19, 6, 12, 0, 0, 37, 13655
n8192-slot-inner, 1024, 18, 6, 12, 0, 0, 36, 13655
n8192-slot-inner, 1024, 18, 6, 12, 0, 0, 36, 13655
n8192-slot-inner, 1024, 17, 6, 12, 0, 0, 35, 13655
n8192-slot-inner, 1024, 18, 6, 12, 0, 0, 36, 13655
n8192-slot-inner, 1024, 18, 6, 12, 0, 0, 36, 13655
n8192-slot-inner, 1024, 18, 6, 12, 0, 0, 36, 13655
n8192-slot-inner, 1024, 18, 6, 12, 0, 0, 36, 13655
n8192-slot-inner, 1024, 18, 6, 12, 0, 0, 36, 13655
n8192-slot-inner, 1024, 18, 6, 12, 0, 0, 36, 13655
n8192-slot-inner, 1024, 18, 6, 12, 0, 0, 36, 13655
n8192-slot-inner, 1024, 18, 6, 12, 0, 0, 36, 13655
n8192-slot-inner, 1024, 18, 6, 12, 0, 0, 36, 13655
n8192-slot-inner, 1024, 18, 6, 12, 0, 0, 36, 13655
n8192-slot-inner, 1024, 18, 6, 12, 0, 0, 36, 13655
n8192-slot-inner, 1024, 18, 6, 12, 0, 0, 36, 13655
n8192-slot-inner, 1024, 18, 6, 12, 0, 0, 36, 13655
n8192-slot-inner, 1024, 18, 6, 12, 0, 0, 36, 13655
n8192-slot-inner, 1024, 18, 6, 12, 0, 0, 36, 13655
n8192-slot-inner, 1024, 18, 6, 12, 0, 0, 36, 13655
n8192-slot-inner, 1024, 18, 6, 12, 0, 0, 36, 13655
n8192-slot-inner, 1024, 18, 6, 12, 0, 0, 36, 13655
n8192-slot-inner, 1024, 18, 6, 12, 0, 0, 36, 13655
n8192-slot-inner, 1024, 18, 6, 12, 0, 0, 36, 13655
n8192-slot-inner, 1024, 18, 6, 12, 0, 0, 36, 13655
n8192-slot-inner, 1024, 18, 6, 12, 0, 0, 36, 13655
n8192-slot-inner, 1024, 18, 6, 12, 0, 0, 36, 13655
n8192-slot-inner, 1024, 18, 6, 13, 0, 0, 37, 13655
n8192-slot-inner, 1024, 18, 6, 12, 0, 0, 36, 13655
n8192-slot-inner, 1024, 18, 6, 12, 0, 0, 36, 13655
n8192-slot-inner, 1024, 18, 6, 12, 0, 0, 36, 13655
n8192-slot-inner, 1024, 18, 6, 12, 0, 0, 36, 13655
n8192-slot-inner, 1024, 18, 6, 12, 0, 0, 36, 13655
n8192-slot-inner, 1024, 18, 6, 12, 0, 0, 36, 13655
n8192-slot-inner, 1024, 18, 6, 12, 0, 0, 36, 13655
n8192-slot-inner, 1024, 18, 6, 12, 0, 0, 36, 13655
n8192-slot-inner, 1024, 18, 6, 12, 0, 0, 36, 13655
n8192-slot-inner, 1024, 18, 6, 12, 0, 0, 36, 13655
n8192-coef-inner, 8192, 50, 32, 16, 1, 0, 99, 13655
n8192-coef-inner, 8192, 56, 30, 15, 1, 0, 102, 13655
n8192-coef-inner, 8192, 50, 29, 16, 1, 0, 96, 13655
n8192-coef-inner, 8192, 50, 30, 16, 1, 0, 97, 13655
n8192-coef-inner, 8192, 51, 29, 16, 1, 0, 97, 13655
n8192-coef-inner, 8192, 57, 29, 15, 1, 0, 102, 13655
n8192-coef-inner, 8192, 50, 29, 16, 1, 0, 96, 13655
n8192-coef-inner, 8192, 50, 30, 15, 1, 0, 96, 13655
n8192-coef-inner, 8192, 62, 29, 16, 1, 0, 108, 13655
n8192-coef-inner, 8192, 53, 29, 16, 1, 0, 99, 13655
n8192-coef-inner, 8192, 51, 29, 15, 1, 0, 96, 13655
n8192-coef-inner, 8192, 53, 29, 16, 1, 0, 99, 13655
n8192-coef-inner, 8192, 54, 30, 15, 1, 0, 100, 13655
n8192-coef-inner, 8192, 54, 30, 17, 1, 0, 102, 13655
n8192-coef-inner, 8192, 52, 32, 15, 1, 0, 100, 13655
n8192-coef-inner, 8192, 51, 29, 16, 1, 0, 97, 13655
n8192-coef-inner, 8192, 51, 29, 15, 1, 0, 96, 13655
n8192-coef-inner, 8192, 51, 30, 15, 1, 0, 97, 13655
n8192-coef-inner, 8192, 54, 29, 15, 1, 0, 99, 13655
n8192-coef-inner, 8192, 54, 30, 15, 1, 0, 100, 13655
n8192-coef-inner, 8192, 54, 29, 15, 1, 0, 99, 13655
n8192-coef-inner, 8192, 50, 30, 16, 1, 0, 97, 13655
n8192-coef-inner, 8192, 51, 30, 16, 1, 0, 98, 13655
n8192-coef-inner, 8192, 55, 29, 16, 1, 0, 101, 13655
n8192-coef-inner, 8192, 53, 30, 15, 1, 0, 99, 13655
n8192-coef-inner, 8192, 54, 30, 15, 1, 0, 100, 13655
n8192-coef-inner, 8192, 55, 30, 16, 1, 0, 102, 13655
n8192-coef-inner, 8192, 57, 30, 16, 1, 0, 104, 13655
n8192-coef-inner, 8192, 54, 29, 15, 1, 0, 99, 13655
n8192-coef-inner, 8192, 51, 29, 15, 1, 0, 96, 13655
n8192-coef-inner, 8192, 55, 30, 15, 1, 0, 101, 13655
n8192-coef-inner, 8192, 54, 29, 16, 1, 0, 100, 13655
n8192-coef-inner, 8192, 53, 30, 16, 1, 0, 100, 13655
n8192-coef-inner, 8192, 53, 29, 16, 1, 0, 99, 13655
n8192-coef-inner, 8192, 54, 30, 16, 1, 0, 101, 13655
n8192-coef-inner, 8192, 54, 29, 16, 1, 0, 100, 13655
n8192-coef-inner, 8192, 54, 30, 16, 1, 0, 101, 13655
n8192-coef-inner, 8192, 53, 30, 16, 1, 0, 100, 13655
n8192-coef-inner, 8192, 54, 29, 16, 1, 0, 100, 13655
n8192-coef-inner, 8192, 54, 29, 15, 1, 0, 99, 13655
n8192-coef-inner, 8192, 55, 30, 17, 1, 0, 103, 13655
n8192-coef-inner, 8192, 54, 30, 17, 1, 0, 102, 13655
n8192-coef-inner, 8192, 50, 30, 15, 1, 0, 96, 13655
n8192-coef-inner, 8192, 50, 29, 16, 1, 0, 96, 13655
n8192-coef-inner, 8192, 50, 29, 16, 1, 0, 96, 13655
n8192-coef-inner, 8192, 54, 30, 17, 1, 0, 102, 13655
n8192-coef-inner, 8192, 53, 30, 16, 1, 0, 100, 13655
n8192-coef-inner, 8192, 53, 30, 16, 1, 0, 100, 13655
n8192-coef-inner, 8192, 54, 29, 16, 1, 0, 100, 13655
n8192-coef-inner, 8192, 50, 30, 15, 1, 0, 96, 13655
n8192-coef-inner, 8192, 54, 29, 15, 1, 0, 99, 13655
n8192-coef-inner, 8192, 55, 29, 15, 1, 0, 100, 13655
n8192-coef-inner, 8192, 50, 30, 15, 1, 0, 96, 13655
n8192-coef-inner, 8192, 54, 30, 16, 1, 0, 101, 13655
n8192-coef-inner, 8192, 53, 29, 16, 1, 0, 99, 13655
n8192-coef-inner, 8192, 57, 29, 16, 1, 0, 103, 13655
n8192-coef-inner, 8192, 54, 29, 15, 1, 0, 99, 13655
n8192-coef-inner, 8192, 51, 29, 15, 1, 0, 96, 13655
n8192-coef-inner, 8192, 60, 29, 16, 1, 0, 106, 13655
n8192-coef-inner, 8192, 62, 32, 16, 1, 0, 111, 13655
n8192-coef-inner, 8192, 54, 30, 16, 1, 0, 101, 13655
n8192-coef-inner, 8192, 54, 30, 16, 1, 0, 101, 13655
n8192-coef-inner, 8192, 58, 30, 15, 1, 0, 104, 13655
n8192-coef-inner, 8192, 53, 30, 16, 1, 0, 100, 13655
n8192-coef-inner, 8192, 53, 30, 15, 1, 0, 99, 13655
n8192-coef-inner, 8192, 54, 29, 16, 1, 0, 100, 13655
n8192-coef-inner, 8192, 50, 30, 16, 1, 0, 97, 13655
n8192-coef-inner, 8192, 54, 30, 16, 1, 0, 101, 13655
n8192-coef-inner, 8192, 53, 30, 15, 1, 0, 99, 13655
n8192-coef-inner, 8192, 54, 29, 16, 1, 0, 100, 13655
n8192-coef-inner, 8192, 50, 30, 17, 1, 0, 98, 13655
n8192-coef-inner, 8192, 57, 29, 15, 1, 0, 102, 13655
n8192-coef-inner, 8192, 50, 29, 16, 1, 0, 96, 13655
n8192-coef-inner, 8192, 54, 29, 15, 1, 0, 99, 13655
n8192-coef-inner, 8192, 51, 29, 16, 1, 0, 97, 13655
n8192-coef-inner, 8192, 51, 30, 16, 1, 0, 98, 13655
n8192-coef-inner, 8192, 50, 29, 15, 1, 0, 95, 13655
n8192-coef-inner, 8192, 50, 29, 16, 1, 0, 96, 13655
n8192-coef-inner, 8192, 55, 30, 15, 1, 0, 101, 13655
n8192-coef-inner, 8192, 58, 30, 15, 1, 0, 104, 13655
n8192-coef-inner, 8192, 54, 29, 15, 1, 0, 99, 13655
n8192-coef-inner, 8192, 50, 29, 15, 1, 0, 95, 13655
n8192-coef-inner, 8192, 51, 29, 16, 1, 0, 97, 13655
n8192-coef-inner, 8192, 55, 29, 16, 1, 0, 101, 13655
n8192-coef-inner, 8192, 53, 29, 15, 1, 0, 98, 13655
n8192-coef-inner, 8192, 50, 29, 15, 1, 0, 95, 13655
n8192-coef-inner, 8192, 52, 30, 16, 1, 0, 99, 13655
n8192-coef-inner, 8192, 53, 30, 16, 1, 0, 100, 13655
n8192-coef-inner, 8192, 50, 29, 15, 1, 0, 95, 13655
n8192-coef-inner, 8192, 51, 29, 16, 1, 0, 97, 13655
n8192-coef-inner, 8192, 53, 29, 16, 1, 0, 99, 13655
n8192-coef-inner, 8192, 51, 29, 16, 1, 0, 97, 13655
n8192-coef-inner, 8192, 54, 30, 15, 1, 0, 100, 13655
n8192-coef-inner, 8192, 55, 29, 16, 1, 0, 101, 13655
n8192-coef-inner, 8192, 52, 30, 17, 1, 0, 100, 13655
n8192-coef-inner, 8192, 52, 29, 16, 1, 0, 98, 13655
n8192-coef-inner, 8192, 50, 29, 16, 1, 0, 96, 13655
n8192-coef-inner, 8192, 54, 29, 16, 1, 0, 100, 13655
n8192-coef-inner, 8192, 54, 29, 15, 1, 0, 99, 13655
n8192-coef-inner, 8192, 56, 29, 16, 1, 0, 102, 13655
n8192-coef-inner, 4096, 27, 29, 14, 0, 0, 70, 13655
n8192-coef-inner, 4096, 28, 29, 14, 0, 0, 71, 13655
n8192-coef-inner, 4096, 27, 29, 14, 0, 0, 70, 13655
n8192-coef-inner, 4096, 37, 29, 14, 0, 0, 80, 13655
n8192-coef-inner, 4096, 28, 29, 14, 0, 0, 71, 13655
n8192-coef-inner, 4096, 27, 29, 14, 0, 0, 70, 13655
n8192-coef-inner, 4096, 31, 29, 13, 0, 0, 73, 13655
n8192-coef-inner, 4096, 30, 28, 14, 0, 0, 72, 13655
n8192-coef-inner, 4096, 29, 29, 14, 0, 0, 72, 13655
n8192-coef-inner, 4096, 28, 29, 14, 0, 0, 71, 13655
n8192-coef-inner, 4096, 28, 29, 14, 0, 0, 71, 13655
n8192-coef-inner, 4096, 27, 28, 14, 0, 0, 69, 13655
n8192-coef-inner, 4096, 32, 29, 14, 0, 0, 75, 13655
n8192-coef-inner, 4096, 27, 29, 14, 0, 0, 70, 13655
n8192-coef-inner, 4096, 30, 29, 13, 0, 0, 72, 13655
n8192-coef-inner, 4096, 37, 29, 14, 0, 0, 80, 13655
n8192-coef-inner, 4096, 29, 29, 14, 0, 0, 72, 13655
n8192-coef-inner, 4096, 37, 29, 14, 0, 0, 80, 13655
n8192-coef-inner, 4096, 27, 28, 14, 0, 0, 69, 13655
n8192-coef-inner, 4096, 32, 29, 14, 0, 0, 75, 13655
n8192-coef-inner, 4096, 29, 29, 15, 0, 0, 73, 13655
n8192-coef-inner, 4096, 32, 29, 14, 0, 0, 75, 13655
n8192-coef-inner, 4096, 37, 29, 14, 0, 0, 80, 13655
n8192-coef-inner, 4096, 27, 29, 13, 0, 0, 69, 13655
n8192-coef-inner, 4096, 32, 29, 14, 0, 0, 75, 13655
n8192-coef-inner, 4096, 29, 29, 14, 0, 0, 72, 13655
n8192-coef-inner, 4096, 29, 28, 13, 0, 0, 70, 13655
n8192-coef-inner, 4096, 30, 29, 14, 0, 0, 73, 13655
n8192-coef-inner, 4096, 29, 29, 14, 0, 0, 72, 13655
n8192-coef-inner, 4096, 32, 29, 14, 0, 0, 75, 13655
n8192-coef-inner, 4096, 28, 29, 14, 0, 0, 71, 13655
n8192-coef-inner, 4096, 31, 29, 14, 0, 0, 74, 13655
n8192-coef-inner, 4096, 28, 29, 14, 0, 0, 71, 13655
n8192-coef-inner, 4096, 30, 29, 14, 0, 0, 73, 13655
n8192-coef-inner, 4096, 27, 29, 13, 0, 0, 69, 13655
n8192-coef-inner, 4096, 39, 28, 14, 0, 0, 81, 13655
n8192-coef-inner, 4096, 29, 29, 15, 0, 0, 73, 13655
n8192-coef-inner, 4096, 29, 28, 13, 0, 0, 70, 13655
n8192-coef-inner, 4096, 38, 29, 14, 0, 0, 81, 13655
n8192-coef-inner, 4096, 30, 29, 14, 0, 0, 73, 13655
n8192-coef-inner, 4096, 27, 28, 14, 0, 0, 69, 13655
n8192-coef-inner, 4096, 28, 29, 14, 0, 0, 71, 13655
n8192-coef-inner, 4096, 28, 29, 14, 0, 0, 71, 13655
n8192-coef-inner, 4096, 31, 29, 14, 0, 0, 74, 13655
n8192-coef-inner, 4096, 27, 29, 14, 0, 0, 70, 13655
n8192-coef-inner, 4096, 30, 29, 14, 0, 0, 73, 13655
n8192-coef-inner, 4096, 28, 29, 14, 0, 0, 71, 13655
n8192-coef-inner, 4096, 28, 29, 14, 0, 0, 71, 13655
n8192-coef-inner, 4096, 27, 29, 14, 0, 0, 70, 13655
n8192-coef-inner, 4096, 29, 28, 14, 0, 0, 71, 13655
n8192-coef-inner, 4096, 29, 29, 14, 0, 0, 72, 13655
n8192-coef-inner, 4096, 29, 29, 14, 0, 0, 72, 13655
n8192-coef-inner, 4096, 28, 29, 14, 0, 0, 71, 13655
n8192-coef-inner, 4096, 30, 30, 15, 0, 0, 75, 13655
n8192-coef-inner, 4096, 27, 29, 14, 0, 0, 70, 13655
n8192-coef-inner, 4096, 28, 29, 14, 0, 0, 71, 13655
n8192-coef-inner, 4096, 30, 29, 14, 0, 0, 73, 13655
n8192-coef-inner, 4096, 29, 29, 14, 0, 0, 72, 13655
n8192-coef-inner, 4096, 28, 30, 14, 0, 0, 72, 13655
n8192-coef-inner, 4096, 31, 29, 14, 0, 0, 74, 13655
n8192-coef-inner, 4096, 28, 29, 15, 0, 0, 72, 13655
n8192-coef-inner, 4096, 32, 29, 14, 0, 0, 75, 13655
n8192-coef-inner, 4096, 29, 30, 15, 0, 0, 74, 13655
n8192-coef-inner, 4096, 27, 30, 15, 0, 0, 72, 13655
n8192-coef-inner, 4096, 28, 30, 14, 0, 0, 72, 13655
n8192-coef-inner, 4096, 31, 29, 14, 0, 0, 74, 13655
n8192-coef-inner, 4096, 29, 29, 14, 0, 0, 72, 13655
n8192-coef-inner, 4096, 27, 29, 14, 0, 0, 70, 13655
n8192-coef-inner, 4096, 28, 29, 14, 0, 0, 71, 13655
n8192-coef-inner, 4096, 28, 29, 14, 0, 0, 71, 13655
n8192-coef-inner, 4096, 28, 30, 14, 0, 0, 72, 13655
n8192-coef-inner, 4096, 39, 29, 14, 0, 0, 82, 13655
n8192-coef-inner, 4096, 28, 29, 15, 0, 0, 72, 13655
n8192-coef-inner, 4096, 29, 29, 16, 0, 0, 74, 13655
n8192-coef-inner, 4096, 30, 29, 14, 0, 0, 73, 13655
n8192-coef-inner, 4096, 29, 28, 14, 0, 0, 71, 13655
n8192-coef-inner, 4096, 30, 29, 14, 0, 0, 73, 13655
n8192-coef-inner, 4096, 29, 29, 14, 0, 0, 72, 13655
n8192-coef-inner, 4096, 29, 28, 16, 0, 0, 73, 13655
n8192-coef-inner, 4096, 31, 28, 14, 0, 0, 73, 13655
n8192-coef-inner, 4096, 28, 29, 14, 0, 0, 71, 13655
n8192-coef-inner, 4096, 31, 29, 15, 0, 0, 75, 13655
n8192-coef-inner, 4096, 28, 29, 15, 0, 0, 72, 13655
n8192-coef-inner, 4096, 31, 30, 14, 0, 0, 75, 13655
n8192-coef-inner, 4096, 28, 29, 14, 0, 0, 71, 13655
n8192-coef-inner, 4096, 28, 29, 14, 0, 0, 71, 13655
n8192-coef-inner, 4096, 27, 29, 14, 0, 0, 70, 13655
n8192-coef-inner, 4096, 30, 30, 14, 0, 0, 74, 13655
n8192-coef-inner, 4096, 27, 29, 14, 0, 0, 70, 13655
n8192-coef-inner, 4096, 30, 29, 14, 0, 0, 73, 13655
n8192-coef-inner, 4096, 28, 29, 14, 0, 0, 71, 13655
n8192-coef-inner, 4096, 29, 29, 14, 0, 0, 72, 13655
n8192-coef-inner, 4096, 29, 29, 14, 0, 0, 72, 13655
n8192-coef-inner, 4096, 30, 29, 14, 0, 0, 73, 13655
n8192-coef-inner, 4096, 29, 29, 14, 0, 0, 72, 13655
n8192-coef-inner, 4096, 29, 30, 14, 0, 0, 73, 13655
n8192-coef-inner, 4096, 32, 30, 14, 0, 0, 76, 13655
n8192-coef-inner, 4096, 32, 29, 14, 0, 0, 75, 13655
n8192-coef-inner, 4096, 29, 29, 14, 0, 0, 72, 13655
n8192-coef-inner, 4096, 33, 29, 14, 0, 0, 76, 13655
n8192-coef-inner, 2048, 10, 22, 8, 0, 0, 40, 13655
n8192-coef-inner, 2048, 10, 22, 8, 0, 0, 40, 13655
n8192-coef-inner, 2048, 10, 22, 8, 0, 0, 40, 13655
n8192-coef-inner, 2048, 10, 23, 8, 0, 0, 41, 13655
n8192-coef-inner, 2048, 10, 22, 8, 0, 0, 40, 13655
n8192-coef-inner, 2048, 10, 23, 8, 0, 0, 41, 13655
n8192-coef-inner, 2048, 10, 22, 8, 0, 0, 40, 13655
n8192-coef-inner, 2048, 10, 22, 8, 0, 0, 40, 13655
n8192-coef-inner, 2048, 10, 22, 8, 0, 0, 40, 13655
n8192-coef-inner, 2048, 14, 22, 8, 0, 0, 44, 13655
n8192-coef-inner, 2048, 10, 22, 8, 0, 0, 40, 13655
n8192-coef-inner, 2048, 10, 22, 9, 0, 0, 41, 13655
n8192-coef-inner, 2048, 10, 22, 8, 0, 0, 40, 13655
n8192-coef-inner, 2048, 10, 22, 8, 0, 0, 40, 13655
n8192-coef-inner, 2048, 11, 22, 9, 0, 0, 42, 13655
n8192-coef-inner, 2048, 10, 23, 8, 0, 0, 41, 13655
n8192-coef-inner, 2048, 10, 22, 8, 0, 0, 40, 13655
n8192-coef-inner, 2048, 10, 22, 8, 0, 0, 40, 13655
n8192-coef-inner, 2048, 11, 23, 8, 0, 0, 42, 13655
n8192-coef-inner, 2048, 10, 22, 8, 0, 0, 40, 13655
n8192-coef-inner, 2048, 10, 22, 8, 0, 0, 40, 13655
n8192-coef-inner, 2048, 10, 22, 9, 0, 0, 41, 13655
n8192-coef-inner, 2048, 10, 22, 8, 0, 0, 40, 13655
n8192-coef-inner, 2048, 10, 22, 8, 0, 0, 40, 13655
n8192-coef-inner, 2048, 10, 23, 9, 0, 0, 42, 13655
n8192-coef-inner, 2048, 10, 22, 8, 0, 0, 40, 13655
n8192-coef-inner, 2048, 10, 22, 8, 0, 0, 40, 13655
n8192-coef-inner, 2048, 10, 22, 8, 0, 0, 40, 13655
n8192-coef-inner, 2048, 10, 22, 9, 0, 0, 41, 13655
n8192-coef-inner, 2048, 10, 21, 8, 0, 0, 39, 13655
n8192-coef-inner, 2048, 10, 22, 8, 0, 0, 40, 13655
n8192-coef-inner, 2048, 10, 22, 8, 0, 0, 40, 13655
n8192-coef-inner, 2048, 10, 22, 8, 0, 0, 40, 13655
n8192-coef-inner, 2048, 10, 23, 8, 0, 0, 41, 13655
n8192-coef-inner, 2048, 10, 22, 8, 0, 0, 40, 13655
n8192-coef-inner, 2048, 10, 22, 8, 0, 0, 40, 13655
n8192-coef-inner, 2048, 11, 22, 8, 0, 0, 41, 13655
n8192-coef-inner, 2048, 10, 23, 8, 0, 0, 41, 13655
n8192-coef-inner, 2048, 10, 22, 8, 0, 0, 40, 13655
n8192-coef-inner, 2048, 11, 23, 8, 0, 0, 42, 13655
n8192-coef-inner, 2048, 10, 22, 8, 0, 0, 40, 13655
n8192-coef-inner, 2048, 10, 22, 8, 0, 0, 40, 13655
n8192-coef-inner, 2048, 10, 22, 8, 0, 0, 40, 13655
n8192-coef-inner, 2048, 10, 22, 8, 0, 0, 40, 13655
n8192-coef-inner, 2048, 10, 22, 9, 0, 0, 41, 13655
n8192-coef-inner, 2048, 10, 22, 8, 0, 0, 40, 13655
n8192-coef-inner, 2048, 10, 22, 8, 0, 0, 40, 13655
n8192-coef-inner, 2048, 10, 22, 8, 0, 0, 40, 13655
n8192-coef-inner, 2048, 10, 22, 8, 0, 0, 40, 13655
n8192-coef-inner, 2048, 10, 21, 8, 0, 0, 39, 13655
n8192-coef-inner, 2048, 10, 22, 8, 0, 0, 40, 13655
n8192-coef-inner, 2048, 10, 22, 8, 0, 0, 40, 13655
n8192-coef-inner, 2048, 10, 22, 8, 0, 0, 40, 13655
n8192-coef-inner, 2048, 10, 22, 8, 0, 0, 40, 13655
n8192-coef-inner, 2048, 10, 22, 8, 0, 0, 40, 13655
n8192-coef-inner, 2048, 10, 22, 8, 0, 0, 40, 13655
n8192-coef-inner, 2048, 10, 22, 8, 0, 0, 40, 13655
n8192-coef-inner, 2048, 10, 22, 8, 0, 0, 40, 13655
n8192-coef-inner, 2048, 10, 22, 8, 0, 0, 40, 13655
n8192-coef-inner, 2048, 10, 21, 8, 0, 0, 39, 13655
n8192-coef-inner, 2048, 10, 22, 8, 0, 0, 40, 13655
n8192-coef-inner, 2048, 10, 23, 8, 0, 0, 41, 13655
n8192-coef-inner, 2048, 10, 22, 8, 0, 0, 40, 13655
n8192-coef-inner, 2048, 10, 22, 9, 0, 0, 41, 13655
n8192-coef-inner, 2048, 10, 22, 8, 0, 0, 40, 13655
n8192-coef-inner, 2048, 10, 22, 8, 0, 0, 40, 13655
n8192-coef-inner, 2048, 10, 22, 8, 0, 0, 40, 13655
n8192-coef-inner, 2048, 10, 22, 8, 0, 0, 40, 13655
n8192-coef-inner, 2048, 10, 22, 8, 0, 0, 40, 13655
n8192-coef-inner, 2048, 10, 21, 8, 0, 0, 39, 13655
n8192-coef-inner, 2048, 10, 21, 8, 0, 0, 39, 13655
n8192-coef-inner, 2048, 10, 22, 8, 0, 0, 40, 13655
n8192-coef-inner, 2048, 10, 22, 8, 0, 0, 40, 13655
n8192-coef-inner, 2048, 10, 21, 8, 0, 0, 39, 13655
n8192-coef-inner, 2048, 10, 22, 9, 0, 0, 41, 13655
n8192-coef-inner, 2048, 10, 22, 8, 0, 0, 40, 13655
n8192-coef-inner, 2048, 10, 22, 8, 0, 0, 40, 13655
n8192-coef-inner, 2048, 11, 22, 8, 0, 0, 41, 13655
n8192-coef-inner, 2048, 10, 22, 8, 0, 0, 40, 13655
n8192-coef-inner, 2048, 11, 23, 8, 0, 0, 42, 13655
n8192-coef-inner, 2048, 10, 22, 8, 0, 0, 40, 13655
n8192-coef-inner, 2048, 10, 22, 8, 0, 0, 40, 13655
n8192-coef-inner, 2048, 10, 22, 8, 0, 0, 40, 13655
n8192-coef-inner, 2048, 10, 22, 8, 0, 0, 40, 13655
n8192-coef-inner, 2048, 10, 22, 8, 0, 0, 40, 13655
n8192-coef-inner, 2048, 10, 22, 8, 0, 0, 40, 13655
n8192-coef-inner, 2048, 10, 22, 8, 0, 0, 40, 13655
n8192-coef-inner, 2048, 10, 22, 8, 0, 0, 40, 13655
n8192-coef-inner, 2048, 10, 22, 8, 0, 0, 40, 13655
n8192-coef-inner, 2048, 10, 22, 8, 0, 0, 40, 13655
n8192-coef-inner, 2048, 10, 22, 8, 0, 0, 40, 13655
n8192-coef-inner, 2048, 10, 22, 8, 0, 0, 40, 13655
n8192-coef-inner, 2048, 10, 21, 8, 0, 0, 39, 13655
n8192-coef-inner, 2048, 10, 22, 8, 0, 0, 40, 13655
n8192-coef-inner, 2048, 10, 22, 8, 0, 0, 40, 13655
n8192-coef-inner, 2048, 10, 22, 8, 0, 0, 40, 13655
n8192-coef-inner, 2048, 10, 22, 8, 0, 0, 40, 13655
n8192-coef-inner, 2048, 10, 22, 8, 0, 0, 40, 13655
n8192-coef-inner, 2048, 11, 22, 8, 0, 0, 41, 13655
n8192-coef-inner, 2048, 10, 22, 8, 0, 0, 40, 13655
n8192-coef-inner, 1024, 7, 22, 8, 0, 0, 37, 13655
n8192-coef-inner, 1024, 7, 21, 8, 0, 0, 36, 13655
n8192-coef-inner, 1024, 7, 22, 9, 0, 0, 38, 13655
n8192-coef-inner, 1024, 7, 22, 9, 0, 0, 38, 13655
n8192-coef-inner, 1024, 7, 21, 8, 0, 0, 36, 13655
n8192-coef-inner, 1024, 7, 22, 8, 0, 0, 37, 13655
n8192-coef-inner, 1024, 7, 22, 9, 0, 0, 38, 13655
n8192-coef-inner, 1024, 7, 22, 9, 0, 0, 38, 13655
n8192-coef-inner, 1024, 7, 22, 9, 0, 0, 38, 13655
n8192-coef-inner, 1024, 7, 22, 8, 0, 0, 37, 13655
n8192-coef-inner, 1024, 7, 21, 8, 0, 0, 36, 13655
n8192-coef-inner, 1024, 7, 21, 8, 0, 0, 36, 13655
n8192-coef-inner, 1024, 7, 22, 9, 0, 0, 38, 13655
n8192-coef-inner, 1024, 7, 22, 9, 0, 0, 38, 13655
n8192-coef-inner, 1024, 7, 22, 8, 0, 0, 37, 13655
n8192-coef-inner, 1024, 7, 21, 8, 0, 0, 36, 13655
n8192-coef-inner, 1024, 7, 21, 8, 0, 0, 36, 13655
n8192-coef-inner, 1024, 7, 22, 9, 0, 0, 38, 13655
n8192-coef-inner, 1024, 7, 22, 9, 0, 0, 38, 13655
n8192-coef-inner, 1024, 7, 22, 8, 0, 0, 37, 13655
n8192-coef-inner, 1024, 8, 35, 8, 0, 0, 51, 13655
n8192-coef-inner, 1024, 7, 22, 9, 0, 0, 38, 13655
n8192-coef-inner, 1024, 7, 21, 8, 0, 0, 36, 13655
n8192-coef-inner, 1024, 7, 21, 8, 0, 0, 36, 13655
n8192-coef-inner, 1024, 7, 22, 9, 0, 0, 38, 13655
n8192-coef-inner, 1024, 7, 21, 8, 0, 0, 36, 13655
n8192-coef-inner, 1024, 7, 21, 8, 0, 0, 36, 13655
n8192-coef-inner, 1024, 7, 22, 8, 0, 0, 37, 13655
n8192-coef-inner, 1024, 7, 21, 8, 0, 0, 36, 13655
n8192-coef-inner, 1024, 7, 22, 9, 0, 0, 38, 13655
n8192-coef-inner, 1024, 7, 22, 8, 0, 0, 37, 13655
n8192-coef-inner, 1024, 7, 21, 9, 0, 0, 37, 13655
n8192-coef-inner, 1024, 7, 21, 9, 0, 0, 37, 13655
n8192-coef-inner, 1024, 7, 22, 8, 0, 0, 37, 13655
n8192-coef-inner, 1024, 7, 22, 8, 0, 0, 37, 13655
n8192-coef-inner, 1024, 7, 21, 8, 0, 0, 36, 13655
n8192-coef-inner, 1024, 7, 22, 8, 0, 0, 37, 13655
n8192-coef-inner, 1024, 7, 21, 8, 0, 0, 36, 13655
n8192-coef-inner, 1024, 7, 21, 8, 0, 0, 36, 13655
n8192-coef-inner, 1024, 7, 22, 8, 0, 0, 37, 13655
n8192-coef-inner, 1024, 7, 21, 8, 0, 0, 36, 13655
n8192-coef-inner, 1024, 7, 21, 8, 0, 0, 36, 13655
n8192-coef-inner, 1024, 7, 22, 9, 0, 0, 38, 13655
n8192-coef-inner, 1024, 7, 21, 9, 0, 0, 37, 13655
n8192-coef-inner, 1024, 7, 21, 8, 0, 0, 36, 13655
n8192-coef-inner, 1024, 7, 22, 8, 0, 0, 37, 13655
n8192-coef-inner, 1024, 7, 22, 9, 0, 0, 38, 13655
n8192-coef-inner, 1024, 7, 22, 8, 0, 0, 37, 13655
n8192-coef-inner, 1024, 7, 22, 8, 0, 0, 37, 13655
n8192-coef-inner, 1024, 7, 21, 9, 0, 0, 37, 13655
n8192-coef-inner, 1024, 7, 22, 9, 0, 0, 38, 13655
n8192-coef-inner, 1024, 7, 22, 9, 0, 0, 38, 13655
n8192-coef-inner, 1024, 7, 22, 9, 0, 0, 38, 13655
n8192-coef-inner, 1024, 7, 22, 8, 0, 0, 37, 13655
n8192-coef-inner, 1024, 7, 21, 8, 0, 0, 36, 13655
n8192-coef-inner, 1024, 7, 21, 8, 0, 0, 36, 13655
n8192-coef-inner, 1024, 7, 21, 8, 0, 0, 36, 13655
n8192-coef-inner, 1024, 7, 22, 8, 0, 0, 37, 13655
n8192-coef-inner, 1024, 7, 21, 8, 0, 0, 36, 13655
n8192-coef-inner, 1024, 7, 22, 8, 0, 0, 37, 13655
n8192-coef-inner, 1024, 7, 21, 8, 0, 0, 36, 13655
n8192-coef-inner, 1024, 7, 22, 9, 0, 0, 38, 13655
n8192-coef-inner, 1024, 7, 22, 9, 0, 0, 38, 13655
n8192-coef-inner, 1024, 8, 22, 8, 0, 0, 38, 13655
n8192-coef-inner, 1024, 7, 21, 9, 0, 0, 37, 13655
n8192-coef-inner, 1024, 7, 22, 9, 0, 0, 38, 13655
n8192-coef-inner, 1024, 7, 22, 9, 0, 0, 38, 13655
n8192-coef-inner, 1024, 7, 21, 8, 0, 0, 36, 13655
n8192-coef-inner, 1024, 7, 21, 8, 0, 0, 36, 13655
n8192-coef-inner, 1024, 7, 22, 8, 0, 0, 37, 13655
n8192-coef-inner, 1024, 7, 22, 9, 0, 0, 38, 13655
n8192-coef-inner, 1024, 7, 22, 9, 0, 0, 38, 13655
n8192-coef-inner, 1024, 7, 22, 8, 0, 0, 37, 13655
n8192-coef-inner, 1024, 7, 21, 8, 0, 0, 36, 13655
n8192-coef-inner, 1024, 7, 21, 9, 0, 0, 37, 13655
n8192-coef-inner, 1024, 7, 22, 9, 0, 0, 38, 13655
n8192-coef-inner, 1024, 7, 22, 8, 0, 0, 37, 13655
n8192-coef-inner, 1024, 7, 21, 8, 0, 0, 36, 13655
n8192-coef-inner, 1024, 7, 21, 8, 0, 0, 36, 13655
n8192-coef-inner, 1024, 7, 21, 8, 0, 0, 36, 13655
n8192-coef-inner, 1024, 7, 21, 8, 0, 0, 36, 13655
n8192-coef-inner, 1024, 7, 21, 8, 0, 0, 36, 13655
n8192-coef-inner, 1024, 7, 22, 8, 0, 0, 37, 13655
n8192-coef-inner, 1024, 7, 21, 8, 0, 0, 36, 13655
n8192-coef-inner, 1024, 7, 22, 9, 0, 0, 38, 13655
n8192-coef-inner, 1024, 8, 22, 8, 0, 0, 38, 13655
n8192-coef-inner, 1024, 7, 22, 9, 0, 0, 38, 13655
n8192-coef-inner, 1024, 7, 22, 9, 0, 0, 38, 13655
n8192-coef-inner, 1024, 7, 21, 8, 0, 0, 36, 13655
n8192-coef-inner, 1024, 7, 21, 8, 0, 0, 36, 13655
n8192-coef-inner, 1024, 7, 22, 8, 0, 0, 37, 13655
n8192-coef-inner, 1024, 7, 22, 8, 0, 0, 37, 13655
n8192-coef-inner, 1024, 7, 22, 8, 0, 0, 37, 13655
n8192-coef-inner, 1024, 7, 21, 8, 0, 0, 36, 13655
n8192-coef-inner, 1024, 7, 22, 8, 0, 0, 37, 13655
n8192-coef-inner, 1024, 7, 22, 9, 0, 0, 38, 13655
n8192-coef-inner, 1024, 7, 22, 8, 0, 0, 37, 13655
n8192-coef-inner, 1024, 7, 22, 8, 0, 0, 37, 13655
n8192-coef-inner, 1024, 7, 22, 8, 0, 0, 37, 13655
n8192-coef-inner, 1024, 7, 22, 8, 0, 0, 37, 13655
n50x8192-coef-sum, 8192, 56, 690, 19, 1, 0, 766, 1
n50x8192-coef-sum, 8192, 58, 698, 19, 1, 0, 776, 1
n50x8192-coef-sum, 8192, 60, 698, 19, 1, 0, 778, 1
n50x8192-coef-sum, 8192, 58, 693, 19, 1, 0, 771, 1
n50x8192-coef-sum, 8192, 58, 693, 19, 1, 0, 771, 1
n50x8192-coef-sum, 8192, 62, 700, 19, 1, 0, 782, 1
n50x8192-coef-sum, 8192, 60, 699, 19, 1, 0, 779, 1
n50x8192-coef-sum, 8192, 56, 693, 19, 1, 0, 769, 1
n50x8192-coef-sum, 8192, 59, 694, 19, 1, 0, 773, 1
n50x8192-coef-sum, 8192, 61, 686, 19, 1, 0, 767, 1
n50x8192-coef-sum, 8192, 57, 698, 19, 1, 0, 775, 1
n50x8192-coef-sum, 8192, 59, 699, 19, 1, 0, 778, 1
n50x8192-coef-sum, 8192, 59, 692, 20, 1, 0, 772, 1
n50x8192-coef-sum, 8192, 59, 698, 19, 1, 0, 777, 1
n50x8192-coef-sum, 8192, 57, 690, 19, 1, 0, 767, 1
n50x8192-coef-sum, 8192, 57, 695, 19, 1, 0, 772, 1
n50x8192-coef-sum, 8192, 56, 698, 19, 1, 0, 774, 1
n50x8192-coef-sum, 8192, 58, 694, 19, 1, 0, 772, 1
n50x8192-coef-sum, 8192, 60, 693, 18, 1, 0, 772, 1
n50x8192-coef-sum, 8192, 58, 693, 19, 1, 0, 771, 1
n50x8192-coef-sum, 8192, 56, 693, 19, 1, 0, 769, 1
n50x8192-coef-sum, 8192, 60, 695, 19, 1, 0, 775, 1
n50x8192-coef-sum, 8192, 63, 699, 23, 1, 0, 786, 1
n50x8192-coef-sum, 8192, 61, 695, 19, 1, 0, 776, 1
n50x8192-coef-sum, 8192, 58, 690, 19, 1, 0, 768, 1
n50x8192-coef-sum, 8192, 60, 696, 19, 1, 0, 776, 1
n50x8192-coef-sum, 8192, 59, 693, 19, 1, 0, 772, 1
n50x8192-coef-sum, 8192, 58, 699, 19, 1, 0, 777, 1
n50x8192-coef-sum, 8192, 57, 697, 19, 1, 0, 774, 1
n50x8192-coef-sum, 8192, 57, 692, 20, 1, 0, 770, 1
n50x8192-coef-sum, 8192, 60, 687, 19, 1, 0, 767, 1
n50x8192-coef-sum, 8192, 60, 692, 19, 1, 0, 772, 1
n50x8192-coef-sum, 8192, 58, 695, 19, 1, 0, 773, 1
n50x8192-coef-sum, 8192, 60, 696, 19, 1, 0, 776, 1
n50x8192-coef-sum, 8192, 60, 694, 18, 1, 0, 773, 1
n50x8192-coef-sum, 8192, 56, 694, 20, 1, 0, 771, 1
n50x8192-coef-sum, 8192, 57, 688, 18, 1, 0, 764, 1
n50x8192-coef-sum, 8192, 64, 695, 19, 1, 0, 779, 1
n50x8192-coef-sum, 8192, 55, 685, 19, 1, 0, 760, 1
n50x8192-coef-sum, 8192, 57, 687, 20, 1, 0, 765, 1
n50x8192-coef-sum, 8192, 59, 689, 19, 1, 0, 768, 1
n50x8192-coef-sum, 8192, 58, 692, 19, 1, 0, 770, 1
n50x8192-coef-sum, 8192, 62, 700, 19, 1, 0, 782, 1
n50x8192-coef-sum, 8192, 59, 691, 19, 1, 0, 770, 1
n50x8192-coef-sum, 8192, 62, 695, 19, 1, 0, 777, 1
n50x8192-coef-sum, 8192, 57, 694, 20, 1, 0, 772, 1
n50x8192-coef-sum, 8192, 59, 693, 19, 1, 0, 772, 1
n50x8192-coef-sum, 8192, 56, 699, 20, 1, 0, 776, 1
n50x8192-coef-sum, 8192, 56, 703, 19, 1, 0, 779, 1
n50x8192-coef-sum, 8192, 56, 695, 19, 1, 0, 771, 1
n50x8192-coef-sum, 8192, 58, 695, 19, 1, 0, 773, 1
n50x8192-coef-sum, 8192, 61, 695, 20, 1, 0, 777, 1
n50x8192-coef-sum, 8192, 60, 695, 19, 1, 0, 775, 1
n50x8192-coef-sum, 8192, 58, 698, 19, 1, 0, 776, 1
n50x8192-coef-sum, 8192, 58, 693, 20, 1, 0, 772, 1
n50x8192-coef-sum, 8192, 57, 695, 19, 1, 0, 772, 1
n50x8192-coef-sum, 8192, 60, 701, 19, 1, 0, 781, 1
n50x8192-coef-sum, 8192, 60, 697, 19, 1, 0, 777, 1
n50x8192-coef-sum, 8192, 59, 706, 19, 1, 0, 785, 1
n50x8192-coef-sum, 8192, 68, 694, 18, 1, 0, 781, 1
n50x8192-coef-sum, 8192, 58, 695, 19, 1, 0, 773, 1
n50x8192-coef-sum, 8192, 57, 694, 19, 1, 0, 771, 1
n50x8192-coef-sum, 8192, 57, 698, 19, 1, 0, 775, 1
n50x8192-coef-sum, 8192, 61, 688, 18, 1, 0, 768, 1
n50x8192-coef-sum, 8192, 59, 696, 19, 1, 0, 775, 1
n50x8192-coef-sum, 8192, 63, 698, 19, 1, 0, 781, 1
n50x8192-coef-sum, 8192, 60, 692, 20, 1, 0, 773, 1
n50x8192-coef-sum, 8192, 61, 691, 20, 1, 0, 773, 1
n50x8192-coef-sum, 8192, 59, 690, 19, 1, 0, 769, 1
n50x8192-coef-sum, 8192, 57, 700, 19, 1, 0, 777, 1
n50x8192-coef-sum, 8192, 59, 693, 18, 1, 0, 771, 1
n50x8192-coef-sum, 8192, 60, 688, 19, 1, 0, 768, 1
n50x8192-coef-sum, 8192, 58, 689, 19, 1, 0, 767, 1
n50x8192-coef-sum, 8192, 57, 688, 19, 1, 0, 765, 1
n50x8192-coef-sum, 8192, 60, 687, 19, 1, 0, 767, 1
n50x8192-coef-sum, 8192, 69, 694, 19, 1, 0, 783, 1
n50x8192-coef-sum, 8192, 66, 697, 20, 1, 0, 784, 1
n50x8192-coef-sum, 8192, 57, 698, 20, 1, 0, 776, 1
n50x8192-coef-sum, 8192, 60, 693, 19, 1, 0, 773, 1
n50x8192-coef-sum, 8192, 58, 689, 19, 1, 0, 767, 1
n50x8192-coef-sum, 8192, 56, 688, 18, 1, 0, 763, 1
n50x8192-coef-sum, 8192, 59, 688, 18, 1, 0, 766, 1
n50x8192-coef-sum, 8192, 60, 690, 19, 1, 0, 770, 1
n50x8192-coef-sum, 8192, 57, 686, 19, 1, 0, 763, 1
n50x8192-coef-sum, 8192, 59, 696, 19, 1, 0, 775, 1
n50x8192-coef-sum, 8192, 60, 694, 19, 1, 0, 774, 1
n50x8192-coef-sum, 8192, 59, 691, 19, 1, 0, 770, 1
n50x8192-coef-sum, 8192, 64, 689, 19, 1, 0, 773, 1
n50x8192-coef-sum, 8192, 59, 689, 19, 1, 0, 768, 1
n50x8192-coef-sum, 8192, 57, 693, 18, 1, 0, 769, 1
n50x8192-coef-sum, 8192, 56, 690, 18, 1, 0, 765, 1
n50x8192-coef-sum, 8192, 57, 695, 19, 1, 0, 772, 1
n50x8192-coef-sum, 8192, 56, 693, 19, 1, 0, 769, 1
n50x8192-coef-sum, 8192, 58, 692, 19, 1, 0, 770, 1
n50x8192-coef-sum, 8192, 58, 697, 19, 1, 0, 775, 1
n50x8192-coef-sum, 8192, 56, 691, 19, 1, 0, 767, 1
n50x8192-coef-sum, 8192, 56, 693, 19, 1, 0, 769, 1
n50x8192-coef-sum, 8192, 58, 695, 19, 1, 0, 773, 1
n50x8192-coef-sum, 8192, 59, 688, 19, 1, 0, 767, 1
n50x8192-coef-sum, 8192, 60, 693, 20, 1, 0, 774, 1
n50x8192-coef-sum, 4096, 30, 677, 20, 0, 0, 727, 1
n50x8192-coef-sum, 4096, 34, 683, 20, 0, 0, 737, 1
n50x8192-coef-sum, 4096, 32, 679, 20, 0, 0, 731, 1
n50x8192-coef-sum, 4096, 31, 682, 20, 0, 0, 733, 1
n50x8192-coef-sum, 4096, 31, 685, 21, 0, 0, 737, 1
n50x8192-coef-sum, 4096, 30, 682, 21, 0, 0, 733, 1
n50x8192-coef-sum, 4096, 33, 681, 20, 0, 0, 734, 1
n50x8192-coef-sum, 4096, 37, 680, 21, 0, 0, 738, 1
n50x8192-coef-sum, 4096, 34, 682, 20, 0, 0, 736, 1
n50x8192-coef-sum, 4096, 33, 680, 20, 0, 0, 733, 1
n50x8192-coef-sum, 4096, 32, 688, 22, 0, 0, 742, 1
n50x8192-coef-sum, 4096, 33, 682, 21, 0, 0, 736, 1
n50x8192-coef-sum, 4096, 30, 682, 20, 0, 0, 732, 1
n50x8192-coef-sum, 4096, 30, 681, 20, 0, 0, 731, 1
n50x8192-coef-sum, 4096, 33, 686, 21, 0, 0, 740, 1
n50x8192-coef-sum, 4096, 30, 684, 20, 0, 0, 734, 1
n50x8192-coef-sum, 4096, 31, 683, 22, 0, 0, 736, 1
n50x8192-coef-sum, 4096, 34, 681, 20, 0, 0, 735, 1
n50x8192-coef-sum, 4096, 31, 688, 21, 0, 0, 740, 1
n50x8192-coef-sum, 4096, 31, 685, 20, 0, 0, 736, 1
n50x8192-coef-sum, 4096, 31, 683, 20, 0, 0, 734, 1
n50x8192-coef-sum, 4096, 39, 684, 21, 0, 0, 744, 1
n50x8192-coef-sum, 4096, 37, 688, 20, 0, 0, 745, 1
n50x8192-coef-sum, 4096, 31, 686, 21, 0, 0, 738, 1
n50x8192-coef-sum, 4096, 33, 686, 20, 0, 0, 739, 1
n50x8192-coef-sum, 4096, 33, 685, 20, 0, 0, 738, 1
n50x8192-coef-sum, 4096, 30, 682, 21, 0, 0, 733, 1
n50x8192-coef-sum, 4096, 33, 677, 20, 0, 0, 730, 1
n50x8192-coef-sum, 4096, 34, 677, 20, 0, 0, 731, 1
n50x8192-coef-sum, 4096, 30, 681, 20, 0, 0, 731, 1
n50x8192-coef-sum, 4096, 30, 682, 20, 0, 0, 732, 1
n50x8192-coef-sum, 4096, 33, 685, 20, 0, 0, 738, 1
n50x8192-coef-sum, 4096, 30, 679, 20, 0, 0, 729, 1
n50x8192-coef-sum, 4096, 34, 695, 21, 0, 0, 750, 1
n50x8192-coef-sum, 4096, 31, 687, 20, 0, 0, 738, 1
n50x8192-coef-sum, 4096, 31, 681, 20, 0, 0, 732, 1
n50x8192-coef-sum, 4096, 33, 682, 20, 0, 0, 735, 1
n50x8192-coef-sum, 4096, 34, 689, 21, 0, 0, 744, 1
n50x8192-coef-sum, 4096, 40, 683, 21, 0, 0, 744, 1
n50x8192-coef-sum, 4096, 35, 684, 20, 0, 0, 739, 1
n50x8192-coef-sum, 4096, 30, 685, 20, 0, 0, 735, 1
n50x8192-coef-sum, 4096, 32, 684, 21, 0, 0, 737, 1
n50x8192-coef-sum, 4096, 31, 684, 20, 0, 0, 735, 1
n50x8192-coef-sum, 4096, 34, 683, 20, 0, 0, 737, 1
n50x8192-coef-sum, 4096, 32, 682, 20, 0, 0, 734, 1
n50x8192-coef-sum, 4096, 31, 689, 20, 0, 0, 740, 1
n50x8192-coef-sum, 4096, 35, 682, 20, 0, 0, 737, 1
n50x8192-coef-sum, 4096, 31, 680, 20, 0, 0, 731, 1
n50x8192-coef-sum, 4096, 30, 680, 20, 0, 0, 730, 1
n50x8192-coef-sum, 4096, 33, 680, 21, 0, 0, 734, 1
n50x8192-coef-sum, 4096, 42, 679, 21, 0, 0, 742, 1
n50x8192-coef-sum, 4096, 32, 685, 20, 0, 0, 737, 1
n50x8192-coef-sum, 4096, 36, 687, 20, 0, 0, 743, 1
n50x8192-coef-sum, 4096, 37, 681, 20, 0, 0, 738, 1
n50x8192-coef-sum, 4096, 31, 681, 20, 0, 0, 732, 1
n50x8192-coef-sum, 4096, 31, 683, 22, 0, 0, 736, 1
n50x8192-coef-sum, 4096, 30, 682, 21, 0, 0, 733, 1
n50x8192-coef-sum, 4096, 35, 686, 20, 0, 0, 741, 1
n50x8192-coef-sum, 4096, 32, 682, 21, 0, 0, 735, 1
n50x8192-coef-sum, 4096, 31, 684, 20, 0, 0, 735, 1
n50x8192-coef-sum, 4096, 31, 681, 20, 0, 0, 732, 1
n50x8192-coef-sum, 4096, 34, 686, 20, 0, 0, 740, 1
n50x8192-coef-sum, 4096, 33, 691, 20, 0, 0, 744, 1
n50x8192-coef-sum, 4096, 30, 674, 21, 0, 0, 725, 1
n50x8192-coef-sum, 4096, 32, 684, 20, 0, 0, 736, 1
n50x8192-coef-sum, 4096, 30, 683, 21, 0, 0, 734, 1
n50x8192-coef-sum, 4096, 37, 683, 20, 0, 0, 740, 1
n50x8192-coef-sum, 4096, 32, 680, 20, 0, 0, 732, 1
n50x8192-coef-sum, 4096, 31, 686, 21, 0, 0, 738, 1
n50x8192-coef-sum, 4096, 33, 679, 21, 0, 0, 733, 1
n50x8192-coef-sum, 4096, 31, 687, 20, 0, 0, 738, 1
n50x8192-coef-sum, 4096, 34, 692, 22, 0, 0, 748, 1
n50x8192-coef-sum, 4096, 30, 677, 20, 0, 0, 727, 1
n50x8192-coef-sum, 4096, 30, 680, 20, 0, 0, 730, 1
n50x8192-coef-sum, 4096, 30, 682, 20, 0, 0, 732, 1
n50x8192-coef-sum, 4096, 30, 688, 21, 0, 0, 739, 1
n50x8192-coef-sum, 4096, 37, 684, 20, 0, 0, 741, 1
n50x8192-coef-sum, 4096, 33, 684, 20, 0, 0, 737, 1
n50x8192-coef-sum, 4096, 39, 683, 21, 0, 0, 743, 1
n50x8192-coef-sum, 4096, 35, 685, 20, 0, 0, 740, 1
n50x8192-coef-sum, 4096, 30, 690, 21, 0, 0, 741, 1
n50x8192-coef-sum, 4096, 32, 689, 20, 0, 0, 741, 1
n50x8192-coef-sum, 4096, 30, 684, 21, 0, 0, 735, 1
n50x8192-coef-sum, 4096, 31, 680, 21, 0, 0, 732, 1
n50x8192-coef-sum, 4096, 36, 694, 21, 0, 0, 751, 1
n50x8192-coef-sum, 4096, 32, 686, 20, 0, 0, 738, 1
n50x8192-coef-sum, 4096, 30, 688, 21, 0, 0, 739, 1
n50x8192-coef-sum, 4096, 33, 683, 22, 0, 0, 738, 1
n50x8192-coef-sum, 4096, 31, 683, 21, 0, 0, 735, 1
n50x8192-coef-sum, 4096, 30, 682, 21, 0, 0, 733, 1
n50x8192-coef-sum, 4096, 31, 682, 20, 0, 0, 733, 1
n50x8192-coef-sum, 4096, 33, 684, 20, 0, 0, 737, 1
n50x8192-coef-sum, 4096, 35, 683, 20, 0, 0, 738, 1
n50x8192-coef-sum, 4096, 31, 687, 20, 0, 0, 738, 1
n50x8192-coef-sum, 4096, 30, 689, 20, 0, 0, 739, 1
n50x8192-coef-sum, 4096, 30, 682, 20, 0, 0, 732, 1
n50x8192-coef-sum, 4096, 35, 681, 20, 0, 0, 736, 1
n50x8192-coef-sum, 4096, 31, 684, 20, 0, 0, 735, 1
n50x8192-coef-sum, 4096, 31, 692, 21, 0, 0, 744, 1
n50x8192-coef-sum, 4096, 30, 684, 20, 0, 0, 734, 1
n50x8192-coef-sum, 2048, 17, 673, 21, 0, 0, 711, 1
n50x8192-coef-sum, 2048, 18, 677, 21, 0, 0, 716, 1
n50x8192-coef-sum, 2048, 18, 672, 20, 0, 0, 710, 1
n50x8192-coef-sum, 2048, 18, 677, 21, 0, 0, 716, 1
n50x8192-coef-sum, 2048, 18, 671, 20, 0, 0, 709, 1
n50x8192-coef-sum, 2048, 18, 669, 21, 0, 0, 708, 1
n50x8192-coef-sum, 2048, 25, 674, 21, 0, 0, 720, 1
n50x8192-coef-sum, 2048, 18, 676, 22, 0, 0, 716, 1
n50x8192-coef-sum, 2048, 17, 673, 21, 0, 0, 711, 1
n50x8192-coef-sum, 2048, 18, 675, 21, 0, 0, 714, 1
n50x8192-coef-sum, 2048, 26, 674, 21, 0, 0, 721, 1
n50x8192-coef-sum, 2048, 18, 691, 21, 0, 0, 730, 1
n50x8192-coef-sum, 2048, 18, 683, 21, 0, 0, 722, 1
n50x8192-coef-sum, 2048, 18, 673, 20, 0, 0, 711, 1
n50x8192-coef-sum, 2048, 18, 682, 22, 0, 0, 722, 1
n50x8192-coef-sum, 2048, 18, 679, 21, 0, 0, 718, 1
n50x8192-coef-sum, 2048, 18, 681, 21, 0, 0, 720, 1
n50x8192-coef-sum, 2048, 18, 674, 21, 0, 0, 713, 1
n50x8192-coef-sum, 2048, 19, 678, 20, 0, 0, 717, 1
n50x8192-coef-sum, 2048, 20, 686, 22, 0, 0, 728, 1
n50x8192-coef-sum, 2048, 18, 686, 20, 0, 0, 724, 1
n50x8192-coef-sum, 2048, 18, 687, 20, 0, 0, 725, 1
n50x8192-coef-sum, 2048, 18, 679, 21, 0, 0, 718, 1
n50x8192-coef-sum, 2048, 17, 682, 22, 0, 0, 721, 1
n50x8192-coef-sum, 2048, 17, 679, 22, 0, 0, 718, 1
n50x8192-coef-sum, 2048, 18, 682, 21, 0, 0, 721, 1
n50x8192-coef-sum, 2048, 18, 675, 20, 0, 0, 713, 1
n50x8192-coef-sum, 2048, 23, 684, 21, 0, 0, 728, 1
n50x8192-coef-sum, 2048, 18, 679, 21, 0, 0, 718, 1
n50x8192-coef-sum, 2048, 18, 677, 21, 0, 0, 716, 1
n50x8192-coef-sum, 2048, 18, 679, 20, 0, 0, 717, 1
n50x8192-coef-sum, 2048, 18, 679, 20, 0, 0, 717, 1
n50x8192-coef-sum, 2048, 17, 680, 21, 0, 0, 718, 1
n50x8192-coef-sum, 2048, 18, 678, 21, 0, 0, 717, 1
n50x8192-coef-sum, 2048, 18, 674, 20, 0, 0, 712, 1
n50x8192-coef-sum, 2048, 18, 679, 21, 0, 0, 718, 1
n50x8192-coef-sum, 2048, 25, 672, 20, 0, 0, 717, 1
n50x8192-coef-sum, 2048, 18, 671, 21, 0, 0, 710, 1
n50x8192-coef-sum, 2048, 18, 673, 21, 0, 0, 712, 1
n50x8192-coef-sum, 2048, 18, 675, 21, 0, 0, 714, 1
n50x8192-coef-sum, 2048, 18, 674, 22, 0, 0, 714, 1
n50x8192-coef-sum, 2048, 18, 672, 21, 0, 0, 711, 1
n50x8192-coef-sum, 2048, 18, 672, 21, 0, 0, 711, 1
n50x8192-coef-sum, 2048, 18, 672, 20, 0, 0, 710, 1
n50x8192-coef-sum, 2048, 24, 678, 21, 0, 0, 723, 1
n50x8192-coef-sum, 2048, 18, 671, 20, 0, 0, 709, 1
n50x8192-coef-sum, 2048, 17, 678, 22, 0, 0, 717, 1
n50x8192-coef-sum, 2048, 18, 675, 20, 0, 0, 713, 1
n50x8192-coef-sum, 2048, 18, 673, 21, 0, 0, 712, 1
n50x8192-coef-sum, 2048, 18, 675, 20, 0, 0, 713, 1
n50x8192-coef-sum, 2048, 18, 669, 20, 0, 0, 707, 1
n50x8192-coef-sum, 2048, 18, 674, 20, 0, 0, 712, 1
n50x8192-coef-sum, 2048, 18, 669, 21, 0, 0, 708, 1
n50x8192-coef-sum, 2048, 17, 670, 20, 0, 0, 707, 1
n50x8192-coef-sum, 2048, 18, 676, 20, 0, 0, 714, 1
n50x8192-coef-sum, 2048, 18, 673, 20, 0, 0, 711, 1
n50x8192-coef-sum, 2048, 18, 673, 20, 0, 0, 711, 1
n50x8192-coef-sum, 2048, 18, 671, 20, 0, 0, 709, 1
n50x8192-coef-sum, 2048, 18, 670, 21, 0, 0, 709, 1
n50x8192-coef-sum, 2048, 17, 677, 20, 0, 0, 714, 1
n50x8192-coef-sum, 2048, 18, 675, 22, 0, 0, 715, 1
n50x8192-coef-sum, 2048, 18, 672, 21, 0, 0, 711, 1
n50x8192-coef-sum, 2048, 18, 672, 20, 0, 0, 710, 1
n50x8192-coef-sum, 2048, 18, 676, 20, 0, 0, 714, 1
n50x8192-coef-sum, 2048, 17, 675, 21, 0, 0, 713, 1
n50x8192-coef-sum, 2048, 19, 676, 20, 0, 0, 715, 1
n50x8192-coef-sum, 2048, 18, 674, 20, 0, 0, 712, 1
n50x8192-coef-sum, 2048, 27, 671, 21, 0, 0, 719, 1
n50x8192-coef-sum, 2048, 18, 670, 20, 0, 0, 708, 1
n50x8192-coef-sum, 2048, 18, 671, 21, 0, 0, 710, 1
n50x8192-coef-sum, 2048, 18, 669, 20, 0, 0, 707, 1
n50x8192-coef-sum, 2048, 18, 670, 20, 0, 0, 708, 1
n50x8192-coef-sum, 2048, 18, 674, 20, 0, 0, 712, 1
n50x8192-coef-sum, 2048, 18, 676, 20, 0, 0, 714, 1
n50x8192-coef-sum, 2048, 18, 675, 20, 0, 0, 713, 1
n50x8192-coef-sum, 2048, 18, 675, 20, 0, 0, 713, 1
n50x8192-coef-sum, 2048, 21, 678, 20, 0, 0, 719, 1
n50x8192-coef-sum, 2048, 18, 671, 21, 0, 0, 710, 1
n50x8192-coef-sum, 2048, 18, 675, 20, 0, 0, 713, 1
n50x8192-coef-sum, 2048, 18, 681, 22, 0, 0, 721, 1
n50x8192-coef-sum, 2048, 18, 678, 21, 0, 0, 717, 1
n50x8192-coef-sum, 2048, 28, 673, 22, 0, 0, 723, 1
n50x8192-coef-sum, 2048, 18, 670, 21, 0, 0, 709, 1
n50x8192-coef-sum, 2048, 18, 670, 21, 0, 0, 709, 1
n50x8192-coef-sum, 2048, 21, 668, 20, 0, 0, 709, 1
n50x8192-coef-sum, 2048, 18, 667, 21, 0, 0, 706, 1
n50x8192-coef-sum, 2048, 18, 674, 20, 0, 0, 712, 1
n50x8192-coef-sum, 2048, 18, 669, 20, 0, 0, 707, 1
n50x8192-coef-sum, 2048, 29, 670, 20, 0, 0, 719, 1
n50x8192-coef-sum, 2048, 18, 675, 20, 0, 0, 713, 1
n50x8192-coef-sum, 2048, 19, 674, 22, 0, 0, 715, 1
n50x8192-coef-sum, 2048, 26, 682, 22, 0, 0, 730, 1
n50x8192-coef-sum, 2048, 19, 678, 20, 0, 0, 717, 1
n50x8192-coef-sum, 2048, 18, 677, 21, 0, 0, 716, 1
n50x8192-coef-sum, 2048, 20, 670, 20, 0, 0, 710, 1
n50x8192-coef-sum, 2048, 18, 675, 21, 0, 0, 714, 1
n50x8192-coef-sum, 2048, 19, 677, 21, 0, 0, 717, 1
n50x8192-coef-sum, 2048, 18, 675, 21, 0, 0, 714, 1
n50x8192-coef-sum, 2048, 21, 672, 20, 0, 0, 713, 1
n50x8192-coef-sum, 2048, 18, 677, 21, 0, 0, 716, 1
n50x8192-coef-sum, 1024, 13, 680, 26, 0, 0, 719, 1
n50x8192-coef-sum, 1024, 13, 675, 24, 0, 0, 712, 1
n50x8192-coef-sum, 1024, 13, 675, 23, 0, 0, 711, 1
n50x8192-coef-sum, 1024, 13, 690, 24, 0, 0, 727, 1
n50x8192-coef-sum, 1024, 13, 670, 24, 0, 0, 707, 1
n50x8192-coef-sum, 1024, 13, 670, 23, 0, 0, 706, 1
n50x8192-coef-sum, 1024, 12, 676, 23, 0, 0, 711, 1
n50x8192-coef-sum, 1024, 12, 673, 23, 0, 0, 708, 1
n50x8192-coef-sum, 1024, 12, 669, 23, 0, 0, 704, 1
n50x8192-coef-sum, 1024, 13, 669, 23, 0, 0, 705, 1
n50x8192-coef-sum, 1024, 14, 670, 24, 0, 0, 708, 1
n50x8192-coef-sum, 1024, 13, 679, 23, 0, 0, 715, 1
n50x8192-coef-sum, 1024, 12, 674, 22, 0, 0, 708, 1
n50x8192-coef-sum, 1024, 13, 677, 23, 0, 0, 713, 1
n50x8192-coef-sum, 1024, 13, 678, 22, 0, 0, 713, 1
n50x8192-coef-sum, 1024, 13, 674, 23, 0, 0, 710, 1
n50x8192-coef-sum, 1024, 13, 675, 25, 0, 0, 713, 1
n50x8192-coef-sum, 1024, 13, 669, 24, 0, 0, 706, 1
n50x8192-coef-sum, 1024, 14, 670, 23, 0, 0, 707, 1
n50x8192-coef-sum, 1024, 13, 680, 23, 0, 0, 716, 1
n50x8192-coef-sum, 1024, 12, 676, 25, 0, 0, 713, 1
n50x8192-coef-sum, 1024, 13, 667, 23, 0, 0, 703, 1
n50x8192-coef-sum, 1024, 13, 669, 23, 0, 0, 705, 1
n50x8192-coef-sum, 1024, 13, 674, 22, 0, 0, 709, 1
n50x8192-coef-sum, 1024, 13, 671, 23, 0, 0, 707, 1
n50x8192-coef-sum, 1024, 13, 670, 22, 0, 0, 705, 1
n50x8192-coef-sum, 1024, 12, 675, 24, 0, 0, 711, 1
n50x8192-coef-sum, 1024, 13, 674, 24, 0, 0, 711, 1
n50x8192-coef-sum, 1024, 13, 676, 22, 0, 0, 711, 1
n50x8192-coef-sum, 1024, 13, 672, 23, 0, 0, 708, 1
n50x8192-coef-sum, 1024, 14, 680, 23, 0, 0, 717, 1
n50x8192-coef-sum, 1024, 13, 670, 23, 0, 0, 706, 1
n50x8192-coef-sum, 1024, 13, 671, 23, 0, 0, 707, 1
n50x8192-coef-sum, 1024, 12, 677, 23, 0, 0, 712, 1
n50x8192-coef-sum, 1024, 13, 679, 23, 0, 0, 715, 1
n50x8192-coef-sum, 1024, 14, 677, 23, 0, 0, 714, 1
n50x8192-coef-sum, 1024, 12, 672, 23, 0, 0, 707, 1
n50x8192-coef-sum, 1024, 13, 668, 23, 0, 0, 704, 1
n50x8192-coef-sum, 1024, 13, 675, 22, 0, 0, 710, 1
n50x8192-coef-sum, 1024, 13, 673, 24, 0, 0, 710, 1
n50x8192-coef-sum, 1024, 13, 675, 24, 0, 0, 712, 1
n50x8192-coef-sum, 1024, 13, 675, 23, 0, 0, 711, 1
n50x8192-coef-sum, 1024, 13, 680, 23, 0, 0, 716, 1
n50x8192-coef-sum, 1024, 12, 675, 23, 0, 0, 710, 1
n50x8192-coef-sum, 1024, 13, 678, 25, 0, 0, 716, 1
n50x8192-coef-sum, 1024, 13, 682, 23, 0, 0, 718, 1
n50x8192-coef-sum, 1024, 13, 682, 23, 0, 0, 718, 1
n50x8192-coef-sum, 1024, 13, 677, 23, 0, 0, 713, 1
n50x8192-coef-sum, 1024, 13, 675, 23, 0, 0, 711, 1
n50x8192-coef-sum, 1024, 13, 676, 23, 0, 0, 712, 1
n50x8192-coef-sum, 1024, 13, 672, 23, 0, 0, 708, 1
n50x8192-coef-sum, 1024, 14, 672, 23, 0, 0, 709, 1
n50x8192-coef-sum, 1024, 14, 671, 23, 0, 0, 708, 1
n50x8192-coef-sum, 1024, 12, 672, 25, 0, 0, 709, 1
n50x8192-coef-sum, 1024, 12, 679, 23, 0, 0, 714, 1
n50x8192-coef-sum, 1024, 12, 678, 24, 0, 0, 714, 1
n50x8192-coef-sum, 1024, 12, 674, 23, 0, 0, 709, 1
n50x8192-coef-sum, 1024, 13, 674, 23, 0, 0, 710, 1
n50x8192-coef-sum, 1024, 13, 681, 23, 0, 0, 717, 1
n50x8192-coef-sum, 1024, 12, 677, 24, 0, 0, 713, 1
n50x8192-coef-sum, 1024, 12, 679, 25, 0, 0, 716, 1
n50x8192-coef-sum, 1024, 12, 673, 23, 0, 0, 708, 1
n50x8192-coef-sum, 1024, 15, 675, 23, 0, 0, 713, 1
n50x8192-coef-sum, 1024, 13, 673, 23, 0, 0, 709, 1
n50x8192-coef-sum, 1024, 17, 673, 23, 0, 0, 713, 1
n50x8192-coef-sum, 1024, 13, 674, 23, 0, 0, 710, 1
n50x8192-coef-sum, 1024, 13, 675, 23, 0, 0, 711, 1
n50x8192-coef-sum, 1024, 13, 672, 23, 0, 0, 708, 1
n50x8192-coef-sum, 1024, 13, 673, 23, 0, 0, 709, 1
n50x8192-coef-sum, 1024, 13, 677, 22, 0, 0, 712, 1
n50x8192-coef-sum, 1024, 13, 674, 23, 0, 0, 710, 1
n50x8192-coef-sum, 1024, 13, 689, 24, 0, 0, 726, 1
n50x8192-coef-sum, 1024, 14, 686, 23, 0, 0, 723, 1
n50x8192-coef-sum, 1024, 13, 678, 24, 0, 0, 715, 1
n50x8192-coef-sum, 1024, 13, 677, 23, 0, 0, 713, 1
n50x8192-coef-sum, 1024, 13, 681, 24, 0, 0, 718, 1
n50x8192-coef-sum, 1024, 13, 683, 23, 0, 0, 719, 1
n50x8192-coef-sum, 1024, 13, 677, 24, 0, 0, 714, 1
n50x8192-coef-sum, 1024, 13, 675, 23, 0, 0, 711, 1
n50x8192-coef-sum, 1024, 12, 680, 23, 0, 0, 715, 1
n50x8192-coef-sum, 1024, 13, 678, 23, 0, 0, 714, 1
n50x8192-coef-sum, 1024, 13, 684, 23, 0, 0, 720, 1
n50x8192-coef-sum, 1024, 12, 681, 23, 0, 0, 716, 1
n50x8192-coef-sum, 1024, 15, 690, 24, 0, 0, 729, 1
n50x8192-coef-sum, 1024, 12, 674, 23, 0, 0, 709, 1
n50x8192-coef-sum, 1024, 13, 674, 24, 0, 0, 711, 1
n50x8192-coef-sum, 1024, 13, 673, 23, 0, 0, 709, 1
n50x8192-coef-sum, 1024, 13, 672, 23, 0, 0, 708, 1
n50x8192-coef-sum, 1024, 14, 674, 24, 0, 0, 712, 1
n50x8192-coef-sum, 1024, 13, 674, 23, 0, 0, 710, 1
n50x8192-coef-sum, 1024, 13, 671, 24, 0, 0, 708, 1
n50x8192-coef-sum, 1024, 13, 676, 23, 0, 0, 712, 1
n50x8192-coef-sum, 1024, 13, 677, 23, 0, 0, 713, 1
n50x8192-coef-sum, 1024, 13, 680, 23, 0, 0, 716, 1
n50x8192-coef-sum, 1024, 12, 681, 23, 0, 0, 716, 1
n50x8192-coef-sum, 1024, 13, 674, 25, 0, 0, 712, 1
n50x8192-coef-sum, 1024, 12, 669, 23, 0, 0, 704, 1
n50x8192-coef-sum, 1024, 12, 675, 24, 0, 0, 711, 1
n50x8192-coef-sum, 1024, 13, 671, 23, 0, 0, 707, 1
n50x8192-coef-sum, 1024, 13, 679, 23, 0, 0, 715, 1
n50x8192-slot-sum, 8192, 268, 408, 62, 1, 0, 739, 1
n50x8192-slot-sum, 8192, 265, 404, 64, 1, 0, 734, 1
n50x8192-slot-sum, 8192, 266, 406, 61, 1, 0, 734, 1
n50x8192-slot-sum, 8192, 265, 405, 61, 1, 0, 732, 1
n50x8192-slot-sum, 8192, 268, 404, 60, 1, 0, 733, 1
n50x8192-slot-sum, 8192, 267, 406, 61, 1, 0, 735, 1
n50x8192-slot-sum, 8192, 269, 407, 62, 1, 0, 739, 1
n50x8192-slot-sum, 8192, 270, 408, 61, 1, 0, 740, 1
n50x8192-slot-sum, 8192, 269, 408, 60, 1, 0, 738, 1
n50x8192-slot-sum, 8192, 268, 410, 63, 1, 0, 742, 1
n50x8192-slot-sum, 8192, 268, 406, 62, 1, 0, 737, 1
n50x8192-slot-sum, 8192, 268, 408, 61, 1, 0, 738, 1
n50x8192-slot-sum, 8192, 267, 406, 61, 1, 0, 735, 1
n50x8192-slot-sum, 8192, 269, 411, 62, 1, 0, 743, 1
n50x8192-slot-sum, 8192, 267, 403, 61, 1, 0, 732, 1
n50x8192-slot-sum, 8192, 267, 406, 60, 1, 0, 734, 1
n50x8192-slot-sum, 8192, 267, 407, 63, 1, 0, 738, 1
n50x8192-slot-sum, 8192, 266, 405, 61, 1, 0, 733, 1
n50x8192-slot-sum, 8192, 266, 407, 61, 1, 0, 735, 1
n50x8192-slot-sum, 8192, 272, 410, 63, 1, 0, 746, 1
n50x8192-slot-sum, 8192, 269, 403, 59, 1, 0, 732, 1
n50x8192-slot-sum, 8192, 270, 407, 63, 1, 0, 741, 1
n50x8192-slot-sum, 8192, 267, 405, 61, 1, 0, 734, 1
n50x8192-slot-sum, 8192, 269, 405, 60, 1, 0, 735, 1
n50x8192-slot-sum, 8192, 271, 411, 63, 1, 0, 746, 1
n50x8192-slot-sum, 8192, 268, 413, 63, 1, 0, 745, 1
n50x8192-slot-sum, 8192, 268, 406, 61, 1, 0, 736, 1
n50x8192-slot-sum, 8192, 273, 409, 63, 1, 0, 746, 1
n50x8192-slot-sum, 8192, 266, 410, 62, 1, 0, 739, 1
n50x8192-slot-sum, 8192, 267, 404, 60, 1, 0, 732, 1
n50x8192-slot-sum, 8192, 273, 409, 63, 1, 0, 746, 1
n50x8192-slot-sum, 8192, 273, 406, 60, 1, 0, 740, 1
n50x8192-slot-sum, 8192, 273, 409, 63, 1, 0, 746, 1
n50x8192-slot-sum, 8192, 269, 403, 61, 1, 0, 734, 1
n50x8192-slot-sum, 8192, 274, 410, 62, 1, 0, 747, 1
n50x8192-slot-sum, 8192, 270, 407, 61, 1, 0, 739, 1
n50x8192-slot-sum, 8192, 269, 402, 59, 1, 0, 731, 1
n50x8192-slot-sum, 8192, 269, 408, 62, 1, 0, 740, 1
n50x8192-slot-sum, 8192, 266, 408, 61, 1, 0, 736, 1
n50x8192-slot-sum, 8192, 270, 407, 61, 1, 0, 739, 1
n50x8192-slot-sum, 8192, 269, 412, 62, 1, 0, 744, 1
n50x8192-slot-sum, 8192, 266, 408, 60, 1, 0, 735, 1
n50x8192-slot-sum, 8192, 268, 403, 59, 1, 0, 731, 1
n50x8192-slot-sum, 8192, 268, 402, 60, 1, 0, 731, 1
n50x8192-slot-sum, 8192, 271, 409, 63, 1, 0, 744, 1
n50x8192-slot-sum, 8192, 270, 411, 62, 1, 0, 744, 1
n50x8192-slot-sum, 8192, 273, 410, 64, 1, 0, 748, 1
n50x8192-slot-sum, 8192, 268, 411, 63, 1, 0, 743, 1
n50x8192-slot-sum, 8192, 266, 406, 62, 1, 0, 735, 1
n50x8192-slot-sum, 8192, 269, 416, 66, 1, 0, 752, 1
n50x8192-slot-sum, 8192, 273, 413, 64, 1, 0, 751, 1
n50x8192-slot-sum, 8192, 278, 409, 63, 1, 0, 751, 1
n50x8192-slot-sum, 8192, 279, 405, 61, 1, 0, 746, 1
n50x8192-slot-sum, 8192, 266, 408, 62, 1, 0, 737, 1
n50x8192-slot-sum, 8192, 277, 406, 62, 1, 0, 746, 1
n50x8192-slot-sum, 8192, 275, 412, 64, 1, 0, 752, 1
n50x8192-slot-sum, 8192, 272, 406, 60, 1, 0, 739, 1
n50x8192-slot-sum, 8192, 268, 408, 61, 1, 0, 738, 1
n50x8192-slot-sum, 8192, 273, 411, 63, 1, 0, 748, 1
n50x8192-slot-sum, 8192, 269, 406, 60, 1, 0, 736, 1
n50x8192-slot-sum, 8192, 267, 406, 60, 1, 0, 734, 1
n50x8192-slot-sum, 8192, 274, 410, 64, 1, 0, 749, 1
n50x8192-slot-sum, 8192, 271, 413, 63, 1, 0, 748, 1
n50x8192-slot-sum, 8192, 265, 408, 63, 1, 0, 737, 1
n50x8192-slot-sum, 8192, 270, 406, 61, 1, 0, 738, 1
n50x8192-slot-sum, 8192, 267, 403, 60, 1, 0, 731, 1
n50x8192-slot-sum, 8192, 267, 409, 63, 1, 0, 740, 1
n50x8192-slot-sum, 8192, 269, 412, 62, 1, 0, 744, 1
n50x8192-slot-sum, 8192, 270, 411, 64, 1, 0, 746, 1
n50x8192-slot-sum, 8192, 267, 406, 61, 1, 0, 735, 1
n50x8192-slot-sum, 8192, 271, 411, 60, 1, 0, 743, 1
n50x8192-slot-sum, 8192, 269, 407, 63, 1, 0, 740, 1
n50x8192-slot-sum, 8192, 266, 407, 61, 1, 0, 735, 1
n50x8192-slot-sum, 8192, 271, 406, 60, 1, 0, 738, 1
n50x8192-slot-sum, 8192, 272, 410, 62, 1, 0, 745, 1
n50x8192-slot-sum, 8192, 270, 409, 64, 1, 0, 744, 1
n50x8192-slot-sum, 8192, 273, 404, 61, 1, 0, 739, 1
n50x8192-slot-sum, 8192, 269, 411, 65, 1, 0, 746, 1
n50x8192-slot-sum, 8192, 275, 407, 62, 1, 0, 745, 1
n50x8192-slot-sum, 8192, 266, 412, 64, 1, 0, 743, 1
n50x8192-slot-sum, 8192, 272, 407, 60, 1, 0, 740, 1
n50x8192-slot-sum, 8192, 266, 409, 63, 1, 0, 739, 1
n50x8192-slot-sum, 8192, 265, 408, 63, 1, 0, 737, 1
n50x8192-slot-sum, 8192, 266, 407, 60, 1, 0, 734, 1
n50x8192-slot-sum, 8192, 269, 409, 65, 1, 0, 744, 1
n50x8192-slot-sum, 8192, 270, 411, 63, 1, 0, 745, 1
n50x8192-slot-sum, 8192, 266, 410, 63, 1, 0, 740, 1
n50x8192-slot-sum, 8192, 265, 405, 60, 1, 0, 731, 1
n50x8192-slot-sum, 8192, 264, 406, 60, 1, 0, 731, 1
n50x8192-slot-sum, 8192, 271, 408, 63, 1, 0, 743, 1
n50x8192-slot-sum, 8192, 270, 409, 61, 1, 0, 741, 1
n50x8192-slot-sum, 8192, 271, 407, 65, 1, 0, 744, 1
n50x8192-slot-sum, 8192, 268, 407, 61, 1, 0, 737, 1
n50x8192-slot-sum, 8192, 268, 413, 63, 1, 0, 745, 1
n50x8192-slot-sum, 8192, 267, 408, 63, 1, 0, 739, 1
n50x8192-slot-sum, 8192, 264, 402, 61, 1, 0, 728, 1
n50x8192-slot-sum, 8192, 273, 405, 61, 1, 0, 740, 1
n50x8192-slot-sum, 8192, 274, 408, 62, 1, 0, 745, 1
n50x8192-slot-sum, 8192, 268, 406, 60, 1, 0, 735, 1
n50x8192-slot-sum, 8192, 263, 405, 61, 1, 0, 730, 1
n50x8192-slot-sum, 4096, 125, 389, 39, 0, 0, 553, 1
n50x8192-slot-sum, 4096, 124, 391, 39, 0, 0, 554, 1
n50x8192-slot-sum, 4096, 126, 388, 38, 0, 0, 552, 1
n50x8192-slot-sum, 4096, 124, 390, 38, 0, 0, 552, 1
n50x8192-slot-sum, 4096, 127, 392, 39, 0, 0, 558, 1
n50x8192-slot-sum, 4096, 132, 400, 40, 0, 0, 572, 1
n50x8192-slot-sum, 4096, 128, 391, 39, 0, 0, 558, 1
n50x8192-slot-sum, 4096, 129, 395, 39, 0, 0, 563, 1
n50x8192-slot-sum, 4096, 124, 394, 39, 0, 0, 557, 1
n50x8192-slot-sum, 4096, 123, 390, 40, 0, 0, 553, 1
n50x8192-slot-sum, 4096, 125, 391, 38, 0, 0, 554, 1
n50x8192-slot-sum, 4096, 128, 392, 39, 0, 0, 559, 1
n50x8192-slot-sum, 4096, 127, 396, 41, 0, 0, 564, 1
n50x8192-slot-sum, 4096, 125, 391, 38, 0, 0, 554, 1
n50x8192-slot-sum, 4096, 127, 400, 40, 0, 0, 567, 1
n50x8192-slot-sum, 4096, 126, 394, 38, 0, 0, 558, 1
n50x8192-slot-sum, 4096, 130, 391, 38, 0, 0, 559, 1
n50x8192-slot-sum, 4096, 129, 389, 39, 0, 0, 557, 1
n50x8192-slot-sum, 4096, 125, 398, 39, 0, 0, 562, 1
n50x8192-slot-sum, 4096, 123, 390, 38, 0, 0, 551, 1
n50x8192-slot-sum, 4096, 126, 395, 39, 0, 0, 560, 1
n50x8192-slot-sum, 4096, 126, 393, 40, 0, 0, 559, 1
n50x8192-slot-sum, 4096, 126, 389, 39, 0, 0, 554, 1
n50x8192-slot-sum, 4096, 129, 396, 41, 0, 0, 566, 1
n50x8192-slot-sum, 4096, 124, 392, 39, 0, 0, 555, 1
n50x8192-slot-sum, 4096, 128, 391, 38, 0, 0, 557, 1
n50x8192-slot-sum, 4096, 124, 387, 39, 0, 0, 550, 1
n50x8192-slot-sum, 4096, 139, 387, 38, 0, 0, 564, 1
n50x8192-slot-sum, 4096, 125, 388, 38, 0, 0, 551, 1
n50x8192-slot-sum, 4096, 127, 389, 39, 0, 0, 555, 1
n50x8192-slot-sum, 4096, 126, 393, 39, 0, 0, 558, 1
n50x8192-slot-sum, 4096, 123, 390, 38, 0, 0, 551, 1
n50x8192-slot-sum, 4096, 125, 385, 39, 0, 0, 549, 1
n50x8192-slot-sum, 4096, 126, 386, 38, 0, 0, 550, 1
n50x8192-slot-sum, 4096, 125, 395, 39, 0, 0, 559, 1
n50x8192-slot-sum, 4096, 129, 401, 38, 0, 0, 568, 1
n50x8192-slot-sum, 4096, 125, 393, 39, 0, 0, 557, 1
n50x8192-slot-sum, 4096, 134, 395, 39, 0, 0, 568, 1
n50x8192-slot-sum, 4096, 126, 393, 40, 0, 0, 559, 1
n50x8192-slot-sum, 4096, 126, 393, 39, 0, 0, 558, 1
n50x8192-slot-sum, 4096, 124, 396, 38, 0, 0, 558, 1
n50x8192-slot-sum, 4096, 126, 390, 39, 0, 0, 555, 1
n50x8192-slot-sum, 4096, 129, 391, 39, 0, 0, 559, 1
n50x8192-slot-sum, 4096, 127, 395, 41, 0, 0, 563, 1
n50x8192-slot-sum, 4096, 127, 392, 39, 0, 0, 558, 1
n50x8192-slot-sum, 4096, 125, 399, 39, 0, 0, 563, 1
n50x8192-slot-sum, 4096, 131, 394, 40, 0, 0, 565, 1
n50x8192-slot-sum, 4096, 129, 395, 40, 0, 0, 564, 1
n50x8192-slot-sum, 4096, 128, 392, 39, 0, 0, 559, 1
n50x8192-slot-sum, 4096, 126, 390, 39, 0, 0, 555, 1
n50x8192-slot-sum, 4096, 128, 390, 38, 0, 0, 556, 1
n50x8192-slot-sum, 4096, 125, 389, 39, 0, 0, 553, 1
n50x8192-slot-sum, 4096, 128, 392, 39, 0, 0, 559, 1
n50x8192-slot-sum, 4096, 126, 389, 39, 0, 0, 554, 1
n50x8192-slot-sum, 4096, 124, 396, 38, 0, 0, 558, 1
n50x8192-slot-sum, 4096, 125, 387, 39, 0, 0, 551, 1
n50x8192-slot-sum, 4096, 128, 390, 38, 0, 0, 556, 1
n50x8192-slot-sum, 4096, 123, 394, 39, 0, 0, 556, 1
n50x8192-slot-sum, 4096, 125, 389, 38, 0, 0, 552, 1
n50x8192-slot-sum, 4096, 125, 394, 39, 0, 0, 558, 1
n50x8192-slot-sum, 4096, 125, 392, 38, 0, 0, 555, 1
n50x8192-slot-sum, 4096, 127, 393, 38, 0, 0, 558, 1
n50x8192-slot-sum, 4096, 123, 393, 38, 0, 0, 554, 1
n50x8192-slot-sum, 4096, 127, 394, 39, 0, 0, 560, 1
n50x8192-slot-sum, 4096, 129, 393, 40, 0, 0, 562, 1
n50x8192-slot-sum, 4096, 129, 395, 40, 0, 0, 564, 1
n50x8192-slot-sum, 4096, 124, 391, 39, 0, 0, 554, 1
n50x8192-slot-sum, 4096, 126, 393, 39, 0, 0, 558, 1
n50x8192-slot-sum, 4096, 126, 393, 39, 0, 0, 558, 1
n50x8192-slot-sum, 4096, 128, 388, 38, 0, 0, 554, 1
n50x8192-slot-sum, 4096, 126, 395, 41, 0, 0, 562, 1
n50x8192-slot-sum, 4096, 125, 399, 39, 0, 0, 563, 1
n50x8192-slot-sum, 4096, 126, 397, 39, 0, 0, 562, 1
n50x8192-slot-sum, 4096, 129, 395, 39, 0, 0, 563, 1
n50x8192-slot-sum, 4096, 126, 393, 39, 0, 0, 558, 1
n50x8192-slot-sum, 4096, 125, 391, 40, 0, 0, 556, 1
n50x8192-slot-sum, 4096, 132, 389, 39, 0, 0, 560, 1
n50x8192-slot-sum, 4096, 125, 394, 38, 0, 0, 557, 1
n50x8192-slot-sum, 4096, 126, 394, 39, 0, 0, 559, 1
n50x8192-slot-sum, 4096, 127, 395, 39, 0, 0, 561, 1
n50x8192-slot-sum, 4096, 125, 387, 39, 0, 0, 551, 1
n50x8192-slot-sum, 4096, 129, 396, 40, 0, 0, 565, 1
n50x8192-slot-sum, 4096, 126, 394, 40, 0, 0, 560, 1
n50x8192-slot-sum, 4096, 123, 387, 38, 0, 0, 548, 1
n50x8192-slot-sum, 4096, 125, 392, 39, 0, 0, 556, 1
n50x8192-slot-sum, 4096, 133, 391, 39, 0, 0, 563, 1
n50x8192-slot-sum, 4096, 124, 390, 38, 0, 0, 552, 1
n50x8192-slot-sum, 4096, 123, 387, 38, 0, 0, 548, 1
n50x8192-slot-sum, 4096, 125, 393, 38, 0, 0, 556, 1
n50x8192-slot-sum, 4096, 127, 392, 40, 0, 0, 559, 1
n50x8192-slot-sum, 4096, 125, 394, 38, 0, 0, 557, 1
n50x8192-slot-sum, 4096, 126, 392, 38, 0, 0, 556, 1
n50x8192-slot-sum, 4096, 126, 399, 39, 0, 0, 564, 1
n50x8192-slot-sum, 4096, 124, 392, 39, 0, 0, 555, 1
n50x8192-slot-sum, 4096, 125, 389, 38, 0, 0, 552, 1
n50x8192-slot-sum, 4096, 126, 391, 38, 0, 0, 555, 1
n50x8192-slot-sum, 4096, 129, 393, 38, 0, 0, 560, 1
n50x8192-slot-sum, 4096, 126, 389, 40, 0, 0, 555, 1
n50x8192-slot-sum, 4096, 124, 386, 38, 0, 0, 548, 1
n50x8192-slot-sum, 4096, 127, 386, 39, 0, 0, 552, 1
n50x8192-slot-sum, 2048, 60, 380, 29, 0, 0, 469, 1
n50x8192-slot-sum, 2048, 62, 376, 29, 0, 0, 467, 1
n50x8192-slot-sum, 2048, 59, 381, 29, 0, 0, 469, 1
n50x8192-slot-sum, 2048, 60, 381, 30, 0, 0, 471, 1
n50x8192-slot-sum, 2048, 60, 383, 30, 0, 0, 473, 1
n50x8192-slot-sum, 2048, 59, 380, 29, 0, 0, 468, 1
n50x8192-slot-sum, 2048, 60, 383, 31, 0, 0, 474, 1
n50x8192-slot-sum, 2048, 60, 379, 30, 0, 0, 469, 1
n50x8192-slot-sum, 2048, 59, 380, 29, 0, 0, 468, 1
n50x8192-slot-sum, 2048, 59, 380, 30, 0, 0, 469, 1
n50x8192-slot-sum, 2048, 60, 378, 30, 0, 0, 468, 1
n50x8192-slot-sum, 2048, 60, 383, 30, 0, 0, 473, 1
n50x8192-slot-sum, 2048, 60, 379, 30, 0, 0, 469, 1
n50x8192-slot-sum, 2048, 59, 381, 29, 0, 0, 469, 1
n50x8192-slot-sum, 2048, 60, 378, 29, 0, 0, 467, 1
n50x8192-slot-sum, 2048, 60, 386, 30, 0, 0, 476, 1
n50x8192-slot-sum, 2048, 61, 386, 30, 0, 0, 477, 1
n50x8192-slot-sum, 2048, 59, 383, 30, 0, 0, 472, 1
n50x8192-slot-sum, 2048, 60, 379, 29, 0, 0, 468, 1
n50x8192-slot-sum, 2048, 64, 389, 31, 0, 0, 484, 1
n50x8192-slot-sum, 2048, 59, 375, 29, 0, 0, 463, 1
n50x8192-slot-sum, 2048, 60, 379, 29, 0, 0, 468, 1
n50x8192-slot-sum, 2048, 60, 376, 30, 0, 0, 466, 1
n50x8192-slot-sum, 2048, 59, 376, 29, 0, 0, 464, 1
n50x8192-slot-sum, 2048, 60, 385, 30, 0, 0, 475, 1
n50x8192-slot-sum, 2048, 60, 383, 31, 0, 0, 474, 1
n50x8192-slot-sum, 2048, 61, 387, 30, 0, 0, 478, 1
n50x8192-slot-sum, 2048, 65, 384, 29, 0, 0, 478, 1
n50x8192-slot-sum, 2048, 62, 380, 29, 0, 0, 471, 1
n50x8192-slot-sum, 2048, 59, 382, 29, 0, 0, 470, 1
n50x8192-slot-sum, 2048, 60, 389, 30, 0, 0, 479, 1
n50x8192-slot-sum, 2048, 62, 396, 31, 0, 0, 489, 1
n50x8192-slot-sum, 2048, 61, 390, 31, 0, 0, 482, 1
n50x8192-slot-sum, 2048, 61, 393, 30, 0, 0, 484, 1
n50x8192-slot-sum, 2048, 61, 386, 30, 0, 0, 477, 1
n50x8192-slot-sum, 2048, 64, 384, 30, 0, 0, 478, 1
n50x8192-slot-sum, 2048, 60, 383, 30, 0, 0, 473, 1
n50x8192-slot-sum, 2048, 60, 381, 30, 0, 0, 471, 1
n50x8192-slot-sum, 2048, 60, 382, 30, 0, 0, 472, 1
n50x8192-slot-sum, 2048, 60, 383, 30, 0, 0, 473, 1
n50x8192-slot-sum, 2048, 60, 380, 30, 0, 0, 470, 1
n50x8192-slot-sum, 2048, 61, 389, 30, 0, 0, 480, 1
n50x8192-slot-sum, 2048, 63, 383, 30, 0, 0, 476, 1
n50x8192-slot-sum, 2048, 60, 380, 29, 0, 0, 469, 1
n50x8192-slot-sum, 2048, 60, 376, 29, 0, 0, 465, 1
n50x8192-slot-sum, 2048, 59, 385, 30, 0, 0, 474, 1
n50x8192-slot-sum, 2048, 61, 380, 29, 0, 0, 470, 1
n50x8192-slot-sum, 2048, 66, 383, 30, 0, 0, 479, 1
n50x8192-slot-sum, 2048, 61, 393, 30, 0, 0, 484, 1
n50x8192-slot-sum, 2048, 60, 379, 29, 0, 0, 468, 1
n50x8192-slot-sum, 2048, 59, 381, 29, 0, 0, 469, 1
n50x8192-slot-sum, 2048, 62, 380, 30, 0, 0, 472, 1
n50x8192-slot-sum, 2048, 60, 380, 30, 0, 0, 470, 1
n50x8192-slot-sum, 2048, 61, 380, 31, 0, 0, 472, 1
n50x8192-slot-sum, 2048, 62, 386, 29, 0, 0, 477, 1
n50x8192-slot-sum, 2048, 60, 381, 30, 0, 0, 471, 1
n50x8192-slot-sum, 2048, 60, 381, 30, 0, 0, 471, 1
n50x8192-slot-sum, 2048, 62, 377, 30, 0, 0, 469, 1
n50x8192-slot-sum, 2048, 61, 383, 29, 0, 0, 473, 1
n50x8192-slot-sum, 2048, 59, 394, 29, 0, 0, 482, 1
n50x8192-slot-sum, 2048, 67, 383, 30, 0, 0, 480, 1
n50x8192-slot-sum, 2048, 61, 387, 31, 0, 0, 479, 1
n50x8192-slot-sum, 2048, 62, 387, 31, 0, 0, 480, 1
n50x8192-slot-sum, 2048, 61, 378, 31, 0, 0, 470, 1
n50x8192-slot-sum, 2048, 60, 386, 30, 0, 0, 476, 1
n50x8192-slot-sum, 2048, 60, 379, 30, 0, 0, 469, 1
n50x8192-slot-sum, 2048, 59, 380, 29, 0, 0, 468, 1
n50x8192-slot-sum, 2048, 60, 382, 31, 0, 0, 473, 1
n50x8192-slot-sum, 2048, 60, 382, 30, 0, 0, 472, 1
n50x8192-slot-sum, 2048, 59, 383, 31, 0, 0, 473, 1
n50x8192-slot-sum, 2048, 60, 387, 30, 0, 0, 477, 1
n50x8192-slot-sum, 2048, 60, 384, 30, 0, 0, 474, 1
n50x8192-slot-sum, 2048, 68, 383, 30, 0, 0, 481, 1
n50x8192-slot-sum, 2048, 60, 385, 30, 0, 0, 475, 1
n50x8192-slot-sum, 2048, 60, 385, 32, 0, 0, 477, 1
n50x8192-slot-sum, 2048, 60, 385, 29, 0, 0, 474, 1
n50x8192-slot-sum, 2048, 60, 385, 30, 0, 0, 475, 1
n50x8192-slot-sum, 2048, 62, 384, 30, 0, 0, 476, 1
n50x8192-slot-sum, 2048, 60, 391, 31, 0, 0, 482, 1
n50x8192-slot-sum, 2048, 61, 386, 31, 0, 0, 478, 1
n50x8192-slot-sum, 2048, 63, 395, 31, 0, 0, 489, 1
n50x8192-slot-sum, 2048, 61, 388, 31, 0, 0, 480, 1
n50x8192-slot-sum, 2048, 62, 392, 30, 0, 0, 484, 1
n50x8192-slot-sum, 2048, 69, 383, 30, 0, 0, 482, 1
n50x8192-slot-sum, 2048, 63, 394, 29, 0, 0, 486, 1
n50x8192-slot-sum, 2048, 60, 389, 31, 0, 0, 480, 1
n50x8192-slot-sum, 2048, 61, 385, 30, 0, 0, 476, 1
n50x8192-slot-sum, 2048, 59, 386, 30, 0, 0, 475, 1
n50x8192-slot-sum, 2048, 61, 386, 31, 0, 0, 478, 1
n50x8192-slot-sum, 2048, 60, 381, 31, 0, 0, 472, 1
n50x8192-slot-sum, 2048, 60, 390, 30, 0, 0, 480, 1
n50x8192-slot-sum, 2048, 60, 380, 29, 0, 0, 469, 1
n50x8192-slot-sum, 2048, 65, 383, 29, 0, 0, 477, 1
n50x8192-slot-sum, 2048, 61, 386, 31, 0, 0, 478, 1
n50x8192-slot-sum, 2048, 60, 383, 29, 0, 0, 472, 1
n50x8192-slot-sum, 2048, 59, 377, 31, 0, 0, 467, 1
n50x8192-slot-sum, 2048, 60, 377, 29, 0, 0, 466, 1
n50x8192-slot-sum, 2048, 60, 384, 30, 0, 0, 474, 1
n50x8192-slot-sum, 2048, 60, 382, 30, 0, 0, 472, 1
n50x8192-slot-sum, 2048, 59, 378, 31, 0, 0, 468, 1
n50x8192-slot-sum, 1024, 32, 379, 28, 0, 0, 439, 1
n50x8192-slot-sum, 1024, 31, 382, 29, 0, 0, 442, 1
n50x8192-slot-sum, 1024, 33, 385, 28, 0, 0, 446, 1
n50x8192-slot-sum, 1024, 32, 384, 29, 0, 0, 445, 1
n50x8192-slot-sum, 1024, 33, 386, 28, 0, 0, 447, 1
n50x8192-slot-sum, 1024, 31, 383, 28, 0, 0, 442, 1
n50x8192-slot-sum, 1024, 33, 385, 28, 0, 0, 446, 1
n50x8192-slot-sum, 1024, 32, 384, 28, 0, 0, 444, 1
n50x8192-slot-sum, 1024, 32, 381, 27, 0, 0, 440, 1
n50x8192-slot-sum, 1024, 32, 379, 29, 0, 0, 440, 1
n50x8192-slot-sum, 1024, 36, 384, 28, 0, 0, 448, 1
n50x8192-slot-sum, 1024, 32, 379, 28, 0, 0, 439, 1
n50x8192-slot-sum, 1024, 32, 380, 28, 0, 0, 440, 1
n50x8192-slot-sum, 1024, 32, 381, 28, 0, 0, 441, 1
n50x8192-slot-sum, 1024, 32, 385, 28, 0, 0, 445, 1
n50x8192-slot-sum, 1024, 33, 380, 28, 0, 0, 441, 1
n50x8192-slot-sum, 1024, 32, 383, 28, 0, 0, 443, 1
n50x8192-slot-sum, 1024, 31, 379, 27, 0, 0, 437, 1
n50x8192-slot-sum, 1024, 31, 385, 28, 0, 0, 444, 1
n50x8192-slot-sum, 1024, 32, 383, 28, 0, 0, 443, 1
n50x8192-slot-sum, 1024, 31, 382, 29, 0, 0, 442, 1
n50x8192-slot-sum, 1024, 32, 385, 30, 0, 0, 447, 1
n50x8192-slot-sum, 1024, 32, 387, 28, 0, 0, 447, 1
n50x8192-slot-sum, 1024, 31, 383, 29, 0, 0, 443, 1
n50x8192-slot-sum, 1024, 32, 381, 28, 0, 0, 441, 1
n50x8192-slot-sum, 1024, 32, 381, 29, 0, 0, 442, 1
n50x8192-slot-sum, 1024, 32, 386, 28, 0, 0, 446, 1
n50x8192-slot-sum, 1024, 40, 382, 28, 0, 0, 450, 1
n50x8192-slot-sum, 1024, 32, 383, 28, 0, 0, 443, 1
n50x8192-slot-sum, 1024, 31, 378, 28, 0, 0, 437, 1
n50x8192-slot-sum, 1024, 32, 383, 28, 0, 0, 443, 1
n50x8192-slot-sum, 1024, 33, 385, 28, 0, 0, 446, 1
n50x8192-slot-sum, 1024, 32, 380, 28, 0, 0, 440, 1
n50x8192-slot-sum, 1024, 33, 383, 28, 0, 0, 444, 1
n50x8192-slot-sum, 1024, 32, 377, 27, 0, 0, 436, 1
n50x8192-slot-sum, 1024, 33, 381, 28, 0, 0, 442, 1
n50x8192-slot-sum, 1024, 35, 377, 28, 0, 0, 440, 1
n50x8192-slot-sum, 1024, 33, 380, 28, 0, 0, 441, 1
n50x8192-slot-sum, 1024, 32, 381, 27, 0, 0, 440, 1
n50x8192-slot-sum, 1024, 32, 389, 28, 0, 0, 449, 1
n50x8192-slot-sum, 1024, 32, 384, 28, 0, 0, 444, 1
n50x8192-slot-sum, 1024, 32, 385, 29, 0, 0, 446, 1
n50x8192-slot-sum, 1024, 32, 385, 28, 0, 0, 445, 1
n50x8192-slot-sum, 1024, 32, 391, 28, 0, 0, 451, 1
n50x8192-slot-sum, 1024, 32, 388, 28, 0, 0, 448, 1
n50x8192-slot-sum, 1024, 33, 386, 28, 0, 0, 447, 1
n50x8192-slot-sum, 1024, 33, 390, 28, 0, 0, 451, 1
n50x8192-slot-sum, 1024, 32, 390, 29, 0, 0, 451, 1
n50x8192-slot-sum, 1024, 32, 387, 29, 0, 0, 448, 1
n50x8192-slot-sum, 1024, 33, 383, 28, 0, 0, 444, 1
n50x8192-slot-sum, 1024, 33, 385, 28, 0, 0, 446, 1
n50x8192-slot-sum, 1024, 31, 382, 28, 0, 0, 441, 1
n50x8192-slot-sum, 1024, 32, 384, 29, 0, 0, 445, 1
n50x8192-slot-sum, 1024, 31, 378, 28, 0, 0, 437, 1
n50x8192-slot-sum, 1024, 32, 385, 28, 0, 0, 445, 1
n50x8192-slot-sum, 1024, 33, 383, 29, 0, 0, 445, 1
n50x8192-slot-sum, 1024, 33, 385, 29, 0, 0, 447, 1
n50x8192-slot-sum, 1024, 32, 385, 28, 0, 0, 445, 1
n50x8192-slot-sum, 1024, 32, 381, 28, 0, 0, 441, 1
n50x8192-slot-sum, 1024, 32, 382, 28, 0, 0, 442, 1
n50x8192-slot-sum, 1024, 33, 381, 27, 0, 0, 441, 1
n50x8192-slot-sum, 1024, 31, 383, 28, 0, 0, 442, 1
n50x8192-slot-sum, 1024, 32, 388, 29, 0, 0, 449, 1
n50x8192-slot-sum, 1024, 32, 385, 28, 0, 0, 445, 1
n50x8192-slot-sum, 1024, 32, 382, 27, 0, 0, 441, 1
n50x8192-slot-sum, 1024, 32, 382, 28, 0, 0, 442, 1
n50x8192-slot-sum, 1024, 32, 383, 28, 0, 0, 443, 1
n50x8192-slot-sum, 1024, 32, 384, 27, 0, 0, 443, 1
n50x8192-slot-sum, 1024, 31, 386, 29, 0, 0, 446, 1
n50x8192-slot-sum, 1024, 32, 381, 27, 0, 0, 440, 1
n50x8192-slot-sum, 1024, 33, 384, 28, 0, 0, 445, 1
n50x8192-slot-sum, 1024, 32, 382, 28, 0, 0, 442, 1
n50x8192-slot-sum, 1024, 31, 385, 28, 0, 0, 444, 1
n50x8192-slot-sum, 1024, 38, 382, 27, 0, 0, 447, 1
n50x8192-slot-sum, 1024, 32, 382, 28, 0, 0, 442, 1
n50x8192-slot-sum, 1024, 33, 388, 27, 0, 0, 448, 1
n50x8192-slot-sum, 1024, 32, 385, 30, 0, 0, 447, 1
n50x8192-slot-sum, 1024, 32, 386, 29, 0, 0, 447, 1
n50x8192-slot-sum, 1024, 32, 382, 28, 0, 0, 442, 1
n50x8192-slot-sum, 1024, 33, 380, 29, 0, 0, 442, 1
n50x8192-slot-sum, 1024, 32, 381, 28, 0, 0, 441, 1
n50x8192-slot-sum, 1024, 48, 379, 28, 0, 0, 455, 1
n50x8192-slot-sum, 1024, 32, 380, 28, 0, 0, 440, 1
n50x8192-slot-sum, 1024, 33, 384, 28, 0, 0, 445, 1
n50x8192-slot-sum, 1024, 32, 384, 29, 0, 0, 445, 1
n50x8192-slot-sum, 1024, 32, 379, 27, 0, 0, 438, 1
n50x8192-slot-sum, 1024, 34, 377, 28, 0, 0, 439, 1
n50x8192-slot-sum, 1024, 31, 383, 27, 0, 0, 441, 1
n50x8192-slot-sum, 1024, 32, 389, 28, 0, 0, 449, 1
n50x8192-slot-sum, 1024, 33, 385, 28, 0, 0, 446, 1
n50x8192-slot-sum, 1024, 31, 384, 28, 0, 0, 443, 1
n50x8192-slot-sum, 1024, 32, 382, 30, 0, 0, 444, 1
n50x8192-slot-sum, 1024, 31, 387, 28, 0, 0, 446, 1
n50x8192-slot-sum, 1024, 32, 386, 29, 0, 0, 447, 1
n50x8192-slot-sum, 1024, 32, 381, 28, 0, 0, 441, 1
n50x8192-slot-sum, 1024, 33, 380, 27, 0, 0, 440, 1
n50x8192-slot-sum, 1024, 33, 384, 27, 0, 0, 444, 1
n50x8192-slot-sum, 1024, 32, 383, 28, 0, 0, 443, 1
n50x8192-slot-sum, 1024, 31, 380, 28, 0, 0, 439, 1
n50x8192-slot-sum, 1024, 32, 381, 28, 0, 0, 441, 1
n50x8192-slot-inner, 8192, 286, 405, 736, 1, 0, 1428, 682666
n50x8192-slot-inner, 8192, 290, 406, 735, 1, 0, 1432, 682666
n50x8192-slot-inner, 8192, 297, 411, 734, 1, 0, 1443, 682666
n50x8192-slot-inner, 8192, 287, 403, 731, 1, 0, 1422, 682666
n50x8192-slot-inner, 8192, 282, 405, 734, 1, 0, 1422, 682666
n50x8192-slot-inner, 8192, 287, 408, 765, 1, 0, 1461, 682666
n50x8192-slot-inner, 8192, 290, 411, 746, 1, 0, 1448, 682666
n50x8192-slot-inner, 8192, 287, 412, 747, 1, 0, 1447, 682666
n50x8192-slot-inner, 8192, 293, 406, 772, 1, 0, 1472, 682666
n50x8192-slot-inner, 8192, 288, 415, 747, 1, 0, 1451, 682666
n50x8192-slot-inner, 8192, 298, 414, 740, 1, 0, 1453, 682666
n50x8192-slot-inner, 8192, 281, 405, 733, 1, 0, 1420, 682666
n50x8192-slot-inner, 8192, 287, 406, 764, 1, 0, 1458, 682666
n50x8192-slot-inner, 8192, 285, 405, 726, 1, 0, 1417, 682666
n50x8192-slot-inner, 8192, 285, 406, 734, 1, 0, 1426, 682666
n50x8192-slot-inner, 8192, 285, 407, 740, 1, 0, 1433, 682666
n50x8192-slot-inner, 8192, 289, 409, 742, 1, 0, 1441, 682666
n50x8192-slot-inner, 8192, 291, 408, 739, 1, 0, 1439, 682666
n50x8192-slot-inner, 8192, 289, 408, 745, 1, 0, 1443, 682666
n50x8192-slot-inner, 8192, 290, 408, 741, 1, 0, 1440, 682666
n50x8192-slot-inner, 8192, 293, 409, 736, 1, 0, 1439, 682666
n50x8192-slot-inner, 8192, 290, 409, 770, 1, 0, 1470, 682666
n50x8192-slot-inner, 8192, 291, 414, 755, 1, 0, 1461, 682666
n50x8192-slot-inner, 8192, 289, 409, 770, 1, 0, 1469, 682666
n50x8192-slot-inner, 8192, 288, 405, 740, 1, 0, 1434, 682666
n50x8192-slot-inner, 8192, 292, 410, 739, 1, 0, 1442, 682666
n50x8192-slot-inner, 8192, 289, 406, 736, 1, 0, 1432, 682666
n50x8192-slot-inner, 8192, 285, 415, 762, 1, 0, 1463, 682666
n50x8192-slot-inner, 8192, 297, 425, 769, 1, 0, 1492, 682666
n50x8192-slot-inner, 8192, 292, 416, 783, 1, 0, 1492, 682666
n50x8192-slot-inner, 8192, 291, 415, 762, 1, 0, 1469, 682666
n50x8192-slot-inner, 8192, 290, 410, 757, 1, 0, 1458, 682666
n50x8192-slot-inner, 8192, 292, 415, 751, 1, 0, 1459, 682666
n50x8192-slot-inner, 8192, 290, 414, 739, 1, 0, 1444, 682666
n50x8192-slot-inner, 8192, 291, 419, 777, 1, 0, 1488, 682666
n50x8192-slot-inner, 8192, 286, 408, 742, 1, 0, 1437, 682666
n50x8192-slot-inner, 8192, 287, 407, 737, 1, 0, 1432, 682666
n50x8192-slot-inner, 8192, 291, 411, 752, 1, 0, 1455, 682666
n50x8192-slot-inner, 8192, 290, 412, 757, 1, 0, 1460, 682666
n50x8192-slot-inner, 8192, 293, 410, 771, 1, 0, 1475, 682666
n50x8192-slot-inner, 8192, 295, 415, 751, 1, 0, 1462, 682666
n50x8192-slot-inner, 8192, 287, 410, 738, 1, 0, 1436, 682666
n50x8192-slot-inner, 8192, 288, 411, 748, 1, 0, 1448, 682666
n50x8192-slot-inner, 8192, 284, 410, 740, 1, 0, 1435, 682666
n50x8192-slot-inner, 8192, 288, 411, 747, 1, 0, 1447, 682666
n50x8192-slot-inner, 8192, 295, 409, 777, 1, 0, 1482, 682666
n50x8192-slot-inner, 8192, 288, 408, 778, 1, 0, 1475, 682666
n50x8192-slot-inner, 8192, 288, 412, 748, 1, 0, 1449, 682666
n50x8192-slot-inner, 8192, 294, 409, 745, 1, 0, 1449, 682666
n50x8192-slot-inner, 8192, 290, 412, 748, 1, 0, 1451, 682666
n50x8192-slot-inner, 8192, 289, 412, 748, 1, 0, 1450, 682666
n50x8192-slot-inner, 8192, 289, 413, 748, 1, 0, 1451, 682666
n50x8192-slot-inner, 8192, 288, 411, 743, 1, 0, 1443, 682666
n50x8192-slot-inner, 8192, 294, 411, 744, 1, 0, 1450, 682666
n50x8192-slot-inner, 8192, 288, 409, 771, 1, 0, 1469, 682666
n50x8192-slot-inner, 8192, 291, 407, 773, 1, 0, 1472, 682666
n50x8192-slot-inner, 8192, 293, 415, 756, 1, 0, 1465, 682666
n50x8192-slot-inner, 8192, 288, 410, 768, 1, 0, 1467, 682666
n50x8192-slot-inner, 8192, 290, 414, 752, 1, 0, 1457, 682666
n50x8192-slot-inner, 8192, 290, 406, 743, 1, 0, 1440, 682666
n50x8192-slot-inner, 8192, 287, 411, 746, 1, 0, 1445, 682666
n50x8192-slot-inner, 8192, 286, 410, 745, 1, 0, 1442, 682666
n50x8192-slot-inner, 8192, 286, 408, 749, 1, 0, 1444, 682666
n50x8192-slot-inner, 8192, 290, 411, 747, 1, 0, 1449, 682666
n50x8192-slot-inner, 8192, 293, 408, 771, 1, 0, 1473, 682666
n50x8192-slot-inner, 8192, 286, 412, 745, 1, 0, 1444, 682666
n50x8192-slot-inner, 8192, 285, 412, 741, 1, 0, 1439, 682666
n50x8192-slot-inner, 8192, 289, 409, 776, 1, 0, 1475, 682666
n50x8192-slot-inner, 8192, 283, 418, 755, 1, 0, 1457, 682666
n50x8192-slot-inner, 8192, 290, 409, 755, 1, 0, 1455, 682666
n50x8192-slot-inner, 8192, 289, 416, 759, 1, 0, 1465, 682666
n50x8192-slot-inner, 8192, 290, 412, 749, 1, 0, 1452, 682666
n50x8192-slot-inner, 8192, 289, 411, 755, 1, 0, 1456, 682666
n50x8192-slot-inner, 8192, 291, 411, 774, 1, 0, 1477, 682666
n50x8192-slot-inner, 8192, 290, 420, 737, 1, 0, 1448, 682666
n50x8192-slot-inner, 8192, 284, 415, 738, 1, 0, 1438, 682666
n50x8192-slot-inner, 8192, 288, 411, 748, 1, 0, 1448, 682666
n50x8192-slot-inner, 8192, 289, 408, 741, 1, 0, 1439, 682666
n50x8192-slot-inner, 8192, 291, 413, 749, 1, 0, 1454, 682666
n50x8192-slot-inner, 8192, 289, 410, 752, 1, 0, 1452, 682666
n50x8192-slot-inner, 8192, 287, 412, 744, 1, 0, 1444, 682666
n50x8192-slot-inner, 8192, 287, 407, 738, 1, 0, 1433, 682666
n50x8192-slot-inner, 8192, 295, 408, 740, 1, 0, 1444, 682666
n50x8192-slot-inner, 8192, 288, 411, 751, 1, 0, 1451, 682666
n50x8192-slot-inner, 8192, 288, 411, 737, 1, 0, 1437, 682666
n50x8192-slot-inner, 8192, 288, 412, 739, 1, 0, 1440, 682666
n50x8192-slot-inner, 8192, 288, 409, 771, 1, 0, 1469, 682666
n50x8192-slot-inner, 8192, 297, 408, 770, 1, 0, 1476, 682666
n50x8192-slot-inner, 8192, 289, 409, 737, 1, 0, 1436, 682666
n50x8192-slot-inner, 8192, 285, 404, 739, 1, 0, 1429, 682666
n50x8192-slot-inner, 8192, 285, 409, 739, 1, 0, 1434, 682666
n50x8192-slot-inner, 8192, 289, 412, 747, 1, 0, 1449, 682666
n50x8192-slot-inner, 8192, 290, 406, 742, 1, 0, 1439, 682666
n50x8192-slot-inner, 8192, 291, 414, 747, 1, 0, 1453, 682666
n50x8192-slot-inner, 8192, 285, 411, 745, 1, 0, 1442, 682666
n50x8192-slot-inner, 8192, 291, 416, 749, 1, 0, 1457, 682666
n50x8192-slot-inner, 8192, 287, 411, 770, 1, 0, 1469, 682666
n50x8192-slot-inner, 8192, 291, 414, 752, 1, 0, 1458, 682666
n50x8192-slot-inner, 8192, 288, 406, 776, 1, 0, 1471, 682666
n50x8192-slot-inner, 8192, 295, 415, 754, 1, 0, 1465, 682666
n50x8192-slot-inner, 4096, 137, 394, 687, 0, 0, 1218, 682666
n50x8192-slot-inner, 4096, 135, 390, 682, 0, 0, 1207, 682666
n50x8192-slot-inner, 4096, 131, 393, 691, 0, 0, 1215, 682666
n50x8192-slot-inner, 4096, 139, 395, 699, 0, 0, 1233, 682666
n50x8192-slot-inner, 4096, 136, 393, 688, 0, 0, 1217, 682666
n50x8192-slot-inner, 4096, 135, 396, 693, 0, 0, 1224, 682666
n50x8192-slot-inner, 4096, 133, 396, 691, 0, 0, 1220, 682666
n50x8192-slot-inner, 4096, 134, 389, 701, 0, 0, 1224, 682666
n50x8192-slot-inner, 4096, 138, 396, 729, 0, 0, 1263, 682666
n50x8192-slot-inner, 4096, 133, 393, 696, 0, 0, 1222, 682666
n50x8192-slot-inner, 4096, 138, 405, 707, 0, 0, 1250, 682666
n50x8192-slot-inner, 4096, 134, 395, 705, 0, 0, 1234, 682666
n50x8192-slot-inner, 4096, 138, 389, 691, 0, 0, 1218, 682666
n50x8192-slot-inner, 4096, 135, 394, 692, 0, 0, 1221, 682666
n50x8192-slot-inner, 4096, 138, 398, 703, 0, 0, 1239, 682666
n50x8192-slot-inner, 4096, 140, 400, 725, 0, 0, 1265, 682666
n50x8192-slot-inner, 4096, 138, 397, 691, 0, 0, 1226, 682666
n50x8192-slot-inner, 4096, 134, 407, 693, 0, 0, 1234, 682666
n50x8192-slot-inner, 4096, 135, 394, 697, 0, 0, 1226, 682666
n50x8192-slot-inner, 4096, 135, 394, 695, 0, 0, 1224, 682666
n50x8192-slot-inner, 4096, 136, 393, 698, 0, 0, 1227, 682666
n50x8192-slot-inner, 4096, 134, 397, 700, 0, 0, 1231, 682666
n50x8192-slot-inner, 4096, 137, 393, 719, 0, 0, 1249, 682666
n50x8192-slot-inner, 4096, 139, 394, 723, 0, 0, 1256, 682666
n50x8192-slot-inner, 4096, 136, 394, 732, 0, 0, 1262, 682666
n50x8192-slot-inner, 4096, 138, 391, 714, 0, 0, 1243, 682666
n50x8192-slot-inner, 4096, 135, 391, 703, 0, 0, 1229, 682666
n50x8192-slot-inner, 4096, 134, 394, 699, 0, 0, 1227, 682666
n50x8192-slot-inner, 4096, 137, 395, 697, 0, 0, 1229, 682666
n50x8192-slot-inner, 4096, 137, 398, 698, 0, 0, 1233, 682666
n50x8192-slot-inner, 4096, 146, 393, 716, 0, 0, 1255, 682666
n50x8192-slot-inner, 4096, 135, 392, 681, 0, 0, 1208, 682666
n50x8192-slot-inner, 4096, 136, 392, 687, 0, 0, 1215, 682666
n50x8192-slot-inner, 4096, 139, 399, 697, 0, 0, 1235, 682666
n50x8192-slot-inner, 4096, 134, 389, 691, 0, 0, 1214, 682666
n50x8192-slot-inner, 4096, 137, 391, 691, 0, 0, 1219, 682666
n50x8192-slot-inner, 4096, 136, 402, 700, 0, 0, 1238, 682666
n50x8192-slot-inner, 4096, 137, 393, 688, 0, 0, 1218, 682666
n50x8192-slot-inner, 4096, 138, 395, 696, 0, 0, 1229, 682666
n50x8192-slot-inner, 4096, 140, 397, 711, 0, 0, 1248, 682666
n50x8192-slot-inner, 4096, 137, 393, 694, 0, 0, 1224, 682666
n50x8192-slot-inner, 4096, 139, 393, 698, 0, 0, 1230, 682666
n50x8192-slot-inner, 4096, 133, 396, 691, 0, 0, 1220, 682666
n50x8192-slot-inner, 4096, 142, 393, 719, 0, 0, 1254, 682666
n50x8192-slot-inner, 4096, 134, 393, 694, 0, 0, 1221, 682666
n50x8192-slot-inner, 4096, 139, 391, 689, 0, 0, 1219, 682666
n50x8192-slot-inner, 4096, 135, 392, 693, 0, 0, 1220, 682666
n50x8192-slot-inner, 4096, 137, 390, 684, 0, 0, 1211, 682666
n50x8192-slot-inner, 4096, 140, 393, 720, 0, 0, 1253, 682666
n50x8192-slot-inner, 4096, 138, 390, 692, 0, 0, 1220, 682666
n50x8192-slot-inner, 4096, 134, 391, 694, 0, 0, 1219, 682666
n50x8192-slot-inner, 4096, 133, 403, 692, 0, 0, 1228, 682666
n50x8192-slot-inner, 4096, 133, 391, 691, 0, 0, 1215, 682666
n50x8192-slot-inner, 4096, 134, 392, 702, 0, 0, 1228, 682666
n50x8192-slot-inner, 4096, 135, 393, 698, 0, 0, 1226, 682666
n50x8192-slot-inner, 4096, 139, 391, 694, 0, 0, 1224, 682666
n50x8192-slot-inner, 4096, 135, 396, 694, 0, 0, 1225, 682666
n50x8192-slot-inner, 4096, 134, 391, 694, 0, 0, 1219, 682666
n50x8192-slot-inner, 4096, 137, 404, 698, 0, 0, 1239, 682666
n50x8192-slot-inner, 4096, 139, 399, 701, 0, 0, 1239, 682666
n50x8192-slot-inner, 4096, 136, 395, 695, 0, 0, 1226, 682666
n50x8192-slot-inner, 4096, 136, 399, 701, 0, 0, 1236, 682666
n50x8192-slot-inner, 4096, 134, 390, 700, 0, 0, 1224, 682666
n50x8192-slot-inner, 4096, 135, 393, 688, 0, 0, 1216, 682666
n50x8192-slot-inner, 4096, 135, 386, 695, 0, 0, 1216, 682666
n50x8192-slot-inner, 4096, 134, 392, 690, 0, 0, 1216, 682666
n50x8192-slot-inner, 4096, 137, 393, 694, 0, 0, 1224, 682666
n50x8192-slot-inner, 4096, 135, 392, 690, 0, 0, 1217, 682666
n50x8192-slot-inner, 4096, 132, 391, 691, 0, 0, 1214, 682666
n50x8192-slot-inner, 4096, 136, 396, 694, 0, 0, 1226, 682666
n50x8192-slot-inner, 4096, 140, 391, 694, 0, 0, 1225, 682666
n50x8192-slot-inner, 4096, 134, 388, 689, 0, 0, 1211, 682666
n50x8192-slot-inner, 4096, 134, 391, 688, 0, 0, 1213, 682666
n50x8192-slot-inner, 4096, 134, 400, 703, 0, 0, 1237, 682666
n50x8192-slot-inner, 4096, 135, 395, 693, 0, 0, 1223, 682666
n50x8192-slot-inner, 4096, 136, 390, 690, 0, 0, 1216, 682666
n50x8192-slot-inner, 4096, 134, 392, 698, 0, 0, 1224, 682666
n50x8192-slot-inner, 4096, 140, 404, 706, 0, 0, 1250, 682666
n50x8192-slot-inner, 4096, 138, 393, 695, 0, 0, 1226, 682666
n50x8192-slot-inner, 4096, 137, 402, 706, 0, 0, 1245, 682666
n50x8192-slot-inner, 4096, 137, 397, 699, 0, 0, 1233, 682666
n50x8192-slot-inner, 4096, 135, 400, 706, 0, 0, 1241, 682666
n50x8192-slot-inner, 4096, 136, 399, 699, 0, 0, 1234, 682666
n50x8192-slot-inner, 4096, 141, 399, 709, 0, 0, 1249, 682666
n50x8192-slot-inner, 4096, 134, 397, 691, 0, 0, 1222, 682666
n50x8192-slot-inner, 4096, 134, 394, 693, 0, 0, 1221, 682666
n50x8192-slot-inner, 4096, 134, 393, 697, 0, 0, 1224, 682666
n50x8192-slot-inner, 4096, 145, 391, 719, 0, 0, 1255, 682666
n50x8192-slot-inner, 4096, 135, 394, 718, 0, 0, 1247, 682666
n50x8192-slot-inner, 4096, 134, 395, 695, 0, 0, 1224, 682666
n50x8192-slot-inner, 4096, 135, 400, 706, 0, 0, 1241, 682666
n50x8192-slot-inner, 4096, 135, 393, 695, 0, 0, 1223, 682666
n50x8192-slot-inner, 4096, 137, 399, 701, 0, 0, 1237, 682666
n50x8192-slot-inner, 4096, 135, 389, 691, 0, 0, 1215, 682666
n50x8192-slot-inner, 4096, 134, 389, 692, 0, 0, 1215, 682666
n50x8192-slot-inner, 4096, 133, 391, 684, 0, 0, 1208, 682666
n50x8192-slot-inner, 4096, 140, 394, 688, 0, 0, 1222, 682666
n50x8192-slot-inner, 4096, 134, 394, 695, 0, 0, 1223, 682666
n50x8192-slot-inner, 4096, 133, 389, 696, 0, 0, 1218, 682666
n50x8192-slot-inner, 4096, 136, 393, 689, 0, 0, 1218, 682666
n50x8192-slot-inner, 2048, 65, 380, 667, 0, 0, 1112, 682666
n50x8192-slot-inner, 2048, 65, 381, 676, 0, 0, 1122, 682666
n50x8192-slot-inner, 2048, 64, 380, 666, 0, 0, 1110, 682666
n50x8192-slot-inner, 2048, 65, 379, 668, 0, 0, 1112, 682666
n50x8192-slot-inner, 2048, 64, 380, 666, 0, 0, 1110, 682666
n50x8192-slot-inner, 2048, 65, 382, 682, 0, 0, 1129, 682666
n50x8192-slot-inner, 2048, 65, 384, 674, 0, 0, 1123, 682666
n50x8192-slot-inner, 2048, 66, 381, 668, 0, 0, 1115, 682666
n50x8192-slot-inner, 2048, 64, 382, 679, 0, 0, 1125, 682666
n50x8192-slot-inner, 2048, 64, 387, 678, 0, 0, 1129, 682666
n50x8192-slot-inner, 2048, 66, 381, 672, 0, 0, 1119, 682666
n50x8192-slot-inner, 2048, 65, 382, 671, 0, 0, 1118, 682666
n50x8192-slot-inner, 2048, 64, 382, 674, 0, 0, 1120, 682666
n50x8192-slot-inner, 2048, 65, 398, 701, 0, 0, 1164, 682666
n50x8192-slot-inner, 2048, 64, 383, 677, 0, 0, 1124, 682666
n50x8192-slot-inner, 2048, 64, 385, 677, 0, 0, 1126, 682666
n50x8192-slot-inner, 2048, 66, 382, 678, 0, 0, 1126, 682666
n50x8192-slot-inner, 2048, 68, 383, 707, 0, 0, 1158, 682666
n50x8192-slot-inner, 2048, 65, 385, 677, 0, 0, 1127, 682666
n50x8192-slot-inner, 2048, 65, 382, 706, 0, 0, 1153, 682666
n50x8192-slot-inner, 2048, 65, 382, 688, 0, 0, 1135, 682666
n50x8192-slot-inner, 2048, 64, 379, 672, 0, 0, 1115, 682666
n50x8192-slot-inner, 2048, 64, 379, 665, 0, 0, 1108, 682666
n50x8192-slot-inner, 2048, 71, 381, 701, 0, 0, 1153, 682666
n50x8192-slot-inner, 2048, 67, 384, 667, 0, 0, 1118, 682666
n50x8192-slot-inner, 2048, 66, 383, 668, 0, 0, 1117, 682666
n50x8192-slot-inner, 2048, 64, 384, 680, 0, 0, 1128, 682666
n50x8192-slot-inner, 2048, 64, 383, 672, 0, 0, 1119, 682666
n50x8192-slot-inner, 2048, 64, 384, 672, 0, 0, 1120, 682666
n50x8192-slot-inner, 2048, 64, 379, 678, 0, 0, 1121, 682666
n50x8192-slot-inner, 2048, 63, 382, 671, 0, 0, 1116, 682666
n50x8192-slot-inner, 2048, 64, 380, 669, 0, 0, 1113, 682666
n50x8192-slot-inner, 2048, 67, 380, 681, 0, 0, 1128, 682666
n50x8192-slot-inner, 2048, 65, 383, 670, 0, 0, 1118, 682666
n50x8192-slot-inner, 2048, 65, 383, 662, 0, 0, 1110, 682666
n50x8192-slot-inner, 2048, 66, 385, 678, 0, 0, 1129, 682666
n50x8192-slot-inner, 2048, 64, 382, 674, 0, 0, 1120, 682666
n50x8192-slot-inner, 2048, 65, 387, 666, 0, 0, 1118, 682666
n50x8192-slot-inner, 2048, 63, 380, 669, 0, 0, 1112, 682666
n50x8192-slot-inner, 2048, 64, 380, 675, 0, 0, 1119, 682666
n50x8192-slot-inner, 2048, 68, 381, 680, 0, 0, 1129, 682666
n50x8192-slot-inner, 2048, 73, 383, 703, 0, 0, 1159, 682666
n50x8192-slot-inner, 2048, 64, 379, 674, 0, 0, 1117, 682666
n50x8192-slot-inner, 2048, 64, 381, 666, 0, 0, 1111, 682666
n50x8192-slot-inner, 2048, 68, 388, 680, 0, 0, 1136, 682666
n50x8192-slot-inner, 2048, 71, 380, 694, 0, 0, 1145, 682666
n50x8192-slot-inner, 2048, 65, 379, 662, 0, 0, 1106, 682666
n50x8192-slot-inner, 2048, 65, 384, 676, 0, 0, 1125, 682666
n50x8192-slot-inner, 2048, 64, 380, 680, 0, 0, 1124, 682666
n50x8192-slot-inner, 2048, 64, 382, 667, 0, 0, 1113, 682666
n50x8192-slot-inner, 2048, 66, 386, 675, 0, 0, 1127, 682666
n50x8192-slot-inner, 2048, 66, 387, 677, 0, 0, 1130, 682666
n50x8192-slot-inner, 2048, 64, 383, 680, 0, 0, 1127, 682666
n50x8192-slot-inner, 2048, 64, 380, 665, 0, 0, 1109, 682666
n50x8192-slot-inner, 2048, 64, 384, 661, 0, 0, 1109, 682666
n50x8192-slot-inner, 2048, 66, 383, 686, 0, 0, 1135, 682666
n50x8192-slot-inner, 2048, 65, 377, 682, 0, 0, 1124, 682666
n50x8192-slot-inner, 2048, 65, 387, 666, 0, 0, 1118, 682666
n50x8192-slot-inner, 2048, 70, 388, 693, 0, 0, 1151, 682666
n50x8192-slot-inner, 2048, 66, 379, 673, 0, 0, 1118, 682666
n50x8192-slot-inner, 2048, 65, 383, 673, 0, 0, 1121, 682666
n50x8192-slot-inner, 2048, 65, 379, 670, 0, 0, 1114, 682666
n50x8192-slot-inner, 2048, 65, 379, 690, 0, 0, 1134, 682666
n50x8192-slot-inner, 2048, 64, 383, 673, 0, 0, 1120, 682666
n50x8192-slot-inner, 2048, 65, 382, 687, 0, 0, 1134, 682666
n50x8192-slot-inner, 2048, 75, 376, 697, 0, 0, 1148, 682666
n50x8192-slot-inner, 2048, 66, 380, 664, 0, 0, 1110, 682666
n50x8192-slot-inner, 2048, 64, 381, 674, 0, 0, 1119, 682666
n50x8192-slot-inner, 2048, 64, 380, 681, 0, 0, 1125, 682666
n50x8192-slot-inner, 2048, 65, 383, 682, 0, 0, 1130, 682666
n50x8192-slot-inner, 2048, 65, 383, 671, 0, 0, 1119, 682666
n50x8192-slot-inner, 2048, 65, 384, 670, 0, 0, 1119, 682666
n50x8192-slot-inner, 2048, 65, 382, 678, 0, 0, 1125, 682666
n50x8192-slot-inner, 2048, 64, 381, 672, 0, 0, 1117, 682666
n50x8192-slot-inner, 2048, 65, 380, 678, 0, 0, 1123, 682666
n50x8192-slot-inner, 2048, 66, 381, 698, 0, 0, 1145, 682666
n50x8192-slot-inner, 2048, 66, 384, 683, 0, 0, 1133, 682666
n50x8192-slot-inner, 2048, 63, 385, 680, 0, 0, 1128, 682666
n50x8192-slot-inner, 2048, 64, 387, 680, 0, 0, 1131, 682666
n50x8192-slot-inner, 2048, 64, 383, 675, 0, 0, 1122, 682666
n50x8192-slot-inner, 2048, 65, 384, 665, 0, 0, 1114, 682666
n50x8192-slot-inner, 2048, 65, 381, 668, 0, 0, 1114, 682666
n50x8192-slot-inner, 2048, 64, 379, 671, 0, 0, 1114, 682666
n50x8192-slot-inner, 2048, 64, 378, 662, 0, 0, 1104, 682666
n50x8192-slot-inner, 2048, 64, 380, 669, 0, 0, 1113, 682666
n50x8192-slot-inner, 2048, 64, 379, 665, 0, 0, 1108, 682666
n50x8192-slot-inner, 2048, 65, 386, 665, 0, 0, 1116, 682666
n50x8192-slot-inner, 2048, 64, 377, 669, 0, 0, 1110, 682666
n50x8192-slot-inner, 2048, 64, 383, 662, 0, 0, 1109, 682666
n50x8192-slot-inner, 2048, 70, 378, 670, 0, 0, 1118, 682666
n50x8192-slot-inner, 2048, 64, 380, 661, 0, 0, 1105, 682666
n50x8192-slot-inner, 2048, 64, 378, 669, 0, 0, 1111, 682666
n50x8192-slot-inner, 2048, 73, 379, 685, 0, 0, 1137, 682666
n50x8192-slot-inner, 2048, 66, 382, 665, 0, 0, 1113, 682666
n50x8192-slot-inner, 2048, 65, 379, 662, 0, 0, 1106, 682666
n50x8192-slot-inner, 2048, 64, 377, 669, 0, 0, 1110, 682666
n50x8192-slot-inner, 2048, 69, 379, 659, 0, 0, 1107, 682666
n50x8192-slot-inner, 2048, 64, 378, 666, 0, 0, 1108, 682666
n50x8192-slot-inner, 2048, 76, 378, 690, 0, 0, 1144, 682666
n50x8192-slot-inner, 2048, 64, 379, 658, 0, 0, 1101, 682666
n50x8192-slot-inner, 1024, 34, 378, 683, 0, 0, 1095, 682666
n50x8192-slot-inner, 1024, 36, 387, 682, 0, 0, 1105, 682666
n50x8192-slot-inner, 1024, 36, 378, 679, 0, 0, 1093, 682666
n50x8192-slot-inner, 1024, 41, 377, 702, 0, 0, 1120, 682666
n50x8192-slot-inner, 1024, 34, 377, 679, 0, 0, 1090, 682666
n50x8192-slot-inner, 1024, 33, 376, 674, 0, 0, 1083, 682666
n50x8192-slot-inner, 1024, 34, 383, 669, 0, 0, 1086, 682666
n50x8192-slot-inner, 1024, 34, 381, 687, 0, 0, 1102, 682666
n50x8192-slot-inner, 1024, 35, 377, 685, 0, 0, 1097, 682666
n50x8192-slot-inner, 1024, 35, 387, 679, 0, 0, 1101, 682666
n50x8192-slot-inner, 1024, 33, 380, 692, 0, 0, 1105, 682666
n50x8192-slot-inner, 1024, 35, 380, 688, 0, 0, 1103, 682666
n50x8192-slot-inner, 1024, 34, 379, 681, 0, 0, 1094, 682666
n50x8192-slot-inner, 1024, 35, 382, 685, 0, 0, 1102, 682666
n50x8192-slot-inner, 1024, 34, 383, 687, 0, 0, 1104, 682666
n50x8192-slot-inner, 1024, 34, 385, 675, 0, 0, 1094, 682666
n50x8192-slot-inner, 1024, 34, 378, 690, 0, 0, 1102, 682666
n50x8192-slot-inner, 1024, 34, 376, 680, 0, 0, 1090, 682666
n50x8192-slot-inner, 1024, 34, 381, 673, 0, 0, 1088, 682666
n50x8192-slot-inner, 1024, 34, 377, 682, 0, 0, 1093, 682666
n50x8192-slot-inner, 1024, 34, 377, 680, 0, 0, 1091, 682666
n50x8192-slot-inner, 1024, 35, 381, 682, 0, 0, 1098, 682666
n50x8192-slot-inner, 1024, 34, 380, 676, 0, 0, 1090, 682666
n50x8192-slot-inner, 1024, 34, 377, 684, 0, 0, 1095, 682666
n50x8192-slot-inner, 1024, 35, 377, 678, 0, 0, 1090, 682666
n50x8192-slot-inner, 1024, 34, 374, 674, 0, 0, 1082, 682666
n50x8192-slot-inner, 1024, 33, 374, 675, 0, 0, 1082, 682666
n50x8192-slot-inner, 1024, 34, 376, 676, 0, 0, 1086, 682666
n50x8192-slot-inner, 1024, 34, 380, 687, 0, 0, 1101, 682666
n50x8192-slot-inner, 1024, 33, 377, 679, 0, 0, 1089, 682666
n50x8192-slot-inner, 1024, 34, 377, 679, 0, 0, 1090, 682666
n50x8192-slot-inner, 1024, 34, 384, 682, 0, 0, 1100, 682666
n50x8192-slot-inner, 1024, 34, 378, 680, 0, 0, 1092, 682666
n50x8192-slot-inner, 1024, 35, 376, 677, 0, 0, 1088, 682666
n50x8192-slot-inner, 1024, 34, 380, 682, 0, 0, 1096, 682666
n50x8192-slot-inner, 1024, 33, 377, 684, 0, 0, 1094, 682666
n50x8192-slot-inner, 1024, 35, 380, 687, 0, 0, 1102, 682666
n50x8192-slot-inner, 1024, 33, 388, 685, 0, 0, 1106, 682666
n50x8192-slot-inner, 1024, 34, 387, 696, 0, 0, 1117, 682666
n50x8192-slot-inner, 1024, 36, 378, 680, 0, 0, 1094, 682666
n50x8192-slot-inner, 1024, 34, 381, 677, 0, 0, 1092, 682666
n50x8192-slot-inner, 1024, 34, 382, 694, 0, 0, 1110, 682666
n50x8192-slot-inner, 1024, 35, 376, 688, 0, 0, 1099, 682666
n50x8192-slot-inner, 1024, 34, 380, 682, 0, 0, 1096, 682666
n50x8192-slot-inner, 1024, 34, 383, 672, 0, 0, 1089, 682666
n50x8192-slot-inner, 1024, 34, 377, 685, 0, 0, 1096, 682666
n50x8192-slot-inner, 1024, 34, 374, 676, 0, 0, 1084, 682666
n50x8192-slot-inner, 1024, 34, 383, 682, 0, 0, 1099, 682666
n50x8192-slot-inner, 1024, 34, 375, 679, 0, 0, 1088, 682666
n50x8192-slot-inner, 1024, 34, 377, 680, 0, 0, 1091, 682666
n50x8192-slot-inner, 1024, 34, 384, 688, 0, 0, 1106, 682666
n50x8192-slot-inner, 1024, 34, 379, 678, 0, 0, 1091, 682666
n50x8192-slot-inner, 1024, 35, 380, 679, 0, 0, 1094, 682666
n50x8192-slot-inner, 1024, 35, 382, 675, 0, 0, 1092, 682666
n50x8192-slot-inner, 1024, 35, 380, 680, 0, 0, 1095, 682666
n50x8192-slot-inner, 1024, 35, 379, 676, 0, 0, 1090, 682666
n50x8192-slot-inner, 1024, 36, 380, 699, 0, 0, 1115, 682666
n50x8192-slot-inner, 1024, 34, 378, 680, 0, 0, 1092, 682666
n50x8192-slot-inner, 1024, 34, 379, 673, 0, 0, 1086, 682666
n50x8192-slot-inner, 1024, 35, 379, 685, 0, 0, 1099, 682666
n50x8192-slot-inner, 1024, 34, 380, 686, 0, 0, 1100, 682666
n50x8192-slot-inner, 1024, 35, 377, 700, 0, 0, 1112, 682666
n50x8192-slot-inner, 1024, 34, 383, 684, 0, 0, 1101, 682666
n50x8192-slot-inner, 1024, 34, 380, 686, 0, 0, 1100, 682666
n50x8192-slot-inner, 1024, 33, 377, 689, 0, 0, 1099, 682666
n50x8192-slot-inner, 1024, 35, 382, 683, 0, 0, 1100, 682666
n50x8192-slot-inner, 1024, 34, 383, 685, 0, 0, 1102, 682666
n50x8192-slot-inner, 1024, 34, 380, 689, 0, 0, 1103, 682666
n50x8192-slot-inner, 1024, 33, 384, 689, 0, 0, 1106, 682666
n50x8192-slot-inner, 1024, 33, 378, 684, 0, 0, 1095, 682666
n50x8192-slot-inner, 1024, 34, 379, 688, 0, 0, 1101, 682666
n50x8192-slot-inner, 1024, 34, 383, 678, 0, 0, 1095, 682666
n50x8192-slot-inner, 1024, 33, 376, 676, 0, 0, 1085, 682666
n50x8192-slot-inner, 1024, 34, 380, 680, 0, 0, 1094, 682666
n50x8192-slot-inner, 1024, 34, 381, 685, 0, 0, 1100, 682666
n50x8192-slot-inner, 1024, 34, 380, 686, 0, 0, 1100, 682666
n50x8192-slot-inner, 1024, 34, 382, 693, 0, 0, 1109, 682666
n50x8192-slot-inner, 1024, 34, 379, 680, 0, 0, 1093, 682666
n50x8192-slot-inner, 1024, 33, 377, 685, 0, 0, 1095, 682666
n50x8192-slot-inner, 1024, 35, 379, 680, 0, 0, 1094, 682666
n50x8192-slot-inner, 1024, 34, 378, 678, 0, 0, 1090, 682666
n50x8192-slot-inner, 1024, 34, 381, 691, 0, 0, 1106, 682666
n50x8192-slot-inner, 1024, 35, 377, 689, 0, 0, 1101, 682666
n50x8192-slot-inner, 1024, 34, 375, 692, 0, 0, 1101, 682666
n50x8192-slot-inner, 1024, 34, 383, 685, 0, 0, 1102, 682666
n50x8192-slot-inner, 1024, 34, 377, 682, 0, 0, 1093, 682666
n50x8192-slot-inner, 1024, 34, 382, 683, 0, 0, 1099, 682666
n50x8192-slot-inner, 1024, 34, 377, 681, 0, 0, 1092, 682666
n50x8192-slot-inner, 1024, 38, 377, 695, 0, 0, 1110, 682666
n50x8192-slot-inner, 1024, 34, 378, 681, 0, 0, 1093, 682666
n50x8192-slot-inner, 1024, 35, 379, 682, 0, 0, 1096, 682666
n50x8192-slot-inner, 1024, 34, 377, 691, 0, 0, 1102, 682666
n50x8192-slot-inner, 1024, 34, 381, 692, 0, 0, 1107, 682666
n50x8192-slot-inner, 1024, 34, 382, 690, 0, 0, 1106, 682666
n50x8192-slot-inner, 1024, 35, 381, 684, 0, 0, 1100, 682666
n50x8192-slot-inner, 1024, 33, 379, 674, 0, 0, 1086, 682666
n50x8192-slot-inner, 1024, 35, 383, 684, 0, 0, 1102, 682666
n50x8192-slot-inner, 1024, 36, 382, 692, 0, 0, 1110, 682666
n50x8192-slot-inner, 1024, 33, 375, 687, 0, 0, 1095, 682666
n50x8192-slot-inner, 1024, 34, 385, 682, 0, 0, 1101, 682666
n50x8192-coef-inner, 8192, 53, 1386, 689, 1, 0, 2129, 682666
n50x8192-coef-inner, 8192, 57, 1386, 698, 1, 0, 2142, 682666
n50x8192-coef-inner, 8192, 54, 1383, 683, 1, 0, 2121, 682666
n50x8192-coef-inner, 8192, 50, 1377, 697, 1, 0, 2125, 682666
n50x8192-coef-inner, 8192, 50, 1378, 693, 1, 0, 2122, 682666
n50x8192-coef-inner, 8192, 50, 1372, 693, 1, 0, 2116, 682666
n50x8192-coef-inner, 8192, 59, 1378, 690, 1, 0, 2128, 682666
n50x8192-coef-inner, 8192, 56, 1374, 741, 1, 0, 2172, 682666
n50x8192-coef-inner, 8192, 53, 1383, 723, 1, 0, 2160, 682666
n50x8192-coef-inner, 8192, 53, 1383, 692, 1, 0, 2129, 682666
n50x8192-coef-inner, 8192, 52, 1384, 699, 1, 0, 2136, 682666
n50x8192-coef-inner, 8192, 53, 1383, 699, 1, 0, 2136, 682666
n50x8192-coef-inner, 8192, 50, 1378, 692, 1, 0, 2121, 682666
n50x8192-coef-inner, 8192, 55, 1384, 684, 1, 0, 2124, 682666
n50x8192-coef-inner, 8192, 53, 1381, 686, 1, 0, 2121, 682666
n50x8192-coef-inner, 8192, 52, 1383, 685, 1, 0, 2121, 682666
n50x8192-coef-inner, 8192, 51, 1372, 693, 1, 0, 2117, 682666
n50x8192-coef-inner, 8192, 52, 1385, 688, 1, 0, 2126, 682666
n50x8192-coef-inner, 8192, 52, 1381, 688, 1, 0, 2122, 682666
n50x8192-coef-inner, 8192, 51, 1396, 691, 1, 0, 2139, 682666
n50x8192-coef-inner, 8192, 53, 1377, 689, 1, 0, 2120, 682666
n50x8192-coef-inner, 8192, 51, 1379, 690, 1, 0, 2121, 682666
n50x8192-coef-inner, 8192, 55, 1382, 698, 1, 0, 2136, 682666
n50x8192-coef-inner, 8192, 59, 1401, 693, 1, 0, 2154, 682666
n50x8192-coef-inner, 8192, 53, 1382, 732, 1, 0, 2168, 682666
n50x8192-coef-inner, 8192, 54, 1392, 694, 1, 0, 2141, 682666
n50x8192-coef-inner, 8192, 53, 1393, 699, 1, 0, 2146, 682666
n50x8192-coef-inner, 8192, 50, 1385, 696, 1, 0, 2132, 682666
n50x8192-coef-inner, 8192, 52, 1384, 696, 1, 0, 2133, 682666
n50x8192-coef-inner, 8192, 52, 1377, 695, 1, 0, 2125, 682666
n50x8192-coef-inner, 8192, 53, 1384, 726, 1, 0, 2164, 682666
n50x8192-coef-inner, 8192, 53, 1385, 690, 1, 0, 2129, 682666
n50x8192-coef-inner, 8192, 54, 1385, 690, 1, 0, 2130, 682666
n50x8192-coef-inner, 8192, 54, 1384, 689, 1, 0, 2128, 682666
n50x8192-coef-inner, 8192, 51, 1373, 690, 1, 0, 2115, 682666
n50x8192-coef-inner, 8192, 54, 1391, 692, 1, 0, 2138, 682666
n50x8192-coef-inner, 8192, 56, 1394, 687, 1, 0, 2138, 682666
n50x8192-coef-inner, 8192, 50, 1380, 695, 1, 0, 2126, 682666
n50x8192-coef-inner, 8192, 53, 1395, 687, 1, 0, 2136, 682666
n50x8192-coef-inner, 8192, 51, 1380, 690, 1, 0, 2122, 682666
n50x8192-coef-inner, 8192, 54, 1377, 688, 1, 0, 2120, 682666
n50x8192-coef-inner, 8192, 51, 1380, 692, 1, 0, 2124, 682666
n50x8192-coef-inner, 8192, 62, 1384, 724, 1, 0, 2171, 682666
n50x8192-coef-inner, 8192, 50, 1379, 687, 1, 0, 2117, 682666
n50x8192-coef-inner, 8192, 54, 1377, 681, 1, 0, 2113, 682666
n50x8192-coef-inner, 8192, 50, 1378, 692, 1, 0, 2121, 682666
n50x8192-coef-inner, 8192, 51, 1395, 688, 1, 0, 2135, 682666
n50x8192-coef-inner, 8192, 52, 1386, 691, 1, 0, 2130, 682666
n50x8192-coef-inner, 8192, 54, 1376, 721, 1, 0, 2152, 682666
n50x8192-coef-inner, 8192, 50, 1376, 695, 1, 0, 2122, 682666
n50x8192-coef-inner, 8192, 55, 1380, 692, 1, 0, 2128, 682666
n50x8192-coef-inner, 8192, 51, 1381, 690, 1, 0, 2123, 682666
n50x8192-coef-inner, 8192, 51, 1388, 697, 1, 0, 2137, 682666
n50x8192-coef-inner, 8192, 57, 1383, 698, 1, 0, 2139, 682666
n50x8192-coef-inner, 8192, 52, 1386, 698, 1, 0, 2137, 682666
n50x8192-coef-inner, 8192, 50, 1381, 690, 1, 0, 2122, 682666
n50x8192-coef-inner, 8192, 54, 1374, 721, 1, 0, 2150, 682666
n50x8192-coef-inner, 8192, 53, 1394, 695, 1, 0, 2143, 682666
n50x8192-coef-inner, 8192, 51, 1376, 689, 1, 0, 2117, 682666
n50x8192-coef-inner, 8192, 50, 1382, 695, 1, 0, 2128, 682666
n50x8192-coef-inner, 8192, 53, 1389, 683, 1, 0, 2126, 682666
n50x8192-coef-inner, 8192, 52, 1380, 682, 1, 0, 2115, 682666
n50x8192-coef-inner, 8192, 54, 1384, 703, 1, 0, 2142, 682666
n50x8192-coef-inner, 8192, 56, 1395, 696, 1, 0, 2148, 682666
n50x8192-coef-inner, 8192, 52, 1388, 698, 1, 0, 2139, 682666
n50x8192-coef-inner, 8192, 53, 1385, 692, 1, 0, 2131, 682666
n50x8192-coef-inner, 8192, 50, 1390, 689, 1, 0, 2130, 682666
n50x8192-coef-inner, 8192, 54, 1379, 726, 1, 0, 2160, 682666
n50x8192-coef-inner, 8192, 50, 1382, 693, 1, 0, 2126, 682666
n50x8192-coef-inner, 8192, 57, 1384, 687, 1, 0, 2129, 682666
n50x8192-coef-inner, 8192, 53, 1385, 688, 1, 0, 2127, 682666
n50x8192-coef-inner, 8192, 51, 1377, 695, 1, 0, 2124, 682666
n50x8192-coef-inner, 8192, 52, 1376, 722, 1, 0, 2151, 682666
n50x8192-coef-inner, 8192, 50, 1380, 693, 1, 0, 2124, 682666
n50x8192-coef-inner, 8192, 55, 1374, 720, 1, 0, 2150, 682666
n50x8192-coef-inner, 8192, 50, 1380, 689, 1, 0, 2120, 682666
n50x8192-coef-inner, 8192, 50, 1375, 690, 1, 0, 2116, 682666
n50x8192-coef-inner, 8192, 50, 1380, 689, 1, 0, 2120, 682666
n50x8192-coef-inner, 8192, 50, 1383, 696, 1, 0, 2130, 682666
n50x8192-coef-inner, 8192, 54, 1378, 693, 1, 0, 2126, 682666
n50x8192-coef-inner, 8192, 53, 1381, 687, 1, 0, 2122, 682666
n50x8192-coef-inner, 8192, 62, 1382, 695, 1, 0, 2140, 682666
n50x8192-coef-inner, 8192, 52, 1379, 727, 1, 0, 2159, 682666
n50x8192-coef-inner, 8192, 54, 1385, 692, 1, 0, 2132, 682666
n50x8192-coef-inner, 8192, 51, 1381, 690, 1, 0, 2123, 682666
n50x8192-coef-inner, 8192, 53, 1374, 695, 1, 0, 2123, 682666
n50x8192-coef-inner, 8192, 52, 1395, 692, 1, 0, 2140, 682666
n50x8192-coef-inner, 8192, 54, 1380, 720, 1, 0, 2155, 682666
n50x8192-coef-inner, 8192, 51, 1377, 690, 1, 0, 2119, 682666
n50x8192-coef-inner, 8192, 54, 1375, 688, 1, 0, 2118, 682666
n50x8192-coef-inner, 8192, 53, 1383, 702, 1, 0, 2139, 682666
n50x8192-coef-inner, 8192, 53, 1389, 693, 1, 0, 2136, 682666
n50x8192-coef-inner, 8192, 54, 1391, 687, 1, 0, 2133, 682666
n50x8192-coef-inner, 8192, 53, 1391, 695, 1, 0, 2140, 682666
n50x8192-coef-inner, 8192, 50, 1373, 725, 1, 0, 2149, 682666
n50x8192-coef-inner, 8192, 50, 1375, 687, 1, 0, 2113, 682666
n50x8192-coef-inner, 8192, 51, 1382, 691, 1, 0, 2125, 682666
n50x8192-coef-inner, 8192, 51, 1381, 723, 1, 0, 2156, 682666
n50x8192-coef-inner, 8192, 52, 1382, 688, 1, 0, 2123, 682666
n50x8192-coef-inner, 8192, 53, 1375, 685, 1, 0, 2114, 682666
n50x8192-coef-inner, 4096, 27, 1362, 665, 0, 0, 2054, 682666
n50x8192-coef-inner, 4096, 27, 1364, 659, 0, 0, 2050, 682666
n50x8192-coef-inner, 4096, 27, 1370, 668, 0, 0, 2065, 682666
n50x8192-coef-inner, 4096, 30, 1365, 660, 0, 0, 2055, 682666
n50x8192-coef-inner, 4096, 27, 1362, 660, 0, 0, 2049, 682666
n50x8192-coef-inner, 4096, 30, 1366, 688, 0, 0, 2084, 682666
n50x8192-coef-inner, 4096, 28, 1366, 657, 0, 0, 2051, 682666
n50x8192-coef-inner, 4096, 31, 1366, 691, 0, 0, 2088, 682666
n50x8192-coef-inner, 4096, 35, 1359, 664, 0, 0, 2058, 682666
n50x8192-coef-inner, 4096, 29, 1358, 659, 0, 0, 2046, 682666
n50x8192-coef-inner, 4096, 27, 1362, 657, 0, 0, 2046, 682666
n50x8192-coef-inner, 4096, 40, 1359, 689, 0, 0, 2088, 682666
n50x8192-coef-inner, 4096, 28, 1369, 664, 0, 0, 2061, 682666
n50x8192-coef-inner, 4096, 28, 1359, 660, 0, 0, 2047, 682666
n50x8192-coef-inner, 4096, 29, 1364, 660, 0, 0, 2053, 682666
n50x8192-coef-inner, 4096, 32, 1362, 670, 0, 0, 2064, 682666
n50x8192-coef-inner, 4096, 27, 1358, 663, 0, 0, 2048, 682666
n50x8192-coef-inner, 4096, 39, 1361, 693, 0, 0, 2093, 682666
n50x8192-coef-inner, 4096, 37, 1369, 705, 0, 0, 2111, 682666
n50x8192-coef-inner, 4096, 34, 1367, 693, 0, 0, 2094, 682666
n50x8192-coef-inner, 4096, 36, 1375, 693, 0, 0, 2104, 682666
n50x8192-coef-inner, 4096, 28, 1368, 667, 0, 0, 2063, 682666
n50x8192-coef-inner, 4096, 28, 1379, 667, 0, 0, 2074, 682666
n50x8192-coef-inner, 4096, 27, 1379, 663, 0, 0, 2069, 682666
n50x8192-coef-inner, 4096, 27, 1364, 660, 0, 0, 2051, 682666
n50x8192-coef-inner, 4096, 27, 1357, 661, 0, 0, 2045, 682666
n50x8192-coef-inner, 4096, 27, 1366, 669, 0, 0, 2062, 682666
n50x8192-coef-inner, 4096, 37, 1367, 664, 0, 0, 2068, 682666
n50x8192-coef-inner, 4096, 28, 1367, 668, 0, 0, 2063, 682666
n50x8192-coef-inner, 4096, 27, 1363, 662, 0, 0, 2052, 682666
n50x8192-coef-inner, 4096, 27, 1364, 658, 0, 0, 2049, 682666
n50x8192-coef-inner, 4096, 28, 1374, 666, 0, 0, 2068, 682666
n50x8192-coef-inner, 4096, 32, 1369, 662, 0, 0, 2063, 682666
n50x8192-coef-inner, 4096, 28, 1367, 660, 0, 0, 2055, 682666
n50x8192-coef-inner, 4096, 61, 1586, 662, 0, 0, 2309, 682666
n50x8192-coef-inner, 4096, 29, 1366, 671, 0, 0, 2066, 682666
n50x8192-coef-inner, 4096, 29, 1366, 667, 0, 0, 2062, 682666
n50x8192-coef-inner, 4096, 27, 1355, 666, 0, 0, 2048, 682666
n50x8192-coef-inner, 4096, 27, 1375, 691, 0, 0, 2093, 682666
n50x8192-coef-inner, 4096, 30, 1366, 662, 0, 0, 2058, 682666
n50x8192-coef-inner, 4096, 28, 1362, 673, 0, 0, 2063, 682666
n50x8192-coef-inner, 4096, 29, 1370, 668, 0, 0, 2067, 682666
n50x8192-coef-inner, 4096, 28, 1358, 661, 0, 0, 2047, 682666
n50x8192-coef-inner, 4096, 31, 1379, 661, 0, 0, 2071, 682666
n50x8192-coef-inner, 4096, 27, 1360, 661, 0, 0, 2048, 682666
n50x8192-coef-inner, 4096, 31, 1361, 662, 0, 0, 2054, 682666
n50x8192-coef-inner, 4096, 27, 1365, 659, 0, 0, 2051, 682666
n50x8192-coef-inner, 4096, 28, 1386, 662, 0, 0, 2076, 682666
n50x8192-coef-inner, 4096, 27, 1372, 664, 0, 0, 2063, 682666
n50x8192-coef-inner, 4096, 27, 1371, 661, 0, 0, 2059, 682666
n50x8192-coef-inner, 4096, 36, 1388, 694, 0, 0, 2118, 682666
n50x8192-coef-inner, 4096, 31, 1374, 657, 0, 0, 2062, 682666
n50x8192-coef-inner, 4096, 30, 1364, 665, 0, 0, 2059, 682666
n50x8192-coef-inner, 4096, 28, 1362, 666, 0, 0, 2056, 682666
n50x8192-coef-inner, 4096, 27, 1367, 668, 0, 0, 2062, 682666
n50x8192-coef-inner, 4096, 28, 1378, 664, 0, 0, 2070, 682666
n50x8192-coef-inner, 4096, 27, 1361, 662, 0, 0, 2050, 682666
n50x8192-coef-inner, 4096, 27, 1366, 670, 0, 0, 2063, 682666
n50x8192-coef-inner, 4096, 30, 1365, 663, 0, 0, 2058, 682666
n50x8192-coef-inner, 4096, 28, 1367, 674, 0, 0, 2069, 682666
n50x8192-coef-inner, 4096, 27, 1359, 661, 0, 0, 2047, 682666
n50x8192-coef-inner, 4096, 29, 1356, 659, 0, 0, 2044, 682666
n50x8192-coef-inner, 4096, 29, 1360, 663, 0, 0, 2052, 682666
n50x8192-coef-inner, 4096, 30, 1364, 665, 0, 0, 2059, 682666
n50x8192-coef-inner, 4096, 27, 1367, 677, 0, 0, 2071, 682666
n50x8192-coef-inner, 4096, 29, 1363, 665, 0, 0, 2057, 682666
n50x8192-coef-inner, 4096, 27, 1364, 665, 0, 0, 2056, 682666
n50x8192-coef-inner, 4096, 29, 1368, 668, 0, 0, 2065, 682666
n50x8192-coef-inner, 4096, 28, 1377, 674, 0, 0, 2079, 682666
n50x8192-coef-inner, 4096, 28, 1381, 672, 0, 0, 2081, 682666
n50x8192-coef-inner, 4096, 28, 1364, 661, 0, 0, 2053, 682666
n50x8192-coef-inner, 4096, 28, 1379, 697, 0, 0, 2104, 682666
n50x8192-coef-inner, 4096, 28, 1363, 669, 0, 0, 2060, 682666
n50x8192-coef-inner, 4096, 27, 1370, 662, 0, 0, 2059, 682666
n50x8192-coef-inner, 4096, 31, 1374, 666, 0, 0, 2071, 682666
n50x8192-coef-inner, 4096, 27, 1369, 673, 0, 0, 2069, 682666
n50x8192-coef-inner, 4096, 27, 1367, 666, 0, 0, 2060, 682666
n50x8192-coef-inner, 4096, 27, 1371, 663, 0, 0, 2061, 682666
n50x8192-coef-inner, 4096, 27, 1360, 669, 0, 0, 2056, 682666
n50x8192-coef-inner, 4096, 27, 1366, 661, 0, 0, 2054, 682666
n50x8192-coef-inner, 4096, 32, 1359, 666, 0, 0, 2057, 682666
n50x8192-coef-inner, 4096, 27, 1359, 657, 0, 0, 2043, 682666
n50x8192-coef-inner, 4096, 29, 1357, 666, 0, 0, 2052, 682666
n50x8192-coef-inner, 4096, 27, 1356, 670, 0, 0, 2053, 682666
n50x8192-coef-inner, 4096, 28, 1360, 663, 0, 0, 2051, 682666
n50x8192-coef-inner, 4096, 27, 1357, 663, 0, 0, 2047, 682666
n50x8192-coef-inner, 4096, 34, 1356, 690, 0, 0, 2080, 682666
n50x8192-coef-inner, 4096, 30, 1352, 663, 0, 0, 2045, 682666
n50x8192-coef-inner, 4096, 28, 1367, 663, 0, 0, 2058, 682666
n50x8192-coef-inner, 4096, 28, 1357, 660, 0, 0, 2045, 682666
n50x8192-coef-inner, 4096, 27, 1359, 662, 0, 0, 2048, 682666
n50x8192-coef-inner, 4096, 28, 1361, 656, 0, 0, 2045, 682666
n50x8192-coef-inner, 4096, 29, 1352, 661, 0, 0, 2042, 682666
n50x8192-coef-inner, 4096, 31, 1365, 683, 0, 0, 2079, 682666
n50x8192-coef-inner, 4096, 33, 1357, 663, 0, 0, 2053, 682666
n50x8192-coef-inner, 4096, 27, 1371, 657, 0, 0, 2055, 682666
n50x8192-coef-inner, 4096, 27, 1359, 660, 0, 0, 2046, 682666
n50x8192-coef-inner, 4096, 27, 1360, 666, 0, 0, 2053, 682666
n50x8192-coef-inner, 4096, 27, 1369, 667, 0, 0, 2063, 682666
n50x8192-coef-inner, 4096, 32, 1367, 665, 0, 0, 2064, 682666
n50x8192-coef-inner, 2048, 16, 1365, 657, 0, 0, 2038, 682666
n50x8192-coef-inner, 2048, 16, 1345, 659, 0, 0, 2020, 682666
n50x8192-coef-inner, 2048, 16, 1349, 655, 0, 0, 2020, 682666
n50x8192-coef-inner, 2048, 19, 1352, 691, 0, 0, 2062, 682666
n50x8192-coef-inner, 2048, 16, 1377, 686, 0, 0, 2079, 682666
n50x8192-coef-inner, 2048, 17, 1368, 674, 0, 0, 2059, 682666
n50x8192-coef-inner, 2048, 16, 1367, 677, 0, 0, 2060, 682666
n50x8192-coef-inner, 2048, 16, 1381, 686, 0, 0, 2083, 682666
n50x8192-coef-inner, 2048, 16, 1370, 680, 0, 0, 2066, 682666
n50x8192-coef-inner, 2048, 16, 1366, 656, 0, 0, 2038, 682666
n50x8192-coef-inner, 2048, 16, 1355, 661, 0, 0, 2032, 682666
n50x8192-coef-inner, 2048, 17, 1358, 672, 0, 0, 2047, 682666
n50x8192-coef-inner, 2048, 16, 1363, 667, 0, 0, 2046, 682666
n50x8192-coef-inner, 2048, 16, 1358, 661, 0, 0, 2035, 682666
n50x8192-coef-inner, 2048, 16, 1359, 666, 0, 0, 2041, 682666
n50x8192-coef-inner, 2048, 20, 1355, 661, 0, 0, 2036, 682666
n50x8192-coef-inner, 2048, 17, 1356, 661, 0, 0, 2034, 682666
n50x8192-coef-inner, 2048, 16, 1362, 673, 0, 0, 2051, 682666
n50x8192-coef-inner, 2048, 23, 1358, 689, 0, 0, 2070, 682666
n50x8192-coef-inner, 2048, 16, 1359, 664, 0, 0, 2039, 682666
n50x8192-coef-inner, 2048, 17, 1369, 656, 0, 0, 2042, 682666
n50x8192-coef-inner, 2048, 16, 1359, 658, 0, 0, 2033, 682666
n50x8192-coef-inner, 2048, 16, 1359, 660, 0, 0, 2035, 682666
n50x8192-coef-inner, 2048, 17, 1355, 666, 0, 0, 2038, 682666
n50x8192-coef-inner, 2048, 16, 1356, 666, 0, 0, 2038, 682666
n50x8192-coef-inner, 2048, 17, 1354, 657, 0, 0, 2028, 682666
n50x8192-coef-inner, 2048, 16, 1354, 665, 0, 0, 2035, 682666
n50x8192-coef-inner, 2048, 16, 1363, 659, 0, 0, 2038, 682666
n50x8192-coef-inner, 2048, 17, 1355, 664, 0, 0, 2036, 682666
n50x8192-coef-inner, 2048, 17, 1353, 658, 0, 0, 2028, 682666
n50x8192-coef-inner, 2048, 17, 1357, 664, 0, 0, 2038, 682666
n50x8192-coef-inner, 2048, 23, 1354, 690, 0, 0, 2067, 682666
n50x8192-coef-inner, 2048, 16, 1363, 661, 0, 0, 2040, 682666
n50x8192-coef-inner, 2048, 16, 1360, 654, 0, 0, 2030, 682666
n50x8192-coef-inner, 2048, 16, 1357, 670, 0, 0, 2043, 682666
n50x8192-coef-inner, 2048, 17, 1354, 661, 0, 0, 2032, 682666
n50x8192-coef-inner, 2048, 16, 1355, 668, 0, 0, 2039, 682666
n50x8192-coef-inner, 2048, 18, 1370, 684, 0, 0, 2072, 682666
n50x8192-coef-inner, 2048, 16, 1353, 652, 0, 0, 2021, 682666
n50x8192-coef-inner, 2048, 16, 1346, 660, 0, 0, 2022, 682666
n50x8192-coef-inner, 2048, 18, 1359, 674, 0, 0, 2051, 682666
n50x8192-coef-inner, 2048, 16, 1356, 662, 0, 0, 2034, 682666
n50x8192-coef-inner, 2048, 16, 1355, 665, 0, 0, 2036, 682666
n50x8192-coef-inner, 2048, 16, 1357, 662, 0, 0, 2035, 682666
n50x8192-coef-inner, 2048, 16, 1356, 660, 0, 0, 2032, 682666
n50x8192-coef-inner, 2048, 16, 1352, 656, 0, 0, 2024, 682666
n50x8192-coef-inner, 2048, 26, 1357, 696, 0, 0, 2079, 682666
n50x8192-coef-inner, 2048, 17, 1359, 658, 0, 0, 2034, 682666
n50x8192-coef-inner, 2048, 16, 1357, 677, 0, 0, 2050, 682666
n50x8192-coef-inner, 2048, 17, 1367, 659, 0, 0, 2043, 682666
n50x8192-coef-inner, 2048, 16, 1360, 666, 0, 0, 2042, 682666
n50x8192-coef-inner, 2048, 17, 1359, 666, 0, 0, 2042, 682666
n50x8192-coef-inner, 2048, 16, 1360, 667, 0, 0, 2043, 682666
n50x8192-coef-inner, 2048, 16, 1357, 658, 0, 0, 2031, 682666
n50x8192-coef-inner, 2048, 17, 1356, 659, 0, 0, 2032, 682666
n50x8192-coef-inner, 2048, 17, 1355, 691, 0, 0, 2063, 682666
n50x8192-coef-inner, 2048, 16, 1366, 665, 0, 0, 2047, 682666
n50x8192-coef-inner, 2048, 16, 1364, 671, 0, 0, 2051, 682666
n50x8192-coef-inner, 2048, 16, 1365, 665, 0, 0, 2046, 682666
n50x8192-coef-inner, 2048, 17, 1354, 666, 0, 0, 2037, 682666
n50x8192-coef-inner, 2048, 17, 1362, 672, 0, 0, 2051, 682666
n50x8192-coef-inner, 2048, 17, 1364, 675, 0, 0, 2056, 682666
n50x8192-coef-inner, 2048, 16, 1366, 669, 0, 0, 2051, 682666
n50x8192-coef-inner, 2048, 16, 1366, 669, 0, 0, 2051, 682666
n50x8192-coef-inner, 2048, 16, 1355, 668, 0, 0, 2039, 682666
n50x8192-coef-inner, 2048, 17, 1376, 689, 0, 0, 2082, 682666
n50x8192-coef-inner, 2048, 17, 1366, 659, 0, 0, 2042, 682666
n50x8192-coef-inner, 2048, 16, 1367, 691, 0, 0, 2074, 682666
n50x8192-coef-inner, 2048, 16, 1366, 672, 0, 0, 2054, 682666
n50x8192-coef-inner, 2048, 16, 1365, 660, 0, 0, 2041, 682666
n50x8192-coef-inner, 2048, 16, 1355, 658, 0, 0, 2029, 682666
n50x8192-coef-inner, 2048, 16, 1359, 658, 0, 0, 2033, 682666
n50x8192-coef-inner, 2048, 23, 1357, 692, 0, 0, 2072, 682666
n50x8192-coef-inner, 2048, 17, 1366, 664, 0, 0, 2047, 682666
n50x8192-coef-inner, 2048, 17, 1375, 667, 0, 0, 2059, 682666
n50x8192-coef-inner, 2048, 17, 1361, 670, 0, 0, 2048, 682666
n50x8192-coef-inner, 2048, 16, 1362, 666, 0, 0, 2044, 682666
n50x8192-coef-inner, 2048, 16, 1359, 665, 0, 0, 2040, 682666
n50x8192-coef-inner, 2048, 16, 1355, 662, 0, 0, 2033, 682666
n50x8192-coef-inner, 2048, 16, 1365, 676, 0, 0, 2057, 682666
n50x8192-coef-inner, 2048, 17, 1370, 665, 0, 0, 2052, 682666
n50x8192-coef-inner, 2048, 16, 1367, 669, 0, 0, 2052, 682666
n50x8192-coef-inner, 2048, 17, 1372, 674, 0, 0, 2063, 682666
n50x8192-coef-inner, 2048, 17, 1360, 668, 0, 0, 2045, 682666
n50x8192-coef-inner, 2048, 17, 1371, 672, 0, 0, 2060, 682666
n50x8192-coef-inner, 2048, 16, 1363, 670, 0, 0, 2049, 682666
n50x8192-coef-inner, 2048, 20, 1378, 677, 0, 0, 2075, 682666
n50x8192-coef-inner, 2048, 16, 1361, 668, 0, 0, 2045, 682666
n50x8192-coef-inner, 2048, 16, 1365, 662, 0, 0, 2043, 682666
n50x8192-coef-inner, 2048, 24, 1356, 697, 0, 0, 2077, 682666
n50x8192-coef-inner, 2048, 16, 1366, 674, 0, 0, 2056, 682666
n50x8192-coef-inner, 2048, 17, 1368, 666, 0, 0, 2051, 682666
n50x8192-coef-inner, 2048, 17, 1366, 670, 0, 0, 2053, 682666
n50x8192-coef-inner, 2048, 17, 1358, 671, 0, 0, 2046, 682666
n50x8192-coef-inner, 2048, 16, 1367, 690, 0, 0, 2073, 682666
n50x8192-coef-inner, 2048, 16, 1362, 669, 0, 0, 2047, 682666
n50x8192-coef-inner, 2048, 16, 1380, 676, 0, 0, 2072, 682666
n50x8192-coef-inner, 2048, 16, 1386, 678, 0, 0, 2080, 682666
n50x8192-coef-inner, 2048, 17, 1370, 664, 0, 0, 2051, 682666
n50x8192-coef-inner, 2048, 16, 1358, 662, 0, 0, 2036, 682666
n50x8192-coef-inner, 1024, 13, 1370, 683, 0, 0, 2066, 682666
n50x8192-coef-inner, 1024, 13, 1369, 684, 0, 0, 2066, 682666
n50x8192-coef-inner, 1024, 11, 1364, 683, 0, 0, 2058, 682666
n50x8192-coef-inner, 1024, 12, 1365, 686, 0, 0, 2063, 682666
n50x8192-coef-inner, 1024, 12, 1363, 682, 0, 0, 2057, 682666
n50x8192-coef-inner, 1024, 13, 1373, 693, 0, 0, 2079, 682666
n50x8192-coef-inner, 1024, 12, 1378, 688, 0, 0, 2078, 682666
n50x8192-coef-inner, 1024, 12, 1366, 687, 0, 0, 2065, 682666
n50x8192-coef-inner, 1024, 12, 1411, 706, 0, 0, 2129, 682666
n50x8192-coef-inner, 1024, 12, 1389, 690, 0, 0, 2091, 682666
n50x8192-coef-inner, 1024, 12, 1377, 679, 0, 0, 2068, 682666
n50x8192-coef-inner, 1024, 12, 1362, 682, 0, 0, 2056, 682666
n50x8192-coef-inner, 1024, 12, 1372, 689, 0, 0, 2073, 682666
n50x8192-coef-inner, 1024, 12, 1371, 693, 0, 0, 2076, 682666
n50x8192-coef-inner, 1024, 13, 1361, 687, 0, 0, 2061, 682666
n50x8192-coef-inner, 1024, 14, 1376, 685, 0, 0, 2075, 682666
n50x8192-coef-inner, 1024, 13, 1366, 686, 0, 0, 2065, 682666
n50x8192-coef-inner, 1024, 12, 1381, 691, 0, 0, 2084, 682666
n50x8192-coef-inner, 1024, 13, 1379, 698, 0, 0, 2090, 682666
n50x8192-coef-inner, 1024, 12, 1384, 708, 0, 0, 2104, 682666
n50x8192-coef-inner, 1024, 12, 1383, 701, 0, 0, 2096, 682666
n50x8192-coef-inner, 1024, 11, 1383, 701, 0, 0, 2095, 682666
n50x8192-coef-inner, 1024, 12, 1397, 691, 0, 0, 2100, 682666
n50x8192-coef-inner, 1024, 12, 1387, 713, 0, 0, 2112, 682666
n50x8192-coef-inner, 1024, 12, 1363, 688, 0, 0, 2063, 682666
n50x8192-coef-inner, 1024, 12, 1375, 683, 0, 0, 2070, 682666
n50x8192-coef-inner, 1024, 12, 1383, 684, 0, 0, 2079, 682666
n50x8192-coef-inner, 1024, 12, 1375, 698, 0, 0, 2085, 682666
n50x8192-coef-inner, 1024, 13, 1381, 699, 0, 0, 2093, 682666
n50x8192-coef-inner, 1024, 12, 1378, 689, 0, 0, 2079, 682666
n50x8192-coef-inner, 1024, 12, 1373, 688, 0, 0, 2073, 682666
n50x8192-coef-inner, 1024, 12, 1381, 694, 0, 0, 2087, 682666
n50x8192-coef-inner, 1024, 12, 1377, 690, 0, 0, 2079, 682666
n50x8192-coef-inner, 1024, 12, 1387, 701, 0, 0, 2100, 682666
n50x8192-coef-inner, 1024, 13, 1395, 701, 0, 0, 2109, 682666
n50x8192-coef-inner, 1024, 11, 1368, 697, 0, 0, 2076, 682666
n50x8192-coef-inner, 1024, 12, 1388, 693, 0, 0, 2093, 682666
n50x8192-coef-inner, 1024, 12, 1374, 693, 0, 0, 2079, 682666
n50x8192-coef-inner, 1024, 12, 1372, 694, 0, 0, 2078, 682666
n50x8192-coef-inner, 1024, 12, 1385, 694, 0, 0, 2091, 682666
n50x8192-coef-inner, 1024, 12, 1360, 683, 0, 0, 2055, 682666
n50x8192-coef-inner, 1024, 12, 1372, 688, 0, 0, 2072, 682666
n50x8192-coef-inner, 1024, 11, 1367, 690, 0, 0, 2068, 682666
n50x8192-coef-inner, 1024, 12, 1386, 699, 0, 0, 2097, 682666
n50x8192-coef-inner, 1024, 12, 1379, 687, 0, 0, 2078, 682666
n50x8192-coef-inner, 1024, 12, 1373, 696, 0, 0, 2081, 682666
n50x8192-coef-inner, 1024, 12, 1377, 685, 0, 0, 2074, 682666
n50x8192-coef-inner, 1024, 12, 1400, 698, 0, 0, 2110, 682666
n50x8192-coef-inner, 1024, 12, 1377, 701, 0, 0, 2090, 682666
n50x8192-coef-inner, 1024, 12, 1385, 698, 0, 0, 2095, 682666
n50x8192-coef-inner, 1024, 12, 1388, 701, 0, 0, 2101, 682666
n50x8192-coef-inner, 1024, 13, 1396, 700, 0, 0, 2109, 682666
n50x8192-coef-inner, 1024, 11, 1373, 695, 0, 0, 2079, 682666
n50x8192-coef-inner, 1024, 12, 1378, 708, 0, 0, 2098, 682666
n50x8192-coef-inner, 1024, 12, 1385, 708, 0, 0, 2105, 682666
n50x8192-coef-inner, 1024, 12, 1390, 708, 0, 0, 2110, 682666
n50x8192-coef-inner, 1024, 12, 1383, 698, 0, 0, 2093, 682666
n50x8192-coef-inner, 1024, 12, 1386, 693, 0, 0, 2091, 682666
n50x8192-coef-inner, 1024, 12, 1370, 689, 0, 0, 2071, 682666
n50x8192-coef-inner, 1024, 12, 1383, 693, 0, 0, 2088, 682666
n50x8192-coef-inner, 1024, 12, 1384, 698, 0, 0, 2094, 682666
n50x8192-coef-inner, 1024, 12, 1376, 697, 0, 0, 2085, 682666
n50x8192-coef-inner, 1024, 12, 1376, 699, 0, 0, 2087, 682666
n50x8192-coef-inner, 1024, 12, 1371, 695, 0, 0, 2078, 682666
n50x8192-coef-inner, 1024, 12, 1384, 709, 0, 0, 2105, 682666
n50x8192-coef-inner, 1024, 13, 1380, 694, 0, 0, 2087, 682666
n50x8192-coef-inner, 1024, 12, 1388, 697, 0, 0, 2097, 682666
n50x8192-coef-inner, 1024, 12, 1385, 704, 0, 0, 2101, 682666
n50x8192-coef-inner, 1024, 11, 1387, 695, 0, 0, 2093, 682666
n50x8192-coef-inner, 1024, 13, 1379, 702, 0, 0, 2094, 682666
n50x8192-coef-inner, 1024, 12, 1384, 717, 0, 0, 2113, 682666
n50x8192-coef-inner, 1024, 12, 1382, 693, 0, 0, 2087, 682666
n50x8192-coef-inner, 1024, 12, 1373, 685, 0, 0, 2070, 682666
n50x8192-coef-inner, 1024, 12, 1382, 697, 0, 0, 2091, 682666
n50x8192-coef-inner, 1024, 12, 1390, 714, 0, 0, 2116, 682666
n50x8192-coef-inner, 1024, 11, 1415, 728, 0, 0, 2154, 682666
n50x8192-coef-inner, 1024, 12, 1392, 721, 0, 0, 2125, 682666
n50x8192-coef-inner, 1024, 14, 1389, 708, 0, 0, 2111, 682666
n50x8192-coef-inner, 1024, 13, 1397, 729, 0, 0, 2139, 682666
n50x8192-coef-inner, 1024, 12, 1400, 707, 0, 0, 2119, 682666
n50x8192-coef-inner, 1024, 13, 1394, 704, 0, 0, 2111, 682666
n50x8192-coef-inner, 1024, 12, 1379, 708, 0, 0, 2099, 682666
n50x8192-coef-inner, 1024, 12, 1375, 697, 0, 0, 2084, 682666
n50x8192-coef-inner, 1024, 12, 1384, 691, 0, 0, 2087, 682666
n50x8192-coef-inner, 1024, 12, 1375, 697, 0, 0, 2084, 682666
n50x8192-coef-inner, 1024, 12, 1384, 713, 0, 0, 2109, 682666
n50x8192-coef-inner, 1024, 12, 1377, 700, 0, 0, 2089, 682666
n50x8192-coef-inner, 1024, 12, 1382, 711, 0, 0, 2105, 682666
n50x8192-coef-inner, 1024, 12, 1387, 702, 0, 0, 2101, 682666
n50x8192-coef-inner, 1024, 12, 1386, 695, 0, 0, 2093, 682666
n50x8192-coef-inner, 1024, 13, 1377, 693, 0, 0, 2083, 682666
n50x8192-coef-inner, 1024, 18, 1362, 710, 0, 0, 2090, 682666
n50x8192-coef-inner, 1024, 12, 1386, 715, 0, 0, 2113, 682666
n50x8192-coef-inner, 1024, 12, 1380, 689, 0, 0, 2081, 682666
n50x8192-coef-inner, 1024, 13, 1369, 710, 0, 0, 2092, 682666
n50x8192-coef-inner, 1024, 12, 1375, 691, 0, 0, 2078, 682666
n50x8192-coef-inner, 1024, 15, 1371, 709, 0, 0, 2095, 682666
n50x8192-coef-inner, 1024, 13, 1376, 714, 0, 0, 2103, 682666
n50x8192-coef-inner, 1024, 12, 1372, 696, 0, 0, 2080, 682666
n50x8192-coef-inner, 1024, 12, 1387, 694, 0, 0, 2093, 682666
n100x8192-coef-sum, 8192, 59, 1404, 41, 1, 0, 1505, 1
n100x8192-coef-sum, 8192, 61, 1400, 39, 1, 0, 1501, 1
n100x8192-coef-sum, 8192, 61, 1396, 39, 1, 0, 1497, 1
n100x8192-coef-sum, 8192, 61, 1391, 40, 1, 0, 1493, 1
n100x8192-coef-sum, 8192, 60, 1414, 44, 1, 0, 1519, 1
n100x8192-coef-sum, 8192, 60, 1417, 41, 1, 0, 1519, 1
n100x8192-coef-sum, 8192, 59, 1410, 41, 1, 0, 1511, 1
n100x8192-coef-sum, 8192, 58, 1400, 40, 1, 0, 1499, 1
n100x8192-coef-sum, 8192, 59, 1389, 42, 1, 0, 1491, 1
n100x8192-coef-sum, 8192, 61, 1393, 39, 1, 0, 1494, 1
n100x8192-coef-sum, 8192, 57, 1395, 40, 1, 0, 1493, 1
n100x8192-coef-sum, 8192, 59, 1394, 41, 1, 0, 1495, 1
n100x8192-coef-sum, 8192, 60, 1386, 39, 1, 0, 1486, 1
n100x8192-coef-sum, 8192, 70, 1394, 39, 1, 0, 1504, 1
n100x8192-coef-sum, 8192, 56, 1388, 42, 1, 0, 1487, 1
n100x8192-coef-sum, 8192, 56, 1390, 39, 1, 0, 1486, 1
n100x8192-coef-sum, 8192, 59, 1406, 40, 1, 0, 1506, 1
n100x8192-coef-sum, 8192, 61, 1418, 41, 1, 0, 1521, 1
n100x8192-coef-sum, 8192, 60, 1423, 40, 1, 0, 1524, 1
n100x8192-coef-sum, 8192, 61, 1431, 41, 1, 0, 1534, 1
n100x8192-coef-sum, 8192, 60, 1394, 41, 1, 0, 1496, 1
n100x8192-coef-sum, 8192, 66, 1399, 40, 1, 0, 1506, 1
n100x8192-coef-sum, 8192, 59, 1407, 44, 1, 0, 1511, 1
n100x8192-coef-sum, 8192, 57, 1395, 39, 1, 0, 1492, 1
n100x8192-coef-sum, 8192, 56, 1399, 39, 1, 0, 1495, 1
n100x8192-coef-sum, 8192, 61, 1408, 40, 1, 0, 1510, 1
n100x8192-coef-sum, 8192, 61, 1406, 39, 1, 0, 1507, 1
n100x8192-coef-sum, 8192, 59, 1401, 40, 1, 0, 1501, 1
n100x8192-coef-sum, 8192, 60, 1395, 39, 1, 0, 1495, 1
n100x8192-coef-sum, 8192, 59, 1386, 40, 1, 0, 1486, 1
n100x8192-coef-sum, 8192, 61, 1397, 40, 1, 0, 1499, 1
n100x8192-coef-sum, 8192, 62, 1397, 40, 1, 0, 1500, 1
n100x8192-coef-sum, 8192, 58, 1403, 39, 1, 0, 1501, 1
n100x8192-coef-sum, 8192, 60, 1386, 40, 1, 0, 1487, 1
n100x8192-coef-sum, 8192, 65, 1402, 41, 1, 0, 1509, 1
n100x8192-coef-sum, 8192, 60, 1391, 40, 1, 0, 1492, 1
n100x8192-coef-sum, 8192, 58, 1392, 39, 1, 0, 1490, 1
n100x8192-coef-sum, 8192, 57, 1392, 40, 1, 0, 1490, 1
n100x8192-coef-sum, 8192, 57, 1393, 40, 1, 0, 1491, 1
n100x8192-coef-sum, 8192, 60, 1382, 39, 1, 0, 1482, 1
n100x8192-coef-sum, 8192, 61, 1395, 41, 1, 0, 1498, 1
n100x8192-coef-sum, 8192, 58, 1389, 39, 1, 0, 1487, 1
n100x8192-coef-sum, 8192, 60, 1398, 41, 1, 0, 1500, 1
n100x8192-coef-sum, 8192, 58, 1394, 41, 1, 0, 1494, 1
n100x8192-coef-sum, 8192, 60, 1401, 40, 1, 0, 1502, 1
n100x8192-coef-sum, 8192, 58, 1392, 40, 1, 0, 1491, 1
n100x8192-coef-sum, 8192, 57, 1387, 39, 1, 0, 1484, 1
n100x8192-coef-sum, 8192, 64, 1393, 39, 1, 0, 1497, 1
n100x8192-coef-sum, 8192, 57, 1400, 40, 1, 0, 1498, 1
n100x8192-coef-sum, 8192, 57, 1388, 39, 1, 0, 1485, 1
n100x8192-coef-sum, 8192, 57, 1394, 40, 1, 0, 1492, 1
n100x8192-coef-sum, 8192, 56, 1395, 40, 1, 0, 1492, 1
n100x8192-coef-sum, 8192, 58, 1401, 40, 1, 0, 1500, 1
n100x8192-coef-sum, 8192, 56, 1388, 39, 1, 0, 1484, 1
n100x8192-coef-sum, 8192, 57, 1389, 40, 1, 0, 1487, 1
n100x8192-coef-sum, 8192, 57, 1387, 39, 1, 0, 1484, 1
n100x8192-coef-sum, 8192, 59, 1384, 41, 1, 0, 1485, 1
n100x8192-coef-sum, 8192, 61, 1388, 40, 1, 0, 1490, 1
n100x8192-coef-sum, 8192, 56, 1384, 38, 1, 0, 1479, 1
n100x8192-coef-sum, 8192, 59, 1381, 40, 1, 0, 1481, 1
n100x8192-coef-sum, 8192, 61, 1384, 38, 1, 0, 1484, 1
n100x8192-coef-sum, 8192, 58, 1389, 40, 1, 0, 1488, 1
n100x8192-coef-sum, 8192, 58, 1385, 40, 1, 0, 1484, 1
n100x8192-coef-sum, 8192, 58, 1389, 40, 1, 0, 1488, 1
n100x8192-coef-sum, 8192, 57, 1386, 39, 1, 0, 1483, 1
n100x8192-coef-sum, 8192, 59, 1395, 39, 1, 0, 1494, 1
n100x8192-coef-sum, 8192, 59, 1387, 39, 1, 0, 1486, 1
n100x8192-coef-sum, 8192, 59, 1387, 41, 1, 0, 1488, 1
n100x8192-coef-sum, 8192, 57, 1388, 40, 1, 0, 1486, 1
n100x8192-coef-sum, 8192, 60, 1384, 40, 1, 0, 1485, 1
n100x8192-coef-sum, 8192, 60, 1386, 40, 1, 0, 1487, 1
n100x8192-coef-sum, 8192, 67, 1392, 41, 1, 0, 1501, 1
n100x8192-coef-sum, 8192, 60, 1389, 39, 1, 0, 1489, 1
n100x8192-coef-sum, 8192, 58, 1386, 39, 1, 0, 1484, 1
n100x8192-coef-sum, 8192, 59, 1380, 38, 1, 0, 1478, 1
n100x8192-coef-sum, 8192, 57, 1380, 38, 1, 0, 1476, 1
n100x8192-coef-sum, 8192, 61, 1390, 40, 1, 0, 1492, 1
n100x8192-coef-sum, 8192, 58, 1384, 38, 1, 0, 1481, 1
n100x8192-coef-sum, 8192, 60, 1375, 38, 1, 0, 1474, 1
n100x8192-coef-sum, 8192, 57, 1384, 39, 1, 0, 1481, 1
n100x8192-coef-sum, 8192, 61, 1403, 40, 1, 0, 1505, 1
n100x8192-coef-sum, 8192, 58, 1393, 39, 1, 0, 1491, 1
n100x8192-coef-sum, 8192, 60, 1397, 39, 1, 0, 1497, 1
n100x8192-coef-sum, 8192, 62, 1406, 39, 1, 0, 1508, 1
n100x8192-coef-sum, 8192, 67, 1383, 39, 1, 0, 1490, 1
n100x8192-coef-sum, 8192, 57, 1401, 40, 1, 0, 1499, 1
n100x8192-coef-sum, 8192, 59, 1394, 40, 1, 0, 1494, 1
n100x8192-coef-sum, 8192, 59, 1400, 40, 1, 0, 1500, 1
n100x8192-coef-sum, 8192, 63, 1396, 42, 1, 0, 1502, 1
n100x8192-coef-sum, 8192, 62, 1391, 39, 1, 0, 1493, 1
n100x8192-coef-sum, 8192, 58, 1389, 40, 1, 0, 1488, 1
n100x8192-coef-sum, 8192, 61, 1394, 40, 1, 0, 1496, 1
n100x8192-coef-sum, 8192, 60, 1396, 40, 1, 0, 1497, 1
n100x8192-coef-sum, 8192, 60, 1386, 39, 1, 0, 1486, 1
n100x8192-coef-sum, 8192, 57, 1385, 40, 1, 0, 1483, 1
n100x8192-coef-sum, 8192, 59, 1383, 39, 1, 0, 1482, 1
n100x8192-coef-sum, 8192, 60, 1382, 39, 1, 0, 1482, 1
n100x8192-coef-sum, 8192, 56, 1383, 41, 1, 0, 1481, 1
n100x8192-coef-sum, 8192, 57, 1382, 40, 1, 0, 1480, 1
n100x8192-coef-sum, 8192, 56, 1382, 38, 1, 0, 1477, 1
n100x8192-coef-sum, 4096, 32, 1375, 41, 0, 0, 1448, 1
n100x8192-coef-sum, 4096, 35, 1374, 42, 0, 0, 1451, 1
n100x8192-coef-sum, 4096, 42, 1373, 41, 0, 0, 1456, 1
n100x8192-coef-sum, 4096, 32, 1368, 41, 0, 0, 1441, 1
n100x8192-coef-sum, 4096, 33, 1377, 41, 0, 0, 1451, 1
n100x8192-coef-sum, 4096, 30, 1360, 40, 0, 0, 1430, 1
n100x8192-coef-sum, 4096, 31, 1367, 40, 0, 0, 1438, 1
n100x8192-coef-sum, 4096, 31, 1381, 40, 0, 0, 1452, 1
n100x8192-coef-sum, 4096, 32, 1370, 40, 0, 0, 1442, 1
n100x8192-coef-sum, 4096, 33, 1366, 40, 0, 0, 1439, 1
n100x8192-coef-sum, 4096, 32, 1364, 40, 0, 0, 1436, 1
n100x8192-coef-sum, 4096, 34, 1378, 43, 0, 0, 1455, 1
n100x8192-coef-sum, 4096, 33, 1360, 40, 0, 0, 1433, 1
n100x8192-coef-sum, 4096, 31, 1362, 40, 0, 0, 1433, 1
n100x8192-coef-sum, 4096, 30, 1372, 40, 0, 0, 1442, 1
n100x8192-coef-sum, 4096, 33, 1381, 41, 0, 0, 1455, 1
n100x8192-coef-sum, 4096, 32, 1371, 41, 0, 0, 1444, 1
n100x8192-coef-sum, 4096, 30, 1355, 40, 0, 0, 1425, 1
n100x8192-coef-sum, 4096, 32, 1378, 42, 0, 0, 1452, 1
n100x8192-coef-sum, 4096, 30, 1375, 41, 0, 0, 1446, 1
n100x8192-coef-sum, 4096, 31, 1406, 42, 0, 0, 1479, 1
n100x8192-coef-sum, 4096, 31, 1381, 40, 0, 0, 1452, 1
n100x8192-coef-sum, 4096, 31, 1380, 42, 0, 0, 1453, 1
n100x8192-coef-sum, 4096, 33, 1373, 40, 0, 0, 1446, 1
n100x8192-coef-sum, 4096, 34, 1366, 41, 0, 0, 1441, 1
n100x8192-coef-sum, 4096, 33, 1374, 41, 0, 0, 1448, 1
n100x8192-coef-sum, 4096, 32, 1388, 42, 0, 0, 1462, 1
n100x8192-coef-sum, 4096, 32, 1369, 41, 0, 0, 1442, 1
n100x8192-coef-sum, 4096, 32, 1368, 40, 0, 0, 1440, 1
n100x8192-coef-sum, 4096, 34, 1365, 41, 0, 0, 1440, 1
n100x8192-coef-sum, 4096, 30, 1366, 40, 0, 0, 1436, 1
n100x8192-coef-sum, 4096, 31, 1375, 42, 0, 0, 1448, 1
n100x8192-coef-sum, 4096, 32, 1359, 40, 0, 0, 1431, 1
n100x8192-coef-sum, 4096, 31, 1363, 41, 0, 0, 1435, 1
n100x8192-coef-sum, 4096, 30, 1367, 41, 0, 0, 1438, 1
n100x8192-coef-sum, 4096, 37, 1374, 41, 0, 0, 1452, 1
n100x8192-coef-sum, 4096, 31, 1368, 42, 0, 0, 1441, 1
n100x8192-coef-sum, 4096, 32, 1383, 41, 0, 0, 1456, 1
n100x8192-coef-sum, 4096, 30, 1368, 41, 0, 0, 1439, 1
n100x8192-coef-sum, 4096, 37, 1377, 42, 0, 0, 1456, 1
n100x8192-coef-sum, 4096, 31, 1369, 42, 0, 0, 1442, 1
n100x8192-coef-sum, 4096, 32, 1373, 41, 0, 0, 1446, 1
n100x8192-coef-sum, 4096, 33, 1370, 41, 0, 0, 1444, 1
n100x8192-coef-sum, 4096, 30, 1365, 42, 0, 0, 1437, 1
n100x8192-coef-sum, 4096, 34, 1362, 40, 0, 0, 1436, 1
n100x8192-coef-sum, 4096, 32, 1370, 42, 0, 0, 1444, 1
n100x8192-coef-sum, 4096, 30, 1369, 41, 0, 0, 1440, 1
n100x8192-coef-sum, 4096, 36, 1361, 40, 0, 0, 1437, 1
n100x8192-coef-sum, 4096, 30, 1365, 40, 0, 0, 1435, 1
n100x8192-coef-sum, 4096, 30, 1359, 40, 0, 0, 1429, 1
n100x8192-coef-sum, 4096, 31, 1367, 43, 0, 0, 1441, 1
n100x8192-coef-sum, 4096, 36, 1364, 41, 0, 0, 1441, 1
n100x8192-coef-sum, 4096, 33, 1364, 41, 0, 0, 1438, 1
n100x8192-coef-sum, 4096, 34, 1377, 41, 0, 0, 1452, 1
n100x8192-coef-sum, 4096, 32, 1366, 40, 0, 0, 1438, 1
n100x8192-coef-sum, 4096, 35, 1367, 42, 0, 0, 1444, 1
n100x8192-coef-sum, 4096, 32, 1355, 40, 0, 0, 1427, 1
n100x8192-coef-sum, 4096, 30, 1354, 40, 0, 0, 1424, 1
n100x8192-coef-sum, 4096, 32, 1365, 41, 0, 0, 1438, 1
n100x8192-coef-sum, 4096, 32, 1365, 42, 0, 0, 1439, 1
n100x8192-coef-sum, 4096, 35, 1397, 42, 0, 0, 1474, 1
n100x8192-coef-sum, 4096, 31, 1376, 40, 0, 0, 1447, 1
n100x8192-coef-sum, 4096, 35, 1377, 42, 0, 0, 1454, 1
n100x8192-coef-sum, 4096, 30, 1364, 40, 0, 0, 1434, 1
n100x8192-coef-sum, 4096, 31, 1356, 42, 0, 0, 1429, 1
n100x8192-coef-sum, 4096, 30, 1364, 40, 0, 0, 1434, 1
n100x8192-coef-sum, 4096, 31, 1385, 42, 0, 0, 1458, 1
n100x8192-coef-sum, 4096, 31, 1366, 41, 0, 0, 1438, 1
n100x8192-coef-sum, 4096, 31, 1367, 40, 0, 0, 1438, 1
n100x8192-coef-sum, 4096, 31, 1371, 41, 0, 0, 1443, 1
n100x8192-coef-sum, 4096, 31, 1366, 40, 0, 0, 1437, 1
n100x8192-coef-sum, 4096, 30, 1361, 40, 0, 0, 1431, 1
n100x8192-coef-sum, 4096, 35, 1361, 41, 0, 0, 1437, 1
n100x8192-coef-sum, 4096, 32, 1359, 40, 0, 0, 1431, 1
n100x8192-coef-sum, 4096, 30, 1368, 41, 0, 0, 1439, 1
n100x8192-coef-sum, 4096, 31, 1361, 41, 0, 0, 1433, 1
n100x8192-coef-sum, 4096, 30, 1360, 40, 0, 0, 1430, 1
n100x8192-coef-sum, 4096, 31, 1366, 42, 0, 0, 1439, 1
n100x8192-coef-sum, 4096, 30, 1362, 41, 0, 0, 1433, 1
n100x8192-coef-sum, 4096, 33, 1366, 42, 0, 0, 1441, 1
n100x8192-coef-sum, 4096, 34, 1371, 42, 0, 0, 1447, 1
n100x8192-coef-sum, 4096, 34, 1372, 41, 0, 0, 1447, 1
n100x8192-coef-sum, 4096, 31, 1371, 41, 0, 0, 1443, 1
n100x8192-coef-sum, 4096, 33, 1371, 40, 0, 0, 1444, 1
n100x8192-coef-sum, 4096, 30, 1364, 40, 0, 0, 1434, 1
n100x8192-coef-sum, 4096, 31, 1370, 41, 0, 0, 1442, 1
n100x8192-coef-sum, 4096, 30, 1368, 41, 0, 0, 1439, 1
n100x8192-coef-sum, 4096, 31, 1367, 41, 0, 0, 1439, 1
n100x8192-coef-sum, 4096, 32, 1381, 41, 0, 0, 1454, 1
n100x8192-coef-sum, 4096, 31, 1375, 40, 0, 0, 1446, 1
n100x8192-coef-sum, 4096, 33, 1378, 42, 0, 0, 1453, 1
n100x8192-coef-sum, 4096, 34, 1378, 43, 0, 0, 1455, 1
n100x8192-coef-sum, 4096, 31, 1377, 41, 0, 0, 1449, 1
n100x8192-coef-sum, 4096, 31, 1376, 41, 0, 0, 1448, 1
n100x8192-coef-sum, 4096, 31, 1370, 40, 0, 0, 1441, 1
n100x8192-coef-sum, 4096, 32, 1370, 40, 0, 0, 1442, 1
n100x8192-coef-sum, 4096, 31, 1375, 41, 0, 0, 1447, 1
n100x8192-coef-sum, 4096, 34, 1361, 41, 0, 0, 1436, 1
n100x8192-coef-sum, 4096, 30, 1361, 40, 0, 0, 1431, 1
n100x8192-coef-sum, 4096, 36, 1371, 41, 0, 0, 1448, 1
n100x8192-coef-sum, 2048, 19, 1349, 40, 0, 0, 1408, 1
n100x8192-coef-sum, 2048, 18, 1354, 41, 0, 0, 1413, 1
n100x8192-coef-sum, 2048, 18, 1350, 41, 0, 0, 1409, 1
n100x8192-coef-sum, 2048, 18, 1355, 41, 0, 0, 1414, 1
n100x8192-coef-sum, 2048, 18, 1353, 41, 0, 0, 1412, 1
n100x8192-coef-sum, 2048, 18, 1343, 40, 0, 0, 1401, 1
n100x8192-coef-sum, 2048, 17, 1359, 41, 0, 0, 1417, 1
n100x8192-coef-sum, 2048, 18, 1351, 41, 0, 0, 1410, 1
n100x8192-coef-sum, 2048, 18, 1350, 40, 0, 0, 1408, 1
n100x8192-coef-sum, 2048, 18, 1350, 41, 0, 0, 1409, 1
n100x8192-coef-sum, 2048, 18, 1346, 41, 0, 0, 1405, 1
n100x8192-coef-sum, 2048, 18, 1348, 40, 0, 0, 1406, 1
n100x8192-coef-sum, 2048, 18, 1353, 40, 0, 0, 1411, 1
n100x8192-coef-sum, 2048, 18, 1360, 40, 0, 0, 1418, 1
n100x8192-coef-sum, 2048, 18, 1370, 41, 0, 0, 1429, 1
n100x8192-coef-sum, 2048, 18, 1353, 42, 0, 0, 1413, 1
n100x8192-coef-sum, 2048, 18, 1360, 41, 0, 0, 1419, 1
n100x8192-coef-sum, 2048, 18, 1366, 43, 0, 0, 1427, 1
n100x8192-coef-sum, 2048, 18, 1359, 41, 0, 0, 1418, 1
n100x8192-coef-sum, 2048, 18, 1343, 40, 0, 0, 1401, 1
n100x8192-coef-sum, 2048, 18, 1346, 42, 0, 0, 1406, 1
n100x8192-coef-sum, 2048, 18, 1353, 41, 0, 0, 1412, 1
n100x8192-coef-sum, 2048, 18, 1359, 42, 0, 0, 1419, 1
n100x8192-coef-sum, 2048, 19, 1356, 41, 0, 0, 1416, 1
n100x8192-coef-sum, 2048, 23, 1353, 41, 0, 0, 1417, 1
n100x8192-coef-sum, 2048, 18, 1348, 40, 0, 0, 1406, 1
n100x8192-coef-sum, 2048, 18, 1346, 41, 0, 0, 1405, 1
n100x8192-coef-sum, 2048, 18, 1352, 41, 0, 0, 1411, 1
n100x8192-coef-sum, 2048, 17, 1362, 41, 0, 0, 1420, 1
n100x8192-coef-sum, 2048, 18, 1362, 42, 0, 0, 1422, 1
n100x8192-coef-sum, 2048, 18, 1347, 42, 0, 0, 1407, 1
n100x8192-coef-sum, 2048, 18, 1355, 41, 0, 0, 1414, 1
n100x8192-coef-sum, 2048, 22, 1382, 42, 0, 0, 1446, 1
n100x8192-coef-sum, 2048, 19, 1399, 43, 0, 0, 1461, 1
n100x8192-coef-sum, 2048, 18, 1365, 43, 0, 0, 1426, 1
n100x8192-coef-sum, 2048, 21, 1354, 40, 0, 0, 1415, 1
n100x8192-coef-sum, 2048, 18, 1349, 41, 0, 0, 1408, 1
n100x8192-coef-sum, 2048, 18, 1342, 40, 0, 0, 1400, 1
n100x8192-coef-sum, 2048, 18, 1357, 40, 0, 0, 1415, 1
n100x8192-coef-sum, 2048, 18, 1357, 40, 0, 0, 1415, 1
n100x8192-coef-sum, 2048, 17, 1369, 42, 0, 0, 1428, 1
n100x8192-coef-sum, 2048, 18, 1359, 42, 0, 0, 1419, 1
n100x8192-coef-sum, 2048, 18, 1364, 42, 0, 0, 1424, 1
n100x8192-coef-sum, 2048, 18, 1363, 41, 0, 0, 1422, 1
n100x8192-coef-sum, 2048, 18, 1357, 41, 0, 0, 1416, 1
n100x8192-coef-sum, 2048, 21, 1355, 41, 0, 0, 1417, 1
n100x8192-coef-sum, 2048, 21, 1369, 41, 0, 0, 1431, 1
n100x8192-coef-sum, 2048, 18, 1350, 41, 0, 0, 1409, 1
n100x8192-coef-sum, 2048, 18, 1344, 42, 0, 0, 1404, 1
n100x8192-coef-sum, 2048, 18, 1356, 41, 0, 0, 1415, 1
n100x8192-coef-sum, 2048, 18, 1379, 42, 0, 0, 1439, 1
n100x8192-coef-sum, 2048, 22, 1364, 42, 0, 0, 1428, 1
n100x8192-coef-sum, 2048, 18, 1352, 43, 0, 0, 1413, 1
n100x8192-coef-sum, 2048, 18, 1359, 42, 0, 0, 1419, 1
n100x8192-coef-sum, 2048, 18, 1357, 42, 0, 0, 1417, 1
n100x8192-coef-sum, 2048, 18, 1347, 40, 0, 0, 1405, 1
n100x8192-coef-sum, 2048, 18, 1343, 40, 0, 0, 1401, 1
n100x8192-coef-sum, 2048, 18, 1342, 41, 0, 0, 1401, 1
n100x8192-coef-sum, 2048, 19, 1347, 41, 0, 0, 1407, 1
n100x8192-coef-sum, 2048, 18, 1345, 42, 0, 0, 1405, 1
n100x8192-coef-sum, 2048, 18, 1359, 41, 0, 0, 1418, 1
n100x8192-coef-sum, 2048, 18, 1346, 42, 0, 0, 1406, 1
n100x8192-coef-sum, 2048, 19, 1355, 41, 0, 0, 1415, 1
n100x8192-coef-sum, 2048, 20, 1348, 41, 0, 0, 1409, 1
n100x8192-coef-sum, 2048, 18, 1351, 43, 0, 0, 1412, 1
n100x8192-coef-sum, 2048, 22, 1353, 41, 0, 0, 1416, 1
n100x8192-coef-sum, 2048, 18, 1349, 41, 0, 0, 1408, 1
n100x8192-coef-sum, 2048, 18, 1350, 41, 0, 0, 1409, 1
n100x8192-coef-sum, 2048, 18, 1356, 42, 0, 0, 1416, 1
n100x8192-coef-sum, 2048, 19, 1351, 41, 0, 0, 1411, 1
n100x8192-coef-sum, 2048, 18, 1349, 41, 0, 0, 1408, 1
n100x8192-coef-sum, 2048, 17, 1340, 41, 0, 0, 1398, 1
n100x8192-coef-sum, 2048, 18, 1366, 42, 0, 0, 1426, 1
n100x8192-coef-sum, 2048, 18, 1349, 41, 0, 0, 1408, 1
n100x8192-coef-sum, 2048, 18, 1359, 41, 0, 0, 1418, 1
n100x8192-coef-sum, 2048, 18, 1363, 41, 0, 0, 1422, 1
n100x8192-coef-sum, 2048, 18, 1360, 41, 0, 0, 1419, 1
n100x8192-coef-sum, 2048, 18, 1351, 41, 0, 0, 1410, 1
n100x8192-coef-sum, 2048, 20, 1356, 41, 0, 0, 1417, 1
n100x8192-coef-sum, 2048, 24, 1358, 41, 0, 0, 1423, 1
n100x8192-coef-sum, 2048, 17, 1349, 42, 0, 0, 1408, 1
n100x8192-coef-sum, 2048, 18, 1362, 41, 0, 0, 1421, 1
n100x8192-coef-sum, 2048, 21, 1352, 42, 0, 0, 1415, 1
n100x8192-coef-sum, 2048, 18, 1366, 41, 0, 0, 1425, 1
n100x8192-coef-sum, 2048, 20, 1356, 42, 0, 0, 1418, 1
n100x8192-coef-sum, 2048, 18, 1368, 42, 0, 0, 1428, 1
n100x8192-coef-sum, 2048, 20, 1345, 42, 0, 0, 1407, 1
n100x8192-coef-sum, 2048, 18, 1367, 43, 0, 0, 1428, 1
n100x8192-coef-sum, 2048, 21, 1354, 42, 0, 0, 1417, 1
n100x8192-coef-sum, 2048, 17, 1370, 41, 0, 0, 1428, 1
n100x8192-coef-sum, 2048, 18, 1372, 42, 0, 0, 1432, 1
n100x8192-coef-sum, 2048, 18, 1360, 42, 0, 0, 1420, 1
n100x8192-coef-sum, 2048, 18, 1365, 41, 0, 0, 1424, 1
n100x8192-coef-sum, 2048, 19, 1355, 41, 0, 0, 1415, 1
n100x8192-coef-sum, 2048, 18, 1354, 43, 0, 0, 1415, 1
n100x8192-coef-sum, 2048, 18, 1365, 41, 0, 0, 1424, 1
n100x8192-coef-sum, 2048, 18, 1361, 41, 0, 0, 1420, 1
n100x8192-coef-sum, 2048, 18, 1366, 42, 0, 0, 1426, 1
n100x8192-coef-sum, 2048, 19, 1365, 41, 0, 0, 1425, 1
n100x8192-coef-sum, 2048, 18, 1362, 42, 0, 0, 1422, 1
n100x8192-coef-sum, 1024, 13, 1367, 47, 0, 0, 1427, 1
n100x8192-coef-sum, 1024, 17, 1351, 46, 0, 0, 1414, 1
n100x8192-coef-sum, 1024, 13, 1365, 46, 0, 0, 1424, 1
n100x8192-coef-sum, 1024, 13, 1355, 46, 0, 0, 1414, 1
n100x8192-coef-sum, 1024, 14, 1355, 46, 0, 0, 1415, 1
n100x8192-coef-sum, 1024, 15, 1369, 48, 0, 0, 1432, 1
n100x8192-coef-sum, 1024, 13, 1353, 46, 0, 0, 1412, 1
n100x8192-coef-sum, 1024, 13, 1354, 47, 0, 0, 1414, 1
n100x8192-coef-sum, 1024, 14, 1369, 47, 0, 0, 1430, 1
n100x8192-coef-sum, 1024, 12, 1359, 48, 0, 0, 1419, 1
n100x8192-coef-sum, 1024, 13, 1357, 46, 0, 0, 1416, 1
n100x8192-coef-sum, 1024, 13, 1359, 47, 0, 0, 1419, 1
n100x8192-coef-sum, 1024, 12, 1357, 46, 0, 0, 1415, 1
n100x8192-coef-sum, 1024, 13, 1359, 47, 0, 0, 1419, 1
n100x8192-coef-sum, 1024, 13, 1360, 46, 0, 0, 1419, 1
n100x8192-coef-sum, 1024, 13, 1363, 51, 0, 0, 1427, 1
n100x8192-coef-sum, 1024, 13, 1364, 46, 0, 0, 1423, 1
n100x8192-coef-sum, 1024, 13, 1351, 46, 0, 0, 1410, 1
n100x8192-coef-sum, 1024, 12, 1346, 46, 0, 0, 1404, 1
n100x8192-coef-sum, 1024, 12, 1350, 46, 0, 0, 1408, 1
n100x8192-coef-sum, 1024, 12, 1390, 47, 0, 0, 1449, 1
n100x8192-coef-sum, 1024, 13, 1443, 50, 0, 0, 1506, 1
n100x8192-coef-sum, 1024, 14, 1392, 47, 0, 0, 1453, 1
n100x8192-coef-sum, 1024, 13, 1393, 49, 0, 0, 1455, 1
n100x8192-coef-sum, 1024, 12, 1397, 47, 0, 0, 1456, 1
n100x8192-coef-sum, 1024, 14, 1405, 51, 0, 0, 1470, 1
n100x8192-coef-sum, 1024, 13, 1378, 47, 0, 0, 1438, 1
n100x8192-coef-sum, 1024, 14, 1384, 47, 0, 0, 1445, 1
n100x8192-coef-sum, 1024, 13, 1364, 46, 0, 0, 1423, 1
n100x8192-coef-sum, 1024, 14, 1370, 49, 0, 0, 1433, 1
n100x8192-coef-sum, 1024, 13, 1365, 47, 0, 0, 1425, 1
n100x8192-coef-sum, 1024, 13, 1377, 47, 0, 0, 1437, 1
n100x8192-coef-sum, 1024, 13, 1366, 46, 0, 0, 1425, 1
n100x8192-coef-sum, 1024, 12, 1373, 47, 0, 0, 1432, 1
n100x8192-coef-sum, 1024, 13, 1370, 47, 0, 0, 1430, 1
n100x8192-coef-sum, 1024, 13, 1387, 47, 0, 0, 1447, 1
n100x8192-coef-sum, 1024, 13, 1376, 46, 0, 0, 1435, 1
n100x8192-coef-sum, 1024, 12, 1363, 47, 0, 0, 1422, 1
n100x8192-coef-sum, 1024, 12, 1372, 48, 0, 0, 1432, 1
n100x8192-coef-sum, 1024, 12, 1370, 46, 0, 0, 1428, 1
n100x8192-coef-sum, 1024, 13, 1365, 47, 0, 0, 1425, 1
n100x8192-coef-sum, 1024, 13, 1378, 47, 0, 0, 1438, 1
n100x8192-coef-sum, 1024, 13, 1379, 48, 0, 0, 1440, 1
n100x8192-coef-sum, 1024, 13, 1381, 47, 0, 0, 1441, 1
n100x8192-coef-sum, 1024, 13, 1375, 47, 0, 0, 1435, 1
n100x8192-coef-sum, 1024, 14, 1389, 47, 0, 0, 1450, 1
n100x8192-coef-sum, 1024, 14, 1377, 48, 0, 0, 1439, 1
n100x8192-coef-sum, 1024, 13, 1385, 47, 0, 0, 1445, 1
n100x8192-coef-sum, 1024, 13, 1372, 48, 0, 0, 1433, 1
n100x8192-coef-sum, 1024, 13, 1375, 49, 0, 0, 1437, 1
n100x8192-coef-sum, 1024, 14, 1366, 47, 0, 0, 1427, 1
n100x8192-coef-sum, 1024, 12, 1369, 48, 0, 0, 1429, 1
n100x8192-coef-sum, 1024, 13, 1367, 47, 0, 0, 1427, 1
n100x8192-coef-sum, 1024, 13, 1369, 47, 0, 0, 1429, 1
n100x8192-coef-sum, 1024, 13, 1377, 46, 0, 0, 1436, 1
n100x8192-coef-sum, 1024, 12, 1386, 46, 0, 0, 1444, 1
n100x8192-coef-sum, 1024, 13, 1372, 46, 0, 0, 1431, 1
n100x8192-coef-sum, 1024, 13, 1373, 47, 0, 0, 1433, 1
n100x8192-coef-sum, 1024, 14, 1368, 49, 0, 0, 1431, 1
n100x8192-coef-sum, 1024, 13, 1366, 47, 0, 0, 1426, 1
n100x8192-coef-sum, 1024, 17, 1378, 48, 0, 0, 1443, 1
n100x8192-coef-sum, 1024, 14, 1407, 48, 0, 0, 1469, 1
n100x8192-coef-sum, 1024, 14, 1375, 47, 0, 0, 1436, 1
n100x8192-coef-sum, 1024, 16, 1382, 48, 0, 0, 1446, 1
n100x8192-coef-sum, 1024, 13, 1381, 48, 0, 0, 1442, 1
n100x8192-coef-sum, 1024, 13, 1402, 47, 0, 0, 1462, 1
n100x8192-coef-sum, 1024, 12, 1375, 47, 0, 0, 1434, 1
n100x8192-coef-sum, 1024, 13, 1385, 46, 0, 0, 1444, 1
n100x8192-coef-sum, 1024, 13, 1370, 47, 0, 0, 1430, 1
n100x8192-coef-sum, 1024, 13, 1363, 48, 0, 0, 1424, 1
n100x8192-coef-sum, 1024, 14, 1380, 48, 0, 0, 1442, 1
n100x8192-coef-sum, 1024, 16, 1376, 49, 0, 0, 1441, 1
n100x8192-coef-sum, 1024, 13, 1380, 47, 0, 0, 1440, 1
n100x8192-coef-sum, 1024, 14, 1371, 47, 0, 0, 1432, 1
n100x8192-coef-sum, 1024, 13, 1372, 49, 0, 0, 1434, 1
n100x8192-coef-sum, 1024, 13, 1384, 47, 0, 0, 1444, 1
n100x8192-coef-sum, 1024, 13, 1367, 47, 0, 0, 1427, 1
n100x8192-coef-sum, 1024, 14, 1366, 48, 0, 0, 1428, 1
n100x8192-coef-sum, 1024, 13, 1364, 47, 0, 0, 1424, 1
n100x8192-coef-sum, 1024, 12, 1363, 49, 0, 0, 1424, 1
n100x8192-coef-sum, 1024, 13, 1353, 47, 0, 0, 1413, 1
n100x8192-coef-sum, 1024, 13, 1358, 47, 0, 0, 1418, 1
n100x8192-coef-sum, 1024, 13, 1369, 48, 0, 0, 1430, 1
n100x8192-coef-sum, 1024, 13, 1361, 47, 0, 0, 1421, 1
n100x8192-coef-sum, 1024, 13, 1357, 47, 0, 0, 1417, 1
n100x8192-coef-sum, 1024, 13, 1364, 48, 0, 0, 1425, 1
n100x8192-coef-sum, 1024, 13, 1371, 49, 0, 0, 1433, 1
n100x8192-coef-sum, 1024, 13, 1370, 47, 0, 0, 1430, 1
n100x8192-coef-sum, 1024, 13, 1362, 48, 0, 0, 1423, 1
n100x8192-coef-sum, 1024, 13, 1369, 47, 0, 0, 1429, 1
n100x8192-coef-sum, 1024, 14, 1366, 49, 0, 0, 1429, 1
n100x8192-coef-sum, 1024, 13, 1365, 46, 0, 0, 1424, 1
n100x8192-coef-sum, 1024, 20, 1368, 53, 0, 0, 1441, 1
n100x8192-coef-sum, 1024, 14, 1363, 47, 0, 0, 1424, 1
n100x8192-coef-sum, 1024, 13, 1370, 47, 0, 0, 1430, 1
n100x8192-coef-sum, 1024, 13, 1373, 47, 0, 0, 1433, 1
n100x8192-coef-sum, 1024, 14, 1368, 47, 0, 0, 1429, 1
n100x8192-coef-sum, 1024, 14, 1368, 46, 0, 0, 1428, 1
n100x8192-coef-sum, 1024, 13, 1363, 50, 0, 0, 1426, 1
n100x8192-coef-sum, 1024, 13, 1366, 46, 0, 0, 1425, 1
n100x8192-slot-sum, 8192, 271, 821, 84, 1, 0, 1177, 1
n100x8192-slot-sum, 8192, 273, 824, 82, 1, 0, 1180, 1
n100x8192-slot-sum, 8192, 268, 817, 80, 1, 0, 1166, 1
n100x8192-slot-sum, 8192, 268, 823, 83, 1, 0, 1175, 1
n100x8192-slot-sum, 8192, 272, 818, 81, 1, 0, 1172, 1
n100x8192-slot-sum, 8192, 271, 819, 80, 1, 0, 1171, 1
n100x8192-slot-sum, 8192, 275, 820, 84, 1, 0, 1180, 1
n100x8192-slot-sum, 8192, 273, 824, 84, 1, 0, 1182, 1
n100x8192-slot-sum, 8192, 271, 822, 81, 1, 0, 1175, 1
n100x8192-slot-sum, 8192, 269, 813, 81, 1, 0, 1164, 1
n100x8192-slot-sum, 8192, 270, 817, 79, 1, 0, 1167, 1
n100x8192-slot-sum, 8192, 269, 814, 80, 1, 0, 1164, 1
n100x8192-slot-sum, 8192, 270, 819, 80, 1, 0, 1170, 1
n100x8192-slot-sum, 8192, 270, 816, 82, 1, 0, 1169, 1
n100x8192-slot-sum, 8192, 270, 814, 86, 1, 0, 1171, 1
n100x8192-slot-sum, 8192, 270, 818, 80, 1, 0, 1169, 1
n100x8192-slot-sum, 8192, 268, 821, 80, 1, 0, 1170, 1
n100x8192-slot-sum, 8192, 268, 819, 83, 1, 0, 1171, 1
n100x8192-slot-sum, 8192, 269, 811, 81, 1, 0, 1162, 1
n100x8192-slot-sum, 8192, 271, 817, 82, 1, 0, 1171, 1
n100x8192-slot-sum, 8192, 274, 816, 83, 1, 0, 1174, 1
n100x8192-slot-sum, 8192, 286, 821, 82, 1, 0, 1190, 1
n100x8192-slot-sum, 8192, 270, 813, 81, 1, 0, 1165, 1
n100x8192-slot-sum, 8192, 270, 823, 81, 1, 0, 1175, 1
n100x8192-slot-sum, 8192, 268, 821, 80, 1, 0, 1170, 1
n100x8192-slot-sum, 8192, 268, 822, 80, 1, 0, 1171, 1
n100x8192-slot-sum, 8192, 271, 816, 83, 1, 0, 1171, 1
n100x8192-slot-sum, 8192, 274, 826, 85, 1, 0, 1186, 1
n100x8192-slot-sum, 8192, 269, 826, 83, 1, 0, 1179, 1
n100x8192-slot-sum, 8192, 273, 827, 83, 1, 0, 1184, 1
n100x8192-slot-sum, 8192, 271, 823, 82, 1, 0, 1177, 1
n100x8192-slot-sum, 8192, 271, 816, 82, 1, 0, 1170, 1
n100x8192-slot-sum, 8192, 267, 817, 84, 1, 0, 1169, 1
n100x8192-slot-sum, 8192, 271, 824, 81, 1, 0, 1177, 1
n100x8192-slot-sum, 8192, 270, 816, 83, 1, 0, 1170, 1
n100x8192-slot-sum, 8192, 273, 814, 79, 1, 0, 1167, 1
n100x8192-slot-sum, 8192, 272, 823, 80, 1, 0, 1176, 1
n100x8192-slot-sum, 8192, 270, 818, 81, 1, 0, 1170, 1
n100x8192-slot-sum, 8192, 271, 812, 82, 1, 0, 1166, 1
n100x8192-slot-sum, 8192, 274, 814, 83, 1, 0, 1172, 1
n100x8192-slot-sum, 8192, 272, 814, 79, 1, 0, 1166, 1
n100x8192-slot-sum, 8192, 272, 819, 80, 1, 0, 1172, 1
n100x8192-slot-sum, 8192, 272, 820, 79, 1, 0, 1172, 1
n100x8192-slot-sum, 8192, 272, 818, 81, 1, 0, 1172, 1
n100x8192-slot-sum, 8192, 270, 822, 80, 1, 0, 1173, 1
n100x8192-slot-sum, 8192, 269, 819, 81, 1, 0, 1170, 1
n100x8192-slot-sum, 8192, 270, 812, 80, 1, 0, 1163, 1
n100x8192-slot-sum, 8192, 270, 813, 81, 1, 0, 1165, 1
n100x8192-slot-sum, 8192, 270, 824, 82, 1, 0, 1177, 1
n100x8192-slot-sum, 8192, 268, 831, 83, 1, 0, 1183, 1
n100x8192-slot-sum, 8192, 269, 812, 79, 1, 0, 1161, 1
n100x8192-slot-sum, 8192, 273, 815, 81, 1, 0, 1170, 1
n100x8192-slot-sum, 8192, 268, 823, 83, 1, 0, 1175, 1
n100x8192-slot-sum, 8192, 269, 815, 79, 1, 0, 1164, 1
n100x8192-slot-sum, 8192, 267, 826, 82, 1, 0, 1176, 1
n100x8192-slot-sum, 8192, 284, 821, 81, 1, 0, 1187, 1
n100x8192-slot-sum, 8192, 265, 823, 81, 1, 0, 1170, 1
n100x8192-slot-sum, 8192, 269, 816, 81, 1, 0, 1167, 1
n100x8192-slot-sum, 8192, 270, 818, 80, 1, 0, 1169, 1
n100x8192-slot-sum, 8192, 272, 815, 80, 1, 0, 1168, 1
n100x8192-slot-sum, 8192, 267, 818, 79, 1, 0, 1165, 1
n100x8192-slot-sum, 8192, 272, 815, 80, 1, 0, 1168, 1
n100x8192-slot-sum, 8192, 267, 814, 80, 1, 0, 1162, 1
n100x8192-slot-sum, 8192, 270, 812, 82, 1, 0, 1165, 1
n100x8192-slot-sum, 8192, 272, 821, 82, 1, 0, 1176, 1
n100x8192-slot-sum, 8192, 279, 806, 80, 1, 0, 1166, 1
n100x8192-slot-sum, 8192, 269, 819, 82, 1, 0, 1171, 1
n100x8192-slot-sum, 8192, 272, 811, 79, 1, 0, 1163, 1
n100x8192-slot-sum, 8192, 272, 817, 81, 1, 0, 1171, 1
n100x8192-slot-sum, 8192, 269, 809, 79, 1, 0, 1158, 1
n100x8192-slot-sum, 8192, 269, 813, 80, 1, 0, 1163, 1
n100x8192-slot-sum, 8192, 266, 814, 80, 1, 0, 1161, 1
n100x8192-slot-sum, 8192, 272, 816, 82, 1, 0, 1171, 1
n100x8192-slot-sum, 8192, 269, 811, 79, 1, 0, 1160, 1
n100x8192-slot-sum, 8192, 267, 818, 81, 1, 0, 1167, 1
n100x8192-slot-sum, 8192, 272, 819, 81, 1, 0, 1173, 1
n100x8192-slot-sum, 8192, 270, 822, 80, 1, 0, 1173, 1
n100x8192-slot-sum, 8192, 267, 811, 79, 1, 0, 1158, 1
n100x8192-slot-sum, 8192, 275, 814, 83, 1, 0, 1173, 1
n100x8192-slot-sum, 8192, 271, 819, 80, 1, 0, 1171, 1
n100x8192-slot-sum, 8192, 275, 815, 82, 1, 0, 1173, 1
n100x8192-slot-sum, 8192, 273, 815, 79, 1, 0, 1168, 1
n100x8192-slot-sum, 8192, 269, 811, 78, 1, 0, 1159, 1
n100x8192-slot-sum, 8192, 267, 825, 81, 1, 0, 1174, 1
n100x8192-slot-sum, 8192, 270, 816, 83, 1, 0, 1170, 1
n100x8192-slot-sum, 8192, 269, 811, 83, 1, 0, 1164, 1
n100x8192-slot-sum, 8192, 270, 818, 81, 1, 0, 1170, 1
n100x8192-slot-sum, 8192, 271, 814, 80, 1, 0, 1166, 1
n100x8192-slot-sum, 8192, 270, 810, 78, 1, 0, 1159, 1
n100x8192-slot-sum, 8192, 268, 811, 81, 1, 0, 1161, 1
n100x8192-slot-sum, 8192, 277, 822, 79, 1, 0, 1179, 1
n100x8192-slot-sum, 8192, 272, 812, 80, 1, 0, 1165, 1
n100x8192-slot-sum, 8192, 268, 824, 82, 1, 0, 1175, 1
n100x8192-slot-sum, 8192, 272, 811, 79, 1, 0, 1163, 1
n100x8192-slot-sum, 8192, 272, 815, 80, 1, 0, 1168, 1
n100x8192-slot-sum, 8192, 265, 809, 79, 1, 0, 1154, 1
n100x8192-slot-sum, 8192, 270, 815, 81, 1, 0, 1167, 1
n100x8192-slot-sum, 8192, 268, 809, 81, 1, 0, 1159, 1
n100x8192-slot-sum, 8192, 271, 817, 81, 1, 0, 1170, 1
n100x8192-slot-sum, 8192, 267, 814, 79, 1, 0, 1161, 1
n100x8192-slot-sum, 4096, 126, 791, 58, 0, 0, 975, 1
n100x8192-slot-sum, 4096, 131, 784, 57, 0, 0, 972, 1
n100x8192-slot-sum, 4096, 123, 788, 60, 0, 0, 971, 1
n100x8192-slot-sum, 4096, 125, 781, 59, 0, 0, 965, 1
n100x8192-slot-sum, 4096, 125, 787, 58, 0, 0, 970, 1
n100x8192-slot-sum, 4096, 126, 779, 57, 0, 0, 962, 1
n100x8192-slot-sum, 4096, 124, 793, 58, 0, 0, 975, 1
n100x8192-slot-sum, 4096, 126, 779, 57, 0, 0, 962, 1
n100x8192-slot-sum, 4096, 125, 789, 59, 0, 0, 973, 1
n100x8192-slot-sum, 4096, 128, 788, 59, 0, 0, 975, 1
n100x8192-slot-sum, 4096, 138, 784, 57, 0, 0, 979, 1
n100x8192-slot-sum, 4096, 124, 777, 56, 0, 0, 957, 1
n100x8192-slot-sum, 4096, 127, 780, 57, 0, 0, 964, 1
n100x8192-slot-sum, 4096, 125, 780, 58, 0, 0, 963, 1
n100x8192-slot-sum, 4096, 128, 782, 57, 0, 0, 967, 1
n100x8192-slot-sum, 4096, 126, 778, 59, 0, 0, 963, 1
n100x8192-slot-sum, 4096, 129, 788, 61, 0, 0, 978, 1
n100x8192-slot-sum, 4096, 126, 781, 57, 0, 0, 964, 1
n100x8192-slot-sum, 4096, 127, 779, 60, 0, 0, 966, 1
n100x8192-slot-sum, 4096, 128, 783, 58, 0, 0, 969, 1
n100x8192-slot-sum, 4096, 124, 789, 59, 0, 0, 972, 1
n100x8192-slot-sum, 4096, 127, 777, 62, 0, 0, 966, 1
n100x8192-slot-sum, 4096, 127, 783, 57, 0, 0, 967, 1
n100x8192-slot-sum, 4096, 129, 789, 58, 0, 0, 976, 1
n100x8192-slot-sum, 4096, 128, 791, 61, 0, 0, 980, 1
n100x8192-slot-sum, 4096, 125, 792, 59, 0, 0, 976, 1
n100x8192-slot-sum, 4096, 127, 786, 57, 0, 0, 970, 1
n100x8192-slot-sum, 4096, 124, 788, 59, 0, 0, 971, 1
n100x8192-slot-sum, 4096, 127, 799, 62, 0, 0, 988, 1
n100x8192-slot-sum, 4096, 127, 799, 62, 0, 0, 988, 1
n100x8192-slot-sum, 4096, 126, 787, 58, 0, 0, 971, 1
n100x8192-slot-sum, 4096, 129, 785, 58, 0, 0, 972, 1
n100x8192-slot-sum, 4096, 129, 787, 59, 0, 0, 975, 1
n100x8192-slot-sum, 4096, 125, 785, 59, 0, 0, 969, 1
n100x8192-slot-sum, 4096, 125, 778, 59, 0, 0, 962, 1
n100x8192-slot-sum, 4096, 125, 778, 57, 0, 0, 960, 1
n100x8192-slot-sum, 4096, 125, 790, 57, 0, 0, 972, 1
n100x8192-slot-sum, 4096, 125, 776, 58, 0, 0, 959, 1
n100x8192-slot-sum, 4096, 125, 777, 57, 0, 0, 959, 1
n100x8192-slot-sum, 4096, 126, 784, 59, 0, 0, 969, 1
n100x8192-slot-sum, 4096, 124, 775, 58, 0, 0, 957, 1
n100x8192-slot-sum, 4096, 129, 782, 59, 0, 0, 970, 1
n100x8192-slot-sum, 4096, 125, 774, 58, 0, 0, 957, 1
n100x8192-slot-sum, 4096, 133, 778, 58, 0, 0, 969, 1
n100x8192-slot-sum, 4096, 128, 778, 58, 0, 0, 964, 1
n100x8192-slot-sum, 4096, 125, 778, 58, 0, 0, 961, 1
n100x8192-slot-sum, 4096, 124, 783, 58, 0, 0, 965, 1
n100x8192-slot-sum, 4096, 126, 793, 59, 0, 0, 978, 1
n100x8192-slot-sum, 4096, 129, 779, 58, 0, 0, 966, 1
n100x8192-slot-sum, 4096, 125, 779, 57, 0, 0, 961, 1
n100x8192-slot-sum, 4096, 129, 780, 59, 0, 0, 968, 1
n100x8192-slot-sum, 4096, 125, 776, 59, 0, 0, 960, 1
n100x8192-slot-sum, 4096, 135, 775, 58, 0, 0, 968, 1
n100x8192-slot-sum, 4096, 124, 781, 58, 0, 0, 963, 1
n100x8192-slot-sum, 4096, 126, 783, 58, 0, 0, 967, 1
n100x8192-slot-sum, 4096, 128, 798, 60, 0, 0, 986, 1
n100x8192-slot-sum, 4096, 130, 787, 57, 0, 0, 974, 1
n100x8192-slot-sum, 4096, 128, 792, 60, 0, 0, 980, 1
n100x8192-slot-sum, 4096, 129, 781, 59, 0, 0, 969, 1
n100x8192-slot-sum, 4096, 131, 797, 59, 0, 0, 987, 1
n100x8192-slot-sum, 4096, 125, 781, 58, 0, 0, 964, 1
n100x8192-slot-sum, 4096, 129, 781, 59, 0, 0, 969, 1
n100x8192-slot-sum, 4096, 127, 792, 58, 0, 0, 977, 1
n100x8192-slot-sum, 4096, 124, 775, 57, 0, 0, 956, 1
n100x8192-slot-sum, 4096, 127, 797, 60, 0, 0, 984, 1
n100x8192-slot-sum, 4096, 128, 783, 60, 0, 0, 971, 1
n100x8192-slot-sum, 4096, 130, 781, 58, 0, 0, 969, 1
n100x8192-slot-sum, 4096, 127, 781, 59, 0, 0, 967, 1
n100x8192-slot-sum, 4096, 126, 782, 59, 0, 0, 967, 1
n100x8192-slot-sum, 4096, 127, 779, 57, 0, 0, 963, 1
n100x8192-slot-sum, 4096, 126, 787, 61, 0, 0, 974, 1
n100x8192-slot-sum, 4096, 126, 785, 61, 0, 0, 972, 1
n100x8192-slot-sum, 4096, 129, 790, 60, 0, 0, 979, 1
n100x8192-slot-sum, 4096, 125, 779, 57, 0, 0, 961, 1
n100x8192-slot-sum, 4096, 124, 780, 58, 0, 0, 962, 1
n100x8192-slot-sum, 4096, 132, 781, 58, 0, 0, 971, 1
n100x8192-slot-sum, 4096, 125, 782, 58, 0, 0, 965, 1
n100x8192-slot-sum, 4096, 126, 783, 57, 0, 0, 966, 1
n100x8192-slot-sum, 4096, 124, 780, 58, 0, 0, 962, 1
n100x8192-slot-sum, 4096, 123, 779, 58, 0, 0, 960, 1
n100x8192-slot-sum, 4096, 126, 797, 59, 0, 0, 982, 1
n100x8192-slot-sum, 4096, 125, 777, 57, 0, 0, 959, 1
n100x8192-slot-sum, 4096, 126, 780, 57, 0, 0, 963, 1
n100x8192-slot-sum, 4096, 125, 775, 58, 0, 0, 958, 1
n100x8192-slot-sum, 4096, 126, 775, 57, 0, 0, 958, 1
n100x8192-slot-sum, 4096, 124, 776, 57, 0, 0, 957, 1
n100x8192-slot-sum, 4096, 124, 786, 58, 0, 0, 968, 1
n100x8192-slot-sum, 4096, 124, 775, 58, 0, 0, 957, 1
n100x8192-slot-sum, 4096, 126, 790, 60, 0, 0, 976, 1
n100x8192-slot-sum, 4096, 126, 780, 58, 0, 0, 964, 1
n100x8192-slot-sum, 4096, 124, 788, 58, 0, 0, 970, 1
n100x8192-slot-sum, 4096, 123, 781, 59, 0, 0, 963, 1
n100x8192-slot-sum, 4096, 124, 782, 57, 0, 0, 963, 1
n100x8192-slot-sum, 4096, 125, 780, 57, 0, 0, 962, 1
n100x8192-slot-sum, 4096, 123, 775, 57, 0, 0, 955, 1
n100x8192-slot-sum, 4096, 125, 767, 57, 0, 0, 949, 1
n100x8192-slot-sum, 4096, 130, 778, 57, 0, 0, 965, 1
n100x8192-slot-sum, 4096, 125, 785, 59, 0, 0, 969, 1
n100x8192-slot-sum, 4096, 132, 786, 59, 0, 0, 977, 1
n100x8192-slot-sum, 4096, 126, 790, 60, 0, 0, 976, 1
n100x8192-slot-sum, 2048, 59, 759, 50, 0, 0, 868, 1
n100x8192-slot-sum, 2048, 61, 765, 50, 0, 0, 876, 1
n100x8192-slot-sum, 2048, 60, 762, 51, 0, 0, 873, 1
n100x8192-slot-sum, 2048, 61, 769, 51, 0, 0, 881, 1
n100x8192-slot-sum, 2048, 60, 764, 51, 0, 0, 875, 1
n100x8192-slot-sum, 2048, 71, 760, 50, 0, 0, 881, 1
n100x8192-slot-sum, 2048, 62, 767, 51, 0, 0, 880, 1
n100x8192-slot-sum, 2048, 63, 751, 50, 0, 0, 864, 1
n100x8192-slot-sum, 2048, 61, 765, 50, 0, 0, 876, 1
n100x8192-slot-sum, 2048, 59, 755, 50, 0, 0, 864, 1
n100x8192-slot-sum, 2048, 59, 755, 50, 0, 0, 864, 1
n100x8192-slot-sum, 2048, 68, 762, 50, 0, 0, 880, 1
n100x8192-slot-sum, 2048, 59, 760, 51, 0, 0, 870, 1
n100x8192-slot-sum, 2048, 60, 761, 49, 0, 0, 870, 1
n100x8192-slot-sum, 2048, 65, 768, 53, 0, 0, 886, 1
n100x8192-slot-sum, 2048, 60, 778, 51, 0, 0, 889, 1
n100x8192-slot-sum, 2048, 60, 751, 51, 0, 0, 862, 1
n100x8192-slot-sum, 2048, 62, 761, 50, 0, 0, 873, 1
n100x8192-slot-sum, 2048, 60, 762, 50, 0, 0, 872, 1
n100x8192-slot-sum, 2048, 65, 766, 50, 0, 0, 881, 1
n100x8192-slot-sum, 2048, 60, 762, 50, 0, 0, 872, 1
n100x8192-slot-sum, 2048, 59, 770, 51, 0, 0, 880, 1
n100x8192-slot-sum, 2048, 59, 772, 50, 0, 0, 881, 1
n100x8192-slot-sum, 2048, 60, 761, 50, 0, 0, 871, 1
n100x8192-slot-sum, 2048, 59, 772, 53, 0, 0, 884, 1
n100x8192-slot-sum, 2048, 60, 759, 51, 0, 0, 870, 1
n100x8192-slot-sum, 2048, 63, 761, 51, 0, 0, 875, 1
n100x8192-slot-sum, 2048, 61, 763, 49, 0, 0, 873, 1
n100x8192-slot-sum, 2048, 59, 762, 50, 0, 0, 871, 1
n100x8192-slot-sum, 2048, 60, 764, 50, 0, 0, 874, 1
n100x8192-slot-sum, 2048, 59, 762, 52, 0, 0, 873, 1
n100x8192-slot-sum, 2048, 60, 756, 51, 0, 0, 867, 1
n100x8192-slot-sum, 2048, 62, 769, 53, 0, 0, 884, 1
n100x8192-slot-sum, 2048, 60, 752, 51, 0, 0, 863, 1
n100x8192-slot-sum, 2048, 63, 755, 50, 0, 0, 868, 1
n100x8192-slot-sum, 2048, 60, 756, 49, 0, 0, 865, 1
n100x8192-slot-sum, 2048, 60, 758, 49, 0, 0, 867, 1
n100x8192-slot-sum, 2048, 62, 761, 51, 0, 0, 874, 1
n100x8192-slot-sum, 2048, 59, 762, 51, 0, 0, 872, 1
n100x8192-slot-sum, 2048, 59, 758, 52, 0, 0, 869, 1
n100x8192-slot-sum, 2048, 61, 766, 50, 0, 0, 877, 1
n100x8192-slot-sum, 2048, 60, 756, 49, 0, 0, 865, 1
n100x8192-slot-sum, 2048, 59, 764, 49, 0, 0, 872, 1
n100x8192-slot-sum, 2048, 59, 761, 49, 0, 0, 869, 1
n100x8192-slot-sum, 2048, 59, 764, 52, 0, 0, 875, 1
n100x8192-slot-sum, 2048, 60, 761, 51, 0, 0, 872, 1
n100x8192-slot-sum, 2048, 59, 756, 50, 0, 0, 865, 1
n100x8192-slot-sum, 2048, 59, 757, 52, 0, 0, 868, 1
n100x8192-slot-sum, 2048, 60, 758, 51, 0, 0, 869, 1
n100x8192-slot-sum, 2048, 65, 758, 50, 0, 0, 873, 1
n100x8192-slot-sum, 2048, 60, 763, 50, 0, 0, 873, 1
n100x8192-slot-sum, 2048, 60, 763, 50, 0, 0, 873, 1
n100x8192-slot-sum, 2048, 59, 759, 50, 0, 0, 868, 1
n100x8192-slot-sum, 2048, 59, 759, 49, 0, 0, 867, 1
n100x8192-slot-sum, 2048, 60, 766, 51, 0, 0, 877, 1
n100x8192-slot-sum, 2048, 67, 759, 51, 0, 0, 877, 1
n100x8192-slot-sum, 2048, 59, 757, 50, 0, 0, 866, 1
n100x8192-slot-sum, 2048, 59, 761, 50, 0, 0, 870, 1
n100x8192-slot-sum, 2048, 64, 753, 50, 0, 0, 867, 1
n100x8192-slot-sum, 2048, 61, 771, 51, 0, 0, 883, 1
n100x8192-slot-sum, 2048, 63, 754, 50, 0, 0, 867, 1
n100x8192-slot-sum, 2048, 61, 763, 51, 0, 0, 875, 1
n100x8192-slot-sum, 2048, 60, 759, 50, 0, 0, 869, 1
n100x8192-slot-sum, 2048, 61, 770, 52, 0, 0, 883, 1
n100x8192-slot-sum, 2048, 59, 761, 51, 0, 0, 871, 1
n100x8192-slot-sum, 2048, 63, 761, 52, 0, 0, 876, 1
n100x8192-slot-sum, 2048, 60, 758, 50, 0, 0, 868, 1
n100x8192-slot-sum, 2048, 73, 759, 50, 0, 0, 882, 1
n100x8192-slot-sum, 2048, 60, 759, 51, 0, 0, 870, 1
n100x8192-slot-sum, 2048, 61, 764, 50, 0, 0, 875, 1
n100x8192-slot-sum, 2048, 63, 770, 51, 0, 0, 884, 1
n100x8192-slot-sum, 2048, 59, 753, 51, 0, 0, 863, 1
n100x8192-slot-sum, 2048, 60, 761, 51, 0, 0, 872, 1
n100x8192-slot-sum, 2048, 60, 755, 50, 0, 0, 865, 1
n100x8192-slot-sum, 2048, 60, 761, 51, 0, 0, 872, 1
n100x8192-slot-sum, 2048, 61, 759, 50, 0, 0, 870, 1
n100x8192-slot-sum, 2048, 59, 759, 49, 0, 0, 867, 1
n100x8192-slot-sum, 2048, 61, 761, 50, 0, 0, 872, 1
n100x8192-slot-sum, 2048, 59, 765, 51, 0, 0, 875, 1
n100x8192-slot-sum, 2048, 60, 766, 51, 0, 0, 877, 1
n100x8192-slot-sum, 2048, 59, 758, 51, 0, 0, 868, 1
n100x8192-slot-sum, 2048, 61, 760, 52, 0, 0, 873, 1
n100x8192-slot-sum, 2048, 62, 768, 52, 0, 0, 882, 1
n100x8192-slot-sum, 2048, 59, 759, 50, 0, 0, 868, 1
n100x8192-slot-sum, 2048, 64, 765, 52, 0, 0, 881, 1
n100x8192-slot-sum, 2048, 61, 768, 50, 0, 0, 879, 1
n100x8192-slot-sum, 2048, 60, 763, 51, 0, 0, 874, 1
n100x8192-slot-sum, 2048, 61, 762, 50, 0, 0, 873, 1
n100x8192-slot-sum, 2048, 60, 770, 50, 0, 0, 880, 1
n100x8192-slot-sum, 2048, 59, 759, 52, 0, 0, 870, 1
n100x8192-slot-sum, 2048, 60, 758, 49, 0, 0, 867, 1
n100x8192-slot-sum, 2048, 60, 761, 50, 0, 0, 871, 1
n100x8192-slot-sum, 2048, 59, 755, 50, 0, 0, 864, 1
n100x8192-slot-sum, 2048, 59, 760, 51, 0, 0, 870, 1
n100x8192-slot-sum, 2048, 59, 758, 51, 0, 0, 868, 1
n100x8192-slot-sum, 2048, 60, 760, 50, 0, 0, 870, 1
n100x8192-slot-sum, 2048, 60, 764, 50, 0, 0, 874, 1
n100x8192-slot-sum, 2048, 60, 755, 51, 0, 0, 866, 1
n100x8192-slot-sum, 2048, 63, 765, 51, 0, 0, 879, 1
n100x8192-slot-sum, 2048, 60, 755, 51, 0, 0, 866, 1
n100x8192-slot-sum, 1024, 32, 762, 52, 0, 0, 846, 1
n100x8192-slot-sum, 1024, 32, 760, 50, 0, 0, 842, 1
n100x8192-slot-sum, 1024, 33, 762, 51, 0, 0, 846, 1
n100x8192-slot-sum, 1024, 31, 756, 50, 0, 0, 837, 1
n100x8192-slot-sum, 1024, 32, 759, 50, 0, 0, 841, 1
n100x8192-slot-sum, 1024, 32, 757, 50, 0, 0, 839, 1
n100x8192-slot-sum, 1024, 33, 767, 52, 0, 0, 852, 1
n100x8192-slot-sum, 1024, 32, 768, 51, 0, 0, 851, 1
n100x8192-slot-sum, 1024, 31, 766, 51, 0, 0, 848, 1
n100x8192-slot-sum, 1024, 32, 759, 51, 0, 0, 842, 1
n100x8192-slot-sum, 1024, 33, 754, 51, 0, 0, 838, 1
n100x8192-slot-sum, 1024, 31, 763, 52, 0, 0, 846, 1
n100x8192-slot-sum, 1024, 34, 759, 51, 0, 0, 844, 1
n100x8192-slot-sum, 1024, 31, 769, 52, 0, 0, 852, 1
n100x8192-slot-sum, 1024, 31, 759, 51, 0, 0, 841, 1
n100x8192-slot-sum, 1024, 33, 765, 53, 0, 0, 851, 1
n100x8192-slot-sum, 1024, 32, 764, 53, 0, 0, 849, 1
n100x8192-slot-sum, 1024, 32, 756, 51, 0, 0, 839, 1
n100x8192-slot-sum, 1024, 32, 762, 51, 0, 0, 845, 1
n100x8192-slot-sum, 1024, 32, 754, 50, 0, 0, 836, 1
n100x8192-slot-sum, 1024, 31, 761, 51, 0, 0, 843, 1
n100x8192-slot-sum, 1024, 32, 758, 51, 0, 0, 841, 1
n100x8192-slot-sum, 1024, 32, 763, 50, 0, 0, 845, 1
n100x8192-slot-sum, 1024, 31, 755, 51, 0, 0, 837, 1
n100x8192-slot-sum, 1024, 32, 763, 51, 0, 0, 846, 1
n100x8192-slot-sum, 1024, 34, 756, 51, 0, 0, 841, 1
n100x8192-slot-sum, 1024, 31, 762, 51, 0, 0, 844, 1
n100x8192-slot-sum, 1024, 32, 762, 53, 0, 0, 847, 1
n100x8192-slot-sum, 1024, 32, 763, 52, 0, 0, 847, 1
n100x8192-slot-sum, 1024, 32, 761, 52, 0, 0, 845, 1
n100x8192-slot-sum, 1024, 31, 760, 52, 0, 0, 843, 1
n100x8192-slot-sum, 1024, 31, 760, 51, 0, 0, 842, 1
n100x8192-slot-sum, 1024, 32, 759, 51, 0, 0, 842, 1
n100x8192-slot-sum, 1024, 31, 767, 52, 0, 0, 850, 1
n100x8192-slot-sum, 1024, 33, 762, 52, 0, 0, 847, 1
n100x8192-slot-sum, 1024, 32, 762, 52, 0, 0, 846, 1
n100x8192-slot-sum, 1024, 31, 759, 51, 0, 0, 841, 1
n100x8192-slot-sum, 1024, 32, 765, 51, 0, 0, 848, 1
n100x8192-slot-sum, 1024, 32, 762, 50, 0, 0, 844, 1
n100x8192-slot-sum, 1024, 31, 757, 51, 0, 0, 839, 1
n100x8192-slot-sum, 1024, 32, 758, 51, 0, 0, 841, 1
n100x8192-slot-sum, 1024, 32, 758, 51, 0, 0, 841, 1
n100x8192-slot-sum, 1024, 31, 760, 50, 0, 0, 841, 1
n100x8192-slot-sum, 1024, 31, 769, 52, 0, 0, 852, 1
n100x8192-slot-sum, 1024, 31, 766, 51, 0, 0, 848, 1
n100x8192-slot-sum, 1024, 31, 753, 52, 0, 0, 836, 1
n100x8192-slot-sum, 1024, 32, 768, 52, 0, 0, 852, 1
n100x8192-slot-sum, 1024, 32, 762, 52, 0, 0, 846, 1
n100x8192-slot-sum, 1024, 31, 761, 51, 0, 0, 843, 1
n100x8192-slot-sum, 1024, 31, 758, 50, 0, 0, 839, 1
n100x8192-slot-sum, 1024, 31, 759, 51, 0, 0, 841, 1
n100x8192-slot-sum, 1024, 31, 765, 51, 0, 0, 847, 1
n100x8192-slot-sum, 1024, 32, 757, 50, 0, 0, 839, 1
n100x8192-slot-sum, 1024, 32, 775, 51, 0, 0, 858, 1
n100x8192-slot-sum, 1024, 31, 752, 50, 0, 0, 833, 1
n100x8192-slot-sum, 1024, 32, 756, 51, 0, 0, 839, 1
n100x8192-slot-sum, 1024, 33, 926, 58, 0, 0, 1017, 1
n100x8192-slot-sum, 1024, 47, 898, 57, 0, 0, 1002, 1
n100x8192-slot-sum, 1024, 39, 895, 58, 0, 0, 992, 1
n100x8192-slot-sum, 1024, 32, 903, 56, 0, 0, 991, 1
n100x8192-slot-sum, 1024, 35, 900, 57, 0, 0, 992, 1
n100x8192-slot-sum, 1024, 32, 903, 57, 0, 0, 992, 1
n100x8192-slot-sum, 1024, 32, 873, 52, 0, 0, 957, 1
n100x8192-slot-sum, 1024, 32, 759, 52, 0, 0, 843, 1
n100x8192-slot-sum, 1024, 31, 757, 52, 0, 0, 840, 1
n100x8192-slot-sum, 1024, 31, 761, 51, 0, 0, 843, 1
n100x8192-slot-sum, 1024, 32, 761, 54, 0, 0, 847, 1
n100x8192-slot-sum, 1024, 33, 754, 52, 0, 0, 839, 1
n100x8192-slot-sum, 1024, 32, 760, 52, 0, 0, 844, 1
n100x8192-slot-sum, 1024, 32, 750, 51, 0, 0, 833, 1
n100x8192-slot-sum, 1024, 33, 760, 50, 0, 0, 843, 1
n100x8192-slot-sum, 1024, 32, 760, 50, 0, 0, 842, 1
n100x8192-slot-sum, 1024, 31, 758, 51, 0, 0, 840, 1
n100x8192-slot-sum, 1024, 32, 752, 50, 0, 0, 834, 1
n100x8192-slot-sum, 1024, 32, 761, 50, 0, 0, 843, 1
n100x8192-slot-sum, 1024, 32, 754, 50, 0, 0, 836, 1
n100x8192-slot-sum, 1024, 32, 760, 51, 0, 0, 843, 1
n100x8192-slot-sum, 1024, 32, 761, 52, 0, 0, 845, 1
n100x8192-slot-sum, 1024, 33, 762, 53, 0, 0, 848, 1
n100x8192-slot-sum, 1024, 32, 763, 52, 0, 0, 847, 1
n100x8192-slot-sum, 1024, 33, 759, 51, 0, 0, 843, 1
n100x8192-slot-sum, 1024, 33, 761, 53, 0, 0, 847, 1
n100x8192-slot-sum, 1024, 31, 765, 50, 0, 0, 846, 1
n100x8192-slot-sum, 1024, 31, 766, 51, 0, 0, 848, 1
n100x8192-slot-sum, 1024, 32, 761, 52, 0, 0, 845, 1
n100x8192-slot-sum, 1024, 32, 766, 51, 0, 0, 849, 1
n100x8192-slot-sum, 1024, 32, 762, 51, 0, 0, 845, 1
n100x8192-slot-sum, 1024, 32, 765, 51, 0, 0, 848, 1
n100x8192-slot-sum, 1024, 32, 760, 51, 0, 0, 843, 1
n100x8192-slot-sum, 1024, 31, 759, 52, 0, 0, 842, 1
n100x8192-slot-sum, 1024, 32, 766, 52, 0, 0, 850, 1
n100x8192-slot-sum, 1024, 33, 756, 50, 0, 0, 839, 1
n100x8192-slot-sum, 1024, 32, 754, 51, 0, 0, 837, 1
n100x8192-slot-sum, 1024, 32, 754, 51, 0, 0, 837, 1
n100x8192-slot-sum, 1024, 32, 764, 50, 0, 0, 846, 1
n100x8192-slot-sum, 1024, 32, 761, 52, 0, 0, 845, 1
n100x8192-slot-sum, 1024, 32, 761, 55, 0, 0, 848, 1
n100x8192-slot-sum, 1024, 44, 773, 54, 0, 0, 871, 1
n100x8192-slot-sum, 1024, 32, 773, 52, 0, 0, 857, 1
n100x8192-slot-sum, 1024, 32, 771, 51, 0, 0, 854, 1
n100x8192-slot-inner, 8192, 287, 809, 1414, 1, 0, 2511, 1.36534e+06
n100x8192-slot-inner, 8192, 284, 809, 1410, 1, 0, 2504, 1.36534e+06
n100x8192-slot-inner, 8192, 285, 818, 1411, 1, 0, 2515, 1.36534e+06
n100x8192-slot-inner, 8192, 292, 818, 1420, 1, 0, 2531, 1.36534e+06
n100x8192-slot-inner, 8192, 288, 815, 1420, 1, 0, 2524, 1.36534e+06
n100x8192-slot-inner, 8192, 285, 814, 1488, 1, 0, 2588, 1.36534e+06
n100x8192-slot-inner, 8192, 288, 805, 1415, 1, 0, 2509, 1.36534e+06
n100x8192-slot-inner, 8192, 286, 819, 1464, 1, 0, 2570, 1.36534e+06
n100x8192-slot-inner, 8192, 286, 814, 1464, 1, 0, 2565, 1.36534e+06
n100x8192-slot-inner, 8192, 290, 811, 1471, 1, 0, 2573, 1.36534e+06
n100x8192-slot-inner, 8192, 281, 806, 1396, 1, 0, 2484, 1.36534e+06
n100x8192-slot-inner, 8192, 284, 810, 1416, 1, 0, 2511, 1.36534e+06
n100x8192-slot-inner, 8192, 287, 804, 1408, 1, 0, 2500, 1.36534e+06
n100x8192-slot-inner, 8192, 285, 814, 1411, 1, 0, 2511, 1.36534e+06
n100x8192-slot-inner, 8192, 291, 812, 1409, 1, 0, 2513, 1.36534e+06
n100x8192-slot-inner, 8192, 287, 819, 1429, 1, 0, 2536, 1.36534e+06
n100x8192-slot-inner, 8192, 288, 813, 1425, 1, 0, 2527, 1.36534e+06
n100x8192-slot-inner, 8192, 285, 817, 1421, 1, 0, 2524, 1.36534e+06
n100x8192-slot-inner, 8192, 286, 813, 1422, 1, 0, 2522, 1.36534e+06
n100x8192-slot-inner, 8192, 289, 810, 1420, 1, 0, 2520, 1.36534e+06
n100x8192-slot-inner, 8192, 285, 813, 1419, 1, 0, 2518, 1.36534e+06
n100x8192-slot-inner, 8192, 292, 817, 1421, 1, 0, 2531, 1.36534e+06
n100x8192-slot-inner, 8192, 283, 810, 1408, 1, 0, 2502, 1.36534e+06
n100x8192-slot-inner, 8192, 290, 808, 1413, 1, 0, 2512, 1.36534e+06
n100x8192-slot-inner, 8192, 290, 802, 1399, 1, 0, 2492, 1.36534e+06
n100x8192-slot-inner, 8192, 288, 811, 1431, 1, 0, 2531, 1.36534e+06
n100x8192-slot-inner, 8192, 295, 824, 1429, 1, 0, 2549, 1.36534e+06
n100x8192-slot-inner, 8192, 290, 810, 1480, 1, 0, 2581, 1.36534e+06
n100x8192-slot-inner, 8192, 285, 812, 1419, 1, 0, 2517, 1.36534e+06
n100x8192-slot-inner, 8192, 288, 810, 1413, 1, 0, 2512, 1.36534e+06
n100x8192-slot-inner, 8192, 286, 808, 1404, 1, 0, 2499, 1.36534e+06
n100x8192-slot-inner, 8192, 288, 808, 1408, 1, 0, 2505, 1.36534e+06
n100x8192-slot-inner, 8192, 289, 809, 1414, 1, 0, 2513, 1.36534e+06
n100x8192-slot-inner, 8192, 286, 813, 1410, 1, 0, 2510, 1.36534e+06
n100x8192-slot-inner, 8192, 288, 814, 1414, 1, 0, 2517, 1.36534e+06
n100x8192-slot-inner, 8192, 287, 811, 1470, 1, 0, 2569, 1.36534e+06
n100x8192-slot-inner, 8192, 286, 806, 1475, 1, 0, 2568, 1.36534e+06
n100x8192-slot-inner, 8192, 284, 804, 1398, 1, 0, 2487, 1.36534e+06
n100x8192-slot-inner, 8192, 284, 809, 1408, 1, 0, 2502, 1.36534e+06
n100x8192-slot-inner, 8192, 287, 808, 1411, 1, 0, 2507, 1.36534e+06
n100x8192-slot-inner, 8192, 287, 808, 1406, 1, 0, 2502, 1.36534e+06
n100x8192-slot-inner, 8192, 294, 808, 1472, 1, 0, 2575, 1.36534e+06
n100x8192-slot-inner, 8192, 287, 812, 1404, 1, 0, 2504, 1.36534e+06
n100x8192-slot-inner, 8192, 287, 808, 1474, 1, 0, 2570, 1.36534e+06
n100x8192-slot-inner, 8192, 285, 808, 1412, 1, 0, 2506, 1.36534e+06
n100x8192-slot-inner, 8192, 288, 803, 1413, 1, 0, 2505, 1.36534e+06
n100x8192-slot-inner, 8192, 290, 819, 1417, 1, 0, 2527, 1.36534e+06
n100x8192-slot-inner, 8192, 284, 812, 1409, 1, 0, 2506, 1.36534e+06
n100x8192-slot-inner, 8192, 285, 805, 1409, 1, 0, 2500, 1.36534e+06
n100x8192-slot-inner, 8192, 288, 819, 1484, 1, 0, 2592, 1.36534e+06
n100x8192-slot-inner, 8192, 289, 807, 1476, 1, 0, 2573, 1.36534e+06
n100x8192-slot-inner, 8192, 287, 818, 1429, 1, 0, 2535, 1.36534e+06
n100x8192-slot-inner, 8192, 289, 812, 1419, 1, 0, 2521, 1.36534e+06
n100x8192-slot-inner, 8192, 287, 806, 1414, 1, 0, 2508, 1.36534e+06
n100x8192-slot-inner, 8192, 285, 811, 1414, 1, 0, 2511, 1.36534e+06
n100x8192-slot-inner, 8192, 290, 822, 1425, 1, 0, 2538, 1.36534e+06
n100x8192-slot-inner, 8192, 282, 812, 1408, 1, 0, 2503, 1.36534e+06
n100x8192-slot-inner, 8192, 284, 804, 1470, 1, 0, 2559, 1.36534e+06
n100x8192-slot-inner, 8192, 286, 807, 1404, 1, 0, 2498, 1.36534e+06
n100x8192-slot-inner, 8192, 282, 812, 1414, 1, 0, 2509, 1.36534e+06
n100x8192-slot-inner, 8192, 286, 806, 1405, 1, 0, 2498, 1.36534e+06
n100x8192-slot-inner, 8192, 283, 804, 1405, 1, 0, 2493, 1.36534e+06
n100x8192-slot-inner, 8192, 292, 803, 1460, 1, 0, 2556, 1.36534e+06
n100x8192-slot-inner, 8192, 296, 815, 1417, 1, 0, 2529, 1.36534e+06
n100x8192-slot-inner, 8192, 287, 813, 1416, 1, 0, 2517, 1.36534e+06
n100x8192-slot-inner, 8192, 283, 808, 1471, 1, 0, 2563, 1.36534e+06
n100x8192-slot-inner, 8192, 287, 812, 1413, 1, 0, 2513, 1.36534e+06
n100x8192-slot-inner, 8192, 292, 816, 1409, 1, 0, 2518, 1.36534e+06
n100x8192-slot-inner, 8192, 288, 803, 1407, 1, 0, 2499, 1.36534e+06
n100x8192-slot-inner, 8192, 293, 812, 1406, 1, 0, 2512, 1.36534e+06
n100x8192-slot-inner, 8192, 284, 805, 1405, 1, 0, 2495, 1.36534e+06
n100x8192-slot-inner, 8192, 284, 807, 1406, 1, 0, 2498, 1.36534e+06
n100x8192-slot-inner, 8192, 290, 813, 1426, 1, 0, 2530, 1.36534e+06
n100x8192-slot-inner, 8192, 287, 825, 1410, 1, 0, 2523, 1.36534e+06
n100x8192-slot-inner, 8192, 292, 820, 1407, 1, 0, 2520, 1.36534e+06
n100x8192-slot-inner, 8192, 286, 807, 1419, 1, 0, 2513, 1.36534e+06
n100x8192-slot-inner, 8192, 285, 810, 1401, 1, 0, 2497, 1.36534e+06
n100x8192-slot-inner, 8192, 285, 808, 1401, 1, 0, 2495, 1.36534e+06
n100x8192-slot-inner, 8192, 289, 808, 1412, 1, 0, 2510, 1.36534e+06
n100x8192-slot-inner, 8192, 286, 805, 1406, 1, 0, 2498, 1.36534e+06
n100x8192-slot-inner, 8192, 285, 809, 1416, 1, 0, 2511, 1.36534e+06
n100x8192-slot-inner, 8192, 284, 812, 1405, 1, 0, 2502, 1.36534e+06
n100x8192-slot-inner, 8192, 288, 811, 1403, 1, 0, 2503, 1.36534e+06
n100x8192-slot-inner, 8192, 283, 807, 1396, 1, 0, 2487, 1.36534e+06
n100x8192-slot-inner, 8192, 286, 802, 1401, 1, 0, 2490, 1.36534e+06
n100x8192-slot-inner, 8192, 288, 806, 1399, 1, 0, 2494, 1.36534e+06
n100x8192-slot-inner, 8192, 286, 811, 1409, 1, 0, 2507, 1.36534e+06
n100x8192-slot-inner, 8192, 282, 802, 1408, 1, 0, 2493, 1.36534e+06
n100x8192-slot-inner, 8192, 286, 809, 1407, 1, 0, 2503, 1.36534e+06
n100x8192-slot-inner, 8192, 290, 809, 1402, 1, 0, 2502, 1.36534e+06
n100x8192-slot-inner, 8192, 284, 803, 1406, 1, 0, 2494, 1.36534e+06
n100x8192-slot-inner, 8192, 291, 809, 1410, 1, 0, 2511, 1.36534e+06
n100x8192-slot-inner, 8192, 290, 808, 1469, 1, 0, 2568, 1.36534e+06
n100x8192-slot-inner, 8192, 288, 811, 1405, 1, 0, 2505, 1.36534e+06
n100x8192-slot-inner, 8192, 282, 804, 1398, 1, 0, 2485, 1.36534e+06
n100x8192-slot-inner, 8192, 286, 806, 1413, 1, 0, 2506, 1.36534e+06
n100x8192-slot-inner, 8192, 287, 810, 1407, 1, 0, 2505, 1.36534e+06
n100x8192-slot-inner, 8192, 289, 807, 1418, 1, 0, 2515, 1.36534e+06
n100x8192-slot-inner, 8192, 285, 809, 1472, 1, 0, 2567, 1.36534e+06
n100x8192-slot-inner, 8192, 284, 818, 1407, 1, 0, 2510, 1.36534e+06
n100x8192-slot-inner, 4096, 134, 778, 1333, 0, 0, 2245, 1.36534e+06
n100x8192-slot-inner, 4096, 137, 774, 1347, 0, 0, 2258, 1.36534e+06
n100x8192-slot-inner, 4096, 135, 781, 1340, 0, 0, 2256, 1.36534e+06
n100x8192-slot-inner, 4096, 134, 776, 1403, 0, 0, 2313, 1.36534e+06
n100x8192-slot-inner, 4096, 133, 783, 1350, 0, 0, 2266, 1.36534e+06
n100x8192-slot-inner, 4096, 135, 784, 1352, 0, 0, 2271, 1.36534e+06
n100x8192-slot-inner, 4096, 137, 792, 1358, 0, 0, 2287, 1.36534e+06
n100x8192-slot-inner, 4096, 133, 781, 1336, 0, 0, 2250, 1.36534e+06
n100x8192-slot-inner, 4096, 135, 775, 1402, 0, 0, 2312, 1.36534e+06
n100x8192-slot-inner, 4096, 131, 789, 1343, 0, 0, 2263, 1.36534e+06
n100x8192-slot-inner, 4096, 136, 776, 1340, 0, 0, 2252, 1.36534e+06
n100x8192-slot-inner, 4096, 137, 786, 1342, 0, 0, 2265, 1.36534e+06
n100x8192-slot-inner, 4096, 134, 777, 1334, 0, 0, 2245, 1.36534e+06
n100x8192-slot-inner, 4096, 136, 779, 1335, 0, 0, 2250, 1.36534e+06
n100x8192-slot-inner, 4096, 134, 775, 1333, 0, 0, 2242, 1.36534e+06
n100x8192-slot-inner, 4096, 136, 777, 1349, 0, 0, 2262, 1.36534e+06
n100x8192-slot-inner, 4096, 133, 775, 1331, 0, 0, 2239, 1.36534e+06
n100x8192-slot-inner, 4096, 133, 780, 1327, 0, 0, 2240, 1.36534e+06
n100x8192-slot-inner, 4096, 135, 782, 1337, 0, 0, 2254, 1.36534e+06
n100x8192-slot-inner, 4096, 143, 772, 1392, 0, 0, 2307, 1.36534e+06
n100x8192-slot-inner, 4096, 132, 776, 1347, 0, 0, 2255, 1.36534e+06
n100x8192-slot-inner, 4096, 136, 779, 1340, 0, 0, 2255, 1.36534e+06
n100x8192-slot-inner, 4096, 133, 777, 1353, 0, 0, 2263, 1.36534e+06
n100x8192-slot-inner, 4096, 132, 775, 1343, 0, 0, 2250, 1.36534e+06
n100x8192-slot-inner, 4096, 136, 782, 1346, 0, 0, 2264, 1.36534e+06
n100x8192-slot-inner, 4096, 133, 781, 1333, 0, 0, 2247, 1.36534e+06
n100x8192-slot-inner, 4096, 135, 779, 1337, 0, 0, 2251, 1.36534e+06
n100x8192-slot-inner, 4096, 136, 772, 1344, 0, 0, 2252, 1.36534e+06
n100x8192-slot-inner, 4096, 132, 786, 1341, 0, 0, 2259, 1.36534e+06
n100x8192-slot-inner, 4096, 134, 780, 1325, 0, 0, 2239, 1.36534e+06
n100x8192-slot-inner, 4096, 133, 775, 1346, 0, 0, 2254, 1.36534e+06
n100x8192-slot-inner, 4096, 138, 786, 1340, 0, 0, 2264, 1.36534e+06
n100x8192-slot-inner, 4096, 132, 772, 1333, 0, 0, 2237, 1.36534e+06
n100x8192-slot-inner, 4096, 134, 771, 1341, 0, 0, 2246, 1.36534e+06
n100x8192-slot-inner, 4096, 132, 773, 1346, 0, 0, 2251, 1.36534e+06
n100x8192-slot-inner, 4096, 133, 786, 1347, 0, 0, 2266, 1.36534e+06
n100x8192-slot-inner, 4096, 133, 776, 1338, 0, 0, 2247, 1.36534e+06
n100x8192-slot-inner, 4096, 137, 782, 1352, 0, 0, 2271, 1.36534e+06
n100x8192-slot-inner, 4096, 133, 777, 1331, 0, 0, 2241, 1.36534e+06
n100x8192-slot-inner, 4096, 136, 775, 1344, 0, 0, 2255, 1.36534e+06
n100x8192-slot-inner, 4096, 135, 773, 1349, 0, 0, 2257, 1.36534e+06
n100x8192-slot-inner, 4096, 135, 779, 1347, 0, 0, 2261, 1.36534e+06
n100x8192-slot-inner, 4096, 135, 782, 1348, 0, 0, 2265, 1.36534e+06
n100x8192-slot-inner, 4096, 134, 780, 1346, 0, 0, 2260, 1.36534e+06
n100x8192-slot-inner, 4096, 134, 789, 1350, 0, 0, 2273, 1.36534e+06
n100x8192-slot-inner, 4096, 135, 783, 1350, 0, 0, 2268, 1.36534e+06
n100x8192-slot-inner, 4096, 135, 796, 1386, 0, 0, 2317, 1.36534e+06
n100x8192-slot-inner, 4096, 138, 799, 1380, 0, 0, 2317, 1.36534e+06
n100x8192-slot-inner, 4096, 141, 786, 1363, 0, 0, 2290, 1.36534e+06
n100x8192-slot-inner, 4096, 136, 783, 1372, 0, 0, 2291, 1.36534e+06
n100x8192-slot-inner, 4096, 134, 782, 1366, 0, 0, 2282, 1.36534e+06
n100x8192-slot-inner, 4096, 135, 785, 1356, 0, 0, 2276, 1.36534e+06
n100x8192-slot-inner, 4096, 134, 785, 1354, 0, 0, 2273, 1.36534e+06
n100x8192-slot-inner, 4096, 138, 791, 1419, 0, 0, 2348, 1.36534e+06
n100x8192-slot-inner, 4096, 134, 780, 1348, 0, 0, 2262, 1.36534e+06
n100x8192-slot-inner, 4096, 136, 788, 1357, 0, 0, 2281, 1.36534e+06
n100x8192-slot-inner, 4096, 136, 785, 1362, 0, 0, 2283, 1.36534e+06
n100x8192-slot-inner, 4096, 135, 789, 1355, 0, 0, 2279, 1.36534e+06
n100x8192-slot-inner, 4096, 137, 790, 1360, 0, 0, 2287, 1.36534e+06
n100x8192-slot-inner, 4096, 132, 782, 1361, 0, 0, 2275, 1.36534e+06
n100x8192-slot-inner, 4096, 134, 785, 1351, 0, 0, 2270, 1.36534e+06
n100x8192-slot-inner, 4096, 133, 778, 1354, 0, 0, 2265, 1.36534e+06
n100x8192-slot-inner, 4096, 136, 794, 1361, 0, 0, 2291, 1.36534e+06
n100x8192-slot-inner, 4096, 145, 780, 1415, 0, 0, 2340, 1.36534e+06
n100x8192-slot-inner, 4096, 138, 786, 1361, 0, 0, 2285, 1.36534e+06
n100x8192-slot-inner, 4096, 134, 781, 1357, 0, 0, 2272, 1.36534e+06
n100x8192-slot-inner, 4096, 134, 783, 1358, 0, 0, 2275, 1.36534e+06
n100x8192-slot-inner, 4096, 135, 788, 1343, 0, 0, 2266, 1.36534e+06
n100x8192-slot-inner, 4096, 133, 784, 1359, 0, 0, 2276, 1.36534e+06
n100x8192-slot-inner, 4096, 137, 776, 1397, 0, 0, 2310, 1.36534e+06
n100x8192-slot-inner, 4096, 136, 780, 1356, 0, 0, 2272, 1.36534e+06
n100x8192-slot-inner, 4096, 137, 781, 1341, 0, 0, 2259, 1.36534e+06
n100x8192-slot-inner, 4096, 137, 796, 1356, 0, 0, 2289, 1.36534e+06
n100x8192-slot-inner, 4096, 138, 795, 1350, 0, 0, 2283, 1.36534e+06
n100x8192-slot-inner, 4096, 132, 779, 1354, 0, 0, 2265, 1.36534e+06
n100x8192-slot-inner, 4096, 137, 786, 1352, 0, 0, 2275, 1.36534e+06
n100x8192-slot-inner, 4096, 133, 786, 1341, 0, 0, 2260, 1.36534e+06
n100x8192-slot-inner, 4096, 141, 777, 1386, 0, 0, 2304, 1.36534e+06
n100x8192-slot-inner, 4096, 132, 776, 1344, 0, 0, 2252, 1.36534e+06
n100x8192-slot-inner, 4096, 133, 778, 1340, 0, 0, 2251, 1.36534e+06
n100x8192-slot-inner, 4096, 136, 771, 1339, 0, 0, 2246, 1.36534e+06
n100x8192-slot-inner, 4096, 133, 780, 1347, 0, 0, 2260, 1.36534e+06
n100x8192-slot-inner, 4096, 140, 778, 1342, 0, 0, 2260, 1.36534e+06
n100x8192-slot-inner, 4096, 136, 785, 1351, 0, 0, 2272, 1.36534e+06
n100x8192-slot-inner, 4096, 133, 777, 1344, 0, 0, 2254, 1.36534e+06
n100x8192-slot-inner, 4096, 132, 774, 1343, 0, 0, 2249, 1.36534e+06
n100x8192-slot-inner, 4096, 135, 780, 1333, 0, 0, 2248, 1.36534e+06
n100x8192-slot-inner, 4096, 133, 777, 1352, 0, 0, 2262, 1.36534e+06
n100x8192-slot-inner, 4096, 133, 779, 1344, 0, 0, 2256, 1.36534e+06
n100x8192-slot-inner, 4096, 136, 777, 1341, 0, 0, 2254, 1.36534e+06
n100x8192-slot-inner, 4096, 133, 778, 1340, 0, 0, 2251, 1.36534e+06
n100x8192-slot-inner, 4096, 131, 781, 1340, 0, 0, 2252, 1.36534e+06
n100x8192-slot-inner, 4096, 138, 773, 1339, 0, 0, 2250, 1.36534e+06
n100x8192-slot-inner, 4096, 137, 777, 1394, 0, 0, 2308, 1.36534e+06
n100x8192-slot-inner, 4096, 138, 787, 1359, 0, 0, 2284, 1.36534e+06
n100x8192-slot-inner, 4096, 136, 776, 1341, 0, 0, 2253, 1.36534e+06
n100x8192-slot-inner, 4096, 134, 776, 1348, 0, 0, 2258, 1.36534e+06
n100x8192-slot-inner, 4096, 135, 787, 1371, 0, 0, 2293, 1.36534e+06
n100x8192-slot-inner, 4096, 138, 788, 1351, 0, 0, 2277, 1.36534e+06
n100x8192-slot-inner, 4096, 137, 784, 1355, 0, 0, 2276, 1.36534e+06
n100x8192-slot-inner, 2048, 64, 765, 1334, 0, 0, 2163, 1.36534e+06
n100x8192-slot-inner, 2048, 65, 772, 1339, 0, 0, 2176, 1.36534e+06
n100x8192-slot-inner, 2048, 65, 758, 1334, 0, 0, 2157, 1.36534e+06
n100x8192-slot-inner, 2048, 76, 757, 1370, 0, 0, 2203, 1.36534e+06
n100x8192-slot-inner, 2048, 64, 759, 1339, 0, 0, 2162, 1.36534e+06
n100x8192-slot-inner, 2048, 71, 765, 1336, 0, 0, 2172, 1.36534e+06
n100x8192-slot-inner, 2048, 64, 760, 1328, 0, 0, 2152, 1.36534e+06
n100x8192-slot-inner, 2048, 64, 763, 1325, 0, 0, 2152, 1.36534e+06
n100x8192-slot-inner, 2048, 64, 764, 1315, 0, 0, 2143, 1.36534e+06
n100x8192-slot-inner, 2048, 64, 762, 1334, 0, 0, 2160, 1.36534e+06
n100x8192-slot-inner, 2048, 64, 756, 1320, 0, 0, 2140, 1.36534e+06
n100x8192-slot-inner, 2048, 64, 758, 1313, 0, 0, 2135, 1.36534e+06
n100x8192-slot-inner, 2048, 65, 763, 1332, 0, 0, 2160, 1.36534e+06
n100x8192-slot-inner, 2048, 64, 762, 1323, 0, 0, 2149, 1.36534e+06
n100x8192-slot-inner, 2048, 64, 759, 1320, 0, 0, 2143, 1.36534e+06
n100x8192-slot-inner, 2048, 65, 757, 1319, 0, 0, 2141, 1.36534e+06
n100x8192-slot-inner, 2048, 64, 762, 1322, 0, 0, 2148, 1.36534e+06
n100x8192-slot-inner, 2048, 65, 762, 1312, 0, 0, 2139, 1.36534e+06
n100x8192-slot-inner, 2048, 64, 766, 1314, 0, 0, 2144, 1.36534e+06
n100x8192-slot-inner, 2048, 65, 761, 1319, 0, 0, 2145, 1.36534e+06
n100x8192-slot-inner, 2048, 64, 757, 1326, 0, 0, 2147, 1.36534e+06
n100x8192-slot-inner, 2048, 65, 767, 1317, 0, 0, 2149, 1.36534e+06
n100x8192-slot-inner, 2048, 65, 761, 1319, 0, 0, 2145, 1.36534e+06
n100x8192-slot-inner, 2048, 65, 760, 1325, 0, 0, 2150, 1.36534e+06
n100x8192-slot-inner, 2048, 64, 760, 1328, 0, 0, 2152, 1.36534e+06
n100x8192-slot-inner, 2048, 65, 770, 1336, 0, 0, 2171, 1.36534e+06
n100x8192-slot-inner, 2048, 67, 766, 1332, 0, 0, 2165, 1.36534e+06
n100x8192-slot-inner, 2048, 64, 761, 1323, 0, 0, 2148, 1.36534e+06
n100x8192-slot-inner, 2048, 64, 763, 1320, 0, 0, 2147, 1.36534e+06
n100x8192-slot-inner, 2048, 65, 757, 1316, 0, 0, 2138, 1.36534e+06
n100x8192-slot-inner, 2048, 64, 766, 1314, 0, 0, 2144, 1.36534e+06
n100x8192-slot-inner, 2048, 64, 759, 1321, 0, 0, 2144, 1.36534e+06
n100x8192-slot-inner, 2048, 64, 762, 1334, 0, 0, 2160, 1.36534e+06
n100x8192-slot-inner, 2048, 75, 762, 1389, 0, 0, 2226, 1.36534e+06
n100x8192-slot-inner, 2048, 68, 766, 1321, 0, 0, 2155, 1.36534e+06
n100x8192-slot-inner, 2048, 64, 758, 1305, 0, 0, 2127, 1.36534e+06
n100x8192-slot-inner, 2048, 64, 753, 1334, 0, 0, 2151, 1.36534e+06
n100x8192-slot-inner, 2048, 64, 759, 1320, 0, 0, 2143, 1.36534e+06
n100x8192-slot-inner, 2048, 64, 759, 1308, 0, 0, 2131, 1.36534e+06
n100x8192-slot-inner, 2048, 64, 762, 1313, 0, 0, 2139, 1.36534e+06
n100x8192-slot-inner, 2048, 64, 754, 1305, 0, 0, 2123, 1.36534e+06
n100x8192-slot-inner, 2048, 65, 770, 1324, 0, 0, 2159, 1.36534e+06
n100x8192-slot-inner, 2048, 64, 756, 1336, 0, 0, 2156, 1.36534e+06
n100x8192-slot-inner, 2048, 64, 757, 1321, 0, 0, 2142, 1.36534e+06
n100x8192-slot-inner, 2048, 64, 754, 1325, 0, 0, 2143, 1.36534e+06
n100x8192-slot-inner, 2048, 64, 766, 1330, 0, 0, 2160, 1.36534e+06
n100x8192-slot-inner, 2048, 65, 760, 1313, 0, 0, 2138, 1.36534e+06
n100x8192-slot-inner, 2048, 64, 760, 1324, 0, 0, 2148, 1.36534e+06
n100x8192-slot-inner, 2048, 65, 762, 1319, 0, 0, 2146, 1.36534e+06
n100x8192-slot-inner, 2048, 65, 765, 1328, 0, 0, 2158, 1.36534e+06
n100x8192-slot-inner, 2048, 64, 776, 1341, 0, 0, 2181, 1.36534e+06
n100x8192-slot-inner, 2048, 65, 766, 1331, 0, 0, 2162, 1.36534e+06
n100x8192-slot-inner, 2048, 63, 773, 1332, 0, 0, 2168, 1.36534e+06
n100x8192-slot-inner, 2048, 67, 764, 1396, 0, 0, 2227, 1.36534e+06
n100x8192-slot-inner, 2048, 65, 778, 1349, 0, 0, 2192, 1.36534e+06
n100x8192-slot-inner, 2048, 64, 785, 1342, 0, 0, 2191, 1.36534e+06
n100x8192-slot-inner, 2048, 65, 762, 1324, 0, 0, 2151, 1.36534e+06
n100x8192-slot-inner, 2048, 63, 763, 1326, 0, 0, 2152, 1.36534e+06
n100x8192-slot-inner, 2048, 64, 762, 1361, 0, 0, 2187, 1.36534e+06
n100x8192-slot-inner, 2048, 64, 767, 1324, 0, 0, 2155, 1.36534e+06
n100x8192-slot-inner, 2048, 65, 757, 1313, 0, 0, 2135, 1.36534e+06
n100x8192-slot-inner, 2048, 64, 757, 1321, 0, 0, 2142, 1.36534e+06
n100x8192-slot-inner, 2048, 64, 760, 1335, 0, 0, 2159, 1.36534e+06
n100x8192-slot-inner, 2048, 67, 774, 1394, 0, 0, 2235, 1.36534e+06
n100x8192-slot-inner, 2048, 63, 757, 1327, 0, 0, 2147, 1.36534e+06
n100x8192-slot-inner, 2048, 65, 762, 1324, 0, 0, 2151, 1.36534e+06
n100x8192-slot-inner, 2048, 63, 765, 1322, 0, 0, 2150, 1.36534e+06
n100x8192-slot-inner, 2048, 64, 762, 1335, 0, 0, 2161, 1.36534e+06
n100x8192-slot-inner, 2048, 65, 765, 1317, 0, 0, 2147, 1.36534e+06
n100x8192-slot-inner, 2048, 64, 754, 1318, 0, 0, 2136, 1.36534e+06
n100x8192-slot-inner, 2048, 63, 758, 1321, 0, 0, 2142, 1.36534e+06
n100x8192-slot-inner, 2048, 64, 756, 1316, 0, 0, 2136, 1.36534e+06
n100x8192-slot-inner, 2048, 64, 758, 1325, 0, 0, 2147, 1.36534e+06
n100x8192-slot-inner, 2048, 64, 756, 1314, 0, 0, 2134, 1.36534e+06
n100x8192-slot-inner, 2048, 64, 756, 1316, 0, 0, 2136, 1.36534e+06
n100x8192-slot-inner, 2048, 65, 765, 1309, 0, 0, 2139, 1.36534e+06
n100x8192-slot-inner, 2048, 64, 762, 1316, 0, 0, 2142, 1.36534e+06
n100x8192-slot-inner, 2048, 66, 762, 1341, 0, 0, 2169, 1.36534e+06
n100x8192-slot-inner, 2048, 64, 770, 1358, 0, 0, 2192, 1.36534e+06
n100x8192-slot-inner, 2048, 66, 789, 1344, 0, 0, 2199, 1.36534e+06
n100x8192-slot-inner, 2048, 64, 758, 1356, 0, 0, 2178, 1.36534e+06
n100x8192-slot-inner, 2048, 65, 767, 1341, 0, 0, 2173, 1.36534e+06
n100x8192-slot-inner, 2048, 67, 766, 1334, 0, 0, 2167, 1.36534e+06
n100x8192-slot-inner, 2048, 66, 761, 1327, 0, 0, 2154, 1.36534e+06
n100x8192-slot-inner, 2048, 74, 760, 1369, 0, 0, 2203, 1.36534e+06
n100x8192-slot-inner, 2048, 65, 763, 1324, 0, 0, 2152, 1.36534e+06
n100x8192-slot-inner, 2048, 65, 761, 1327, 0, 0, 2153, 1.36534e+06
n100x8192-slot-inner, 2048, 64, 760, 1324, 0, 0, 2148, 1.36534e+06
n100x8192-slot-inner, 2048, 64, 766, 1329, 0, 0, 2159, 1.36534e+06
n100x8192-slot-inner, 2048, 63, 759, 1305, 0, 0, 2127, 1.36534e+06
n100x8192-slot-inner, 2048, 64, 761, 1324, 0, 0, 2149, 1.36534e+06
n100x8192-slot-inner, 2048, 64, 754, 1323, 0, 0, 2141, 1.36534e+06
n100x8192-slot-inner, 2048, 64, 757, 1312, 0, 0, 2133, 1.36534e+06
n100x8192-slot-inner, 2048, 65, 762, 1324, 0, 0, 2151, 1.36534e+06
n100x8192-slot-inner, 2048, 68, 768, 1324, 0, 0, 2160, 1.36534e+06
n100x8192-slot-inner, 2048, 68, 760, 1374, 0, 0, 2202, 1.36534e+06
n100x8192-slot-inner, 2048, 64, 758, 1311, 0, 0, 2133, 1.36534e+06
n100x8192-slot-inner, 2048, 66, 758, 1322, 0, 0, 2146, 1.36534e+06
n100x8192-slot-inner, 2048, 70, 763, 1336, 0, 0, 2169, 1.36534e+06
n100x8192-slot-inner, 2048, 64, 756, 1329, 0, 0, 2149, 1.36534e+06
n100x8192-slot-inner, 1024, 35, 760, 1353, 0, 0, 2148, 1.36534e+06
n100x8192-slot-inner, 1024, 34, 758, 1369, 0, 0, 2161, 1.36534e+06
n100x8192-slot-inner, 1024, 35, 764, 1361, 0, 0, 2160, 1.36534e+06
n100x8192-slot-inner, 1024, 33, 759, 1354, 0, 0, 2146, 1.36534e+06
n100x8192-slot-inner, 1024, 34, 754, 1366, 0, 0, 2154, 1.36534e+06
n100x8192-slot-inner, 1024, 34, 762, 1377, 0, 0, 2173, 1.36534e+06
n100x8192-slot-inner, 1024, 35, 764, 1357, 0, 0, 2156, 1.36534e+06
n100x8192-slot-inner, 1024, 35, 760, 1365, 0, 0, 2160, 1.36534e+06
n100x8192-slot-inner, 1024, 36, 760, 1359, 0, 0, 2155, 1.36534e+06
n100x8192-slot-inner, 1024, 35, 765, 1364, 0, 0, 2164, 1.36534e+06
n100x8192-slot-inner, 1024, 34, 766, 1372, 0, 0, 2172, 1.36534e+06
n100x8192-slot-inner, 1024, 34, 770, 1356, 0, 0, 2160, 1.36534e+06
n100x8192-slot-inner, 1024, 34, 757, 1361, 0, 0, 2152, 1.36534e+06
n100x8192-slot-inner, 1024, 33, 761, 1372, 0, 0, 2166, 1.36534e+06
n100x8192-slot-inner, 1024, 34, 755, 1357, 0, 0, 2146, 1.36534e+06
n100x8192-slot-inner, 1024, 34, 762, 1362, 0, 0, 2158, 1.36534e+06
n100x8192-slot-inner, 1024, 34, 761, 1358, 0, 0, 2153, 1.36534e+06
n100x8192-slot-inner, 1024, 34, 762, 1364, 0, 0, 2160, 1.36534e+06
n100x8192-slot-inner, 1024, 33, 757, 1373, 0, 0, 2163, 1.36534e+06
n100x8192-slot-inner, 1024, 34, 761, 1361, 0, 0, 2156, 1.36534e+06
n100x8192-slot-inner, 1024, 34, 773, 1365, 0, 0, 2172, 1.36534e+06
n100x8192-slot-inner, 1024, 34, 758, 1363, 0, 0, 2155, 1.36534e+06
n100x8192-slot-inner, 1024, 34, 764, 1365, 0, 0, 2163, 1.36534e+06
n100x8192-slot-inner, 1024, 34, 759, 1365, 0, 0, 2158, 1.36534e+06
n100x8192-slot-inner, 1024, 35, 760, 1363, 0, 0, 2158, 1.36534e+06
n100x8192-slot-inner, 1024, 35, 758, 1350, 0, 0, 2143, 1.36534e+06
n100x8192-slot-inner, 1024, 34, 760, 1365, 0, 0, 2159, 1.36534e+06
n100x8192-slot-inner, 1024, 33, 759, 1351, 0, 0, 2143, 1.36534e+06
n100x8192-slot-inner, 1024, 35, 760, 1409, 0, 0, 2204, 1.36534e+06
n100x8192-slot-inner, 1024, 34, 765, 1358, 0, 0, 2157, 1.36534e+06
n100x8192-slot-inner, 1024, 33, 753, 1357, 0, 0, 2143, 1.36534e+06
n100x8192-slot-inner, 1024, 34, 762, 1374, 0, 0, 2170, 1.36534e+06
n100x8192-slot-inner, 1024, 37, 761, 1385, 0, 0, 2183, 1.36534e+06
n100x8192-slot-inner, 1024, 34, 758, 1377, 0, 0, 2169, 1.36534e+06
n100x8192-slot-inner, 1024, 34, 765, 1358, 0, 0, 2157, 1.36534e+06
n100x8192-slot-inner, 1024, 35, 758, 1371, 0, 0, 2164, 1.36534e+06
n100x8192-slot-inner, 1024, 35, 764, 1361, 0, 0, 2160, 1.36534e+06
n100x8192-slot-inner, 1024, 35, 761, 1372, 0, 0, 2168, 1.36534e+06
n100x8192-slot-inner, 1024, 34, 762, 1357, 0, 0, 2153, 1.36534e+06
n100x8192-slot-inner, 1024, 34, 760, 1368, 0, 0, 2162, 1.36534e+06
n100x8192-slot-inner, 1024, 33, 758, 1372, 0, 0, 2163, 1.36534e+06
n100x8192-slot-inner, 1024, 34, 761, 1373, 0, 0, 2168, 1.36534e+06
n100x8192-slot-inner, 1024, 35, 760, 1372, 0, 0, 2167, 1.36534e+06
n100x8192-slot-inner, 1024, 34, 765, 1354, 0, 0, 2153, 1.36534e+06
n100x8192-slot-inner, 1024, 34, 761, 1371, 0, 0, 2166, 1.36534e+06
n100x8192-slot-inner, 1024, 34, 766, 1380, 0, 0, 2180, 1.36534e+06
n100x8192-slot-inner, 1024, 35, 767, 1383, 0, 0, 2185, 1.36534e+06
n100x8192-slot-inner, 1024, 35, 767, 1373, 0, 0, 2175, 1.36534e+06
n100x8192-slot-inner, 1024, 34, 768, 1383, 0, 0, 2185, 1.36534e+06
n100x8192-slot-inner, 1024, 35, 765, 1367, 0, 0, 2167, 1.36534e+06
n100x8192-slot-inner, 1024, 34, 764, 1371, 0, 0, 2169, 1.36534e+06
n100x8192-slot-inner, 1024, 34, 769, 1376, 0, 0, 2179, 1.36534e+06
n100x8192-slot-inner, 1024, 33, 766, 1368, 0, 0, 2167, 1.36534e+06
n100x8192-slot-inner, 1024, 35, 763, 1372, 0, 0, 2170, 1.36534e+06
n100x8192-slot-inner, 1024, 34, 767, 1376, 0, 0, 2177, 1.36534e+06
n100x8192-slot-inner, 1024, 34, 765, 1374, 0, 0, 2173, 1.36534e+06
n100x8192-slot-inner, 1024, 36, 763, 1377, 0, 0, 2176, 1.36534e+06
n100x8192-slot-inner, 1024, 34, 760, 1368, 0, 0, 2162, 1.36534e+06
n100x8192-slot-inner, 1024, 35, 768, 1378, 0, 0, 2181, 1.36534e+06
n100x8192-slot-inner, 1024, 34, 767, 1399, 0, 0, 2200, 1.36534e+06
n100x8192-slot-inner, 1024, 35, 764, 1371, 0, 0, 2170, 1.36534e+06
n100x8192-slot-inner, 1024, 33, 768, 1367, 0, 0, 2168, 1.36534e+06
n100x8192-slot-inner, 1024, 34, 765, 1382, 0, 0, 2181, 1.36534e+06
n100x8192-slot-inner, 1024, 35, 759, 1414, 0, 0, 2208, 1.36534e+06
n100x8192-slot-inner, 1024, 35, 763, 1375, 0, 0, 2173, 1.36534e+06
n100x8192-slot-inner, 1024, 35, 760, 1360, 0, 0, 2155, 1.36534e+06
n100x8192-slot-inner, 1024, 34, 761, 1354, 0, 0, 2149, 1.36534e+06
n100x8192-slot-inner, 1024, 35, 765, 1357, 0, 0, 2157, 1.36534e+06
n100x8192-slot-inner, 1024, 35, 756, 1345, 0, 0, 2136, 1.36534e+06
n100x8192-slot-inner, 1024, 35, 765, 1364, 0, 0, 2164, 1.36534e+06
n100x8192-slot-inner, 1024, 34, 758, 1354, 0, 0, 2146, 1.36534e+06
n100x8192-slot-inner, 1024, 34, 761, 1348, 0, 0, 2143, 1.36534e+06
n100x8192-slot-inner, 1024, 34, 754, 1358, 0, 0, 2146, 1.36534e+06
n100x8192-slot-inner, 1024, 34, 759, 1361, 0, 0, 2154, 1.36534e+06
n100x8192-slot-inner, 1024, 34, 754, 1359, 0, 0, 2147, 1.36534e+06
n100x8192-slot-inner, 1024, 33, 754, 1358, 0, 0, 2145, 1.36534e+06
n100x8192-slot-inner, 1024, 35, 768, 1365, 0, 0, 2168, 1.36534e+06
n100x8192-slot-inner, 1024, 35, 759, 1365, 0, 0, 2159, 1.36534e+06
n100x8192-slot-inner, 1024, 34, 759, 1359, 0, 0, 2152, 1.36534e+06
n100x8192-slot-inner, 1024, 34, 756, 1356, 0, 0, 2146, 1.36534e+06
n100x8192-slot-inner, 1024, 34, 759, 1356, 0, 0, 2149, 1.36534e+06
n100x8192-slot-inner, 1024, 35, 760, 1344, 0, 0, 2139, 1.36534e+06
n100x8192-slot-inner, 1024, 33, 762, 1369, 0, 0, 2164, 1.36534e+06
n100x8192-slot-inner, 1024, 34, 759, 1360, 0, 0, 2153, 1.36534e+06
n100x8192-slot-inner, 1024, 36, 753, 1359, 0, 0, 2148, 1.36534e+06
n100x8192-slot-inner, 1024, 34, 758, 1367, 0, 0, 2159, 1.36534e+06
n100x8192-slot-inner, 1024, 35, 759, 1389, 0, 0, 2183, 1.36534e+06
n100x8192-slot-inner, 1024, 35, 760, 1361, 0, 0, 2156, 1.36534e+06
n100x8192-slot-inner, 1024, 34, 760, 1364, 0, 0, 2158, 1.36534e+06
n100x8192-slot-inner, 1024, 34, 760, 1384, 0, 0, 2178, 1.36534e+06
n100x8192-slot-inner, 1024, 33, 757, 1371, 0, 0, 2161, 1.36534e+06
n100x8192-slot-inner, 1024, 34, 756, 1356, 0, 0, 2146, 1.36534e+06
n100x8192-slot-inner, 1024, 34, 754, 1347, 0, 0, 2135, 1.36534e+06
n100x8192-slot-inner, 1024, 35, 760, 1359, 0, 0, 2154, 1.36534e+06
n100x8192-slot-inner, 1024, 34, 761, 1363, 0, 0, 2158, 1.36534e+06
n100x8192-slot-inner, 1024, 34, 758, 1369, 0, 0, 2161, 1.36534e+06
n100x8192-slot-inner, 1024, 37, 753, 1406, 0, 0, 2196, 1.36534e+06
n100x8192-slot-inner, 1024, 34, 761, 1348, 0, 0, 2143, 1.36534e+06
n100x8192-slot-inner, 1024, 33, 752, 1361, 0, 0, 2146, 1.36534e+06
n100x8192-slot-inner, 1024, 34, 756, 1355, 0, 0, 2145, 1.36534e+06
n100x8192-coef-inner, 8192, 49, 2763, 1379, 1, 0, 4192, 1.36534e+06
n100x8192-coef-inner, 8192, 51, 2767, 1366, 1, 0, 4185, 1.36534e+06
n100x8192-coef-inner, 8192, 54, 2754, 1375, 1, 0, 4184, 1.36534e+06
n100x8192-coef-inner, 8192, 55, 2744, 1371, 1, 0, 4171, 1.36534e+06
n100x8192-coef-inner, 8192, 54, 2758, 1370, 1, 0, 4183, 1.36534e+06
n100x8192-coef-inner, 8192, 50, 2755, 1359, 1, 0, 4165, 1.36534e+06
n100x8192-coef-inner, 8192, 51, 2766, 1380, 1, 0, 4198, 1.36534e+06
n100x8192-coef-inner, 8192, 54, 2765, 1374, 1, 0, 4194, 1.36534e+06
n100x8192-coef-inner, 8192, 54, 2776, 1430, 1, 0, 4261, 1.36534e+06
n100x8192-coef-inner, 8192, 50, 2780, 1380, 1, 0, 4211, 1.36534e+06
n100x8192-coef-inner, 8192, 54, 2787, 1382, 1, 0, 4224, 1.36534e+06
n100x8192-coef-inner, 8192, 51, 2778, 1364, 1, 0, 4194, 1.36534e+06
n100x8192-coef-inner, 8192, 51, 2751, 1419, 1, 0, 4222, 1.36534e+06
n100x8192-coef-inner, 8192, 51, 2753, 1429, 1, 0, 4234, 1.36534e+06
n100x8192-coef-inner, 8192, 56, 2751, 1371, 1, 0, 4179, 1.36534e+06
n100x8192-coef-inner, 8192, 50, 2746, 1370, 1, 0, 4167, 1.36534e+06
n100x8192-coef-inner, 8192, 54, 2762, 1372, 1, 0, 4189, 1.36534e+06
n100x8192-coef-inner, 8192, 52, 2746, 1363, 1, 0, 4162, 1.36534e+06
n100x8192-coef-inner, 8192, 51, 2743, 1378, 1, 0, 4173, 1.36534e+06
n100x8192-coef-inner, 8192, 52, 2769, 1358, 1, 0, 4180, 1.36534e+06
n100x8192-coef-inner, 8192, 55, 2763, 1372, 1, 0, 4191, 1.36534e+06
n100x8192-coef-inner, 8192, 54, 2758, 1372, 1, 0, 4185, 1.36534e+06
n100x8192-coef-inner, 8192, 50, 2752, 1437, 1, 0, 4240, 1.36534e+06
n100x8192-coef-inner, 8192, 53, 2771, 1425, 1, 0, 4250, 1.36534e+06
n100x8192-coef-inner, 8192, 53, 2755, 1432, 1, 0, 4241, 1.36534e+06
n100x8192-coef-inner, 8192, 50, 2756, 1369, 1, 0, 4176, 1.36534e+06
n100x8192-coef-inner, 8192, 51, 2751, 1425, 1, 0, 4228, 1.36534e+06
n100x8192-coef-inner, 8192, 56, 2757, 1361, 1, 0, 4175, 1.36534e+06
n100x8192-coef-inner, 8192, 52, 2772, 1441, 1, 0, 4266, 1.36534e+06
n100x8192-coef-inner, 8192, 52, 2767, 1370, 1, 0, 4190, 1.36534e+06
n100x8192-coef-inner, 8192, 60, 2759, 1431, 1, 0, 4251, 1.36534e+06
n100x8192-coef-inner, 8192, 53, 2770, 1365, 1, 0, 4189, 1.36534e+06
n100x8192-coef-inner, 8192, 50, 2763, 1370, 1, 0, 4184, 1.36534e+06
n100x8192-coef-inner, 8192, 51, 2764, 1393, 1, 0, 4209, 1.36534e+06
n100x8192-coef-inner, 8192, 54, 2798, 1380, 1, 0, 4233, 1.36534e+06
n100x8192-coef-inner, 8192, 55, 2792, 1378, 1, 0, 4226, 1.36534e+06
n100x8192-coef-inner, 8192, 52, 2773, 1395, 1, 0, 4221, 1.36534e+06
n100x8192-coef-inner, 8192, 54, 2786, 1377, 1, 0, 4218, 1.36534e+06
n100x8192-coef-inner, 8192, 51, 2765, 1379, 1, 0, 4196, 1.36534e+06
n100x8192-coef-inner, 8192, 51, 2764, 1386, 1, 0, 4202, 1.36534e+06
n100x8192-coef-inner, 8192, 51, 2773, 1377, 1, 0, 4202, 1.36534e+06
n100x8192-coef-inner, 8192, 52, 2784, 1381, 1, 0, 4218, 1.36534e+06
n100x8192-coef-inner, 8192, 52, 2793, 1400, 1, 0, 4246, 1.36534e+06
n100x8192-coef-inner, 8192, 51, 2781, 1374, 1, 0, 4207, 1.36534e+06
n100x8192-coef-inner, 8192, 51, 2764, 1372, 1, 0, 4188, 1.36534e+06
n100x8192-coef-inner, 8192, 53, 2771, 1373, 1, 0, 4198, 1.36534e+06
n100x8192-coef-inner, 8192, 51, 2753, 1367, 1, 0, 4172, 1.36534e+06
n100x8192-coef-inner, 8192, 55, 2770, 1377, 1, 0, 4203, 1.36534e+06
n100x8192-coef-inner, 8192, 52, 2770, 1380, 1, 0, 4203, 1.36534e+06
n100x8192-coef-inner, 8192, 51, 2770, 1371, 1, 0, 4193, 1.36534e+06
n100x8192-coef-inner, 8192, 53, 2767, 1376, 1, 0, 4197, 1.36534e+06
n100x8192-coef-inner, 8192, 52, 2748, 1424, 1, 0, 4225, 1.36534e+06
n100x8192-coef-inner, 8192, 50, 2761, 1372, 1, 0, 4184, 1.36534e+06
n100x8192-coef-inner, 8192, 53, 2752, 1372, 1, 0, 4178, 1.36534e+06
n100x8192-coef-inner, 8192, 53, 2752, 1365, 1, 0, 4171, 1.36534e+06
n100x8192-coef-inner, 8192, 52, 2753, 1372, 1, 0, 4178, 1.36534e+06
n100x8192-coef-inner, 8192, 51, 2763, 1434, 1, 0, 4249, 1.36534e+06
n100x8192-coef-inner, 8192, 52, 2748, 1369, 1, 0, 4170, 1.36534e+06
n100x8192-coef-inner, 8192, 63, 2755, 1371, 1, 0, 4190, 1.36534e+06
n100x8192-coef-inner, 8192, 58, 2751, 1426, 1, 0, 4236, 1.36534e+06
n100x8192-coef-inner, 8192, 51, 2763, 1375, 1, 0, 4190, 1.36534e+06
n100x8192-coef-inner, 8192, 51, 2763, 1366, 1, 0, 4181, 1.36534e+06
n100x8192-coef-inner, 8192, 53, 2757, 1366, 1, 0, 4177, 1.36534e+06
n100x8192-coef-inner, 8192, 52, 2781, 1382, 1, 0, 4216, 1.36534e+06
n100x8192-coef-inner, 8192, 53, 2764, 1429, 1, 0, 4247, 1.36534e+06
n100x8192-coef-inner, 8192, 52, 2772, 1373, 1, 0, 4198, 1.36534e+06
n100x8192-coef-inner, 8192, 52, 2757, 1366, 1, 0, 4176, 1.36534e+06
n100x8192-coef-inner, 8192, 52, 2747, 1368, 1, 0, 4168, 1.36534e+06
n100x8192-coef-inner, 8192, 57, 2754, 1361, 1, 0, 4173, 1.36534e+06
n100x8192-coef-inner, 8192, 54, 2768, 1367, 1, 0, 4190, 1.36534e+06
n100x8192-coef-inner, 8192, 55, 2751, 1428, 1, 0, 4235, 1.36534e+06
n100x8192-coef-inner, 8192, 52, 2759, 1376, 1, 0, 4188, 1.36534e+06
n100x8192-coef-inner, 8192, 51, 2774, 1367, 1, 0, 4193, 1.36534e+06
n100x8192-coef-inner, 8192, 51, 2757, 1377, 1, 0, 4186, 1.36534e+06
n100x8192-coef-inner, 8192, 53, 2747, 1372, 1, 0, 4173, 1.36534e+06
n100x8192-coef-inner, 8192, 51, 2753, 1423, 1, 0, 4228, 1.36534e+06
n100x8192-coef-inner, 8192, 50, 2750, 1380, 1, 0, 4181, 1.36534e+06
n100x8192-coef-inner, 8192, 56, 2805, 1450, 1, 0, 4312, 1.36534e+06
n100x8192-coef-inner, 8192, 52, 2804, 1402, 1, 0, 4259, 1.36534e+06
n100x8192-coef-inner, 8192, 50, 2798, 1374, 1, 0, 4223, 1.36534e+06
n100x8192-coef-inner, 8192, 53, 2769, 1455, 1, 0, 4278, 1.36534e+06
n100x8192-coef-inner, 8192, 55, 2781, 1443, 1, 0, 4280, 1.36534e+06
n100x8192-coef-inner, 8192, 52, 2783, 1445, 1, 0, 4281, 1.36534e+06
n100x8192-coef-inner, 8192, 53, 2795, 1389, 1, 0, 4238, 1.36534e+06
n100x8192-coef-inner, 8192, 54, 2784, 1379, 1, 0, 4218, 1.36534e+06
n100x8192-coef-inner, 8192, 51, 2763, 1382, 1, 0, 4197, 1.36534e+06
n100x8192-coef-inner, 8192, 54, 2781, 1387, 1, 0, 4223, 1.36534e+06
n100x8192-coef-inner, 8192, 52, 2775, 1389, 1, 0, 4217, 1.36534e+06
n100x8192-coef-inner, 8192, 50, 2777, 1382, 1, 0, 4210, 1.36534e+06
n100x8192-coef-inner, 8192, 53, 2779, 1377, 1, 0, 4210, 1.36534e+06
n100x8192-coef-inner, 8192, 53, 2775, 1384, 1, 0, 4213, 1.36534e+06
n100x8192-coef-inner, 8192, 52, 2773, 1439, 1, 0, 4265, 1.36534e+06
n100x8192-coef-inner, 8192, 52, 2761, 1377, 1, 0, 4191, 1.36534e+06
n100x8192-coef-inner, 8192, 59, 2775, 1410, 1, 0, 4245, 1.36534e+06
n100x8192-coef-inner, 8192, 52, 2752, 1378, 1, 0, 4183, 1.36534e+06
n100x8192-coef-inner, 8192, 54, 2773, 1375, 1, 0, 4203, 1.36534e+06
n100x8192-coef-inner, 8192, 53, 2767, 1370, 1, 0, 4191, 1.36534e+06
n100x8192-coef-inner, 8192, 53, 2766, 1374, 1, 0, 4194, 1.36534e+06
n100x8192-coef-inner, 8192, 53, 2762, 1371, 1, 0, 4187, 1.36534e+06
n100x8192-coef-inner, 8192, 52, 2761, 1369, 1, 0, 4183, 1.36534e+06
n100x8192-coef-inner, 4096, 31, 2743, 1333, 0, 0, 4107, 1.36534e+06
n100x8192-coef-inner, 4096, 36, 2736, 1345, 0, 0, 4117, 1.36534e+06
n100x8192-coef-inner, 4096, 28, 2736, 1322, 0, 0, 4086, 1.36534e+06
n100x8192-coef-inner, 4096, 28, 2730, 1350, 0, 0, 4108, 1.36534e+06
n100x8192-coef-inner, 4096, 27, 2728, 1340, 0, 0, 4095, 1.36534e+06
n100x8192-coef-inner, 4096, 30, 2750, 1393, 0, 0, 4173, 1.36534e+06
n100x8192-coef-inner, 4096, 28, 2742, 1336, 0, 0, 4106, 1.36534e+06
n100x8192-coef-inner, 4096, 31, 2739, 1333, 0, 0, 4103, 1.36534e+06
n100x8192-coef-inner, 4096, 29, 2743, 1351, 0, 0, 4123, 1.36534e+06
n100x8192-coef-inner, 4096, 28, 2743, 1334, 0, 0, 4105, 1.36534e+06
n100x8192-coef-inner, 4096, 28, 2736, 1336, 0, 0, 4100, 1.36534e+06
n100x8192-coef-inner, 4096, 29, 2734, 1334, 0, 0, 4097, 1.36534e+06
n100x8192-coef-inner, 4096, 29, 2747, 1347, 0, 0, 4123, 1.36534e+06
n100x8192-coef-inner, 4096, 38, 2725, 1397, 0, 0, 4160, 1.36534e+06
n100x8192-coef-inner, 4096, 27, 2726, 1331, 0, 0, 4084, 1.36534e+06
n100x8192-coef-inner, 4096, 27, 2744, 1335, 0, 0, 4106, 1.36534e+06
n100x8192-coef-inner, 4096, 27, 2730, 1341, 0, 0, 4098, 1.36534e+06
n100x8192-coef-inner, 4096, 33, 2738, 1346, 0, 0, 4117, 1.36534e+06
n100x8192-coef-inner, 4096, 28, 2727, 1338, 0, 0, 4093, 1.36534e+06
n100x8192-coef-inner, 4096, 29, 2748, 1392, 0, 0, 4169, 1.36534e+06
n100x8192-coef-inner, 4096, 28, 2760, 1338, 0, 0, 4126, 1.36534e+06
n100x8192-coef-inner, 4096, 27, 2730, 1396, 0, 0, 4153, 1.36534e+06
n100x8192-coef-inner, 4096, 32, 2735, 1332, 0, 0, 4099, 1.36534e+06
n100x8192-coef-inner, 4096, 32, 2738, 1337, 0, 0, 4107, 1.36534e+06
n100x8192-coef-inner, 4096, 27, 2720, 1330, 0, 0, 4077, 1.36534e+06
n100x8192-coef-inner, 4096, 28, 2722, 1330, 0, 0, 4080, 1.36534e+06
n100x8192-coef-inner, 4096, 27, 2715, 1318, 0, 0, 4060, 1.36534e+06
n100x8192-coef-inner, 4096, 31, 2722, 1323, 0, 0, 4076, 1.36534e+06
n100x8192-coef-inner, 4096, 29, 2736, 1325, 0, 0, 4090, 1.36534e+06
n100x8192-coef-inner, 4096, 29, 2717, 1333, 0, 0, 4079, 1.36534e+06
n100x8192-coef-inner, 4096, 28, 2721, 1324, 0, 0, 4073, 1.36534e+06
n100x8192-coef-inner, 4096, 29, 2728, 1326, 0, 0, 4083, 1.36534e+06
n100x8192-coef-inner, 4096, 32, 2732, 1332, 0, 0, 4096, 1.36534e+06
n100x8192-coef-inner, 4096, 30, 2714, 1326, 0, 0, 4070, 1.36534e+06
n100x8192-coef-inner, 4096, 27, 2742, 1331, 0, 0, 4100, 1.36534e+06
n100x8192-coef-inner, 4096, 31, 2722, 1341, 0, 0, 4094, 1.36534e+06
n100x8192-coef-inner, 4096, 30, 2717, 1381, 0, 0, 4128, 1.36534e+06
n100x8192-coef-inner, 4096, 28, 2723, 1339, 0, 0, 4090, 1.36534e+06
n100x8192-coef-inner, 4096, 28, 2726, 1329, 0, 0, 4083, 1.36534e+06
n100x8192-coef-inner, 4096, 29, 2738, 1334, 0, 0, 4101, 1.36534e+06
n100x8192-coef-inner, 4096, 34, 2724, 1323, 0, 0, 4081, 1.36534e+06
n100x8192-coef-inner, 4096, 27, 2717, 1338, 0, 0, 4082, 1.36534e+06
n100x8192-coef-inner, 4096, 29, 2732, 1334, 0, 0, 4095, 1.36534e+06
n100x8192-coef-inner, 4096, 30, 2731, 1333, 0, 0, 4094, 1.36534e+06
n100x8192-coef-inner, 4096, 27, 2722, 1319, 0, 0, 4068, 1.36534e+06
n100x8192-coef-inner, 4096, 28, 2721, 1337, 0, 0, 4086, 1.36534e+06
n100x8192-coef-inner, 4096, 30, 2739, 1326, 0, 0, 4095, 1.36534e+06
n100x8192-coef-inner, 4096, 28, 2716, 1329, 0, 0, 4073, 1.36534e+06
n100x8192-coef-inner, 4096, 27, 2729, 1340, 0, 0, 4096, 1.36534e+06
n100x8192-coef-inner, 4096, 29, 2736, 1323, 0, 0, 4088, 1.36534e+06
n100x8192-coef-inner, 4096, 31, 2759, 1333, 0, 0, 4123, 1.36534e+06
n100x8192-coef-inner, 4096, 29, 2733, 1342, 0, 0, 4104, 1.36534e+06
n100x8192-coef-inner, 4096, 27, 2725, 1331, 0, 0, 4083, 1.36534e+06
n100x8192-coef-inner, 4096, 28, 2712, 1335, 0, 0, 4075, 1.36534e+06
n100x8192-coef-inner, 4096, 39, 2727, 1404, 0, 0, 4170, 1.36534e+06
n100x8192-coef-inner, 4096, 27, 2731, 1345, 0, 0, 4103, 1.36534e+06
n100x8192-coef-inner, 4096, 29, 2740, 1338, 0, 0, 4107, 1.36534e+06
n100x8192-coef-inner, 4096, 28, 2751, 1339, 0, 0, 4118, 1.36534e+06
n100x8192-coef-inner, 4096, 31, 2741, 1324, 0, 0, 4096, 1.36534e+06
n100x8192-coef-inner, 4096, 27, 2722, 1332, 0, 0, 4081, 1.36534e+06
n100x8192-coef-inner, 4096, 30, 2721, 1342, 0, 0, 4093, 1.36534e+06
n100x8192-coef-inner, 4096, 31, 2719, 1386, 0, 0, 4136, 1.36534e+06
n100x8192-coef-inner, 4096, 28, 2736, 1354, 0, 0, 4118, 1.36534e+06
n100x8192-coef-inner, 4096, 28, 2733, 1332, 0, 0, 4093, 1.36534e+06
n100x8192-coef-inner, 4096, 32, 2742, 1334, 0, 0, 4108, 1.36534e+06
n100x8192-coef-inner, 4096, 27, 2751, 1335, 0, 0, 4113, 1.36534e+06
n100x8192-coef-inner, 4096, 27, 2718, 1330, 0, 0, 4075, 1.36534e+06
n100x8192-coef-inner, 4096, 27, 2716, 1334, 0, 0, 4077, 1.36534e+06
n100x8192-coef-inner, 4096, 31, 2726, 1329, 0, 0, 4086, 1.36534e+06
n100x8192-coef-inner, 4096, 31, 2727, 1326, 0, 0, 4084, 1.36534e+06
n100x8192-coef-inner, 4096, 29, 2720, 1330, 0, 0, 4079, 1.36534e+06
n100x8192-coef-inner, 4096, 31, 2723, 1327, 0, 0, 4081, 1.36534e+06
n100x8192-coef-inner, 4096, 28, 2711, 1327, 0, 0, 4066, 1.36534e+06
n100x8192-coef-inner, 4096, 32, 2739, 1327, 0, 0, 4098, 1.36534e+06
n100x8192-coef-inner, 4096, 29, 2729, 1327, 0, 0, 4085, 1.36534e+06
n100x8192-coef-inner, 4096, 28, 2720, 1324, 0, 0, 4072, 1.36534e+06
n100x8192-coef-inner, 4096, 27, 2745, 1339, 0, 0, 4111, 1.36534e+06
n100x8192-coef-inner, 4096, 28, 2739, 1341, 0, 0, 4108, 1.36534e+06
n100x8192-coef-inner, 4096, 29, 2745, 1348, 0, 0, 4122, 1.36534e+06
n100x8192-coef-inner, 4096, 31, 2753, 1336, 0, 0, 4120, 1.36534e+06
n100x8192-coef-inner, 4096, 27, 2723, 1388, 0, 0, 4138, 1.36534e+06
n100x8192-coef-inner, 4096, 28, 2742, 1322, 0, 0, 4092, 1.36534e+06
n100x8192-coef-inner, 4096, 29, 2734, 1343, 0, 0, 4106, 1.36534e+06
n100x8192-coef-inner, 4096, 27, 2724, 1339, 0, 0, 4090, 1.36534e+06
n100x8192-coef-inner, 4096, 27, 2715, 1330, 0, 0, 4072, 1.36534e+06
n100x8192-coef-inner, 4096, 31, 2731, 1386, 0, 0, 4148, 1.36534e+06
n100x8192-coef-inner, 4096, 28, 2732, 1340, 0, 0, 4100, 1.36534e+06
n100x8192-coef-inner, 4096, 38, 2716, 1385, 0, 0, 4139, 1.36534e+06
n100x8192-coef-inner, 4096, 28, 2720, 1329, 0, 0, 4077, 1.36534e+06
n100x8192-coef-inner, 4096, 28, 2731, 1344, 0, 0, 4103, 1.36534e+06
n100x8192-coef-inner, 4096, 31, 2730, 1332, 0, 0, 4093, 1.36534e+06
n100x8192-coef-inner, 4096, 27, 2733, 1327, 0, 0, 4087, 1.36534e+06
n100x8192-coef-inner, 4096, 29, 2724, 1330, 0, 0, 4083, 1.36534e+06
n100x8192-coef-inner, 4096, 27, 2726, 1332, 0, 0, 4085, 1.36534e+06
n100x8192-coef-inner, 4096, 28, 2722, 1328, 0, 0, 4078, 1.36534e+06
n100x8192-coef-inner, 4096, 29, 2716, 1340, 0, 0, 4085, 1.36534e+06
n100x8192-coef-inner, 4096, 29, 2724, 1336, 0, 0, 4089, 1.36534e+06
n100x8192-coef-inner, 4096, 30, 2742, 1343, 0, 0, 4115, 1.36534e+06
n100x8192-coef-inner, 4096, 28, 2742, 1387, 0, 0, 4157, 1.36534e+06
n100x8192-coef-inner, 4096, 27, 2738, 1327, 0, 0, 4092, 1.36534e+06
n100x8192-coef-inner, 2048, 18, 2720, 1323, 0, 0, 4061, 1.36534e+06
n100x8192-coef-inner, 2048, 18, 2692, 1365, 0, 0, 4075, 1.36534e+06
n100x8192-coef-inner, 2048, 16, 2697, 1314, 0, 0, 4027, 1.36534e+06
n100x8192-coef-inner, 2048, 16, 2694, 1308, 0, 0, 4018, 1.36534e+06
n100x8192-coef-inner, 2048, 17, 2708, 1305, 0, 0, 4030, 1.36534e+06
n100x8192-coef-inner, 2048, 16, 2700, 1306, 0, 0, 4022, 1.36534e+06
n100x8192-coef-inner, 2048, 22, 2721, 1376, 0, 0, 4119, 1.36534e+06
n100x8192-coef-inner, 2048, 22, 2710, 1377, 0, 0, 4109, 1.36534e+06
n100x8192-coef-inner, 2048, 18, 2716, 1329, 0, 0, 4063, 1.36534e+06
n100x8192-coef-inner, 2048, 16, 2703, 1312, 0, 0, 4031, 1.36534e+06
n100x8192-coef-inner, 2048, 17, 2700, 1298, 0, 0, 4015, 1.36534e+06
n100x8192-coef-inner, 2048, 19, 2699, 1332, 0, 0, 4050, 1.36534e+06
n100x8192-coef-inner, 2048, 16, 2701, 1310, 0, 0, 4027, 1.36534e+06
n100x8192-coef-inner, 2048, 16, 2691, 1313, 0, 0, 4020, 1.36534e+06
n100x8192-coef-inner, 2048, 16, 2696, 1322, 0, 0, 4034, 1.36534e+06
n100x8192-coef-inner, 2048, 16, 2702, 1308, 0, 0, 4026, 1.36534e+06
n100x8192-coef-inner, 2048, 16, 2701, 1310, 0, 0, 4027, 1.36534e+06
n100x8192-coef-inner, 2048, 16, 2688, 1312, 0, 0, 4016, 1.36534e+06
n100x8192-coef-inner, 2048, 16, 2690, 1317, 0, 0, 4023, 1.36534e+06
n100x8192-coef-inner, 2048, 19, 2698, 1317, 0, 0, 4034, 1.36534e+06
n100x8192-coef-inner, 2048, 16, 2713, 1345, 0, 0, 4074, 1.36534e+06
n100x8192-coef-inner, 2048, 16, 2714, 1329, 0, 0, 4059, 1.36534e+06
n100x8192-coef-inner, 2048, 16, 2703, 1331, 0, 0, 4050, 1.36534e+06
n100x8192-coef-inner, 2048, 16, 2694, 1306, 0, 0, 4016, 1.36534e+06
n100x8192-coef-inner, 2048, 16, 2706, 1319, 0, 0, 4041, 1.36534e+06
n100x8192-coef-inner, 2048, 16, 2694, 1312, 0, 0, 4022, 1.36534e+06
n100x8192-coef-inner, 2048, 26, 2707, 1363, 0, 0, 4096, 1.36534e+06
n100x8192-coef-inner, 2048, 16, 2705, 1311, 0, 0, 4032, 1.36534e+06
n100x8192-coef-inner, 2048, 16, 2704, 1320, 0, 0, 4040, 1.36534e+06
n100x8192-coef-inner, 2048, 16, 2714, 1319, 0, 0, 4049, 1.36534e+06
n100x8192-coef-inner, 2048, 16, 2713, 1331, 0, 0, 4060, 1.36534e+06
n100x8192-coef-inner, 2048, 16, 2719, 1327, 0, 0, 4062, 1.36534e+06
n100x8192-coef-inner, 2048, 17, 2719, 1333, 0, 0, 4069, 1.36534e+06
n100x8192-coef-inner, 2048, 20, 2701, 1309, 0, 0, 4030, 1.36534e+06
n100x8192-coef-inner, 2048, 16, 2690, 1321, 0, 0, 4027, 1.36534e+06
n100x8192-coef-inner, 2048, 16, 2704, 1329, 0, 0, 4049, 1.36534e+06
n100x8192-coef-inner, 2048, 16, 2713, 1320, 0, 0, 4049, 1.36534e+06
n100x8192-coef-inner, 2048, 16, 2715, 1364, 0, 0, 4095, 1.36534e+06
n100x8192-coef-inner, 2048, 16, 2699, 1371, 0, 0, 4086, 1.36534e+06
n100x8192-coef-inner, 2048, 16, 2710, 1329, 0, 0, 4055, 1.36534e+06
n100x8192-coef-inner, 2048, 19, 2702, 1364, 0, 0, 4085, 1.36534e+06
n100x8192-coef-inner, 2048, 19, 2702, 1313, 0, 0, 4034, 1.36534e+06
n100x8192-coef-inner, 2048, 16, 2704, 1307, 0, 0, 4027, 1.36534e+06
n100x8192-coef-inner, 2048, 16, 2700, 1310, 0, 0, 4026, 1.36534e+06
n100x8192-coef-inner, 2048, 17, 2700, 1352, 0, 0, 4069, 1.36534e+06
n100x8192-coef-inner, 2048, 16, 2691, 1329, 0, 0, 4036, 1.36534e+06
n100x8192-coef-inner, 2048, 16, 2696, 1305, 0, 0, 4017, 1.36534e+06
n100x8192-coef-inner, 2048, 20, 2686, 1367, 0, 0, 4073, 1.36534e+06
n100x8192-coef-inner, 2048, 16, 2692, 1332, 0, 0, 4040, 1.36534e+06
n100x8192-coef-inner, 2048, 17, 2705, 1338, 0, 0, 4060, 1.36534e+06
n100x8192-coef-inner, 2048, 17, 2704, 1327, 0, 0, 4048, 1.36534e+06
n100x8192-coef-inner, 2048, 20, 2700, 1311, 0, 0, 4031, 1.36534e+06
n100x8192-coef-inner, 2048, 20, 2690, 1364, 0, 0, 4074, 1.36534e+06
n100x8192-coef-inner, 2048, 17, 2697, 1319, 0, 0, 4033, 1.36534e+06
n100x8192-coef-inner, 2048, 16, 2697, 1310, 0, 0, 4023, 1.36534e+06
n100x8192-coef-inner, 2048, 16, 2697, 1312, 0, 0, 4025, 1.36534e+06
n100x8192-coef-inner, 2048, 19, 2684, 1371, 0, 0, 4074, 1.36534e+06
n100x8192-coef-inner, 2048, 18, 2703, 1309, 0, 0, 4030, 1.36534e+06
n100x8192-coef-inner, 2048, 22, 2717, 1322, 0, 0, 4061, 1.36534e+06
n100x8192-coef-inner, 2048, 17, 2695, 1309, 0, 0, 4021, 1.36534e+06
n100x8192-coef-inner, 2048, 16, 2706, 1306, 0, 0, 4028, 1.36534e+06
n100x8192-coef-inner, 2048, 16, 2694, 1312, 0, 0, 4022, 1.36534e+06
n100x8192-coef-inner, 2048, 17, 2703, 1313, 0, 0, 4033, 1.36534e+06
n100x8192-coef-inner, 2048, 16, 2693, 1331, 0, 0, 4040, 1.36534e+06
n100x8192-coef-inner, 2048, 17, 2729, 1331, 0, 0, 4077, 1.36534e+06
n100x8192-coef-inner, 2048, 26, 2725, 1378, 0, 0, 4129, 1.36534e+06
n100x8192-coef-inner, 2048, 16, 2723, 1361, 0, 0, 4100, 1.36534e+06
n100x8192-coef-inner, 2048, 16, 2714, 1327, 0, 0, 4057, 1.36534e+06
n100x8192-coef-inner, 2048, 17, 2707, 1315, 0, 0, 4039, 1.36534e+06
n100x8192-coef-inner, 2048, 16, 2693, 1327, 0, 0, 4036, 1.36534e+06
n100x8192-coef-inner, 2048, 16, 2706, 1306, 0, 0, 4028, 1.36534e+06
n100x8192-coef-inner, 2048, 16, 2695, 1307, 0, 0, 4018, 1.36534e+06
n100x8192-coef-inner, 2048, 17, 2692, 1314, 0, 0, 4023, 1.36534e+06
n100x8192-coef-inner, 2048, 16, 2696, 1316, 0, 0, 4028, 1.36534e+06
n100x8192-coef-inner, 2048, 16, 2689, 1308, 0, 0, 4013, 1.36534e+06
n100x8192-coef-inner, 2048, 16, 2695, 1315, 0, 0, 4026, 1.36534e+06
n100x8192-coef-inner, 2048, 18, 2694, 1377, 0, 0, 4089, 1.36534e+06
n100x8192-coef-inner, 2048, 17, 2684, 1314, 0, 0, 4015, 1.36534e+06
n100x8192-coef-inner, 2048, 16, 2697, 1331, 0, 0, 4044, 1.36534e+06
n100x8192-coef-inner, 2048, 21, 2709, 1380, 0, 0, 4110, 1.36534e+06
n100x8192-coef-inner, 2048, 16, 2704, 1315, 0, 0, 4035, 1.36534e+06
n100x8192-coef-inner, 2048, 16, 2697, 1307, 0, 0, 4020, 1.36534e+06
n100x8192-coef-inner, 2048, 16, 2695, 1316, 0, 0, 4027, 1.36534e+06
n100x8192-coef-inner, 2048, 17, 2698, 1316, 0, 0, 4031, 1.36534e+06
n100x8192-coef-inner, 2048, 16, 2686, 1306, 0, 0, 4008, 1.36534e+06
n100x8192-coef-inner, 2048, 16, 2700, 1326, 0, 0, 4042, 1.36534e+06
n100x8192-coef-inner, 2048, 16, 2695, 1317, 0, 0, 4028, 1.36534e+06
n100x8192-coef-inner, 2048, 16, 2696, 1321, 0, 0, 4033, 1.36534e+06
n100x8192-coef-inner, 2048, 16, 2697, 1310, 0, 0, 4023, 1.36534e+06
n100x8192-coef-inner, 2048, 16, 2690, 1311, 0, 0, 4017, 1.36534e+06
n100x8192-coef-inner, 2048, 16, 2696, 1310, 0, 0, 4022, 1.36534e+06
n100x8192-coef-inner, 2048, 16, 2710, 1313, 0, 0, 4039, 1.36534e+06
n100x8192-coef-inner, 2048, 16, 2695, 1316, 0, 0, 4027, 1.36534e+06
n100x8192-coef-inner, 2048, 17, 2746, 1360, 0, 0, 4123, 1.36534e+06
n100x8192-coef-inner, 2048, 16, 2750, 1332, 0, 0, 4098, 1.36534e+06
n100x8192-coef-inner, 2048, 16, 2725, 1379, 0, 0, 4120, 1.36534e+06
n100x8192-coef-inner, 2048, 16, 2721, 1326, 0, 0, 4063, 1.36534e+06
n100x8192-coef-inner, 2048, 16, 2717, 1337, 0, 0, 4070, 1.36534e+06
n100x8192-coef-inner, 2048, 16, 2718, 1329, 0, 0, 4063, 1.36534e+06
n100x8192-coef-inner, 2048, 19, 2734, 1348, 0, 0, 4101, 1.36534e+06
n100x8192-coef-inner, 1024, 19, 2746, 1429, 0, 0, 4194, 1.36534e+06
n100x8192-coef-inner, 1024, 12, 2735, 1377, 0, 0, 4124, 1.36534e+06
n100x8192-coef-inner, 1024, 12, 2734, 1368, 0, 0, 4114, 1.36534e+06
n100x8192-coef-inner, 1024, 12, 2740, 1378, 0, 0, 4130, 1.36534e+06
n100x8192-coef-inner, 1024, 13, 2735, 1382, 0, 0, 4130, 1.36534e+06
n100x8192-coef-inner, 1024, 12, 2744, 1419, 0, 0, 4175, 1.36534e+06
n100x8192-coef-inner, 1024, 12, 2737, 1380, 0, 0, 4129, 1.36534e+06
n100x8192-coef-inner, 1024, 12, 2729, 1383, 0, 0, 4124, 1.36534e+06
n100x8192-coef-inner, 1024, 13, 2732, 1373, 0, 0, 4118, 1.36534e+06
n100x8192-coef-inner, 1024, 13, 2734, 1364, 0, 0, 4111, 1.36534e+06
n100x8192-coef-inner, 1024, 12, 2713, 1361, 0, 0, 4086, 1.36534e+06
n100x8192-coef-inner, 1024, 13, 2726, 1369, 0, 0, 4108, 1.36534e+06
n100x8192-coef-inner, 1024, 12, 2721, 1373, 0, 0, 4106, 1.36534e+06
n100x8192-coef-inner, 1024, 12, 2718, 1369, 0, 0, 4099, 1.36534e+06
n100x8192-coef-inner, 1024, 12, 2717, 1365, 0, 0, 4094, 1.36534e+06
n100x8192-coef-inner, 1024, 11, 2723, 1376, 0, 0, 4110, 1.36534e+06
n100x8192-coef-inner, 1024, 12, 2721, 1382, 0, 0, 4115, 1.36534e+06
n100x8192-coef-inner, 1024, 12, 2709, 1416, 0, 0, 4137, 1.36534e+06
n100x8192-coef-inner, 1024, 13, 2723, 1375, 0, 0, 4111, 1.36534e+06
n100x8192-coef-inner, 1024, 12, 2732, 1372, 0, 0, 4116, 1.36534e+06
n100x8192-coef-inner, 1024, 12, 2724, 1373, 0, 0, 4109, 1.36534e+06
n100x8192-coef-inner, 1024, 13, 2724, 1363, 0, 0, 4100, 1.36534e+06
n100x8192-coef-inner, 1024, 12, 2760, 1376, 0, 0, 4148, 1.36534e+06
n100x8192-coef-inner, 1024, 13, 2729, 1387, 0, 0, 4129, 1.36534e+06
n100x8192-coef-inner, 1024, 12, 2722, 1368, 0, 0, 4102, 1.36534e+06
n100x8192-coef-inner, 1024, 12, 2735, 1374, 0, 0, 4121, 1.36534e+06
n100x8192-coef-inner, 1024, 13, 2726, 1354, 0, 0, 4093, 1.36534e+06
n100x8192-coef-inner, 1024, 12, 2727, 1365, 0, 0, 4104, 1.36534e+06
n100x8192-coef-inner, 1024, 11, 2729, 1358, 0, 0, 4098, 1.36534e+06
n100x8192-coef-inner, 1024, 12, 2721, 1358, 0, 0, 4091, 1.36534e+06
n100x8192-coef-inner, 1024, 12, 2707, 1379, 0, 0, 4098, 1.36534e+06
n100x8192-coef-inner, 1024, 12, 2706, 1367, 0, 0, 4085, 1.36534e+06
n100x8192-coef-inner, 1024, 13, 2717, 1351, 0, 0, 4081, 1.36534e+06
n100x8192-coef-inner, 1024, 13, 2719, 1380, 0, 0, 4112, 1.36534e+06
n100x8192-coef-inner, 1024, 12, 2757, 1365, 0, 0, 4134, 1.36534e+06
n100x8192-coef-inner, 1024, 12, 2727, 1375, 0, 0, 4114, 1.36534e+06
n100x8192-coef-inner, 1024, 11, 2749, 1386, 0, 0, 4146, 1.36534e+06
n100x8192-coef-inner, 1024, 13, 2720, 1384, 0, 0, 4117, 1.36534e+06
n100x8192-coef-inner, 1024, 13, 2744, 1382, 0, 0, 4139, 1.36534e+06
n100x8192-coef-inner, 1024, 13, 2723, 1358, 0, 0, 4094, 1.36534e+06
n100x8192-coef-inner, 1024, 12, 2725, 1377, 0, 0, 4114, 1.36534e+06
n100x8192-coef-inner, 1024, 13, 2726, 1367, 0, 0, 4106, 1.36534e+06
n100x8192-coef-inner, 1024, 16, 2695, 1398, 0, 0, 4109, 1.36534e+06
n100x8192-coef-inner, 1024, 13, 2706, 1353, 0, 0, 4072, 1.36534e+06
n100x8192-coef-inner, 1024, 12, 2722, 1356, 0, 0, 4090, 1.36534e+06
n100x8192-coef-inner, 1024, 12, 2713, 1366, 0, 0, 4091, 1.36534e+06
n100x8192-coef-inner, 1024, 11, 2715, 1358, 0, 0, 4084, 1.36534e+06
n100x8192-coef-inner, 1024, 12, 2706, 1368, 0, 0, 4086, 1.36534e+06
n100x8192-coef-inner, 1024, 13, 2712, 1362, 0, 0, 4087, 1.36534e+06
n100x8192-coef-inner, 1024, 11, 2721, 1355, 0, 0, 4087, 1.36534e+06
n100x8192-coef-inner, 1024, 12, 2718, 1389, 0, 0, 4119, 1.36534e+06
n100x8192-coef-inner, 1024, 12, 2740, 1381, 0, 0, 4133, 1.36534e+06
n100x8192-coef-inner, 1024, 13, 2726, 1361, 0, 0, 4100, 1.36534e+06
n100x8192-coef-inner, 1024, 12, 2740, 1375, 0, 0, 4127, 1.36534e+06
n100x8192-coef-inner, 1024, 13, 2721, 1355, 0, 0, 4089, 1.36534e+06
n100x8192-coef-inner, 1024, 13, 2717, 1374, 0, 0, 4104, 1.36534e+06
n100x8192-coef-inner, 1024, 12, 2748, 1375, 0, 0, 4135, 1.36534e+06
n100x8192-coef-inner, 1024, 12, 2736, 1363, 0, 0, 4111, 1.36534e+06
n100x8192-coef-inner, 1024, 12, 2720, 1361, 0, 0, 4093, 1.36534e+06
n100x8192-coef-inner, 1024, 13, 2721, 1376, 0, 0, 4110, 1.36534e+06
n100x8192-coef-inner, 1024, 12, 2726, 1366, 0, 0, 4104, 1.36534e+06
n100x8192-coef-inner, 1024, 20, 2709, 1364, 0, 0, 4093, 1.36534e+06
n100x8192-coef-inner, 1024, 12, 2712, 1367, 0, 0, 4091, 1.36534e+06
n100x8192-coef-inner, 1024, 13, 2729, 1354, 0, 0, 4096, 1.36534e+06
n100x8192-coef-inner, 1024, 12, 2713, 1363, 0, 0, 4088, 1.36534e+06
n100x8192-coef-inner, 1024, 12, 2758, 1380, 0, 0, 4150, 1.36534e+06
n100x8192-coef-inner, 1024, 13, 2738, 1398, 0, 0, 4149, 1.36534e+06
n100x8192-coef-inner, 1024, 12, 2746, 1369, 0, 0, 4127, 1.36534e+06
n100x8192-coef-inner, 1024, 12, 2734, 1364, 0, 0, 4110, 1.36534e+06
n100x8192-coef-inner, 1024, 12, 2735, 1374, 0, 0, 4121, 1.36534e+06
n100x8192-coef-inner, 1024, 12, 2724, 1376, 0, 0, 4112, 1.36534e+06
n100x8192-coef-inner, 1024, 11, 2719, 1368, 0, 0, 4098, 1.36534e+06
n100x8192-coef-inner, 1024, 13, 2724, 1367, 0, 0, 4104, 1.36534e+06
n100x8192-coef-inner, 1024, 12, 2723, 1362, 0, 0, 4097, 1.36534e+06
n100x8192-coef-inner, 1024, 12, 2713, 1368, 0, 0, 4093, 1.36534e+06
n100x8192-coef-inner, 1024, 13, 2741, 1352, 0, 0, 4106, 1.36534e+06
n100x8192-coef-inner, 1024, 14, 2727, 1370, 0, 0, 4111, 1.36534e+06
n100x8192-coef-inner, 1024, 12, 2724, 1371, 0, 0, 4107, 1.36534e+06
n100x8192-coef-inner, 1024, 12, 2722, 1671, 0, 0, 4405, 1.36534e+06
n100x8192-coef-inner, 1024, 12, 2779, 1400, 0, 0, 4191, 1.36534e+06
n100x8192-coef-inner, 1024, 12, 2764, 1400, 0, 0, 4176, 1.36534e+06
n100x8192-coef-inner, 1024, 13, 2772, 1388, 0, 0, 4173, 1.36534e+06
n100x8192-coef-inner, 1024, 12, 2737, 1416, 0, 0, 4165, 1.36534e+06
n100x8192-coef-inner, 1024, 12, 2740, 1364, 0, 0, 4116, 1.36534e+06
n100x8192-coef-inner, 1024, 13, 2735, 1379, 0, 0, 4127, 1.36534e+06
n100x8192-coef-inner, 1024, 12, 2723, 1396, 0, 0, 4131, 1.36534e+06
n100x8192-coef-inner, 1024, 14, 2730, 1360, 0, 0, 4104, 1.36534e+06
n100x8192-coef-inner, 1024, 12, 2717, 1361, 0, 0, 4090, 1.36534e+06
n100x8192-coef-inner, 1024, 12, 2731, 1367, 0, 0, 4110, 1.36534e+06
n100x8192-coef-inner, 1024, 12, 2738, 1382, 0, 0, 4132, 1.36534e+06
n100x8192-coef-inner, 1024, 14, 2724, 1426, 0, 0, 4164, 1.36534e+06
n100x8192-coef-inner, 1024, 12, 2724, 1392, 0, 0, 4128, 1.36534e+06
n100x8192-coef-inner, 1024, 13, 2712, 1364, 0, 0, 4089, 1.36534e+06
n100x8192-coef-inner, 1024, 12, 2731, 1395, 0, 0, 4138, 1.36534e+06
n100x8192-coef-inner, 1024, 12, 2740, 1382, 0, 0, 4134, 1.36534e+06
n100x8192-coef-inner, 1024, 13, 2746, 1380, 0, 0, 4139, 1.36534e+06
n100x8192-coef-inner, 1024, 12, 2728, 1381, 0, 0, 4121, 1.36534e+06
n100x8192-coef-inner, 1024, 12, 2727, 1378, 0, 0, 4117, 1.36534e+06
n100x8192-coef-inner, 1024, 13, 2718, 1362, 0, 0, 4093, 1.36534e+06
n100x8192-coef-inner, 1024, 12, 2734, 1366, 0, 0, 4112, 1.36534e+06
n250x8192-coef-sum, 8192, 59, 3464, 109, 1, 0, 3633, 1
n250x8192-coef-sum, 8192, 60, 3482, 98, 1, 0, 3641, 1
n250x8192-coef-sum, 8192, 59, 3461, 97, 1, 0, 3618, 1
n250x8192-coef-sum, 8192, 56, 3457, 102, 1, 0, 3616, 1
n250x8192-coef-sum, 8192, 60, 3463, 95, 1, 0, 3619, 1
n250x8192-coef-sum, 8192, 58, 3485, 97, 1, 0, 3641, 1
n250x8192-coef-sum, 8192, 60, 3463, 94, 1, 0, 3618, 1
n250x8192-coef-sum, 8192, 64, 3485, 96, 1, 0, 3646, 1
n250x8192-coef-sum, 8192, 57, 3476, 97, 1, 0, 3631, 1
n250x8192-coef-sum, 8192, 58, 3485, 102, 1, 0, 3646, 1
n250x8192-coef-sum, 8192, 60, 3462, 100, 1, 0, 3623, 1
n250x8192-coef-sum, 8192, 58, 3492, 97, 1, 0, 3648, 1
n250x8192-coef-sum, 8192, 61, 3469, 97, 1, 0, 3628, 1
n250x8192-coef-sum, 8192, 58, 3460, 101, 1, 0, 3620, 1
n250x8192-coef-sum, 8192, 59, 3474, 97, 1, 0, 3631, 1
n250x8192-coef-sum, 8192, 59, 3462, 97, 1, 0, 3619, 1
n250x8192-coef-sum, 8192, 58, 3468, 98, 1, 0, 3625, 1
n250x8192-coef-sum, 8192, 62, 3445, 96, 1, 0, 3604, 1
n250x8192-coef-sum, 8192, 60, 3441, 95, 1, 0, 3597, 1
n250x8192-coef-sum, 8192, 57, 3443, 95, 1, 0, 3596, 1
n250x8192-coef-sum, 8192, 65, 3446, 96, 1, 0, 3608, 1
n250x8192-coef-sum, 8192, 56, 3442, 95, 1, 0, 3594, 1
n250x8192-coef-sum, 8192, 58, 3444, 96, 1, 0, 3599, 1
n250x8192-coef-sum, 8192, 59, 3434, 95, 1, 0, 3589, 1
n250x8192-coef-sum, 8192, 60, 3451, 97, 1, 0, 3609, 1
n250x8192-coef-sum, 8192, 59, 3451, 95, 1, 0, 3606, 1
n250x8192-coef-sum, 8192, 57, 3450, 96, 1, 0, 3604, 1
n250x8192-coef-sum, 8192, 56, 3439, 96, 1, 0, 3592, 1
n250x8192-coef-sum, 8192, 58, 3438, 96, 1, 0, 3593, 1
n250x8192-coef-sum, 8192, 56, 3450, 95, 1, 0, 3602, 1
n250x8192-coef-sum, 8192, 57, 3468, 98, 1, 0, 3624, 1
n250x8192-coef-sum, 8192, 58, 3458, 98, 1, 0, 3615, 1
n250x8192-coef-sum, 8192, 61, 3459, 101, 1, 0, 3622, 1
n250x8192-coef-sum, 8192, 59, 3443, 95, 1, 0, 3598, 1
n250x8192-coef-sum, 8192, 58, 3461, 96, 1, 0, 3616, 1
n250x8192-coef-sum, 8192, 60, 3442, 96, 1, 0, 3599, 1
n250x8192-coef-sum, 8192, 68, 3450, 95, 1, 0, 3614, 1
n250x8192-coef-sum, 8192, 59, 3433, 96, 1, 0, 3589, 1
n250x8192-coef-sum, 8192, 61, 3453, 95, 1, 0, 3610, 1
n250x8192-coef-sum, 8192, 58, 3437, 95, 1, 0, 3591, 1
n250x8192-coef-sum, 8192, 57, 3459, 96, 1, 0, 3613, 1
n250x8192-coef-sum, 8192, 62, 3458, 97, 1, 0, 3618, 1
n250x8192-coef-sum, 8192, 57, 3461, 96, 1, 0, 3615, 1
n250x8192-coef-sum, 8192, 59, 3467, 94, 1, 0, 3621, 1
n250x8192-coef-sum, 8192, 58, 3443, 96, 1, 0, 3598, 1
n250x8192-coef-sum, 8192, 60, 3449, 95, 1, 0, 3605, 1
n250x8192-coef-sum, 8192, 59, 3445, 95, 1, 0, 3600, 1
n250x8192-coef-sum, 8192, 60, 3446, 98, 1, 0, 3605, 1
n250x8192-coef-sum, 8192, 56, 3450, 96, 1, 0, 3603, 1
n250x8192-coef-sum, 8192, 59, 3429, 95, 1, 0, 3584, 1
n250x8192-coef-sum, 8192, 58, 3440, 95, 1, 0, 3594, 1
n250x8192-coef-sum, 8192, 58, 3442, 95, 1, 0, 3596, 1
n250x8192-coef-sum, 8192, 59, 3436, 99, 1, 0, 3595, 1
n250x8192-coef-sum, 8192, 55, 3439, 100, 1, 0, 3595, 1
n250x8192-coef-sum, 8192, 60, 3431, 96, 1, 0, 3588, 1
n250x8192-coef-sum, 8192, 57, 3472, 97, 1, 0, 3627, 1
n250x8192-coef-sum, 8192, 60, 3457, 95, 1, 0, 3613, 1
n250x8192-coef-sum, 8192, 56, 3476, 97, 1, 0, 3630, 1
n250x8192-coef-sum, 8192, 59, 3510, 96, 1, 0, 3666, 1
n250x8192-coef-sum, 8192, 57, 3470, 97, 1, 0, 3625, 1
n250x8192-coef-sum, 8192, 61, 3488, 96, 1, 0, 3646, 1
n250x8192-coef-sum, 8192, 58, 3454, 95, 1, 0, 3608, 1
n250x8192-coef-sum, 8192, 56, 3452, 95, 1, 0, 3604, 1
n250x8192-coef-sum, 8192, 57, 3457, 96, 1, 0, 3611, 1
n250x8192-coef-sum, 8192, 60, 3439, 95, 1, 0, 3595, 1
n250x8192-coef-sum, 8192, 64, 3457, 98, 1, 0, 3620, 1
n250x8192-coef-sum, 8192, 60, 3447, 96, 1, 0, 3604, 1
n250x8192-coef-sum, 8192, 61, 3451, 98, 1, 0, 3611, 1
n250x8192-coef-sum, 8192, 59, 3445, 96, 1, 0, 3601, 1
n250x8192-coef-sum, 8192, 60, 3453, 96, 1, 0, 3610, 1
n250x8192-coef-sum, 8192, 60, 3448, 95, 1, 0, 3604, 1
n250x8192-coef-sum, 8192, 60, 3461, 99, 1, 0, 3621, 1
n250x8192-coef-sum, 8192, 59, 3466, 97, 1, 0, 3623, 1
n250x8192-coef-sum, 8192, 60, 3457, 97, 1, 0, 3615, 1
n250x8192-coef-sum, 8192, 57, 3479, 96, 1, 0, 3633, 1
n250x8192-coef-sum, 8192, 58, 3460, 97, 1, 0, 3616, 1
n250x8192-coef-sum, 8192, 58, 3434, 96, 1, 0, 3589, 1
n250x8192-coef-sum, 8192, 56, 3451, 95, 1, 0, 3603, 1
n250x8192-coef-sum, 8192, 56, 3439, 97, 1, 0, 3593, 1
n250x8192-coef-sum, 8192, 58, 3451, 97, 1, 0, 3607, 1
n250x8192-coef-sum, 8192, 57, 3455, 94, 1, 0, 3607, 1
n250x8192-coef-sum, 8192, 59, 3472, 96, 1, 0, 3628, 1
n250x8192-coef-sum, 8192, 65, 3449, 95, 1, 0, 3610, 1
n250x8192-coef-sum, 8192, 59, 3475, 97, 1, 0, 3632, 1
n250x8192-coef-sum, 8192, 60, 3458, 96, 1, 0, 3615, 1
n250x8192-coef-sum, 8192, 56, 3449, 96, 1, 0, 3602, 1
n250x8192-coef-sum, 8192, 57, 3473, 96, 1, 0, 3627, 1
n250x8192-coef-sum, 8192, 57, 3453, 101, 1, 0, 3612, 1
n250x8192-coef-sum, 8192, 60, 3465, 96, 1, 0, 3622, 1
n250x8192-coef-sum, 8192, 59, 3446, 95, 1, 0, 3601, 1
n250x8192-coef-sum, 8192, 56, 3441, 95, 1, 0, 3593, 1
n250x8192-coef-sum, 8192, 59, 3424, 95, 1, 0, 3579, 1
n250x8192-coef-sum, 8192, 57, 3436, 96, 1, 0, 3590, 1
n250x8192-coef-sum, 8192, 56, 3437, 95, 1, 0, 3589, 1
n250x8192-coef-sum, 8192, 57, 3438, 96, 1, 0, 3592, 1
n250x8192-coef-sum, 8192, 58, 3432, 94, 1, 0, 3585, 1
n250x8192-coef-sum, 8192, 58, 3468, 97, 1, 0, 3624, 1
n250x8192-coef-sum, 8192, 58, 3429, 96, 1, 0, 3584, 1
n250x8192-coef-sum, 8192, 61, 3472, 96, 1, 0, 3630, 1
n250x8192-coef-sum, 8192, 58, 3451, 96, 1, 0, 3606, 1
n250x8192-coef-sum, 4096, 33, 3450, 99, 0, 0, 3582, 1
n250x8192-coef-sum, 4096, 34, 3429, 99, 0, 0, 3562, 1
n250x8192-coef-sum, 4096, 31, 3426, 101, 0, 0, 3558, 1
n250x8192-coef-sum, 4096, 33, 3422, 100, 0, 0, 3555, 1
n250x8192-coef-sum, 4096, 30, 3437, 100, 0, 0, 3567, 1
n250x8192-coef-sum, 4096, 31, 3435, 98, 0, 0, 3564, 1
n250x8192-coef-sum, 4096, 31, 3421, 97, 0, 0, 3549, 1
n250x8192-coef-sum, 4096, 32, 3441, 98, 0, 0, 3571, 1
n250x8192-coef-sum, 4096, 33, 3429, 100, 0, 0, 3562, 1
n250x8192-coef-sum, 4096, 31, 3412, 97, 0, 0, 3540, 1
n250x8192-coef-sum, 4096, 31, 3414, 99, 0, 0, 3544, 1
n250x8192-coef-sum, 4096, 30, 3416, 99, 0, 0, 3545, 1
n250x8192-coef-sum, 4096, 30, 3419, 100, 0, 0, 3549, 1
n250x8192-coef-sum, 4096, 34, 3414, 99, 1, 0, 3548, 1
n250x8192-coef-sum, 4096, 33, 3444, 100, 0, 0, 3577, 1
n250x8192-coef-sum, 4096, 31, 3414, 100, 0, 0, 3545, 1
n250x8192-coef-sum, 4096, 31, 3446, 104, 0, 0, 3581, 1
n250x8192-coef-sum, 4096, 30, 3429, 98, 0, 0, 3557, 1
n250x8192-coef-sum, 4096, 32, 3433, 99, 0, 0, 3564, 1
n250x8192-coef-sum, 4096, 33, 3404, 100, 0, 0, 3537, 1
n250x8192-coef-sum, 4096, 30, 3469, 100, 0, 0, 3599, 1
n250x8192-coef-sum, 4096, 36, 3507, 104, 0, 0, 3647, 1
n250x8192-coef-sum, 4096, 32, 3490, 99, 0, 0, 3621, 1
n250x8192-coef-sum, 4096, 30, 3482, 103, 0, 0, 3615, 1
n250x8192-coef-sum, 4096, 31, 3457, 100, 0, 0, 3588, 1
n250x8192-coef-sum, 4096, 33, 3468, 102, 0, 0, 3603, 1
n250x8192-coef-sum, 4096, 30, 3452, 99, 0, 0, 3581, 1
n250x8192-coef-sum, 4096, 30, 3444, 100, 0, 0, 3574, 1
n250x8192-coef-sum, 4096, 31, 3454, 99, 0, 0, 3584, 1
n250x8192-coef-sum, 4096, 35, 3475, 103, 0, 0, 3613, 1
n250x8192-coef-sum, 4096, 34, 3473, 100, 0, 0, 3607, 1
n250x8192-coef-sum, 4096, 32, 3473, 105, 0, 0, 3610, 1
n250x8192-coef-sum, 4096, 30, 3450, 99, 0, 0, 3579, 1
n250x8192-coef-sum, 4096, 35, 3454, 100, 0, 0, 3589, 1
n250x8192-coef-sum, 4096, 31, 3443, 100, 0, 0, 3574, 1
n250x8192-coef-sum, 4096, 31, 3460, 99, 4, 0, 3594, 1
n250x8192-coef-sum, 4096, 37, 3466, 101, 0, 0, 3604, 1
n250x8192-coef-sum, 4096, 32, 3458, 99, 0, 0, 3589, 1
n250x8192-coef-sum, 4096, 35, 3443, 103, 0, 0, 3581, 1
n250x8192-coef-sum, 4096, 32, 3423, 98, 0, 0, 3553, 1
n250x8192-coef-sum, 4096, 42, 3408, 99, 0, 0, 3549, 1
n250x8192-coef-sum, 4096, 31, 3438, 100, 0, 0, 3569, 1
n250x8192-coef-sum, 4096, 30, 3439, 102, 0, 0, 3571, 1
n250x8192-coef-sum, 4096, 39, 3445, 102, 0, 0, 3586, 1
n250x8192-coef-sum, 4096, 33, 3445, 99, 0, 0, 3577, 1
n250x8192-coef-sum, 4096, 32, 3445, 98, 0, 0, 3575, 1
n250x8192-coef-sum, 4096, 38, 3406, 99, 0, 0, 3543, 1
n250x8192-coef-sum, 4096, 34, 3437, 101, 0, 0, 3572, 1
n250x8192-coef-sum, 4096, 34, 3444, 100, 0, 0, 3578, 1
n250x8192-coef-sum, 4096, 30, 3428, 99, 0, 0, 3557, 1
n250x8192-coef-sum, 4096, 33, 3425, 98, 0, 0, 3556, 1
n250x8192-coef-sum, 4096, 31, 3405, 98, 0, 0, 3534, 1
n250x8192-coef-sum, 4096, 31, 3419, 98, 0, 0, 3548, 1
n250x8192-coef-sum, 4096, 31, 3432, 99, 0, 0, 3562, 1
n250x8192-coef-sum, 4096, 31, 3435, 99, 0, 0, 3565, 1
n250x8192-coef-sum, 4096, 33, 3472, 99, 0, 0, 3604, 1
n250x8192-coef-sum, 4096, 30, 3403, 99, 0, 0, 3532, 1
n250x8192-coef-sum, 4096, 31, 3419, 98, 0, 0, 3548, 1
n250x8192-coef-sum, 4096, 34, 3429, 99, 2, 0, 3564, 1
n250x8192-coef-sum, 4096, 30, 3409, 99, 0, 0, 3538, 1
n250x8192-coef-sum, 4096, 34, 3436, 98, 0, 0, 3568, 1
n250x8192-coef-sum, 4096, 33, 3428, 99, 0, 0, 3560, 1
n250x8192-coef-sum, 4096, 31, 3430, 99, 0, 0, 3560, 1
n250x8192-coef-sum, 4096, 34, 3441, 103, 0, 0, 3578, 1
n250x8192-coef-sum, 4096, 31, 3438, 98, 0, 0, 3567, 1
n250x8192-coef-sum, 4096, 30, 3417, 98, 0, 0, 3545, 1
n250x8192-coef-sum, 4096, 35, 3472, 103, 0, 0, 3610, 1
n250x8192-coef-sum, 4096, 31, 3416, 100, 0, 0, 3547, 1
n250x8192-coef-sum, 4096, 31, 3411, 99, 0, 0, 3541, 1
n250x8192-coef-sum, 4096, 31, 3441, 99, 0, 0, 3571, 1
n250x8192-coef-sum, 4096, 31, 3425, 99, 0, 0, 3555, 1
n250x8192-coef-sum, 4096, 30, 3450, 107, 1, 0, 3588, 1
n250x8192-coef-sum, 4096, 31, 3410, 98, 0, 0, 3539, 1
n250x8192-coef-sum, 4096, 30, 3413, 101, 0, 0, 3544, 1
n250x8192-coef-sum, 4096, 31, 3408, 98, 0, 0, 3537, 1
n250x8192-coef-sum, 4096, 32, 3417, 98, 0, 0, 3547, 1
n250x8192-coef-sum, 4096, 31, 3420, 100, 0, 0, 3551, 1
n250x8192-coef-sum, 4096, 33, 3422, 99, 0, 0, 3554, 1
n250x8192-coef-sum, 4096, 32, 3445, 107, 0, 0, 3584, 1
n250x8192-coef-sum, 4096, 32, 3404, 99, 0, 0, 3535, 1
n250x8192-coef-sum, 4096, 34, 3411, 97, 0, 0, 3542, 1
n250x8192-coef-sum, 4096, 31, 3405, 98, 0, 0, 3534, 1
n250x8192-coef-sum, 4096, 34, 3411, 99, 0, 0, 3544, 1
n250x8192-coef-sum, 4096, 37, 3445, 107, 0, 0, 3589, 1
n250x8192-coef-sum, 4096, 32, 3402, 99, 0, 0, 3533, 1
n250x8192-coef-sum, 4096, 35, 3439, 98, 0, 0, 3572, 1
n250x8192-coef-sum, 4096, 32, 3415, 100, 0, 0, 3547, 1
n250x8192-coef-sum, 4096, 34, 3423, 97, 3, 0, 3557, 1
n250x8192-coef-sum, 4096, 32, 3391, 99, 0, 0, 3522, 1
n250x8192-coef-sum, 4096, 31, 3410, 100, 0, 0, 3541, 1
n250x8192-coef-sum, 4096, 31, 3401, 97, 0, 0, 3529, 1
n250x8192-coef-sum, 4096, 31, 3405, 97, 0, 0, 3533, 1
n250x8192-coef-sum, 4096, 30, 3408, 99, 0, 0, 3537, 1
n250x8192-coef-sum, 4096, 31, 3437, 100, 0, 0, 3568, 1
n250x8192-coef-sum, 4096, 62, 3433, 102, 0, 0, 3597, 1
n250x8192-coef-sum, 4096, 31, 3430, 98, 0, 0, 3559, 1
n250x8192-coef-sum, 4096, 30, 3417, 100, 0, 0, 3547, 1
n250x8192-coef-sum, 4096, 33, 3443, 100, 0, 0, 3576, 1
n250x8192-coef-sum, 4096, 34, 3446, 100, 0, 0, 3580, 1
n250x8192-coef-sum, 4096, 34, 3438, 100, 0, 0, 3572, 1
n250x8192-coef-sum, 2048, 17, 3365, 104, 0, 0, 3486, 1
n250x8192-coef-sum, 2048, 18, 3399, 104, 0, 0, 3521, 1
n250x8192-coef-sum, 2048, 18, 3387, 106, 0, 0, 3511, 1
n250x8192-coef-sum, 2048, 18, 3392, 103, 0, 0, 3513, 1
n250x8192-coef-sum, 2048, 18, 3379, 103, 0, 0, 3500, 1
n250x8192-coef-sum, 2048, 17, 3378, 107, 0, 0, 3502, 1
n250x8192-coef-sum, 2048, 18, 3387, 104, 0, 0, 3509, 1
n250x8192-coef-sum, 2048, 18, 3372, 103, 0, 0, 3493, 1
n250x8192-coef-sum, 2048, 18, 3379, 108, 0, 0, 3505, 1
n250x8192-coef-sum, 2048, 18, 3379, 104, 0, 0, 3501, 1
n250x8192-coef-sum, 2048, 18, 3378, 103, 0, 0, 3499, 1
n250x8192-coef-sum, 2048, 18, 3373, 105, 0, 0, 3496, 1
n250x8192-coef-sum, 2048, 18, 3362, 106, 0, 0, 3486, 1
n250x8192-coef-sum, 2048, 18, 3372, 105, 0, 0, 3495, 1
n250x8192-coef-sum, 2048, 18, 3379, 105, 0, 0, 3502, 1
n250x8192-coef-sum, 2048, 18, 3382, 104, 0, 0, 3504, 1
n250x8192-coef-sum, 2048, 18, 3358, 104, 0, 0, 3480, 1
n250x8192-coef-sum, 2048, 18, 3373, 108, 0, 0, 3499, 1
n250x8192-coef-sum, 2048, 18, 3386, 104, 0, 0, 3508, 1
n250x8192-coef-sum, 2048, 18, 3388, 106, 0, 0, 3512, 1
n250x8192-coef-sum, 2048, 18, 3397, 105, 0, 0, 3520, 1
n250x8192-coef-sum, 2048, 18, 3379, 105, 0, 0, 3502, 1
n250x8192-coef-sum, 2048, 18, 3392, 105, 0, 0, 3515, 1
n250x8192-coef-sum, 2048, 17, 3375, 104, 0, 0, 3496, 1
n250x8192-coef-sum, 2048, 18, 3374, 104, 0, 0, 3496, 1
n250x8192-coef-sum, 2048, 18, 3400, 105, 0, 0, 3523, 1
n250x8192-coef-sum, 2048, 18, 3407, 107, 0, 0, 3532, 1
n250x8192-coef-sum, 2048, 18, 3381, 109, 0, 0, 3508, 1
n250x8192-coef-sum, 2048, 18, 3404, 106, 0, 0, 3528, 1
n250x8192-coef-sum, 2048, 18, 3391, 103, 0, 0, 3512, 1
n250x8192-coef-sum, 2048, 18, 3369, 106, 0, 0, 3493, 1
n250x8192-coef-sum, 2048, 18, 3382, 106, 0, 0, 3506, 1
n250x8192-coef-sum, 2048, 18, 3387, 105, 0, 0, 3510, 1
n250x8192-coef-sum, 2048, 18, 3371, 104, 0, 0, 3493, 1
n250x8192-coef-sum, 2048, 18, 3390, 107, 0, 0, 3515, 1
n250x8192-coef-sum, 2048, 22, 3390, 103, 0, 0, 3515, 1
n250x8192-coef-sum, 2048, 18, 3426, 105, 0, 0, 3549, 1
n250x8192-coef-sum, 2048, 17, 3372, 105, 0, 0, 3494, 1
n250x8192-coef-sum, 2048, 18, 3390, 106, 0, 0, 3514, 1
n250x8192-coef-sum, 2048, 18, 3384, 104, 0, 0, 3506, 1
n250x8192-coef-sum, 2048, 18, 3403, 110, 0, 0, 3531, 1
n250x8192-coef-sum, 2048, 18, 3402, 105, 0, 0, 3525, 1
n250x8192-coef-sum, 2048, 18, 3395, 105, 0, 0, 3518, 1
n250x8192-coef-sum, 2048, 18, 3412, 104, 0, 0, 3534, 1
n250x8192-coef-sum, 2048, 18, 3399, 104, 0, 0, 3521, 1
n250x8192-coef-sum, 2048, 18, 3375, 104, 0, 0, 3497, 1
n250x8192-coef-sum, 2048, 17, 3368, 105, 0, 0, 3490, 1
n250x8192-coef-sum, 2048, 18, 3372, 105, 0, 0, 3495, 1
n250x8192-coef-sum, 2048, 18, 3386, 104, 0, 0, 3508, 1
n250x8192-coef-sum, 2048, 21, 3364, 105, 0, 0, 3490, 1
n250x8192-coef-sum, 2048, 18, 3378, 105, 0, 0, 3501, 1
n250x8192-coef-sum, 2048, 18, 3392, 110, 0, 0, 3520, 1
n250x8192-coef-sum, 2048, 18, 3387, 105, 0, 0, 3510, 1
n250x8192-coef-sum, 2048, 18, 3363, 103, 3, 0, 3487, 1
n250x8192-coef-sum, 2048, 18, 3375, 104, 0, 0, 3497, 1
n250x8192-coef-sum, 2048, 17, 3373, 104, 0, 0, 3494, 1
n250x8192-coef-sum, 2048, 20, 3404, 105, 0, 0, 3529, 1
n250x8192-coef-sum, 2048, 18, 3379, 103, 0, 0, 3500, 1
n250x8192-coef-sum, 2048, 18, 3376, 104, 0, 0, 3498, 1
n250x8192-coef-sum, 2048, 28, 3382, 108, 0, 0, 3518, 1
n250x8192-coef-sum, 2048, 17, 3390, 109, 0, 0, 3516, 1
n250x8192-coef-sum, 2048, 18, 3374, 104, 0, 0, 3496, 1
n250x8192-coef-sum, 2048, 17, 3362, 104, 0, 0, 3483, 1
n250x8192-coef-sum, 2048, 18, 3369, 107, 0, 0, 3494, 1
n250x8192-coef-sum, 2048, 18, 3380, 105, 0, 0, 3503, 1
n250x8192-coef-sum, 2048, 18, 3386, 104, 0, 0, 3508, 1
n250x8192-coef-sum, 2048, 18, 3378, 104, 0, 0, 3500, 1
n250x8192-coef-sum, 2048, 18, 3514, 126, 0, 0, 3658, 1
n250x8192-coef-sum, 2048, 18, 3818, 130, 0, 0, 3966, 1
n250x8192-coef-sum, 2048, 18, 3830, 128, 7, 0, 3983, 1
n250x8192-coef-sum, 2048, 18, 3424, 105, 0, 0, 3547, 1
n250x8192-coef-sum, 2048, 18, 3375, 104, 0, 0, 3497, 1
n250x8192-coef-sum, 2048, 18, 3370, 103, 0, 0, 3491, 1
n250x8192-coef-sum, 2048, 17, 3363, 105, 0, 0, 3485, 1
n250x8192-coef-sum, 2048, 19, 3380, 104, 0, 0, 3503, 1
n250x8192-coef-sum, 2048, 18, 3368, 105, 0, 0, 3491, 1
n250x8192-coef-sum, 2048, 18, 3366, 103, 0, 0, 3487, 1
n250x8192-coef-sum, 2048, 18, 3376, 104, 0, 0, 3498, 1
n250x8192-coef-sum, 2048, 18, 3365, 107, 0, 0, 3490, 1
n250x8192-coef-sum, 2048, 18, 3352, 103, 0, 0, 3473, 1
n250x8192-coef-sum, 2048, 17, 3365, 103, 0, 0, 3485, 1
n250x8192-coef-sum, 2048, 18, 3369, 103, 0, 0, 3490, 1
n250x8192-coef-sum, 2048, 18, 3354, 109, 0, 0, 3481, 1
n250x8192-coef-sum, 2048, 18, 3405, 105, 0, 0, 3528, 1
n250x8192-coef-sum, 2048, 18, 3369, 104, 0, 0, 3491, 1
n250x8192-coef-sum, 2048, 18, 3381, 104, 0, 0, 3503, 1
n250x8192-coef-sum, 2048, 18, 3356, 104, 0, 0, 3478, 1
n250x8192-coef-sum, 2048, 17, 3357, 103, 0, 0, 3477, 1
n250x8192-coef-sum, 2048, 18, 3369, 104, 0, 0, 3491, 1
n250x8192-coef-sum, 2048, 17, 3359, 105, 0, 0, 3481, 1
n250x8192-coef-sum, 2048, 18, 3366, 104, 0, 0, 3488, 1
n250x8192-coef-sum, 2048, 18, 3363, 104, 0, 0, 3485, 1
n250x8192-coef-sum, 2048, 18, 3387, 105, 0, 0, 3510, 1
n250x8192-coef-sum, 2048, 18, 3385, 107, 0, 0, 3510, 1
n250x8192-coef-sum, 2048, 18, 3373, 105, 0, 0, 3496, 1
n250x8192-coef-sum, 2048, 18, 3376, 106, 0, 0, 3500, 1
n250x8192-coef-sum, 2048, 18, 3380, 107, 0, 0, 3505, 1
n250x8192-coef-sum, 2048, 18, 3386, 104, 0, 0, 3508, 1
n250x8192-coef-sum, 2048, 18, 3373, 106, 0, 0, 3497, 1
n250x8192-coef-sum, 2048, 18, 3391, 104, 0, 0, 3513, 1
n250x8192-coef-sum, 1024, 14, 3441, 115, 0, 0, 3570, 1
n250x8192-coef-sum, 1024, 14, 3436, 115, 0, 0, 3565, 1
n250x8192-coef-sum, 1024, 13, 3429, 115, 0, 0, 3557, 1
n250x8192-coef-sum, 1024, 13, 3412, 117, 0, 0, 3542, 1
n250x8192-coef-sum, 1024, 13, 3399, 117, 0, 0, 3529, 1
n250x8192-coef-sum, 1024, 14, 3384, 116, 0, 0, 3514, 1
n250x8192-coef-sum, 1024, 12, 3397, 116, 0, 0, 3525, 1
n250x8192-coef-sum, 1024, 13, 3408, 115, 0, 0, 3536, 1
n250x8192-coef-sum, 1024, 13, 3402, 110, 0, 0, 3525, 1
n250x8192-coef-sum, 1024, 13, 3399, 116, 0, 0, 3528, 1
n250x8192-coef-sum, 1024, 13, 3420, 116, 0, 0, 3549, 1
n250x8192-coef-sum, 1024, 13, 3406, 116, 0, 0, 3535, 1
n250x8192-coef-sum, 1024, 14, 3431, 118, 0, 0, 3563, 1
n250x8192-coef-sum, 1024, 13, 3432, 120, 0, 0, 3565, 1
n250x8192-coef-sum, 1024, 13, 3407, 115, 0, 0, 3535, 1
n250x8192-coef-sum, 1024, 13, 3399, 116, 0, 0, 3528, 1
n250x8192-coef-sum, 1024, 13, 3420, 117, 0, 0, 3550, 1
n250x8192-coef-sum, 1024, 12, 3410, 119, 0, 0, 3541, 1
n250x8192-coef-sum, 1024, 12, 3444, 120, 0, 0, 3576, 1
n250x8192-coef-sum, 1024, 13, 3432, 116, 0, 0, 3561, 1
n250x8192-coef-sum, 1024, 13, 3418, 117, 0, 0, 3548, 1
n250x8192-coef-sum, 1024, 12, 3434, 118, 1, 0, 3565, 1
n250x8192-coef-sum, 1024, 13, 3418, 116, 6, 0, 3553, 1
n250x8192-coef-sum, 1024, 13, 3420, 118, 3, 0, 3554, 1
n250x8192-coef-sum, 1024, 13, 3397, 116, 0, 0, 3526, 1
n250x8192-coef-sum, 1024, 13, 3436, 118, 0, 0, 3567, 1
n250x8192-coef-sum, 1024, 13, 3433, 118, 0, 0, 3564, 1
n250x8192-coef-sum, 1024, 13, 3418, 120, 0, 0, 3551, 1
n250x8192-coef-sum, 1024, 13, 3417, 116, 0, 0, 3546, 1
n250x8192-coef-sum, 1024, 12, 3431, 116, 0, 0, 3559, 1
n250x8192-coef-sum, 1024, 14, 3413, 117, 0, 0, 3544, 1
n250x8192-coef-sum, 1024, 12, 3413, 116, 0, 0, 3541, 1
n250x8192-coef-sum, 1024, 12, 3434, 118, 0, 0, 3564, 1
n250x8192-coef-sum, 1024, 14, 3423, 117, 0, 0, 3554, 1
n250x8192-coef-sum, 1024, 14, 3468, 113, 0, 0, 3595, 1
n250x8192-coef-sum, 1024, 13, 3445, 116, 0, 0, 3574, 1
n250x8192-coef-sum, 1024, 13, 3449, 115, 0, 0, 3577, 1
n250x8192-coef-sum, 1024, 14, 3451, 118, 0, 0, 3583, 1
n250x8192-coef-sum, 1024, 14, 3416, 118, 0, 0, 3548, 1
n250x8192-coef-sum, 1024, 13, 3403, 118, 0, 0, 3534, 1
n250x8192-coef-sum, 1024, 13, 3430, 117, 0, 0, 3560, 1
n250x8192-coef-sum, 1024, 13, 3418, 121, 0, 0, 3552, 1
n250x8192-coef-sum, 1024, 14, 3428, 119, 0, 0, 3561, 1
n250x8192-coef-sum, 1024, 13, 3435, 116, 0, 0, 3564, 1
n250x8192-coef-sum, 1024, 14, 3399, 118, 0, 0, 3531, 1
n250x8192-coef-sum, 1024, 13, 3431, 115, 0, 0, 3559, 1
n250x8192-coef-sum, 1024, 14, 3432, 117, 0, 0, 3563, 1
n250x8192-coef-sum, 1024, 12, 3399, 119, 0, 0, 3530, 1
n250x8192-coef-sum, 1024, 14, 3434, 117, 0, 0, 3565, 1
n250x8192-coef-sum, 1024, 13, 3425, 117, 0, 0, 3555, 1
n250x8192-coef-sum, 1024, 12, 3467, 116, 0, 0, 3595, 1
n250x8192-coef-sum, 1024, 13, 3404, 119, 0, 0, 3536, 1
n250x8192-coef-sum, 1024, 13, 3419, 116, 0, 0, 3548, 1
n250x8192-coef-sum, 1024, 14, 3428, 116, 0, 0, 3558, 1
n250x8192-coef-sum, 1024, 13, 3430, 116, 0, 0, 3559, 1
n250x8192-coef-sum, 1024, 12, 3411, 118, 0, 0, 3541, 1
n250x8192-coef-sum, 1024, 14, 3428, 118, 0, 0, 3560, 1
n250x8192-coef-sum, 1024, 13, 3431, 116, 0, 0, 3560, 1
n250x8192-coef-sum, 1024, 14, 3426, 117, 0, 0, 3557, 1
n250x8192-coef-sum, 1024, 13, 3428, 116, 0, 0, 3557, 1
n250x8192-coef-sum, 1024, 13, 3403, 123, 0, 0, 3539, 1
n250x8192-coef-sum, 1024, 13, 3416, 115, 0, 0, 3544, 1
n250x8192-coef-sum, 1024, 13, 3420, 118, 0, 0, 3551, 1
n250x8192-coef-sum, 1024, 14, 3396, 115, 0, 0, 3525, 1
n250x8192-coef-sum, 1024, 13, 3458, 123, 0, 0, 3594, 1
n250x8192-coef-sum, 1024, 13, 3468, 119, 0, 0, 3600, 1
n250x8192-coef-sum, 1024, 14, 3453, 116, 0, 0, 3583, 1
n250x8192-coef-sum, 1024, 13, 3451, 117, 0, 0, 3581, 1
n250x8192-coef-sum, 1024, 13, 3436, 118, 0, 0, 3567, 1
n250x8192-coef-sum, 1024, 12, 3423, 117, 0, 0, 3552, 1
n250x8192-coef-sum, 1024, 13, 3443, 119, 0, 0, 3575, 1
n250x8192-coef-sum, 1024, 14, 3435, 117, 0, 0, 3566, 1
n250x8192-coef-sum, 1024, 13, 3431, 118, 0, 0, 3562, 1
n250x8192-coef-sum, 1024, 13, 3423, 117, 0, 0, 3553, 1
n250x8192-coef-sum, 1024, 13, 3407, 116, 0, 0, 3536, 1
n250x8192-coef-sum, 1024, 12, 3423, 117, 0, 0, 3552, 1
n250x8192-coef-sum, 1024, 13, 3430, 115, 0, 0, 3558, 1
n250x8192-coef-sum, 1024, 13, 3412, 116, 0, 0, 3541, 1
n250x8192-coef-sum, 1024, 13, 3433, 118, 0, 0, 3564, 1
n250x8192-coef-sum, 1024, 13, 3426, 120, 0, 0, 3559, 1
n250x8192-coef-sum, 1024, 13, 3426, 116, 0, 0, 3555, 1
n250x8192-coef-sum, 1024, 13, 3416, 116, 0, 0, 3545, 1
n250x8192-coef-sum, 1024, 13, 3403, 117, 0, 0, 3533, 1
n250x8192-coef-sum, 1024, 13, 3411, 116, 0, 0, 3540, 1
n250x8192-coef-sum, 1024, 13, 3402, 114, 0, 0, 3529, 1
n250x8192-coef-sum, 1024, 13, 3392, 116, 0, 0, 3521, 1
n250x8192-coef-sum, 1024, 13, 3394, 117, 0, 0, 3524, 1
n250x8192-coef-sum, 1024, 12, 3393, 115, 0, 0, 3520, 1
n250x8192-coef-sum, 1024, 13, 3399, 115, 0, 0, 3527, 1
n250x8192-coef-sum, 1024, 13, 3409, 116, 0, 0, 3538, 1
n250x8192-coef-sum, 1024, 12, 3399, 115, 0, 0, 3526, 1
n250x8192-coef-sum, 1024, 13, 3405, 115, 0, 0, 3533, 1
n250x8192-coef-sum, 1024, 13, 3402, 115, 0, 0, 3530, 1
n250x8192-coef-sum, 1024, 14, 3411, 118, 0, 0, 3543, 1
n250x8192-coef-sum, 1024, 13, 3412, 121, 0, 0, 3546, 1
n250x8192-coef-sum, 1024, 13, 3410, 116, 0, 0, 3539, 1
n250x8192-coef-sum, 1024, 14, 3398, 114, 0, 0, 3526, 1
n250x8192-coef-sum, 1024, 13, 3420, 116, 0, 0, 3549, 1
n250x8192-coef-sum, 1024, 13, 3398, 117, 0, 0, 3528, 1
n250x8192-coef-sum, 1024, 14, 3404, 114, 0, 0, 3532, 1
n250x8192-slot-sum, 8192, 270, 1996, 132, 1, 0, 2399, 1
n250x8192-slot-sum, 8192, 270, 2028, 135, 1, 0, 2434, 1
n250x8192-slot-sum, 8192, 270, 2017, 133, 1, 0, 2421, 1
n250x8192-slot-sum, 8192, 270, 2005, 131, 1, 0, 2407, 1
n250x8192-slot-sum, 8192, 267, 2027, 132, 1, 0, 2427, 1
n250x8192-slot-sum, 8192, 267, 2001, 134, 1, 0, 2403, 1
n250x8192-slot-sum, 8192, 268, 2017, 134, 1, 0, 2420, 1
n250x8192-slot-sum, 8192, 272, 2029, 135, 1, 0, 2437, 1
n250x8192-slot-sum, 8192, 266, 2014, 132, 1, 0, 2413, 1
n250x8192-slot-sum, 8192, 271, 2006, 131, 1, 0, 2409, 1
n250x8192-slot-sum, 8192, 267, 2007, 133, 1, 0, 2408, 1
n250x8192-slot-sum, 8192, 271, 2008, 131, 1, 0, 2411, 1
n250x8192-slot-sum, 8192, 268, 2013, 133, 1, 0, 2415, 1
n250x8192-slot-sum, 8192, 269, 2003, 131, 1, 0, 2404, 1
n250x8192-slot-sum, 8192, 271, 2005, 136, 1, 0, 2413, 1
n250x8192-slot-sum, 8192, 267, 2009, 131, 1, 0, 2408, 1
n250x8192-slot-sum, 8192, 270, 2012, 132, 1, 0, 2415, 1
n250x8192-slot-sum, 8192, 263, 1999, 131, 1, 0, 2394, 1
n250x8192-slot-sum, 8192, 266, 1998, 132, 1, 0, 2397, 1
n250x8192-slot-sum, 8192, 265, 2036, 136, 1, 0, 2438, 1
n250x8192-slot-sum, 8192, 265, 2012, 132, 1, 0, 2410, 1
n250x8192-slot-sum, 8192, 274, 2031, 135, 1, 0, 2441, 1
n250x8192-slot-sum, 8192, 268, 2019, 135, 1, 0, 2423, 1
n250x8192-slot-sum, 8192, 269, 1998, 134, 1, 0, 2402, 1
n250x8192-slot-sum, 8192, 266, 2026, 135, 1, 0, 2428, 1
n250x8192-slot-sum, 8192, 274, 2015, 133, 1, 0, 2423, 1
n250x8192-slot-sum, 8192, 269, 2029, 133, 1, 0, 2432, 1
n250x8192-slot-sum, 8192, 264, 2009, 133, 1, 0, 2407, 1
n250x8192-slot-sum, 8192, 268, 2032, 133, 1, 0, 2434, 1
n250x8192-slot-sum, 8192, 266, 2021, 136, 1, 0, 2424, 1
n250x8192-slot-sum, 8192, 267, 2034, 135, 1, 0, 2437, 1
n250x8192-slot-sum, 8192, 267, 2024, 137, 1, 0, 2429, 1
n250x8192-slot-sum, 8192, 269, 2001, 136, 1, 0, 2407, 1
n250x8192-slot-sum, 8192, 271, 2017, 133, 1, 0, 2422, 1
n250x8192-slot-sum, 8192, 269, 2005, 132, 1, 0, 2407, 1
n250x8192-slot-sum, 8192, 266, 2034, 137, 1, 0, 2438, 1
n250x8192-slot-sum, 8192, 267, 1996, 133, 1, 0, 2397, 1
n250x8192-slot-sum, 8192, 268, 2016, 135, 1, 0, 2420, 1
n250x8192-slot-sum, 8192, 268, 2011, 130, 1, 0, 2410, 1
n250x8192-slot-sum, 8192, 267, 2024, 135, 1, 0, 2427, 1
n250x8192-slot-sum, 8192, 269, 2017, 136, 1, 0, 2423, 1
n250x8192-slot-sum, 8192, 268, 2017, 138, 1, 0, 2424, 1
n250x8192-slot-sum, 8192, 270, 2016, 133, 1, 0, 2420, 1
n250x8192-slot-sum, 8192, 263, 2021, 137, 1, 0, 2422, 1
n250x8192-slot-sum, 8192, 273, 2002, 133, 1, 0, 2409, 1
n250x8192-slot-sum, 8192, 269, 2037, 132, 1, 0, 2439, 1
n250x8192-slot-sum, 8192, 276, 2007, 134, 1, 0, 2418, 1
n250x8192-slot-sum, 8192, 267, 2035, 136, 1, 0, 2439, 1
n250x8192-slot-sum, 8192, 269, 2021, 135, 1, 0, 2426, 1
n250x8192-slot-sum, 8192, 269, 2005, 132, 1, 0, 2407, 1
n250x8192-slot-sum, 8192, 268, 2025, 138, 1, 0, 2432, 1
n250x8192-slot-sum, 8192, 271, 2035, 134, 1, 0, 2441, 1
n250x8192-slot-sum, 8192, 275, 2021, 136, 1, 0, 2433, 1
n250x8192-slot-sum, 8192, 269, 2011, 132, 1, 0, 2413, 1
n250x8192-slot-sum, 8192, 266, 2003, 133, 1, 0, 2403, 1
n250x8192-slot-sum, 8192, 266, 2002, 132, 1, 0, 2401, 1
n250x8192-slot-sum, 8192, 269, 2020, 135, 1, 0, 2425, 1
n250x8192-slot-sum, 8192, 268, 2010, 133, 1, 0, 2412, 1
n250x8192-slot-sum, 8192, 268, 2002, 133, 1, 0, 2404, 1
n250x8192-slot-sum, 8192, 270, 2014, 133, 1, 0, 2418, 1
n250x8192-slot-sum, 8192, 270, 1999, 132, 1, 0, 2402, 1
n250x8192-slot-sum, 8192, 267, 2030, 135, 1, 0, 2433, 1
n250x8192-slot-sum, 8192, 278, 2005, 133, 1, 0, 2417, 1
n250x8192-slot-sum, 8192, 265, 1999, 134, 1, 0, 2399, 1
n250x8192-slot-sum, 8192, 269, 2017, 133, 1, 0, 2420, 1
n250x8192-slot-sum, 8192, 265, 2012, 138, 1, 0, 2416, 1
n250x8192-slot-sum, 8192, 268, 2026, 135, 1, 0, 2430, 1
n250x8192-slot-sum, 8192, 279, 2032, 135, 1, 0, 2447, 1
n250x8192-slot-sum, 8192, 271, 2007, 132, 1, 0, 2411, 1
n250x8192-slot-sum, 8192, 266, 2016, 135, 1, 0, 2418, 1
n250x8192-slot-sum, 8192, 266, 2017, 137, 1, 0, 2421, 1
n250x8192-slot-sum, 8192, 270, 2014, 133, 1, 0, 2418, 1
n250x8192-slot-sum, 8192, 272, 2019, 136, 1, 0, 2428, 1
n250x8192-slot-sum, 8192, 268, 2009, 133, 1, 0, 2411, 1
n250x8192-slot-sum, 8192, 268, 2028, 134, 1, 0, 2431, 1
n250x8192-slot-sum, 8192, 268, 2003, 137, 1, 0, 2409, 1
n250x8192-slot-sum, 8192, 268, 2011, 133, 1, 0, 2413, 1
n250x8192-slot-sum, 8192, 266, 2010, 133, 1, 0, 2410, 1
n250x8192-slot-sum, 8192, 267, 2007, 133, 1, 0, 2408, 1
n250x8192-slot-sum, 8192, 267, 2014, 138, 1, 0, 2420, 1
n250x8192-slot-sum, 8192, 269, 2012, 131, 1, 0, 2413, 1
n250x8192-slot-sum, 8192, 268, 2004, 132, 1, 0, 2405, 1
n250x8192-slot-sum, 8192, 267, 2016, 135, 1, 0, 2419, 1
n250x8192-slot-sum, 8192, 265, 1997, 131, 1, 0, 2394, 1
n250x8192-slot-sum, 8192, 265, 2000, 134, 1, 0, 2400, 1
n250x8192-slot-sum, 8192, 266, 2034, 135, 1, 0, 2436, 1
n250x8192-slot-sum, 8192, 270, 2030, 135, 1, 0, 2436, 1
n250x8192-slot-sum, 8192, 266, 2024, 134, 1, 0, 2425, 1
n250x8192-slot-sum, 8192, 267, 2024, 134, 1, 0, 2426, 1
n250x8192-slot-sum, 8192, 267, 2023, 132, 1, 0, 2423, 1
n250x8192-slot-sum, 8192, 270, 2013, 132, 1, 0, 2416, 1
n250x8192-slot-sum, 8192, 265, 2014, 134, 1, 0, 2414, 1
n250x8192-slot-sum, 8192, 270, 2033, 137, 1, 0, 2441, 1
n250x8192-slot-sum, 8192, 266, 1999, 134, 1, 0, 2400, 1
n250x8192-slot-sum, 8192, 265, 2003, 133, 1, 0, 2402, 1
n250x8192-slot-sum, 8192, 268, 2001, 133, 1, 0, 2403, 1
n250x8192-slot-sum, 8192, 265, 2001, 133, 1, 0, 2400, 1
n250x8192-slot-sum, 8192, 271, 2019, 139, 1, 0, 2430, 1
n250x8192-slot-sum, 8192, 268, 2022, 134, 1, 0, 2425, 1
n250x8192-slot-sum, 8192, 268, 2007, 131, 1, 0, 2407, 1
n250x8192-slot-sum, 4096, 125, 1935, 112, 0, 0, 2172, 1
n250x8192-slot-sum, 4096, 128, 1936, 113, 0, 0, 2177, 1
n250x8192-slot-sum, 4096, 124, 1927, 112, 0, 0, 2163, 1
n250x8192-slot-sum, 4096, 127, 1951, 114, 0, 0, 2192, 1
n250x8192-slot-sum, 4096, 127, 1961, 116, 0, 0, 2204, 1
n250x8192-slot-sum, 4096, 125, 1933, 112, 0, 0, 2170, 1
n250x8192-slot-sum, 4096, 128, 1956, 115, 0, 0, 2199, 1
n250x8192-slot-sum, 4096, 127, 1922, 112, 0, 0, 2161, 1
n250x8192-slot-sum, 4096, 124, 1934, 111, 0, 0, 2169, 1
n250x8192-slot-sum, 4096, 124, 1938, 115, 0, 0, 2177, 1
n250x8192-slot-sum, 4096, 127, 1935, 116, 0, 0, 2178, 1
n250x8192-slot-sum, 4096, 123, 1928, 112, 0, 0, 2163, 1
n250x8192-slot-sum, 4096, 127, 1950, 114, 0, 0, 2191, 1
n250x8192-slot-sum, 4096, 126, 1945, 117, 0, 0, 2188, 1
n250x8192-slot-sum, 4096, 124, 1963, 115, 0, 0, 2202, 1
n250x8192-slot-sum, 4096, 124, 1941, 112, 0, 0, 2177, 1
n250x8192-slot-sum, 4096, 126, 1931, 111, 0, 0, 2168, 1
n250x8192-slot-sum, 4096, 128, 1954, 111, 0, 0, 2193, 1
n250x8192-slot-sum, 4096, 133, 1933, 112, 0, 0, 2178, 1
n250x8192-slot-sum, 4096, 125, 1969, 116, 0, 0, 2210, 1
n250x8192-slot-sum, 4096, 125, 1936, 113, 0, 0, 2174, 1
n250x8192-slot-sum, 4096, 126, 1931, 111, 0, 0, 2168, 1
n250x8192-slot-sum, 4096, 126, 1923, 111, 0, 0, 2160, 1
n250x8192-slot-sum, 4096, 127, 1936, 112, 0, 0, 2175, 1
n250x8192-slot-sum, 4096, 124, 1929, 112, 0, 0, 2165, 1
n250x8192-slot-sum, 4096, 126, 1924, 114, 0, 0, 2164, 1
n250x8192-slot-sum, 4096, 125, 1927, 112, 0, 0, 2164, 1
n250x8192-slot-sum, 4096, 128, 1960, 114, 0, 0, 2202, 1
n250x8192-slot-sum, 4096, 128, 1958, 117, 0, 0, 2203, 1
n250x8192-slot-sum, 4096, 125, 1949, 113, 0, 0, 2187, 1
n250x8192-slot-sum, 4096, 124, 1930, 112, 0, 0, 2166, 1
n250x8192-slot-sum, 4096, 124, 1932, 113, 0, 0, 2169, 1
n250x8192-slot-sum, 4096, 127, 1959, 115, 0, 0, 2201, 1
n250x8192-slot-sum, 4096, 128, 1923, 112, 0, 0, 2163, 1
n250x8192-slot-sum, 4096, 127, 1952, 116, 0, 0, 2195, 1
n250x8192-slot-sum, 4096, 125, 1935, 113, 0, 0, 2173, 1
n250x8192-slot-sum, 4096, 124, 1943, 113, 0, 0, 2180, 1
n250x8192-slot-sum, 4096, 123, 1933, 113, 0, 0, 2169, 1
n250x8192-slot-sum, 4096, 124, 1929, 113, 0, 0, 2166, 1
n250x8192-slot-sum, 4096, 129, 1943, 113, 0, 0, 2185, 1
n250x8192-slot-sum, 4096, 132, 1933, 114, 0, 0, 2179, 1
n250x8192-slot-sum, 4096, 124, 1939, 115, 0, 0, 2178, 1
n250x8192-slot-sum, 4096, 125, 1954, 112, 0, 0, 2191, 1
n250x8192-slot-sum, 4096, 127, 1949, 113, 0, 0, 2189, 1
n250x8192-slot-sum, 4096, 128, 1927, 120, 0, 0, 2175, 1
n250x8192-slot-sum, 4096, 124, 1942, 113, 0, 0, 2179, 1
n250x8192-slot-sum, 4096, 125, 1943, 115, 0, 0, 2183, 1
n250x8192-slot-sum, 4096, 130, 1928, 111, 0, 0, 2169, 1
n250x8192-slot-sum, 4096, 128, 1931, 112, 0, 0, 2171, 1
n250x8192-slot-sum, 4096, 127, 1933, 116, 0, 0, 2176, 1
n250x8192-slot-sum, 4096, 126, 1943, 111, 0, 0, 2180, 1
n250x8192-slot-sum, 4096, 127, 1930, 112, 0, 0, 2169, 1
n250x8192-slot-sum, 4096, 128, 1953, 114, 0, 0, 2195, 1
n250x8192-slot-sum, 4096, 124, 1930, 113, 0, 0, 2167, 1
n250x8192-slot-sum, 4096, 127, 1950, 113, 0, 0, 2190, 1
n250x8192-slot-sum, 4096, 127, 1938, 112, 0, 0, 2177, 1
n250x8192-slot-sum, 4096, 123, 1923, 112, 0, 0, 2158, 1
n250x8192-slot-sum, 4096, 127, 1924, 112, 0, 0, 2163, 1
n250x8192-slot-sum, 4096, 124, 1944, 113, 0, 0, 2181, 1
n250x8192-slot-sum, 4096, 124, 1928, 113, 0, 0, 2165, 1
n250x8192-slot-sum, 4096, 135, 1930, 114, 0, 0, 2179, 1
n250x8192-slot-sum, 4096, 124, 1945, 113, 0, 0, 2182, 1
n250x8192-slot-sum, 4096, 125, 1953, 114, 0, 0, 2192, 1
n250x8192-slot-sum, 4096, 125, 1933, 113, 0, 0, 2171, 1
n250x8192-slot-sum, 4096, 131, 1956, 116, 0, 0, 2203, 1
n250x8192-slot-sum, 4096, 125, 1955, 113, 0, 0, 2193, 1
n250x8192-slot-sum, 4096, 126, 1930, 114, 0, 0, 2170, 1
n250x8192-slot-sum, 4096, 125, 1935, 113, 0, 0, 2173, 1
n250x8192-slot-sum, 4096, 126, 1939, 113, 0, 0, 2178, 1
n250x8192-slot-sum, 4096, 126, 1951, 113, 0, 0, 2190, 1
n250x8192-slot-sum, 4096, 124, 1939, 113, 0, 0, 2176, 1
n250x8192-slot-sum, 4096, 134, 1937, 112, 0, 0, 2183, 1
n250x8192-slot-sum, 4096, 125, 1938, 112, 0, 0, 2175, 1
n250x8192-slot-sum, 4096, 123, 1945, 113, 0, 0, 2181, 1
n250x8192-slot-sum, 4096, 126, 1940, 115, 0, 0, 2181, 1
n250x8192-slot-sum, 4096, 135, 1942, 112, 0, 0, 2189, 1
n250x8192-slot-sum, 4096, 124, 1937, 113, 0, 0, 2174, 1
n250x8192-slot-sum, 4096, 124, 1925, 112, 0, 0, 2161, 1
n250x8192-slot-sum, 4096, 126, 1932, 111, 0, 0, 2169, 1
n250x8192-slot-sum, 4096, 126, 1938, 117, 0, 0, 2181, 1
n250x8192-slot-sum, 4096, 127, 1964, 115, 0, 0, 2206, 1
n250x8192-slot-sum, 4096, 126, 1938, 118, 0, 0, 2182, 1
n250x8192-slot-sum, 4096, 123, 1939, 113, 0, 0, 2175, 1
n250x8192-slot-sum, 4096, 125, 1943, 112, 0, 0, 2180, 1
n250x8192-slot-sum, 4096, 125, 1935, 111, 0, 0, 2171, 1
n250x8192-slot-sum, 4096, 124, 1933, 113, 0, 0, 2170, 1
n250x8192-slot-sum, 4096, 125, 1923, 113, 0, 0, 2161, 1
n250x8192-slot-sum, 4096, 129, 1940, 112, 0, 0, 2181, 1
n250x8192-slot-sum, 4096, 124, 1931, 112, 0, 0, 2167, 1
n250x8192-slot-sum, 4096, 128, 1932, 112, 0, 0, 2172, 1
n250x8192-slot-sum, 4096, 130, 1965, 115, 0, 0, 2210, 1
n250x8192-slot-sum, 4096, 128, 1985, 115, 0, 0, 2228, 1
n250x8192-slot-sum, 4096, 130, 1960, 115, 0, 0, 2205, 1
n250x8192-slot-sum, 4096, 123, 1947, 114, 0, 0, 2184, 1
n250x8192-slot-sum, 4096, 123, 1943, 113, 0, 0, 2179, 1
n250x8192-slot-sum, 4096, 136, 1930, 113, 0, 0, 2179, 1
n250x8192-slot-sum, 4096, 125, 1924, 112, 0, 0, 2161, 1
n250x8192-slot-sum, 4096, 127, 1966, 116, 0, 0, 2209, 1
n250x8192-slot-sum, 4096, 129, 1959, 117, 0, 0, 2205, 1
n250x8192-slot-sum, 4096, 125, 1926, 112, 0, 0, 2163, 1
n250x8192-slot-sum, 2048, 59, 1898, 108, 0, 0, 2065, 1
n250x8192-slot-sum, 2048, 60, 2205, 136, 0, 0, 2401, 1
n250x8192-slot-sum, 2048, 76, 2263, 139, 0, 0, 2478, 1
n250x8192-slot-sum, 2048, 64, 2217, 109, 0, 0, 2390, 1
n250x8192-slot-sum, 2048, 60, 1904, 109, 0, 0, 2073, 1
n250x8192-slot-sum, 2048, 60, 1887, 109, 0, 0, 2056, 1
n250x8192-slot-sum, 2048, 60, 1886, 109, 0, 0, 2055, 1
n250x8192-slot-sum, 2048, 60, 1891, 108, 0, 0, 2059, 1
n250x8192-slot-sum, 2048, 60, 1884, 109, 0, 0, 2053, 1
n250x8192-slot-sum, 2048, 60, 1892, 108, 0, 0, 2060, 1
n250x8192-slot-sum, 2048, 60, 1890, 109, 0, 0, 2059, 1
n250x8192-slot-sum, 2048, 59, 1889, 110, 0, 0, 2058, 1
n250x8192-slot-sum, 2048, 59, 1880, 114, 0, 0, 2053, 1
n250x8192-slot-sum, 2048, 59, 1895, 110, 0, 0, 2064, 1
n250x8192-slot-sum, 2048, 59, 1892, 108, 0, 0, 2059, 1
n250x8192-slot-sum, 2048, 60, 1887, 112, 0, 0, 2059, 1
n250x8192-slot-sum, 2048, 60, 1894, 110, 0, 0, 2064, 1
n250x8192-slot-sum, 2048, 59, 1901, 108, 0, 0, 2068, 1
n250x8192-slot-sum, 2048, 59, 1887, 109, 0, 0, 2055, 1
n250x8192-slot-sum, 2048, 60, 1885, 110, 0, 0, 2055, 1
n250x8192-slot-sum, 2048, 60, 1892, 110, 0, 0, 2062, 1
n250x8192-slot-sum, 2048, 59, 1908, 109, 0, 0, 2076, 1
n250x8192-slot-sum, 2048, 59, 1893, 110, 0, 0, 2062, 1
n250x8192-slot-sum, 2048, 60, 1891, 110, 0, 0, 2061, 1
n250x8192-slot-sum, 2048, 60, 1891, 109, 0, 0, 2060, 1
n250x8192-slot-sum, 2048, 61, 1887, 112, 0, 0, 2060, 1
n250x8192-slot-sum, 2048, 59, 1886, 109, 0, 0, 2054, 1
n250x8192-slot-sum, 2048, 60, 1889, 109, 0, 0, 2058, 1
n250x8192-slot-sum, 2048, 59, 1889, 110, 0, 0, 2058, 1
n250x8192-slot-sum, 2048, 60, 1886, 110, 0, 0, 2056, 1
n250x8192-slot-sum, 2048, 62, 1890, 110, 0, 0, 2062, 1
n250x8192-slot-sum, 2048, 60, 1898, 110, 0, 0, 2068, 1
n250x8192-slot-sum, 2048, 60, 1889, 112, 0, 0, 2061, 1
n250x8192-slot-sum, 2048, 59, 1886, 108, 0, 0, 2053, 1
n250x8192-slot-sum, 2048, 60, 1878, 110, 0, 0, 2048, 1
n250x8192-slot-sum, 2048, 59, 1889, 109, 0, 0, 2057, 1
n250x8192-slot-sum, 2048, 60, 1910, 112, 0, 0, 2082, 1
n250x8192-slot-sum, 2048, 60, 1890, 107, 0, 0, 2057, 1
n250x8192-slot-sum, 2048, 60, 1877, 112, 0, 0, 2049, 1
n250x8192-slot-sum, 2048, 60, 1879, 124, 0, 0, 2063, 1
n250x8192-slot-sum, 2048, 61, 1894, 110, 0, 0, 2065, 1
n250x8192-slot-sum, 2048, 72, 1885, 110, 0, 0, 2067, 1
n250x8192-slot-sum, 2048, 60, 1887, 111, 0, 0, 2058, 1
n250x8192-slot-sum, 2048, 60, 1893, 110, 0, 0, 2063, 1
n250x8192-slot-sum, 2048, 59, 1910, 112, 0, 0, 2081, 1
n250x8192-slot-sum, 2048, 59, 1896, 109, 0, 0, 2064, 1
n250x8192-slot-sum, 2048, 60, 1895, 109, 0, 0, 2064, 1
n250x8192-slot-sum, 2048, 59, 1904, 108, 0, 0, 2071, 1
n250x8192-slot-sum, 2048, 61, 1903, 111, 0, 0, 2075, 1
n250x8192-slot-sum, 2048, 60, 1891, 110, 0, 0, 2061, 1
n250x8192-slot-sum, 2048, 59, 1896, 109, 0, 0, 2064, 1
n250x8192-slot-sum, 2048, 60, 1902, 109, 0, 0, 2071, 1
n250x8192-slot-sum, 2048, 62, 1903, 112, 0, 0, 2077, 1
n250x8192-slot-sum, 2048, 61, 1898, 109, 0, 0, 2068, 1
n250x8192-slot-sum, 2048, 61, 1907, 110, 0, 0, 2078, 1
n250x8192-slot-sum, 2048, 60, 1906, 109, 0, 0, 2075, 1
n250x8192-slot-sum, 2048, 61, 1907, 109, 0, 0, 2077, 1
n250x8192-slot-sum, 2048, 61, 1887, 111, 0, 0, 2059, 1
n250x8192-slot-sum, 2048, 60, 1897, 109, 0, 0, 2066, 1
n250x8192-slot-sum, 2048, 60, 1894, 111, 0, 0, 2065, 1
n250x8192-slot-sum, 2048, 59, 1891, 116, 0, 0, 2066, 1
n250x8192-slot-sum, 2048, 60, 1889, 109, 0, 0, 2058, 1
n250x8192-slot-sum, 2048, 59, 1886, 109, 0, 0, 2054, 1
n250x8192-slot-sum, 2048, 59, 1890, 112, 0, 0, 2061, 1
n250x8192-slot-sum, 2048, 59, 1882, 109, 0, 0, 2050, 1
n250x8192-slot-sum, 2048, 60, 1886, 108, 0, 0, 2054, 1
n250x8192-slot-sum, 2048, 60, 1894, 108, 0, 0, 2062, 1
n250x8192-slot-sum, 2048, 60, 1890, 109, 0, 0, 2059, 1
n250x8192-slot-sum, 2048, 60, 1891, 110, 0, 0, 2061, 1
n250x8192-slot-sum, 2048, 64, 1912, 113, 0, 0, 2089, 1
n250x8192-slot-sum, 2048, 60, 1892, 110, 0, 0, 2062, 1
n250x8192-slot-sum, 2048, 60, 1905, 110, 0, 0, 2075, 1
n250x8192-slot-sum, 2048, 59, 1889, 111, 0, 0, 2059, 1
n250x8192-slot-sum, 2048, 59, 1897, 111, 0, 0, 2067, 1
n250x8192-slot-sum, 2048, 59, 1901, 109, 0, 0, 2069, 1
n250x8192-slot-sum, 2048, 59, 1895, 108, 0, 0, 2062, 1
n250x8192-slot-sum, 2048, 59, 1879, 110, 0, 0, 2048, 1
n250x8192-slot-sum, 2048, 59, 1889, 110, 0, 0, 2058, 1
n250x8192-slot-sum, 2048, 60, 1884, 110, 0, 0, 2054, 1
n250x8192-slot-sum, 2048, 74, 1888, 109, 0, 0, 2071, 1
n250x8192-slot-sum, 2048, 60, 1882, 109, 0, 0, 2051, 1
n250x8192-slot-sum, 2048, 59, 1884, 109, 0, 0, 2052, 1
n250x8192-slot-sum, 2048, 63, 1892, 110, 0, 0, 2065, 1
n250x8192-slot-sum, 2048, 59, 1882, 109, 0, 0, 2050, 1
n250x8192-slot-sum, 2048, 59, 1882, 109, 0, 0, 2050, 1
n250x8192-slot-sum, 2048, 63, 1890, 113, 0, 0, 2066, 1
n250x8192-slot-sum, 2048, 60, 1894, 109, 0, 0, 2063, 1
n250x8192-slot-sum, 2048, 59, 1886, 112, 0, 0, 2057, 1
n250x8192-slot-sum, 2048, 59, 1892, 109, 0, 0, 2060, 1
n250x8192-slot-sum, 2048, 59, 1899, 109, 0, 0, 2067, 1
n250x8192-slot-sum, 2048, 60, 1888, 111, 0, 0, 2059, 1
n250x8192-slot-sum, 2048, 60, 1898, 111, 0, 0, 2069, 1
n250x8192-slot-sum, 2048, 60, 1888, 111, 0, 0, 2059, 1
n250x8192-slot-sum, 2048, 60, 1883, 110, 0, 0, 2053, 1
n250x8192-slot-sum, 2048, 59, 1895, 111, 0, 0, 2065, 1
n250x8192-slot-sum, 2048, 60, 1902, 111, 0, 0, 2073, 1
n250x8192-slot-sum, 2048, 60, 1888, 111, 0, 0, 2059, 1
n250x8192-slot-sum, 2048, 59, 1919, 110, 0, 0, 2088, 1
n250x8192-slot-sum, 2048, 60, 1914, 111, 0, 0, 2085, 1
n250x8192-slot-sum, 2048, 61, 1910, 113, 0, 0, 2084, 1
n250x8192-slot-sum, 1024, 32, 1919, 120, 0, 0, 2071, 1
n250x8192-slot-sum, 1024, 32, 1917, 118, 0, 0, 2067, 1
n250x8192-slot-sum, 1024, 32, 1903, 117, 0, 0, 2052, 1
n250x8192-slot-sum, 1024, 32, 1889, 119, 0, 0, 2040, 1
n250x8192-slot-sum, 1024, 32, 1913, 118, 0, 0, 2063, 1
n250x8192-slot-sum, 1024, 32, 1900, 120, 0, 0, 2052, 1
n250x8192-slot-sum, 1024, 32, 1914, 118, 0, 0, 2064, 1
n250x8192-slot-sum, 1024, 32, 1888, 116, 0, 0, 2036, 1
n250x8192-slot-sum, 1024, 32, 1899, 119, 0, 0, 2050, 1
n250x8192-slot-sum, 1024, 32, 1893, 118, 0, 0, 2043, 1
n250x8192-slot-sum, 1024, 32, 1901, 117, 0, 0, 2050, 1
n250x8192-slot-sum, 1024, 33, 1898, 120, 0, 0, 2051, 1
n250x8192-slot-sum, 1024, 32, 1889, 117, 0, 0, 2038, 1
n250x8192-slot-sum, 1024, 33, 1899, 118, 0, 0, 2050, 1
n250x8192-slot-sum, 1024, 32, 1887, 118, 0, 0, 2037, 1
n250x8192-slot-sum, 1024, 31, 1904, 118, 0, 0, 2053, 1
n250x8192-slot-sum, 1024, 32, 1892, 119, 0, 0, 2043, 1
n250x8192-slot-sum, 1024, 31, 1893, 116, 0, 0, 2040, 1
n250x8192-slot-sum, 1024, 31, 1902, 117, 0, 0, 2050, 1
n250x8192-slot-sum, 1024, 32, 1888, 117, 0, 0, 2037, 1
n250x8192-slot-sum, 1024, 31, 1889, 117, 0, 0, 2037, 1
n250x8192-slot-sum, 1024, 33, 1900, 119, 0, 0, 2052, 1
n250x8192-slot-sum, 1024, 32, 1922, 118, 0, 0, 2072, 1
n250x8192-slot-sum, 1024, 33, 1894, 117, 0, 0, 2044, 1
n250x8192-slot-sum, 1024, 32, 1884, 118, 0, 0, 2034, 1
n250x8192-slot-sum, 1024, 32, 1948, 123, 0, 0, 2103, 1
n250x8192-slot-sum, 1024, 32, 1940, 121, 0, 0, 2093, 1
n250x8192-slot-sum, 1024, 31, 1946, 119, 0, 0, 2096, 1
n250x8192-slot-sum, 1024, 34, 1924, 118, 0, 0, 2076, 1
n250x8192-slot-sum, 1024, 33, 1925, 120, 0, 0, 2078, 1
n250x8192-slot-sum, 1024, 32, 1916, 118, 0, 0, 2066, 1
n250x8192-slot-sum, 1024, 33, 1911, 118, 0, 0, 2062, 1
n250x8192-slot-sum, 1024, 33, 1909, 119, 0, 0, 2061, 1
n250x8192-slot-sum, 1024, 32, 1912, 122, 0, 0, 2066, 1
n250x8192-slot-sum, 1024, 32, 1906, 117, 0, 0, 2055, 1
n250x8192-slot-sum, 1024, 32, 1928, 119, 0, 0, 2079, 1
n250x8192-slot-sum, 1024, 33, 1907, 118, 0, 0, 2058, 1
n250x8192-slot-sum, 1024, 32, 1913, 117, 0, 0, 2062, 1
n250x8192-slot-sum, 1024, 31, 1919, 118, 0, 0, 2068, 1
n250x8192-slot-sum, 1024, 33, 1914, 120, 0, 0, 2067, 1
n250x8192-slot-sum, 1024, 32, 1928, 118, 0, 0, 2078, 1
n250x8192-slot-sum, 1024, 32, 1909, 121, 0, 0, 2062, 1
n250x8192-slot-sum, 1024, 32, 1936, 119, 0, 0, 2087, 1
n250x8192-slot-sum, 1024, 32, 1907, 121, 0, 0, 2060, 1
n250x8192-slot-sum, 1024, 32, 1904, 119, 0, 0, 2055, 1
n250x8192-slot-sum, 1024, 32, 1908, 117, 0, 0, 2057, 1
n250x8192-slot-sum, 1024, 32, 1911, 120, 0, 0, 2063, 1
n250x8192-slot-sum, 1024, 32, 1914, 117, 0, 0, 2063, 1
n250x8192-slot-sum, 1024, 31, 1919, 118, 0, 0, 2068, 1
n250x8192-slot-sum, 1024, 32, 1920, 121, 0, 0, 2073, 1
n250x8192-slot-sum, 1024, 32, 1926, 119, 0, 0, 2077, 1
n250x8192-slot-sum, 1024, 31, 1914, 116, 0, 0, 2061, 1
n250x8192-slot-sum, 1024, 32, 1913, 118, 0, 0, 2063, 1
n250x8192-slot-sum, 1024, 32, 1926, 117, 0, 0, 2075, 1
n250x8192-slot-sum, 1024, 32, 1911, 117, 0, 0, 2060, 1
n250x8192-slot-sum, 1024, 32, 1907, 116, 0, 0, 2055, 1
n250x8192-slot-sum, 1024, 32, 1913, 120, 0, 0, 2065, 1
n250x8192-slot-sum, 1024, 33, 1898, 118, 0, 0, 2049, 1
n250x8192-slot-sum, 1024, 32, 1907, 117, 0, 0, 2056, 1
n250x8192-slot-sum, 1024, 33, 1902, 117, 0, 0, 2052, 1
n250x8192-slot-sum, 1024, 33, 1900, 121, 0, 0, 2054, 1
n250x8192-slot-sum, 1024, 32, 1891, 119, 0, 0, 2042, 1
n250x8192-slot-sum, 1024, 31, 2661, 121, 0, 0, 2813, 1
n250x8192-slot-sum, 1024, 32, 2048, 117, 0, 0, 2197, 1
n250x8192-slot-sum, 1024, 32, 1893, 116, 0, 0, 2041, 1
n250x8192-slot-sum, 1024, 32, 1899, 119, 0, 0, 2050, 1
n250x8192-slot-sum, 1024, 32, 1901, 119, 0, 0, 2052, 1
n250x8192-slot-sum, 1024, 31, 1900, 116, 0, 0, 2047, 1
n250x8192-slot-sum, 1024, 31, 1891, 116, 0, 0, 2038, 1
n250x8192-slot-sum, 1024, 32, 1895, 116, 0, 0, 2043, 1
n250x8192-slot-sum, 1024, 31, 1895, 118, 0, 0, 2044, 1
n250x8192-slot-sum, 1024, 31, 1896, 118, 0, 0, 2045, 1
n250x8192-slot-sum, 1024, 32, 1889, 119, 0, 0, 2040, 1
n250x8192-slot-sum, 1024, 32, 1896, 115, 0, 0, 2043, 1
n250x8192-slot-sum, 1024, 32, 1894, 115, 0, 0, 2041, 1
n250x8192-slot-sum, 1024, 32, 1884, 120, 0, 0, 2036, 1
n250x8192-slot-sum, 1024, 32, 1889, 117, 0, 0, 2038, 1
n250x8192-slot-sum, 1024, 32, 1883, 115, 0, 0, 2030, 1
n250x8192-slot-sum, 1024, 32, 1891, 118, 0, 0, 2041, 1
n250x8192-slot-sum, 1024, 32, 1905, 118, 0, 0, 2055, 1
n250x8192-slot-sum, 1024, 31, 1900, 124, 0, 0, 2055, 1
n250x8192-slot-sum, 1024, 32, 1898, 118, 0, 0, 2048, 1
n250x8192-slot-sum, 1024, 31, 1907, 123, 0, 0, 2061, 1
n250x8192-slot-sum, 1024, 31, 1902, 118, 0, 0, 2051, 1
n250x8192-slot-sum, 1024, 32, 1893, 116, 0, 0, 2041, 1
n250x8192-slot-sum, 1024, 33, 1887, 117, 0, 0, 2037, 1
n250x8192-slot-sum, 1024, 32, 1892, 115, 0, 0, 2039, 1
n250x8192-slot-sum, 1024, 32, 1892, 116, 0, 0, 2040, 1
n250x8192-slot-sum, 1024, 31, 1893, 118, 0, 0, 2042, 1
n250x8192-slot-sum, 1024, 32, 1901, 116, 0, 0, 2049, 1
n250x8192-slot-sum, 1024, 32, 1908, 117, 0, 0, 2057, 1
n250x8192-slot-sum, 1024, 31, 1905, 117, 0, 0, 2053, 1
n250x8192-slot-sum, 1024, 32, 1898, 117, 0, 0, 2047, 1
n250x8192-slot-sum, 1024, 32, 1893, 118, 0, 0, 2043, 1
n250x8192-slot-sum, 1024, 31, 1913, 118, 0, 0, 2062, 1
n250x8192-slot-sum, 1024, 32, 1912, 120, 0, 0, 2064, 1
n250x8192-slot-sum, 1024, 31, 1898, 117, 0, 0, 2046, 1
n250x8192-slot-sum, 1024, 31, 1888, 117, 0, 0, 2036, 1
n250x8192-slot-sum, 1024, 31, 1891, 117, 0, 0, 2039, 1
n250x8192-slot-sum, 1024, 32, 1895, 117, 0, 0, 2044, 1
n250x8192-slot-inner, 8192, 289, 2029, 3456, 1, 0, 5775, 3.41334e+06
n250x8192-slot-inner, 8192, 290, 2034, 3473, 1, 0, 5798, 3.41334e+06
n250x8192-slot-inner, 8192, 292, 2027, 3495, 1, 0, 5815, 3.41334e+06
n250x8192-slot-inner, 8192, 289, 2031, 3473, 1, 0, 5794, 3.41334e+06
n250x8192-slot-inner, 8192, 288, 2028, 3467, 1, 0, 5784, 3.41334e+06
n250x8192-slot-inner, 8192, 284, 2012, 3431, 1, 0, 5728, 3.41334e+06
n250x8192-slot-inner, 8192, 290, 2036, 3457, 1, 0, 5784, 3.41334e+06
n250x8192-slot-inner, 8192, 287, 2022, 3474, 1, 0, 5784, 3.41334e+06
n250x8192-slot-inner, 8192, 280, 2018, 3465, 1, 0, 5764, 3.41334e+06
n250x8192-slot-inner, 8192, 284, 2029, 3451, 1, 0, 5765, 3.41334e+06
n250x8192-slot-inner, 8192, 287, 2010, 3436, 1, 0, 5734, 3.41334e+06
n250x8192-slot-inner, 8192, 284, 2002, 3430, 1, 0, 5717, 3.41334e+06
n250x8192-slot-inner, 8192, 283, 2031, 3491, 1, 0, 5806, 3.41334e+06
n250x8192-slot-inner, 8192, 287, 2015, 3600, 1, 0, 5903, 3.41334e+06
n250x8192-slot-inner, 8192, 287, 2024, 3439, 1, 0, 5751, 3.41334e+06
n250x8192-slot-inner, 8192, 285, 2024, 3478, 1, 0, 5788, 3.41334e+06
n250x8192-slot-inner, 8192, 284, 2010, 3434, 1, 0, 5729, 3.41334e+06
n250x8192-slot-inner, 8192, 284, 2004, 3442, 1, 0, 5731, 3.41334e+06
n250x8192-slot-inner, 8192, 294, 2041, 3470, 1, 0, 5806, 3.41334e+06
n250x8192-slot-inner, 8192, 280, 2003, 3433, 1, 0, 5717, 3.41334e+06
n250x8192-slot-inner, 8192, 285, 2020, 3456, 1, 0, 5762, 3.41334e+06
n250x8192-slot-inner, 8192, 285, 2017, 3449, 1, 0, 5752, 3.41334e+06
n250x8192-slot-inner, 8192, 287, 2006, 3464, 1, 0, 5758, 3.41334e+06
n250x8192-slot-inner, 8192, 287, 2017, 3470, 1, 0, 5775, 3.41334e+06
n250x8192-slot-inner, 8192, 292, 2039, 3458, 1, 0, 5790, 3.41334e+06
n250x8192-slot-inner, 8192, 290, 2029, 3471, 1, 0, 5791, 3.41334e+06
n250x8192-slot-inner, 8192, 284, 2015, 3474, 1, 0, 5774, 3.41334e+06
n250x8192-slot-inner, 8192, 287, 1998, 3578, 1, 0, 5864, 3.41334e+06
n250x8192-slot-inner, 8192, 283, 2002, 3429, 1, 0, 5715, 3.41334e+06
n250x8192-slot-inner, 8192, 286, 2016, 3438, 1, 0, 5741, 3.41334e+06
n250x8192-slot-inner, 8192, 288, 2030, 3479, 1, 0, 5798, 3.41334e+06
n250x8192-slot-inner, 8192, 284, 2000, 3434, 1, 0, 5719, 3.41334e+06
n250x8192-slot-inner, 8192, 283, 2008, 3444, 1, 0, 5736, 3.41334e+06
n250x8192-slot-inner, 8192, 288, 2031, 3454, 1, 0, 5774, 3.41334e+06
n250x8192-slot-inner, 8192, 289, 2010, 3477, 1, 0, 5777, 3.41334e+06
n250x8192-slot-inner, 8192, 286, 2014, 3606, 1, 0, 5907, 3.41334e+06
n250x8192-slot-inner, 8192, 285, 2036, 3497, 1, 0, 5819, 3.41334e+06
n250x8192-slot-inner, 8192, 290, 2027, 3460, 1, 0, 5778, 3.41334e+06
n250x8192-slot-inner, 8192, 289, 2038, 3477, 1, 0, 5805, 3.41334e+06
n250x8192-slot-inner, 8192, 285, 2013, 3447, 1, 0, 5746, 3.41334e+06
n250x8192-slot-inner, 8192, 285, 2027, 3445, 1, 0, 5758, 3.41334e+06
n250x8192-slot-inner, 8192, 287, 2023, 3499, 1, 0, 5810, 3.41334e+06
n250x8192-slot-inner, 8192, 285, 2029, 3481, 1, 0, 5796, 3.41334e+06
n250x8192-slot-inner, 8192, 288, 2038, 3482, 1, 0, 5809, 3.41334e+06
n250x8192-slot-inner, 8192, 283, 2036, 3490, 1, 0, 5810, 3.41334e+06
n250x8192-slot-inner, 8192, 286, 2029, 3479, 1, 0, 5795, 3.41334e+06
n250x8192-slot-inner, 8192, 285, 2019, 3458, 1, 0, 5763, 3.41334e+06
n250x8192-slot-inner, 8192, 285, 2031, 3466, 1, 0, 5783, 3.41334e+06
n250x8192-slot-inner, 8192, 286, 2016, 3478, 1, 0, 5781, 3.41334e+06
n250x8192-slot-inner, 8192, 289, 2041, 3502, 1, 0, 5833, 3.41334e+06
n250x8192-slot-inner, 8192, 285, 2025, 3457, 1, 0, 5768, 3.41334e+06
n250x8192-slot-inner, 8192, 285, 2008, 3592, 1, 0, 5886, 3.41334e+06
n250x8192-slot-inner, 8192, 289, 2014, 3438, 1, 0, 5742, 3.41334e+06
n250x8192-slot-inner, 8192, 297, 2024, 3605, 1, 0, 5927, 3.41334e+06
n250x8192-slot-inner, 8192, 287, 2037, 3542, 1, 0, 5867, 3.41334e+06
n250x8192-slot-inner, 8192, 283, 2017, 3614, 1, 0, 5915, 3.41334e+06
n250x8192-slot-inner, 8192, 281, 2011, 3457, 1, 0, 5750, 3.41334e+06
n250x8192-slot-inner, 8192, 289, 2010, 3452, 1, 0, 5752, 3.41334e+06
n250x8192-slot-inner, 8192, 289, 2015, 3460, 1, 0, 5765, 3.41334e+06
n250x8192-slot-inner, 8192, 298, 2030, 3584, 1, 0, 5913, 3.41334e+06
n250x8192-slot-inner, 8192, 284, 2036, 3471, 1, 0, 5792, 3.41334e+06
n250x8192-slot-inner, 8192, 286, 2033, 3470, 1, 0, 5790, 3.41334e+06
n250x8192-slot-inner, 8192, 282, 2009, 3447, 1, 0, 5739, 3.41334e+06
n250x8192-slot-inner, 8192, 284, 2042, 3450, 1, 0, 5777, 3.41334e+06
n250x8192-slot-inner, 8192, 288, 2021, 3546, 1, 0, 5856, 3.41334e+06
n250x8192-slot-inner, 8192, 286, 2017, 3478, 1, 0, 5782, 3.41334e+06
n250x8192-slot-inner, 8192, 287, 2010, 3468, 1, 0, 5766, 3.41334e+06
n250x8192-slot-inner, 8192, 289, 2033, 3460, 1, 0, 5783, 3.41334e+06
n250x8192-slot-inner, 8192, 287, 2033, 3469, 1, 0, 5790, 3.41334e+06
n250x8192-slot-inner, 8192, 289, 2007, 3445, 1, 0, 5742, 3.41334e+06
n250x8192-slot-inner, 8192, 291, 2019, 3474, 1, 0, 5785, 3.41334e+06
n250x8192-slot-inner, 8192, 284, 2020, 3467, 1, 0, 5772, 3.41334e+06
n250x8192-slot-inner, 8192, 286, 2007, 3445, 1, 0, 5739, 3.41334e+06
n250x8192-slot-inner, 8192, 287, 2057, 3497, 1, 0, 5842, 3.41334e+06
n250x8192-slot-inner, 8192, 285, 2013, 3467, 1, 0, 5766, 3.41334e+06
n250x8192-slot-inner, 8192, 287, 2029, 3473, 1, 0, 5790, 3.41334e+06
n250x8192-slot-inner, 8192, 287, 2015, 3442, 1, 0, 5745, 3.41334e+06
n250x8192-slot-inner, 8192, 289, 2021, 3474, 1, 0, 5785, 3.41334e+06
n250x8192-slot-inner, 8192, 289, 2031, 3479, 1, 0, 5800, 3.41334e+06
n250x8192-slot-inner, 8192, 287, 2003, 3457, 1, 0, 5748, 3.41334e+06
n250x8192-slot-inner, 8192, 285, 2004, 3447, 1, 0, 5737, 3.41334e+06
n250x8192-slot-inner, 8192, 283, 2009, 3457, 1, 0, 5750, 3.41334e+06
n250x8192-slot-inner, 8192, 284, 2026, 3443, 1, 0, 5754, 3.41334e+06
n250x8192-slot-inner, 8192, 285, 2010, 3450, 1, 0, 5746, 3.41334e+06
n250x8192-slot-inner, 8192, 287, 2014, 3459, 1, 0, 5761, 3.41334e+06
n250x8192-slot-inner, 8192, 286, 2013, 3464, 1, 0, 5764, 3.41334e+06
n250x8192-slot-inner, 8192, 289, 2015, 3437, 1, 0, 5742, 3.41334e+06
n250x8192-slot-inner, 8192, 287, 2024, 3451, 1, 0, 5763, 3.41334e+06
n250x8192-slot-inner, 8192, 283, 2016, 3443, 1, 0, 5743, 3.41334e+06
n250x8192-slot-inner, 8192, 283, 2003, 3421, 1, 0, 5708, 3.41334e+06
n250x8192-slot-inner, 8192, 288, 1997, 3408, 1, 0, 5694, 3.41334e+06
n250x8192-slot-inner, 8192, 287, 2005, 3574, 1, 0, 5867, 3.41334e+06
n250x8192-slot-inner, 8192, 287, 2012, 3445, 1, 0, 5745, 3.41334e+06
n250x8192-slot-inner, 8192, 283, 2015, 3463, 1, 0, 5762, 3.41334e+06
n250x8192-slot-inner, 8192, 285, 2013, 3449, 1, 0, 5748, 3.41334e+06
n250x8192-slot-inner, 8192, 282, 2009, 3415, 1, 0, 5707, 3.41334e+06
n250x8192-slot-inner, 8192, 282, 1999, 3432, 1, 0, 5714, 3.41334e+06
n250x8192-slot-inner, 8192, 292, 2015, 3586, 1, 0, 5894, 3.41334e+06
n250x8192-slot-inner, 8192, 285, 2016, 3450, 1, 0, 5752, 3.41334e+06
n250x8192-slot-inner, 8192, 286, 2020, 3460, 1, 0, 5767, 3.41334e+06
n250x8192-slot-inner, 4096, 136, 1936, 3370, 0, 0, 5442, 3.41334e+06
n250x8192-slot-inner, 4096, 134, 1938, 3352, 0, 0, 5424, 3.41334e+06
n250x8192-slot-inner, 4096, 132, 1943, 3362, 0, 0, 5437, 3.41334e+06
n250x8192-slot-inner, 4096, 136, 1958, 3364, 0, 0, 5458, 3.41334e+06
n250x8192-slot-inner, 4096, 135, 1950, 3327, 0, 0, 5412, 3.41334e+06
n250x8192-slot-inner, 4096, 137, 1943, 3425, 0, 0, 5505, 3.41334e+06
n250x8192-slot-inner, 4096, 135, 1935, 3325, 0, 0, 5395, 3.41334e+06
n250x8192-slot-inner, 4096, 134, 1939, 3338, 0, 0, 5411, 3.41334e+06
n250x8192-slot-inner, 4096, 133, 1934, 3318, 0, 0, 5385, 3.41334e+06
n250x8192-slot-inner, 4096, 136, 1940, 3333, 0, 0, 5409, 3.41334e+06
n250x8192-slot-inner, 4096, 143, 1940, 3464, 0, 0, 5547, 3.41334e+06
n250x8192-slot-inner, 4096, 134, 1934, 3327, 0, 0, 5395, 3.41334e+06
n250x8192-slot-inner, 4096, 133, 1930, 3329, 0, 0, 5392, 3.41334e+06
n250x8192-slot-inner, 4096, 140, 1942, 3315, 0, 0, 5397, 3.41334e+06
n250x8192-slot-inner, 4096, 132, 1941, 3448, 0, 0, 5521, 3.41334e+06
n250x8192-slot-inner, 4096, 136, 1946, 3299, 0, 0, 5381, 3.41334e+06
n250x8192-slot-inner, 4096, 133, 1950, 3324, 0, 0, 5407, 3.41334e+06
n250x8192-slot-inner, 4096, 133, 1941, 3329, 0, 0, 5403, 3.41334e+06
n250x8192-slot-inner, 4096, 141, 1926, 3332, 0, 0, 5399, 3.41334e+06
n250x8192-slot-inner, 4096, 134, 1937, 3304, 0, 0, 5375, 3.41334e+06
n250x8192-slot-inner, 4096, 135, 1939, 3354, 0, 0, 5428, 3.41334e+06
n250x8192-slot-inner, 4096, 134, 1931, 3303, 0, 0, 5368, 3.41334e+06
n250x8192-slot-inner, 4096, 131, 1930, 3310, 0, 0, 5371, 3.41334e+06
n250x8192-slot-inner, 4096, 136, 1929, 3293, 0, 0, 5358, 3.41334e+06
n250x8192-slot-inner, 4096, 132, 1937, 3301, 0, 0, 5370, 3.41334e+06
n250x8192-slot-inner, 4096, 133, 1949, 3398, 0, 0, 5480, 3.41334e+06
n250x8192-slot-inner, 4096, 134, 1973, 3389, 0, 0, 5496, 3.41334e+06
n250x8192-slot-inner, 4096, 133, 1977, 3494, 0, 0, 5604, 3.41334e+06
n250x8192-slot-inner, 4096, 135, 1946, 3360, 0, 0, 5441, 3.41334e+06
n250x8192-slot-inner, 4096, 138, 1967, 3400, 0, 0, 5505, 3.41334e+06
n250x8192-slot-inner, 4096, 138, 1980, 3382, 0, 0, 5500, 3.41334e+06
n250x8192-slot-inner, 4096, 135, 1967, 3364, 0, 0, 5466, 3.41334e+06
n250x8192-slot-inner, 4096, 144, 1957, 3483, 0, 0, 5584, 3.41334e+06
n250x8192-slot-inner, 4096, 137, 1958, 3355, 0, 0, 5450, 3.41334e+06
n250x8192-slot-inner, 4096, 137, 1980, 3385, 0, 0, 5502, 3.41334e+06
n250x8192-slot-inner, 4096, 140, 1978, 3375, 0, 0, 5493, 3.41334e+06
n250x8192-slot-inner, 4096, 135, 1951, 3330, 0, 0, 5416, 3.41334e+06
n250x8192-slot-inner, 4096, 133, 1939, 3394, 0, 0, 5466, 3.41334e+06
n250x8192-slot-inner, 4096, 133, 1948, 3329, 0, 0, 5410, 3.41334e+06
n250x8192-slot-inner, 4096, 139, 1974, 3347, 0, 0, 5460, 3.41334e+06
n250x8192-slot-inner, 4096, 142, 1941, 3315, 0, 0, 5398, 3.41334e+06
n250x8192-slot-inner, 4096, 137, 1957, 3358, 0, 0, 5452, 3.41334e+06
n250x8192-slot-inner, 4096, 134, 1947, 3326, 0, 0, 5407, 3.41334e+06
n250x8192-slot-inner, 4096, 132, 1934, 3324, 0, 0, 5390, 3.41334e+06
n250x8192-slot-inner, 4096, 133, 1922, 3319, 0, 0, 5374, 3.41334e+06
n250x8192-slot-inner, 4096, 133, 1936, 3325, 0, 0, 5394, 3.41334e+06
n250x8192-slot-inner, 4096, 136, 1932, 3333, 0, 0, 5401, 3.41334e+06
n250x8192-slot-inner, 4096, 135, 1940, 3328, 0, 0, 5403, 3.41334e+06
n250x8192-slot-inner, 4096, 134, 1944, 3423, 0, 0, 5501, 3.41334e+06
n250x8192-slot-inner, 4096, 134, 1947, 3313, 0, 0, 5394, 3.41334e+06
n250x8192-slot-inner, 4096, 133, 1938, 3316, 0, 0, 5387, 3.41334e+06
n250x8192-slot-inner, 4096, 136, 1958, 3335, 0, 0, 5429, 3.41334e+06
n250x8192-slot-inner, 4096, 138, 1947, 3352, 0, 0, 5437, 3.41334e+06
n250x8192-slot-inner, 4096, 131, 1933, 3324, 0, 0, 5388, 3.41334e+06
n250x8192-slot-inner, 4096, 134, 1933, 3318, 0, 0, 5385, 3.41334e+06
n250x8192-slot-inner, 4096, 135, 1944, 3329, 0, 0, 5408, 3.41334e+06
n250x8192-slot-inner, 4096, 132, 1951, 3352, 0, 0, 5435, 3.41334e+06
n250x8192-slot-inner, 4096, 135, 1940, 3368, 0, 0, 5443, 3.41334e+06
n250x8192-slot-inner, 4096, 136, 1977, 3395, 0, 0, 5508, 3.41334e+06
n250x8192-slot-inner, 4096, 135, 1948, 3345, 0, 0, 5428, 3.41334e+06
n250x8192-slot-inner, 4096, 133, 1933, 3444, 0, 0, 5510, 3.41334e+06
n250x8192-slot-inner, 4096, 136, 1932, 3316, 0, 0, 5384, 3.41334e+06
n250x8192-slot-inner, 4096, 132, 1930, 3320, 0, 0, 5382, 3.41334e+06
n250x8192-slot-inner, 4096, 136, 1939, 3345, 0, 0, 5420, 3.41334e+06
n250x8192-slot-inner, 4096, 135, 1932, 3319, 0, 0, 5386, 3.41334e+06
n250x8192-slot-inner, 4096, 133, 1969, 3348, 0, 0, 5450, 3.41334e+06
n250x8192-slot-inner, 4096, 133, 1932, 3314, 0, 0, 5379, 3.41334e+06
n250x8192-slot-inner, 4096, 135, 1938, 3311, 0, 0, 5384, 3.41334e+06
n250x8192-slot-inner, 4096, 132, 1936, 3330, 0, 0, 5398, 3.41334e+06
n250x8192-slot-inner, 4096, 134, 1950, 3325, 0, 0, 5409, 3.41334e+06
n250x8192-slot-inner, 4096, 148, 1972, 3379, 0, 0, 5499, 3.41334e+06
n250x8192-slot-inner, 4096, 134, 1957, 3363, 0, 0, 5454, 3.41334e+06
n250x8192-slot-inner, 4096, 133, 1928, 3329, 0, 0, 5390, 3.41334e+06
n250x8192-slot-inner, 4096, 136, 1974, 3360, 0, 0, 5470, 3.41334e+06
n250x8192-slot-inner, 4096, 140, 1948, 3480, 0, 0, 5568, 3.41334e+06
n250x8192-slot-inner, 4096, 137, 1979, 3386, 0, 0, 5502, 3.41334e+06
n250x8192-slot-inner, 4096, 144, 1925, 3465, 0, 0, 5534, 3.41334e+06
n250x8192-slot-inner, 4096, 134, 1942, 3347, 0, 0, 5423, 3.41334e+06
n250x8192-slot-inner, 4096, 133, 1932, 3313, 0, 0, 5378, 3.41334e+06
n250x8192-slot-inner, 4096, 133, 1955, 3320, 0, 0, 5408, 3.41334e+06
n250x8192-slot-inner, 4096, 134, 1973, 3348, 0, 0, 5455, 3.41334e+06
n250x8192-slot-inner, 4096, 131, 1924, 3306, 0, 0, 5361, 3.41334e+06
n250x8192-slot-inner, 4096, 134, 1944, 3317, 0, 0, 5395, 3.41334e+06
n250x8192-slot-inner, 4096, 132, 1932, 3296, 0, 0, 5360, 3.41334e+06
n250x8192-slot-inner, 4096, 132, 1935, 3304, 0, 0, 5371, 3.41334e+06
n250x8192-slot-inner, 4096, 134, 1932, 3301, 0, 0, 5367, 3.41334e+06
n250x8192-slot-inner, 4096, 136, 1930, 3302, 0, 0, 5368, 3.41334e+06
n250x8192-slot-inner, 4096, 134, 1930, 3295, 0, 0, 5359, 3.41334e+06
n250x8192-slot-inner, 4096, 134, 1927, 3302, 0, 0, 5363, 3.41334e+06
n250x8192-slot-inner, 4096, 135, 1926, 3306, 0, 0, 5367, 3.41334e+06
n250x8192-slot-inner, 4096, 135, 1942, 3325, 0, 0, 5402, 3.41334e+06
n250x8192-slot-inner, 4096, 137, 1938, 3336, 0, 0, 5411, 3.41334e+06
n250x8192-slot-inner, 4096, 133, 1953, 3378, 0, 0, 5464, 3.41334e+06
n250x8192-slot-inner, 4096, 135, 1928, 3317, 0, 0, 5380, 3.41334e+06
n250x8192-slot-inner, 4096, 131, 1946, 3306, 0, 0, 5383, 3.41334e+06
n250x8192-slot-inner, 4096, 132, 1925, 3314, 0, 0, 5371, 3.41334e+06
n250x8192-slot-inner, 4096, 132, 1923, 3308, 0, 0, 5363, 3.41334e+06
n250x8192-slot-inner, 4096, 136, 1940, 3340, 0, 0, 5416, 3.41334e+06
n250x8192-slot-inner, 4096, 135, 1952, 3367, 0, 0, 5454, 3.41334e+06
n250x8192-slot-inner, 4096, 134, 1931, 3299, 0, 0, 5364, 3.41334e+06
n250x8192-slot-inner, 2048, 64, 1889, 3313, 0, 0, 5266, 3.41334e+06
n250x8192-slot-inner, 2048, 65, 1891, 3259, 0, 0, 5215, 3.41334e+06
n250x8192-slot-inner, 2048, 64, 1887, 3259, 0, 0, 5210, 3.41334e+06
n250x8192-slot-inner, 2048, 64, 1889, 3272, 0, 0, 5225, 3.41334e+06
n250x8192-slot-inner, 2048, 65, 1888, 3272, 0, 0, 5225, 3.41334e+06
n250x8192-slot-inner, 2048, 65, 1883, 3259, 0, 0, 5207, 3.41334e+06
n250x8192-slot-inner, 2048, 65, 1882, 3274, 0, 0, 5221, 3.41334e+06
n250x8192-slot-inner, 2048, 64, 1891, 3282, 0, 0, 5237, 3.41334e+06
n250x8192-slot-inner, 2048, 65, 1896, 3324, 0, 0, 5285, 3.41334e+06
n250x8192-slot-inner, 2048, 64, 1889, 3247, 0, 0, 5200, 3.41334e+06
n250x8192-slot-inner, 2048, 64, 1882, 3274, 0, 0, 5220, 3.41334e+06
n250x8192-slot-inner, 2048, 65, 1884, 3297, 0, 0, 5246, 3.41334e+06
n250x8192-slot-inner, 2048, 65, 1900, 3313, 0, 0, 5278, 3.41334e+06
n250x8192-slot-inner, 2048, 64, 1895, 3330, 0, 0, 5289, 3.41334e+06
n250x8192-slot-inner, 2048, 65, 1897, 3363, 0, 0, 5325, 3.41334e+06
n250x8192-slot-inner, 2048, 64, 1896, 3255, 0, 0, 5215, 3.41334e+06
n250x8192-slot-inner, 2048, 64, 1890, 3264, 0, 0, 5218, 3.41334e+06
n250x8192-slot-inner, 2048, 64, 1884, 3259, 0, 0, 5207, 3.41334e+06
n250x8192-slot-inner, 2048, 64, 1883, 3259, 0, 0, 5206, 3.41334e+06
n250x8192-slot-inner, 2048, 64, 1892, 3247, 0, 0, 5203, 3.41334e+06
n250x8192-slot-inner, 2048, 64, 1889, 3260, 0, 0, 5213, 3.41334e+06
n250x8192-slot-inner, 2048, 64, 1887, 3277, 0, 0, 5228, 3.41334e+06
n250x8192-slot-inner, 2048, 63, 1884, 3260, 0, 0, 5207, 3.41334e+06
n250x8192-slot-inner, 2048, 64, 1909, 3279, 0, 0, 5252, 3.41334e+06
n250x8192-slot-inner, 2048, 65, 1888, 3298, 0, 0, 5251, 3.41334e+06
n250x8192-slot-inner, 2048, 63, 1880, 3256, 0, 0, 5199, 3.41334e+06
n250x8192-slot-inner, 2048, 64, 1892, 3278, 0, 0, 5234, 3.41334e+06
n250x8192-slot-inner, 2048, 64, 1892, 3262, 0, 0, 5218, 3.41334e+06
n250x8192-slot-inner, 2048, 64, 1895, 3259, 0, 0, 5218, 3.41334e+06
n250x8192-slot-inner, 2048, 65, 1892, 3265, 0, 0, 5222, 3.41334e+06
n250x8192-slot-inner, 2048, 63, 1887, 3275, 0, 0, 5225, 3.41334e+06
n250x8192-slot-inner, 2048, 64, 1883, 3273, 0, 0, 5220, 3.41334e+06
n250x8192-slot-inner, 2048, 64, 1876, 3275, 0, 0, 5215, 3.41334e+06
n250x8192-slot-inner, 2048, 63, 1883, 3291, 0, 0, 5237, 3.41334e+06
n250x8192-slot-inner, 2048, 64, 1909, 3294, 0, 0, 5267, 3.41334e+06
n250x8192-slot-inner, 2048, 64, 1885, 3327, 0, 0, 5276, 3.41334e+06
n250x8192-slot-inner, 2048, 63, 1876, 3337, 0, 0, 5276, 3.41334e+06
n250x8192-slot-inner, 2048, 64, 1896, 3300, 0, 0, 5260, 3.41334e+06
n250x8192-slot-inner, 2048, 65, 1902, 3287, 0, 0, 5254, 3.41334e+06
n250x8192-slot-inner, 2048, 65, 1899, 3287, 0, 0, 5251, 3.41334e+06
n250x8192-slot-inner, 2048, 64, 1908, 3688, 0, 0, 5660, 3.41334e+06
n250x8192-slot-inner, 2048, 65, 1892, 3294, 0, 0, 5251, 3.41334e+06
n250x8192-slot-inner, 2048, 64, 1918, 3350, 0, 0, 5332, 3.41334e+06
n250x8192-slot-inner, 2048, 64, 1890, 3286, 0, 0, 5240, 3.41334e+06
n250x8192-slot-inner, 2048, 65, 1905, 3298, 0, 0, 5268, 3.41334e+06
n250x8192-slot-inner, 2048, 63, 1927, 3294, 0, 0, 5284, 3.41334e+06
n250x8192-slot-inner, 2048, 64, 1900, 3334, 0, 0, 5298, 3.41334e+06
n250x8192-slot-inner, 2048, 64, 1895, 3277, 0, 0, 5236, 3.41334e+06
n250x8192-slot-inner, 2048, 64, 1902, 3284, 0, 0, 5250, 3.41334e+06
n250x8192-slot-inner, 2048, 64, 1892, 3277, 0, 0, 5233, 3.41334e+06
n250x8192-slot-inner, 2048, 65, 1902, 3308, 0, 0, 5275, 3.41334e+06
n250x8192-slot-inner, 2048, 68, 1902, 3438, 0, 0, 5408, 3.41334e+06
n250x8192-slot-inner, 2048, 65, 1897, 3304, 0, 0, 5266, 3.41334e+06
n250x8192-slot-inner, 2048, 64, 1902, 3307, 0, 0, 5273, 3.41334e+06
n250x8192-slot-inner, 2048, 64, 1899, 3316, 0, 0, 5279, 3.41334e+06
n250x8192-slot-inner, 2048, 67, 1894, 3428, 0, 0, 5389, 3.41334e+06
n250x8192-slot-inner, 2048, 64, 1911, 3347, 0, 0, 5322, 3.41334e+06
n250x8192-slot-inner, 2048, 65, 1918, 3328, 0, 0, 5311, 3.41334e+06
n250x8192-slot-inner, 2048, 64, 1905, 3366, 0, 0, 5335, 3.41334e+06
n250x8192-slot-inner, 2048, 65, 1905, 3314, 0, 0, 5284, 3.41334e+06
n250x8192-slot-inner, 2048, 64, 1916, 3300, 0, 0, 5280, 3.41334e+06
n250x8192-slot-inner, 2048, 65, 1893, 3291, 0, 0, 5249, 3.41334e+06
n250x8192-slot-inner, 2048, 64, 1894, 3293, 0, 0, 5251, 3.41334e+06
n250x8192-slot-inner, 2048, 63, 1888, 3279, 0, 0, 5230, 3.41334e+06
n250x8192-slot-inner, 2048, 64, 1889, 3267, 0, 0, 5220, 3.41334e+06
n250x8192-slot-inner, 2048, 63, 1890, 3278, 0, 0, 5231, 3.41334e+06
n250x8192-slot-inner, 2048, 65, 1886, 3283, 0, 0, 5234, 3.41334e+06
n250x8192-slot-inner, 2048, 63, 1899, 3303, 0, 0, 5265, 3.41334e+06
n250x8192-slot-inner, 2048, 64, 1896, 3301, 0, 0, 5261, 3.41334e+06
n250x8192-slot-inner, 2048, 66, 1887, 3298, 0, 0, 5251, 3.41334e+06
n250x8192-slot-inner, 2048, 64, 1897, 3294, 0, 0, 5255, 3.41334e+06
n250x8192-slot-inner, 2048, 66, 1902, 3293, 0, 0, 5261, 3.41334e+06
n250x8192-slot-inner, 2048, 64, 1896, 3277, 0, 0, 5237, 3.41334e+06
n250x8192-slot-inner, 2048, 64, 1888, 3274, 0, 0, 5226, 3.41334e+06
n250x8192-slot-inner, 2048, 69, 1895, 3282, 0, 0, 5246, 3.41334e+06
n250x8192-slot-inner, 2048, 64, 1886, 3274, 0, 0, 5224, 3.41334e+06
n250x8192-slot-inner, 2048, 64, 1886, 3284, 0, 0, 5234, 3.41334e+06
n250x8192-slot-inner, 2048, 64, 1895, 3273, 0, 0, 5232, 3.41334e+06
n250x8192-slot-inner, 2048, 64, 1889, 3301, 0, 0, 5254, 3.41334e+06
n250x8192-slot-inner, 2048, 65, 1893, 3398, 0, 0, 5356, 3.41334e+06
n250x8192-slot-inner, 2048, 64, 1900, 3258, 0, 0, 5222, 3.41334e+06
n250x8192-slot-inner, 2048, 65, 1893, 3288, 0, 0, 5246, 3.41334e+06
n250x8192-slot-inner, 2048, 64, 1890, 3286, 0, 0, 5240, 3.41334e+06
n250x8192-slot-inner, 2048, 63, 1889, 3280, 0, 0, 5232, 3.41334e+06
n250x8192-slot-inner, 2048, 63, 1890, 3260, 0, 0, 5213, 3.41334e+06
n250x8192-slot-inner, 2048, 66, 1897, 3282, 0, 0, 5245, 3.41334e+06
n250x8192-slot-inner, 2048, 64, 1886, 3265, 0, 0, 5215, 3.41334e+06
n250x8192-slot-inner, 2048, 63, 1897, 3401, 0, 0, 5361, 3.41334e+06
n250x8192-slot-inner, 2048, 64, 1891, 3265, 0, 0, 5220, 3.41334e+06
n250x8192-slot-inner, 2048, 64, 1919, 3399, 0, 0, 5382, 3.41334e+06
n250x8192-slot-inner, 2048, 66, 1942, 3363, 0, 0, 5371, 3.41334e+06
n250x8192-slot-inner, 2048, 64, 1937, 3415, 0, 0, 5416, 3.41334e+06
n250x8192-slot-inner, 2048, 68, 1927, 3493, 0, 0, 5488, 3.41334e+06
n250x8192-slot-inner, 2048, 66, 1929, 3355, 0, 0, 5350, 3.41334e+06
n250x8192-slot-inner, 2048, 69, 1924, 3362, 0, 0, 5355, 3.41334e+06
n250x8192-slot-inner, 2048, 66, 1922, 3371, 0, 0, 5359, 3.41334e+06
n250x8192-slot-inner, 2048, 68, 1922, 3359, 0, 0, 5349, 3.41334e+06
n250x8192-slot-inner, 2048, 64, 1910, 3339, 0, 0, 5313, 3.41334e+06
n250x8192-slot-inner, 2048, 66, 1917, 3375, 0, 0, 5358, 3.41334e+06
n250x8192-slot-inner, 2048, 66, 1931, 3390, 0, 0, 5387, 3.41334e+06
n250x8192-slot-inner, 1024, 35, 1932, 3528, 0, 0, 5495, 3.41334e+06
n250x8192-slot-inner, 1024, 33, 1919, 3481, 0, 0, 5433, 3.41334e+06
n250x8192-slot-inner, 1024, 35, 1920, 3476, 0, 0, 5431, 3.41334e+06
n250x8192-slot-inner, 1024, 34, 1920, 3475, 0, 0, 5429, 3.41334e+06
n250x8192-slot-inner, 1024, 34, 1930, 3451, 0, 0, 5415, 3.41334e+06
n250x8192-slot-inner, 1024, 34, 1949, 3483, 0, 0, 5466, 3.41334e+06
n250x8192-slot-inner, 1024, 35, 1926, 3503, 0, 0, 5464, 3.41334e+06
n250x8192-slot-inner, 1024, 38, 1923, 3455, 0, 0, 5416, 3.41334e+06
n250x8192-slot-inner, 1024, 35, 1897, 3455, 0, 0, 5387, 3.41334e+06
n250x8192-slot-inner, 1024, 34, 1925, 3433, 0, 0, 5392, 3.41334e+06
n250x8192-slot-inner, 1024, 34, 1902, 3425, 0, 0, 5361, 3.41334e+06
n250x8192-slot-inner, 1024, 34, 1949, 3464, 0, 0, 5447, 3.41334e+06
n250x8192-slot-inner, 1024, 34, 1918, 3449, 0, 0, 5401, 3.41334e+06
n250x8192-slot-inner, 1024, 35, 1914, 3443, 0, 0, 5392, 3.41334e+06
n250x8192-slot-inner, 1024, 34, 1920, 3404, 0, 0, 5358, 3.41334e+06
n250x8192-slot-inner, 1024, 35, 1903, 3405, 0, 0, 5343, 3.41334e+06
n250x8192-slot-inner, 1024, 35, 1899, 3435, 0, 0, 5369, 3.41334e+06
n250x8192-slot-inner, 1024, 35, 1916, 3424, 0, 0, 5375, 3.41334e+06
n250x8192-slot-inner, 1024, 34, 1897, 3434, 0, 0, 5365, 3.41334e+06
n250x8192-slot-inner, 1024, 33, 1896, 3445, 0, 0, 5374, 3.41334e+06
n250x8192-slot-inner, 1024, 35, 1908, 3428, 0, 0, 5371, 3.41334e+06
n250x8192-slot-inner, 1024, 33, 1888, 3398, 0, 0, 5319, 3.41334e+06
n250x8192-slot-inner, 1024, 35, 1920, 3417, 0, 0, 5372, 3.41334e+06
n250x8192-slot-inner, 1024, 34, 1917, 3411, 0, 0, 5362, 3.41334e+06
n250x8192-slot-inner, 1024, 34, 1887, 3392, 0, 0, 5313, 3.41334e+06
n250x8192-slot-inner, 1024, 34, 1900, 3428, 0, 0, 5362, 3.41334e+06
n250x8192-slot-inner, 1024, 35, 1901, 3423, 0, 0, 5359, 3.41334e+06
n250x8192-slot-inner, 1024, 34, 1902, 3422, 0, 0, 5358, 3.41334e+06
n250x8192-slot-inner, 1024, 34, 1895, 3436, 0, 0, 5365, 3.41334e+06
n250x8192-slot-inner, 1024, 34, 1899, 3417, 0, 0, 5350, 3.41334e+06
n250x8192-slot-inner, 1024, 34, 1894, 3408, 0, 0, 5336, 3.41334e+06
n250x8192-slot-inner, 1024, 34, 1887, 3393, 0, 0, 5314, 3.41334e+06
n250x8192-slot-inner, 1024, 35, 1893, 3449, 0, 0, 5377, 3.41334e+06
n250x8192-slot-inner, 1024, 34, 1904, 3389, 0, 0, 5327, 3.41334e+06
n250x8192-slot-inner, 1024, 33, 1907, 3395, 0, 0, 5335, 3.41334e+06
n250x8192-slot-inner, 1024, 34, 1894, 3413, 0, 0, 5341, 3.41334e+06
n250x8192-slot-inner, 1024, 34, 1904, 3518, 0, 0, 5456, 3.41334e+06
n250x8192-slot-inner, 1024, 35, 1904, 3410, 0, 0, 5349, 3.41334e+06
n250x8192-slot-inner, 1024, 35, 1907, 3428, 0, 0, 5370, 3.41334e+06
n250x8192-slot-inner, 1024, 34, 1895, 3414, 0, 0, 5343, 3.41334e+06
n250x8192-slot-inner, 1024, 33, 1903, 3424, 0, 0, 5360, 3.41334e+06
n250x8192-slot-inner, 1024, 34, 1892, 3417, 0, 0, 5343, 3.41334e+06
n250x8192-slot-inner, 1024, 34, 1903, 3393, 0, 0, 5330, 3.41334e+06
n250x8192-slot-inner, 1024, 34, 1899, 3460, 0, 0, 5393, 3.41334e+06
n250x8192-slot-inner, 1024, 34, 1909, 3448, 0, 0, 5391, 3.41334e+06
n250x8192-slot-inner, 1024, 35, 1902, 3412, 0, 0, 5349, 3.41334e+06
n250x8192-slot-inner, 1024, 34, 1901, 3433, 0, 0, 5368, 3.41334e+06
n250x8192-slot-inner, 1024, 34, 1893, 3433, 0, 0, 5360, 3.41334e+06
n250x8192-slot-inner, 1024, 35, 1902, 3398, 0, 0, 5335, 3.41334e+06
n250x8192-slot-inner, 1024, 34, 1898, 3464, 0, 0, 5396, 3.41334e+06
n250x8192-slot-inner, 1024, 34, 1899, 3421, 0, 0, 5354, 3.41334e+06
n250x8192-slot-inner, 1024, 34, 1894, 3428, 0, 0, 5356, 3.41334e+06
n250x8192-slot-inner, 1024, 35, 1899, 3408, 0, 0, 5342, 3.41334e+06
n250x8192-slot-inner, 1024, 34, 1909, 3449, 0, 0, 5392, 3.41334e+06
n250x8192-slot-inner, 1024, 33, 1913, 3453, 0, 0, 5399, 3.41334e+06
n250x8192-slot-inner, 1024, 34, 1923, 3424, 0, 0, 5381, 3.41334e+06
n250x8192-slot-inner, 1024, 34, 1905, 3520, 0, 0, 5459, 3.41334e+06
n250x8192-slot-inner, 1024, 33, 1903, 3452, 0, 0, 5388, 3.41334e+06
n250x8192-slot-inner, 1024, 37, 1906, 3533, 0, 0, 5476, 3.41334e+06
n250x8192-slot-inner, 1024, 35, 1897, 3466, 0, 0, 5398, 3.41334e+06
n250x8192-slot-inner, 1024, 35, 1903, 3430, 0, 0, 5368, 3.41334e+06
n250x8192-slot-inner, 1024, 34, 1903, 3425, 0, 0, 5362, 3.41334e+06
n250x8192-slot-inner, 1024, 33, 1896, 3413, 0, 0, 5342, 3.41334e+06
n250x8192-slot-inner, 1024, 36, 1901, 3402, 0, 0, 5339, 3.41334e+06
n250x8192-slot-inner, 1024, 35, 1904, 3414, 0, 0, 5353, 3.41334e+06
n250x8192-slot-inner, 1024, 34, 1900, 3442, 0, 0, 5376, 3.41334e+06
n250x8192-slot-inner, 1024, 35, 1907, 3452, 0, 0, 5394, 3.41334e+06
n250x8192-slot-inner, 1024, 34, 1938, 3447, 0, 0, 5419, 3.41334e+06
n250x8192-slot-inner, 1024, 34, 1898, 3398, 0, 0, 5330, 3.41334e+06
n250x8192-slot-inner, 1024, 35, 1895, 3410, 0, 0, 5340, 3.41334e+06
n250x8192-slot-inner, 1024, 34, 1896, 3392, 0, 0, 5322, 3.41334e+06
n250x8192-slot-inner, 1024, 35, 1896, 3391, 0, 0, 5322, 3.41334e+06
n250x8192-slot-inner, 1024, 34, 1902, 3390, 0, 0, 5326, 3.41334e+06
n250x8192-slot-inner, 1024, 34, 1899, 3425, 0, 0, 5358, 3.41334e+06
n250x8192-slot-inner, 1024, 33, 1899, 3396, 0, 0, 5328, 3.41334e+06
n250x8192-slot-inner, 1024, 34, 1887, 3398, 0, 0, 5319, 3.41334e+06
n250x8192-slot-inner, 1024, 34, 1909, 3478, 0, 0, 5421, 3.41334e+06
n250x8192-slot-inner, 1024, 34, 1899, 3419, 0, 0, 5352, 3.41334e+06
n250x8192-slot-inner, 1024, 34, 1899, 3385, 0, 0, 5318, 3.41334e+06
n250x8192-slot-inner, 1024, 34, 1896, 3434, 0, 0, 5364, 3.41334e+06
n250x8192-slot-inner, 1024, 33, 1908, 3457, 0, 0, 5398, 3.41334e+06
n250x8192-slot-inner, 1024, 33, 1894, 3439, 0, 0, 5366, 3.41334e+06
n250x8192-slot-inner, 1024, 34, 1918, 3468, 0, 0, 5420, 3.41334e+06
n250x8192-slot-inner, 1024, 34, 1912, 3468, 0, 0, 5414, 3.41334e+06
n250x8192-slot-inner, 1024, 35, 1912, 3470, 0, 0, 5417, 3.41334e+06
n250x8192-slot-inner, 1024, 34, 1906, 3465, 0, 0, 5405, 3.41334e+06
n250x8192-slot-inner, 1024, 34, 1900, 3401, 0, 0, 5335, 3.41334e+06
n250x8192-slot-inner, 1024, 33, 1925, 3445, 0, 0, 5403, 3.41334e+06
n250x8192-slot-inner, 1024, 35, 1904, 3448, 0, 0, 5387, 3.41334e+06
n250x8192-slot-inner, 1024, 35, 1889, 3372, 0, 0, 5296, 3.41334e+06
n250x8192-slot-inner, 1024, 34, 1896, 3410, 0, 0, 5340, 3.41334e+06
n250x8192-slot-inner, 1024, 34, 1904, 3411, 0, 0, 5349, 3.41334e+06
n250x8192-slot-inner, 1024, 34, 1895, 3406, 0, 0, 5335, 3.41334e+06
n250x8192-slot-inner, 1024, 34, 1900, 3396, 0, 0, 5330, 3.41334e+06
n250x8192-slot-inner, 1024, 33, 1890, 3403, 0, 0, 5326, 3.41334e+06
n250x8192-slot-inner, 1024, 34, 1899, 3423, 0, 0, 5356, 3.41334e+06
n250x8192-slot-inner, 1024, 34, 1901, 3405, 0, 0, 5340, 3.41334e+06
n250x8192-slot-inner, 1024, 34, 1894, 3431, 0, 0, 5359, 3.41334e+06
n250x8192-slot-inner, 1024, 34, 1927, 3436, 0, 0, 5397, 3.41334e+06
n250x8192-slot-inner, 1024, 34, 1910, 3450, 0, 0, 5394, 3.41334e+06
n250x8192-coef-inner, 8192, 51, 6918, 3420, 1, 0, 10390, 3.41334e+06
n250x8192-coef-inner, 8192, 53, 6873, 3411, 1, 0, 10338, 3.41334e+06
n250x8192-coef-inner, 8192, 53, 6878, 3402, 1, 0, 10334, 3.41334e+06
n250x8192-coef-inner, 8192, 50, 6903, 3425, 1, 0, 10379, 3.41334e+06
n250x8192-coef-inner, 8192, 51, 6891, 3588, 1, 0, 10531, 3.41334e+06
n250x8192-coef-inner, 8192, 53, 6953, 3430, 1, 0, 10437, 3.41334e+06
n250x8192-coef-inner, 8192, 51, 6905, 3423, 1, 0, 10380, 3.41334e+06
n250x8192-coef-inner, 8192, 54, 6952, 3434, 1, 0, 10441, 3.41334e+06
n250x8192-coef-inner, 8192, 54, 6915, 3398, 1, 0, 10368, 3.41334e+06
n250x8192-coef-inner, 8192, 50, 6896, 3430, 1, 0, 10377, 3.41334e+06
n250x8192-coef-inner, 8192, 51, 6906, 3574, 1, 0, 10532, 3.41334e+06
n250x8192-coef-inner, 8192, 53, 6889, 3439, 1, 0, 10382, 3.41334e+06
n250x8192-coef-inner, 8192, 52, 6884, 3414, 1, 0, 10351, 3.41334e+06
n250x8192-coef-inner, 8192, 59, 6880, 3432, 1, 0, 10372, 3.41334e+06
n250x8192-coef-inner, 8192, 53, 6886, 3423, 1, 0, 10363, 3.41334e+06
n250x8192-coef-inner, 8192, 55, 6935, 3555, 1, 0, 10546, 3.41334e+06
n250x8192-coef-inner, 8192, 52, 6905, 3466, 1, 0, 10424, 3.41334e+06
n250x8192-coef-inner, 8192, 50, 6865, 3403, 1, 0, 10319, 3.41334e+06
n250x8192-coef-inner, 8192, 50, 6882, 3414, 1, 0, 10347, 3.41334e+06
n250x8192-coef-inner, 8192, 52, 6871, 3540, 1, 0, 10464, 3.41334e+06
n250x8192-coef-inner, 8192, 53, 6897, 3439, 1, 0, 10390, 3.41334e+06
n250x8192-coef-inner, 8192, 54, 6941, 3598, 1, 0, 10594, 3.41334e+06
n250x8192-coef-inner, 8192, 52, 6940, 3438, 1, 0, 10431, 3.41334e+06
n250x8192-coef-inner, 8192, 54, 6865, 3550, 1, 0, 10470, 3.41334e+06
n250x8192-coef-inner, 8192, 51, 6917, 3426, 1, 0, 10395, 3.41334e+06
n250x8192-coef-inner, 8192, 51, 6886, 3409, 1, 0, 10347, 3.41334e+06
n250x8192-coef-inner, 8192, 52, 6887, 3395, 1, 0, 10335, 3.41334e+06
n250x8192-coef-inner, 8192, 54, 6959, 3465, 1, 0, 10479, 3.41334e+06
n250x8192-coef-inner, 8192, 53, 6971, 3470, 1, 0, 10495, 3.41334e+06
n250x8192-coef-inner, 8192, 54, 6930, 3592, 1, 0, 10577, 3.41334e+06
n250x8192-coef-inner, 8192, 52, 6924, 3589, 1, 0, 10566, 3.41334e+06
n250x8192-coef-inner, 8192, 52, 6968, 3471, 1, 0, 10492, 3.41334e+06
n250x8192-coef-inner, 8192, 50, 6966, 3465, 1, 0, 10482, 3.41334e+06
n250x8192-coef-inner, 8192, 52, 6892, 3432, 1, 0, 10377, 3.41334e+06
n250x8192-coef-inner, 8192, 53, 6867, 3409, 1, 0, 10330, 3.41334e+06
n250x8192-coef-inner, 8192, 52, 6911, 3446, 1, 0, 10410, 3.41334e+06
n250x8192-coef-inner, 8192, 50, 6867, 3429, 1, 0, 10347, 3.41334e+06
n250x8192-coef-inner, 8192, 53, 6866, 3575, 1, 0, 10495, 3.41334e+06
n250x8192-coef-inner, 8192, 52, 6873, 3456, 1, 0, 10382, 3.41334e+06
n250x8192-coef-inner, 8192, 65, 6908, 3441, 1, 0, 10415, 3.41334e+06
n250x8192-coef-inner, 8192, 55, 6931, 3439, 1, 0, 10426, 3.41334e+06
n250x8192-coef-inner, 8192, 57, 6927, 3438, 1, 0, 10423, 3.41334e+06
n250x8192-coef-inner, 8192, 53, 6871, 3399, 1, 0, 10324, 3.41334e+06
n250x8192-coef-inner, 8192, 53, 6877, 3420, 1, 0, 10351, 3.41334e+06
n250x8192-coef-inner, 8192, 54, 6884, 3431, 1, 0, 10370, 3.41334e+06
n250x8192-coef-inner, 8192, 55, 6882, 3400, 1, 0, 10338, 3.41334e+06
n250x8192-coef-inner, 8192, 51, 6919, 3421, 1, 0, 10392, 3.41334e+06
n250x8192-coef-inner, 8192, 53, 6874, 3564, 1, 0, 10492, 3.41334e+06
n250x8192-coef-inner, 8192, 54, 6870, 3566, 1, 0, 10491, 3.41334e+06
n250x8192-coef-inner, 8192, 52, 6945, 3461, 1, 0, 10459, 3.41334e+06
n250x8192-coef-inner, 8192, 55, 7007, 3507, 1, 0, 10570, 3.41334e+06
n250x8192-coef-inner, 8192, 50, 6888, 3413, 1, 0, 10352, 3.41334e+06
n250x8192-coef-inner, 8192, 51, 6891, 3427, 1, 0, 10370, 3.41334e+06
n250x8192-coef-inner, 8192, 53, 6872, 3404, 1, 0, 10330, 3.41334e+06
n250x8192-coef-inner, 8192, 53, 6856, 3424, 1, 0, 10334, 3.41334e+06
n250x8192-coef-inner, 8192, 52, 6866, 3602, 1, 0, 10521, 3.41334e+06
n250x8192-coef-inner, 8192, 53, 6940, 3421, 1, 0, 10415, 3.41334e+06
n250x8192-coef-inner, 8192, 53, 6885, 3550, 1, 0, 10489, 3.41334e+06
n250x8192-coef-inner, 8192, 53, 6943, 3445, 1, 0, 10442, 3.41334e+06
n250x8192-coef-inner, 8192, 51, 6932, 3437, 1, 0, 10421, 3.41334e+06
n250x8192-coef-inner, 8192, 51, 6863, 3544, 1, 0, 10459, 3.41334e+06
n250x8192-coef-inner, 8192, 53, 6897, 3389, 1, 0, 10340, 3.41334e+06
n250x8192-coef-inner, 8192, 53, 6873, 3428, 1, 0, 10355, 3.41334e+06
n250x8192-coef-inner, 8192, 51, 6907, 3442, 1, 0, 10401, 3.41334e+06
n250x8192-coef-inner, 8192, 58, 6922, 3464, 1, 0, 10445, 3.41334e+06
n250x8192-coef-inner, 8192, 56, 6915, 3426, 1, 0, 10398, 3.41334e+06
n250x8192-coef-inner, 8192, 54, 6877, 3397, 1, 0, 10329, 3.41334e+06
n250x8192-coef-inner, 8192, 59, 6887, 3590, 1, 0, 10537, 3.41334e+06
n250x8192-coef-inner, 8192, 50, 6853, 3559, 1, 0, 10463, 3.41334e+06
n250x8192-coef-inner, 8192, 52, 6851, 3419, 1, 0, 10323, 3.41334e+06
n250x8192-coef-inner, 8192, 52, 6901, 3540, 1, 0, 10494, 3.41334e+06
n250x8192-coef-inner, 8192, 50, 6863, 3395, 1, 0, 10309, 3.41334e+06
n250x8192-coef-inner, 8192, 53, 6849, 3581, 1, 0, 10484, 3.41334e+06
n250x8192-coef-inner, 8192, 51, 6900, 3393, 1, 0, 10345, 3.41334e+06
n250x8192-coef-inner, 8192, 51, 6859, 3407, 1, 0, 10318, 3.41334e+06
n250x8192-coef-inner, 8192, 57, 6937, 3441, 1, 0, 10436, 3.41334e+06
n250x8192-coef-inner, 8192, 53, 6916, 3427, 1, 0, 10397, 3.41334e+06
n250x8192-coef-inner, 8192, 50, 6860, 3392, 1, 0, 10303, 3.41334e+06
n250x8192-coef-inner, 8192, 59, 6920, 3453, 1, 0, 10433, 3.41334e+06
n250x8192-coef-inner, 8192, 50, 6913, 3447, 1, 0, 10411, 3.41334e+06
n250x8192-coef-inner, 8192, 52, 6935, 3436, 1, 0, 10424, 3.41334e+06
n250x8192-coef-inner, 8192, 51, 6913, 3431, 1, 0, 10396, 3.41334e+06
n250x8192-coef-inner, 8192, 52, 6930, 3432, 1, 0, 10415, 3.41334e+06
n250x8192-coef-inner, 8192, 52, 6886, 3415, 1, 0, 10354, 3.41334e+06
n250x8192-coef-inner, 8192, 53, 6921, 3424, 1, 0, 10399, 3.41334e+06
n250x8192-coef-inner, 8192, 53, 6902, 3437, 1, 0, 10393, 3.41334e+06
n250x8192-coef-inner, 8192, 51, 6900, 3439, 1, 0, 10391, 3.41334e+06
n250x8192-coef-inner, 8192, 53, 6875, 3589, 1, 0, 10518, 3.41334e+06
n250x8192-coef-inner, 8192, 50, 6876, 3419, 1, 0, 10346, 3.41334e+06
n250x8192-coef-inner, 8192, 50, 6872, 3435, 1, 0, 10358, 3.41334e+06
n250x8192-coef-inner, 8192, 50, 6933, 3426, 1, 0, 10410, 3.41334e+06
n250x8192-coef-inner, 8192, 58, 6893, 3423, 1, 0, 10375, 3.41334e+06
n250x8192-coef-inner, 8192, 50, 6904, 3430, 1, 0, 10385, 3.41334e+06
n250x8192-coef-inner, 8192, 52, 6903, 3427, 1, 0, 10383, 3.41334e+06
n250x8192-coef-inner, 8192, 53, 6890, 3580, 1, 0, 10524, 3.41334e+06
n250x8192-coef-inner, 8192, 50, 6931, 3437, 1, 0, 10419, 3.41334e+06
n250x8192-coef-inner, 8192, 55, 6894, 3561, 1, 0, 10511, 3.41334e+06
n250x8192-coef-inner, 8192, 52, 6871, 3402, 1, 0, 10326, 3.41334e+06
n250x8192-coef-inner, 8192, 52, 6907, 3450, 1, 0, 10410, 3.41334e+06
n250x8192-coef-inner, 8192, 50, 6867, 3424, 1, 0, 10342, 3.41334e+06
n250x8192-coef-inner, 4096, 27, 6800, 3330, 0, 0, 10157, 3.41334e+06
n250x8192-coef-inner, 4096, 28, 6865, 3350, 0, 0, 10243, 3.41334e+06
n250x8192-coef-inner, 4096, 29, 6828, 3382, 0, 0, 10239, 3.41334e+06
n250x8192-coef-inner, 4096, 29, 6827, 3358, 0, 0, 10214, 3.41334e+06
n250x8192-coef-inner, 4096, 30, 6837, 3357, 0, 0, 10224, 3.41334e+06
n250x8192-coef-inner, 4096, 27, 6814, 3344, 0, 0, 10185, 3.41334e+06
n250x8192-coef-inner, 4096, 30, 6842, 3353, 0, 0, 10225, 3.41334e+06
n250x8192-coef-inner, 4096, 28, 6846, 3373, 0, 0, 10247, 3.41334e+06
n250x8192-coef-inner, 4096, 27, 6842, 3479, 0, 0, 10348, 3.41334e+06
n250x8192-coef-inner, 4096, 27, 6846, 3357, 0, 0, 10230, 3.41334e+06
n250x8192-coef-inner, 4096, 27, 6830, 3334, 0, 0, 10191, 3.41334e+06
n250x8192-coef-inner, 4096, 29, 6823, 3337, 0, 0, 10189, 3.41334e+06
n250x8192-coef-inner, 4096, 31, 6809, 3438, 0, 0, 10278, 3.41334e+06
n250x8192-coef-inner, 4096, 27, 6910, 3364, 0, 0, 10301, 3.41334e+06
n250x8192-coef-inner, 4096, 28, 6893, 3371, 0, 0, 10292, 3.41334e+06
n250x8192-coef-inner, 4096, 27, 6863, 3361, 0, 0, 10251, 3.41334e+06
n250x8192-coef-inner, 4096, 28, 6857, 3359, 0, 0, 10244, 3.41334e+06
n250x8192-coef-inner, 4096, 28, 6849, 3355, 0, 0, 10232, 3.41334e+06
n250x8192-coef-inner, 4096, 31, 6829, 3311, 0, 0, 10171, 3.41334e+06
n250x8192-coef-inner, 4096, 29, 6807, 3421, 0, 0, 10257, 3.41334e+06
n250x8192-coef-inner, 4096, 30, 6796, 3305, 0, 0, 10131, 3.41334e+06
n250x8192-coef-inner, 4096, 27, 6843, 3304, 0, 0, 10174, 3.41334e+06
n250x8192-coef-inner, 4096, 28, 6801, 3304, 0, 0, 10133, 3.41334e+06
n250x8192-coef-inner, 4096, 28, 6844, 3306, 0, 0, 10178, 3.41334e+06
n250x8192-coef-inner, 4096, 27, 6788, 3331, 0, 0, 10146, 3.41334e+06
n250x8192-coef-inner, 4096, 27, 6827, 3333, 0, 0, 10187, 3.41334e+06
n250x8192-coef-inner, 4096, 30, 6785, 3324, 0, 0, 10139, 3.41334e+06
n250x8192-coef-inner, 4096, 29, 6804, 3308, 0, 0, 10141, 3.41334e+06
n250x8192-coef-inner, 4096, 27, 6797, 3297, 0, 0, 10121, 3.41334e+06
n250x8192-coef-inner, 4096, 27, 6812, 3304, 0, 0, 10143, 3.41334e+06
n250x8192-coef-inner, 4096, 27, 6830, 3328, 0, 0, 10185, 3.41334e+06
n250x8192-coef-inner, 4096, 29, 6817, 3308, 0, 0, 10154, 3.41334e+06
n250x8192-coef-inner, 4096, 27, 6814, 3349, 0, 0, 10190, 3.41334e+06
n250x8192-coef-inner, 4096, 29, 6788, 3435, 0, 0, 10252, 3.41334e+06
n250x8192-coef-inner, 4096, 27, 6800, 3291, 0, 0, 10118, 3.41334e+06
n250x8192-coef-inner, 4096, 29, 6821, 3317, 0, 0, 10167, 3.41334e+06
n250x8192-coef-inner, 4096, 29, 6816, 3334, 0, 0, 10179, 3.41334e+06
n250x8192-coef-inner, 4096, 27, 6789, 3298, 0, 0, 10114, 3.41334e+06
n250x8192-coef-inner, 4096, 29, 6821, 3331, 0, 0, 10181, 3.41334e+06
n250x8192-coef-inner, 4096, 27, 6828, 3313, 0, 0, 10168, 3.41334e+06
n250x8192-coef-inner, 4096, 27, 6831, 3303, 0, 0, 10161, 3.41334e+06
n250x8192-coef-inner, 4096, 39, 6799, 3456, 0, 0, 10294, 3.41334e+06
n250x8192-coef-inner, 4096, 27, 6909, 3375, 0, 0, 10311, 3.41334e+06
n250x8192-coef-inner, 4096, 27, 6800, 3438, 0, 0, 10265, 3.41334e+06
n250x8192-coef-inner, 4096, 27, 6813, 3308, 0, 0, 10148, 3.41334e+06
n250x8192-coef-inner, 4096, 27, 6792, 3326, 0, 0, 10145, 3.41334e+06
n250x8192-coef-inner, 4096, 31, 6833, 3339, 0, 0, 10203, 3.41334e+06
n250x8192-coef-inner, 4096, 27, 6827, 3432, 0, 0, 10286, 3.41334e+06
n250x8192-coef-inner, 4096, 28, 6835, 3295, 0, 0, 10158, 3.41334e+06
n250x8192-coef-inner, 4096, 27, 6777, 3305, 0, 0, 10109, 3.41334e+06
n250x8192-coef-inner, 4096, 28, 6802, 3324, 0, 0, 10154, 3.41334e+06
n250x8192-coef-inner, 4096, 27, 6857, 3327, 0, 0, 10211, 3.41334e+06
n250x8192-coef-inner, 4096, 30, 6817, 3334, 0, 0, 10181, 3.41334e+06
n250x8192-coef-inner, 4096, 29, 6864, 3351, 0, 0, 10244, 3.41334e+06
n250x8192-coef-inner, 4096, 33, 6852, 3351, 0, 0, 10236, 3.41334e+06
n250x8192-coef-inner, 4096, 28, 6801, 3343, 0, 0, 10172, 3.41334e+06
n250x8192-coef-inner, 4096, 30, 6810, 3358, 0, 0, 10198, 3.41334e+06
n250x8192-coef-inner, 4096, 27, 6789, 3327, 0, 0, 10143, 3.41334e+06
n250x8192-coef-inner, 4096, 31, 6848, 3369, 0, 0, 10248, 3.41334e+06
n250x8192-coef-inner, 4096, 28, 6818, 3327, 1, 0, 10174, 3.41334e+06
n250x8192-coef-inner, 4096, 27, 6872, 3358, 0, 0, 10257, 3.41334e+06
n250x8192-coef-inner, 4096, 31, 6771, 3306, 0, 0, 10108, 3.41334e+06
n250x8192-coef-inner, 4096, 31, 6795, 3318, 0, 0, 10144, 3.41334e+06
n250x8192-coef-inner, 4096, 28, 6799, 3302, 0, 0, 10129, 3.41334e+06
n250x8192-coef-inner, 4096, 27, 6792, 3307, 0, 0, 10126, 3.41334e+06
n250x8192-coef-inner, 4096, 31, 6845, 3374, 0, 0, 10250, 3.41334e+06
n250x8192-coef-inner, 4096, 30, 6836, 3450, 0, 0, 10316, 3.41334e+06
n250x8192-coef-inner, 4096, 29, 6820, 3325, 0, 0, 10174, 3.41334e+06
n250x8192-coef-inner, 4096, 29, 6834, 3328, 0, 0, 10191, 3.41334e+06
n250x8192-coef-inner, 4096, 27, 6806, 3315, 0, 0, 10148, 3.41334e+06
n250x8192-coef-inner, 4096, 29, 6804, 3359, 0, 0, 10192, 3.41334e+06
n250x8192-coef-inner, 4096, 31, 6806, 3320, 0, 0, 10157, 3.41334e+06
n250x8192-coef-inner, 4096, 31, 6793, 3452, 0, 0, 10276, 3.41334e+06
n250x8192-coef-inner, 4096, 31, 6798, 3329, 0, 0, 10158, 3.41334e+06
n250x8192-coef-inner, 4096, 27, 6793, 3317, 0, 0, 10137, 3.41334e+06
n250x8192-coef-inner, 4096, 29, 6811, 3331, 0, 0, 10171, 3.41334e+06
n250x8192-coef-inner, 4096, 27, 6813, 3341, 0, 0, 10181, 3.41334e+06
n250x8192-coef-inner, 4096, 32, 6819, 3380, 0, 0, 10231, 3.41334e+06
n250x8192-coef-inner, 4096, 27, 6787, 3342, 0, 0, 10156, 3.41334e+06
n250x8192-coef-inner, 4096, 27, 6797, 3342, 0, 0, 10166, 3.41334e+06
n250x8192-coef-inner, 4096, 27, 6796, 3329, 0, 0, 10152, 3.41334e+06
n250x8192-coef-inner, 4096, 31, 6807, 3326, 0, 0, 10164, 3.41334e+06
n250x8192-coef-inner, 4096, 27, 6824, 3329, 0, 0, 10180, 3.41334e+06
n250x8192-coef-inner, 4096, 28, 6795, 3311, 0, 0, 10134, 3.41334e+06
n250x8192-coef-inner, 4096, 29, 6797, 3307, 0, 0, 10133, 3.41334e+06
n250x8192-coef-inner, 4096, 31, 6838, 3361, 0, 0, 10230, 3.41334e+06
n250x8192-coef-inner, 4096, 30, 6780, 3317, 0, 0, 10127, 3.41334e+06
n250x8192-coef-inner, 4096, 30, 6786, 3437, 0, 0, 10253, 3.41334e+06
n250x8192-coef-inner, 4096, 29, 6810, 3331, 0, 0, 10170, 3.41334e+06
n250x8192-coef-inner, 4096, 30, 6817, 3348, 0, 0, 10195, 3.41334e+06
n250x8192-coef-inner, 4096, 30, 6802, 3318, 0, 0, 10150, 3.41334e+06
n250x8192-coef-inner, 4096, 27, 6793, 3317, 0, 0, 10137, 3.41334e+06
n250x8192-coef-inner, 4096, 27, 6792, 3312, 0, 0, 10131, 3.41334e+06
n250x8192-coef-inner, 4096, 32, 6822, 3344, 0, 0, 10198, 3.41334e+06
n250x8192-coef-inner, 4096, 28, 6807, 3333, 0, 0, 10168, 3.41334e+06
n250x8192-coef-inner, 4096, 27, 6792, 3316, 0, 0, 10135, 3.41334e+06
n250x8192-coef-inner, 4096, 31, 6781, 3313, 0, 0, 10125, 3.41334e+06
n250x8192-coef-inner, 4096, 27, 6827, 3320, 0, 0, 10174, 3.41334e+06
n250x8192-coef-inner, 4096, 38, 6787, 3468, 0, 0, 10293, 3.41334e+06
n250x8192-coef-inner, 4096, 28, 6813, 3569, 0, 0, 10410, 3.41334e+06
n250x8192-coef-inner, 2048, 17, 6873, 3343, 0, 0, 10233, 3.41334e+06
n250x8192-coef-inner, 2048, 16, 6860, 3344, 0, 0, 10220, 3.41334e+06
n250x8192-coef-inner, 2048, 16, 6802, 3332, 0, 0, 10150, 3.41334e+06
n250x8192-coef-inner, 2048, 16, 6835, 3328, 0, 0, 10179, 3.41334e+06
n250x8192-coef-inner, 2048, 16, 6785, 3308, 0, 0, 10109, 3.41334e+06
n250x8192-coef-inner, 2048, 17, 6777, 3296, 0, 0, 10090, 3.41334e+06
n250x8192-coef-inner, 2048, 16, 6751, 3277, 0, 0, 10044, 3.41334e+06
n250x8192-coef-inner, 2048, 16, 6743, 3296, 0, 0, 10055, 3.41334e+06
n250x8192-coef-inner, 2048, 16, 6752, 3288, 0, 0, 10056, 3.41334e+06
n250x8192-coef-inner, 2048, 16, 6743, 3292, 0, 0, 10051, 3.41334e+06
n250x8192-coef-inner, 2048, 16, 6766, 3304, 0, 0, 10086, 3.41334e+06
n250x8192-coef-inner, 2048, 16, 6796, 3295, 0, 0, 10107, 3.41334e+06
n250x8192-coef-inner, 2048, 16, 6762, 3368, 0, 0, 10146, 3.41334e+06
n250x8192-coef-inner, 2048, 16, 6746, 3272, 0, 0, 10034, 3.41334e+06
n250x8192-coef-inner, 2048, 16, 6762, 3301, 0, 0, 10079, 3.41334e+06
n250x8192-coef-inner, 2048, 16, 6762, 3271, 0, 0, 10049, 3.41334e+06
n250x8192-coef-inner, 2048, 16, 6736, 3283, 0, 0, 10035, 3.41334e+06
n250x8192-coef-inner, 2048, 16, 6772, 3299, 0, 0, 10087, 3.41334e+06
n250x8192-coef-inner, 2048, 22, 6746, 3282, 0, 0, 10050, 3.41334e+06
n250x8192-coef-inner, 2048, 16, 6731, 3281, 0, 0, 10028, 3.41334e+06
n250x8192-coef-inner, 2048, 16, 6752, 3286, 0, 0, 10054, 3.41334e+06
n250x8192-coef-inner, 2048, 16, 6745, 3280, 0, 0, 10041, 3.41334e+06
n250x8192-coef-inner, 2048, 16, 6751, 3297, 0, 0, 10064, 3.41334e+06
n250x8192-coef-inner, 2048, 22, 6805, 3430, 0, 0, 10257, 3.41334e+06
n250x8192-coef-inner, 2048, 16, 6793, 3415, 0, 0, 10224, 3.41334e+06
n250x8192-coef-inner, 2048, 16, 6757, 3283, 0, 0, 10056, 3.41334e+06
n250x8192-coef-inner, 2048, 17, 6746, 3271, 0, 0, 10034, 3.41334e+06
n250x8192-coef-inner, 2048, 16, 6767, 3288, 0, 0, 10071, 3.41334e+06
n250x8192-coef-inner, 2048, 16, 6753, 3297, 0, 0, 10066, 3.41334e+06
n250x8192-coef-inner, 2048, 16, 6842, 3322, 0, 0, 10180, 3.41334e+06
n250x8192-coef-inner, 2048, 17, 6753, 3295, 0, 0, 10065, 3.41334e+06
n250x8192-coef-inner, 2048, 16, 6762, 3286, 0, 0, 10064, 3.41334e+06
n250x8192-coef-inner, 2048, 17, 6765, 3276, 0, 0, 10058, 3.41334e+06
n250x8192-coef-inner, 2048, 16, 6771, 3292, 0, 0, 10079, 3.41334e+06
n250x8192-coef-inner, 2048, 18, 6753, 3313, 0, 0, 10084, 3.41334e+06
n250x8192-coef-inner, 2048, 16, 6797, 3371, 0, 0, 10184, 3.41334e+06
n250x8192-coef-inner, 2048, 16, 6747, 3294, 0, 0, 10057, 3.41334e+06
n250x8192-coef-inner, 2048, 16, 6754, 3263, 0, 0, 10033, 3.41334e+06
n250x8192-coef-inner, 2048, 17, 6775, 3408, 0, 0, 10200, 3.41334e+06
n250x8192-coef-inner, 2048, 16, 6739, 3269, 0, 0, 10024, 3.41334e+06
n250x8192-coef-inner, 2048, 16, 6736, 3296, 0, 0, 10048, 3.41334e+06
n250x8192-coef-inner, 2048, 16, 6765, 3400, 0, 0, 10181, 3.41334e+06
n250x8192-coef-inner, 2048, 16, 6772, 3272, 0, 0, 10060, 3.41334e+06
n250x8192-coef-inner, 2048, 16, 6735, 3266, 0, 0, 10017, 3.41334e+06
n250x8192-coef-inner, 2048, 16, 6749, 3256, 0, 0, 10021, 3.41334e+06
n250x8192-coef-inner, 2048, 16, 6748, 3266, 0, 0, 10030, 3.41334e+06
n250x8192-coef-inner, 2048, 16, 6752, 3297, 0, 0, 10065, 3.41334e+06
n250x8192-coef-inner, 2048, 17, 6745, 3408, 0, 0, 10170, 3.41334e+06
n250x8192-coef-inner, 2048, 16, 6745, 3274, 0, 0, 10035, 3.41334e+06
n250x8192-coef-inner, 2048, 16, 6742, 3299, 0, 0, 10057, 3.41334e+06
n250x8192-coef-inner, 2048, 16, 6756, 3271, 0, 0, 10043, 3.41334e+06
n250x8192-coef-inner, 2048, 16, 6758, 3297, 0, 0, 10071, 3.41334e+06
n250x8192-coef-inner, 2048, 16, 6745, 3293, 0, 0, 10054, 3.41334e+06
n250x8192-coef-inner, 2048, 17, 6765, 3419, 0, 0, 10201, 3.41334e+06
n250x8192-coef-inner, 2048, 16, 6765, 3302, 0, 0, 10083, 3.41334e+06
n250x8192-coef-inner, 2048, 16, 6743, 3272, 0, 0, 10031, 3.41334e+06
n250x8192-coef-inner, 2048, 20, 6789, 3401, 0, 0, 10210, 3.41334e+06
n250x8192-coef-inner, 2048, 16, 6736, 3293, 0, 0, 10045, 3.41334e+06
n250x8192-coef-inner, 2048, 16, 6851, 3354, 0, 0, 10221, 3.41334e+06
n250x8192-coef-inner, 2048, 17, 6802, 3427, 0, 0, 10246, 3.41334e+06
n250x8192-coef-inner, 2048, 16, 6794, 3281, 0, 0, 10091, 3.41334e+06
n250x8192-coef-inner, 2048, 16, 6745, 3286, 0, 0, 10047, 3.41334e+06
n250x8192-coef-inner, 2048, 16, 6740, 3437, 0, 0, 10193, 3.41334e+06
n250x8192-coef-inner, 2048, 16, 6760, 3307, 0, 0, 10083, 3.41334e+06
n250x8192-coef-inner, 2048, 16, 6761, 3278, 0, 0, 10055, 3.41334e+06
n250x8192-coef-inner, 2048, 16, 6751, 3285, 0, 0, 10052, 3.41334e+06
n250x8192-coef-inner, 2048, 16, 6764, 3298, 0, 0, 10078, 3.41334e+06
n250x8192-coef-inner, 2048, 16, 6738, 3288, 0, 0, 10042, 3.41334e+06
n250x8192-coef-inner, 2048, 17, 6759, 3312, 0, 0, 10088, 3.41334e+06
n250x8192-coef-inner, 2048, 16, 6747, 3295, 0, 0, 10058, 3.41334e+06
n250x8192-coef-inner, 2048, 16, 6776, 3300, 0, 0, 10092, 3.41334e+06
n250x8192-coef-inner, 2048, 16, 6755, 3284, 0, 0, 10055, 3.41334e+06
n250x8192-coef-inner, 2048, 16, 6746, 3284, 0, 0, 10046, 3.41334e+06
n250x8192-coef-inner, 2048, 16, 6767, 3285, 0, 0, 10068, 3.41334e+06
n250x8192-coef-inner, 2048, 16, 6749, 3293, 0, 0, 10058, 3.41334e+06
n250x8192-coef-inner, 2048, 16, 6736, 3294, 0, 0, 10046, 3.41334e+06
n250x8192-coef-inner, 2048, 16, 6839, 3321, 0, 0, 10176, 3.41334e+06
n250x8192-coef-inner, 2048, 16, 6767, 3337, 0, 0, 10120, 3.41334e+06
n250x8192-coef-inner, 2048, 17, 6758, 3307, 0, 0, 10082, 3.41334e+06
n250x8192-coef-inner, 2048, 16, 6776, 3279, 0, 0, 10071, 3.41334e+06
n250x8192-coef-inner, 2048, 16, 6792, 3285, 0, 0, 10093, 3.41334e+06
n250x8192-coef-inner, 2048, 16, 6769, 3326, 0, 0, 10111, 3.41334e+06
n250x8192-coef-inner, 2048, 22, 6789, 3287, 0, 0, 10098, 3.41334e+06
n250x8192-coef-inner, 2048, 16, 6745, 3422, 0, 0, 10183, 3.41334e+06
n250x8192-coef-inner, 2048, 16, 6776, 3275, 0, 0, 10067, 3.41334e+06
n250x8192-coef-inner, 2048, 16, 6743, 3278, 0, 0, 10037, 3.41334e+06
n250x8192-coef-inner, 2048, 16, 6751, 3312, 0, 0, 10079, 3.41334e+06
n250x8192-coef-inner, 2048, 16, 6817, 3407, 0, 0, 10240, 3.41334e+06
n250x8192-coef-inner, 2048, 16, 6930, 3343, 0, 0, 10289, 3.41334e+06
n250x8192-coef-inner, 2048, 16, 6855, 3360, 0, 0, 10231, 3.41334e+06
n250x8192-coef-inner, 2048, 16, 6858, 3334, 0, 0, 10208, 3.41334e+06
n250x8192-coef-inner, 2048, 16, 6843, 3358, 0, 0, 10217, 3.41334e+06
n250x8192-coef-inner, 2048, 16, 6885, 3340, 0, 0, 10241, 3.41334e+06
n250x8192-coef-inner, 2048, 16, 6878, 3326, 0, 0, 10220, 3.41334e+06
n250x8192-coef-inner, 2048, 18, 6853, 3308, 0, 0, 10179, 3.41334e+06
n250x8192-coef-inner, 2048, 16, 6783, 3290, 0, 0, 10089, 3.41334e+06
n250x8192-coef-inner, 2048, 16, 6771, 3281, 0, 0, 10068, 3.41334e+06
n250x8192-coef-inner, 2048, 16, 6748, 3295, 0, 0, 10059, 3.41334e+06
n250x8192-coef-inner, 2048, 17, 6817, 3282, 0, 0, 10116, 3.41334e+06
n250x8192-coef-inner, 2048, 16, 6782, 3275, 0, 0, 10073, 3.41334e+06
n250x8192-coef-inner, 1024, 12, 6897, 3411, 0, 0, 10320, 3.41334e+06
n250x8192-coef-inner, 1024, 12, 6839, 3406, 0, 0, 10257, 3.41334e+06
n250x8192-coef-inner, 1024, 11, 6831, 3400, 0, 0, 10242, 3.41334e+06
n250x8192-coef-inner, 1024, 12, 6805, 3402, 0, 0, 10219, 3.41334e+06
n250x8192-coef-inner, 1024, 12, 6830, 3478, 0, 0, 10320, 3.41334e+06
n250x8192-coef-inner, 1024, 13, 6864, 3417, 0, 0, 10294, 3.41334e+06
n250x8192-coef-inner, 1024, 12, 6858, 3438, 0, 0, 10308, 3.41334e+06
n250x8192-coef-inner, 1024, 12, 6858, 3432, 0, 0, 10302, 3.41334e+06
n250x8192-coef-inner, 1024, 12, 6813, 3432, 0, 0, 10257, 3.41334e+06
n250x8192-coef-inner, 1024, 12, 6829, 3432, 0, 0, 10273, 3.41334e+06
n250x8192-coef-inner, 1024, 13, 6835, 3430, 0, 0, 10278, 3.41334e+06
n250x8192-coef-inner, 1024, 12, 6868, 3434, 0, 0, 10314, 3.41334e+06
n250x8192-coef-inner, 1024, 12, 6831, 3440, 0, 0, 10283, 3.41334e+06
n250x8192-coef-inner, 1024, 13, 6834, 3422, 0, 0, 10269, 3.41334e+06
n250x8192-coef-inner, 1024, 12, 6840, 3417, 0, 0, 10269, 3.41334e+06
n250x8192-coef-inner, 1024, 12, 6842, 3412, 0, 0, 10266, 3.41334e+06
n250x8192-coef-inner, 1024, 12, 6881, 3444, 0, 0, 10337, 3.41334e+06
n250x8192-coef-inner, 1024, 12, 6849, 3405, 0, 0, 10266, 3.41334e+06
n250x8192-coef-inner, 1024, 12, 6864, 3450, 0, 0, 10326, 3.41334e+06
n250x8192-coef-inner, 1024, 12, 6861, 3446, 0, 0, 10319, 3.41334e+06
n250x8192-coef-inner, 1024, 11, 6853, 3411, 0, 0, 10275, 3.41334e+06
n250x8192-coef-inner, 1024, 13, 6819, 3414, 0, 0, 10246, 3.41334e+06
n250x8192-coef-inner, 1024, 12, 6854, 3440, 0, 0, 10306, 3.41334e+06
n250x8192-coef-inner, 1024, 12, 6830, 3413, 0, 0, 10255, 3.41334e+06
n250x8192-coef-inner, 1024, 11, 6840, 3410, 0, 0, 10261, 3.41334e+06
n250x8192-coef-inner, 1024, 12, 6857, 3431, 0, 0, 10300, 3.41334e+06
n250x8192-coef-inner, 1024, 13, 6827, 3400, 0, 0, 10240, 3.41334e+06
n250x8192-coef-inner, 1024, 13, 6826, 3432, 0, 0, 10271, 3.41334e+06
n250x8192-coef-inner, 1024, 12, 6824, 3410, 0, 0, 10246, 3.41334e+06
n250x8192-coef-inner, 1024, 12, 6822, 3524, 0, 0, 10358, 3.41334e+06
n250x8192-coef-inner, 1024, 11, 6849, 3410, 0, 0, 10270, 3.41334e+06
n250x8192-coef-inner, 1024, 12, 6846, 3435, 0, 0, 10293, 3.41334e+06
n250x8192-coef-inner, 1024, 13, 6826, 3407, 0, 0, 10246, 3.41334e+06
n250x8192-coef-inner, 1024, 11, 6850, 3531, 0, 0, 10392, 3.41334e+06
n250x8192-coef-inner, 1024, 12, 6818, 3396, 0, 0, 10226, 3.41334e+06
n250x8192-coef-inner, 1024, 13, 6836, 3521, 0, 0, 10370, 3.41334e+06
n250x8192-coef-inner, 1024, 12, 6876, 3404, 0, 0, 10292, 3.41334e+06
n250x8192-coef-inner, 1024, 12, 6820, 3515, 0, 0, 10347, 3.41334e+06
n250x8192-coef-inner, 1024, 12, 6850, 3406, 0, 0, 10268, 3.41334e+06
n250x8192-coef-inner, 1024, 12, 6878, 3423, 0, 0, 10313, 3.41334e+06
n250x8192-coef-inner, 1024, 12, 6822, 3432, 0, 0, 10266, 3.41334e+06
n250x8192-coef-inner, 1024, 12, 6852, 3425, 0, 0, 10289, 3.41334e+06
n250x8192-coef-inner, 1024, 12, 6959, 5593, 0, 0, 12564, 3.41334e+06
n250x8192-coef-inner, 1024, 24, 7172, 3555, 0, 0, 10751, 3.41334e+06
n250x8192-coef-inner, 1024, 12, 8760, 4152, 0, 0, 12924, 3.41334e+06
n250x8192-coef-inner, 1024, 12, 6880, 3416, 0, 0, 10308, 3.41334e+06
n250x8192-coef-inner, 1024, 12, 6860, 3432, 0, 0, 10304, 3.41334e+06
n250x8192-coef-inner, 1024, 12, 6875, 3447, 0, 0, 10334, 3.41334e+06
n250x8192-coef-inner, 1024, 12, 6919, 3456, 0, 0, 10387, 3.41334e+06
n250x8192-coef-inner, 1024, 12, 6909, 3407, 0, 0, 10328, 3.41334e+06
n250x8192-coef-inner, 1024, 13, 6896, 3429, 0, 0, 10338, 3.41334e+06
n250x8192-coef-inner, 1024, 12, 6856, 3436, 0, 0, 10304, 3.41334e+06
n250x8192-coef-inner, 1024, 12, 6837, 3431, 0, 0, 10280, 3.41334e+06
n250x8192-coef-inner, 1024, 12, 6847, 3449, 0, 0, 10308, 3.41334e+06
n250x8192-coef-inner, 1024, 13, 6852, 3417, 0, 0, 10282, 3.41334e+06
n250x8192-coef-inner, 1024, 11, 6803, 3425, 0, 0, 10239, 3.41334e+06
n250x8192-coef-inner, 1024, 12, 6849, 3427, 0, 0, 10288, 3.41334e+06
n250x8192-coef-inner, 1024, 13, 6824, 3411, 0, 0, 10248, 3.41334e+06
n250x8192-coef-inner, 1024, 12, 6840, 3435, 0, 0, 10287, 3.41334e+06
n250x8192-coef-inner, 1024, 12, 6833, 3416, 0, 0, 10261, 3.41334e+06
n250x8192-coef-inner, 1024, 13, 6827, 3475, 0, 0, 10315, 3.41334e+06
n250x8192-coef-inner, 1024, 12, 6844, 3479, 0, 0, 10335, 3.41334e+06
n250x8192-coef-inner, 1024, 12, 6872, 3447, 0, 0, 10331, 3.41334e+06
n250x8192-coef-inner, 1024, 12, 6842, 3406, 0, 0, 10260, 3.41334e+06
n250x8192-coef-inner, 1024, 12, 6841, 3404, 0, 0, 10257, 3.41334e+06
n250x8192-coef-inner, 1024, 12, 6803, 3417, 0, 0, 10232, 3.41334e+06
n250x8192-coef-inner, 1024, 12, 6808, 3403, 0, 0, 10223, 3.41334e+06
n250x8192-coef-inner, 1024, 12, 6833, 3428, 0, 0, 10273, 3.41334e+06
n250x8192-coef-inner, 1024, 12, 6819, 3384, 0, 0, 10215, 3.41334e+06
n250x8192-coef-inner, 1024, 14, 6845, 3408, 0, 0, 10267, 3.41334e+06
n250x8192-coef-inner, 1024, 12, 6830, 3382, 0, 0, 10224, 3.41334e+06
n250x8192-coef-inner, 1024, 12, 6858, 3395, 0, 0, 10265, 3.41334e+06
n250x8192-coef-inner, 1024, 12, 6823, 3391, 0, 0, 10226, 3.41334e+06
n250x8192-coef-inner, 1024, 12, 6968, 3478, 0, 0, 10458, 3.41334e+06
n250x8192-coef-inner, 1024, 13, 6898, 3465, 0, 0, 10376, 3.41334e+06
n250x8192-coef-inner, 1024, 13, 6898, 3448, 0, 0, 10359, 3.41334e+06
n250x8192-coef-inner, 1024, 12, 6888, 3460, 0, 0, 10360, 3.41334e+06
n250x8192-coef-inner, 1024, 12, 6882, 3454, 0, 0, 10348, 3.41334e+06
n250x8192-coef-inner, 1024, 12, 6910, 3444, 0, 0, 10366, 3.41334e+06
n250x8192-coef-inner, 1024, 12, 6941, 3434, 0, 0, 10387, 3.41334e+06
n250x8192-coef-inner, 1024, 12, 6848, 3380, 0, 0, 10240, 3.41334e+06
n250x8192-coef-inner, 1024, 12, 6840, 3401, 0, 0, 10253, 3.41334e+06
n250x8192-coef-inner, 1024, 11, 6832, 3407, 0, 0, 10250, 3.41334e+06
n250x8192-coef-inner, 1024, 12, 6837, 3417, 0, 0, 10266, 3.41334e+06
n250x8192-coef-inner, 1024, 12, 6812, 3541, 0, 0, 10365, 3.41334e+06
n250x8192-coef-inner, 1024, 12, 6834, 3403, 0, 0, 10249, 3.41334e+06
n250x8192-coef-inner, 1024, 12, 6826, 3422, 0, 0, 10260, 3.41334e+06
n250x8192-coef-inner, 1024, 12, 6831, 3417, 0, 0, 10260, 3.41334e+06
n250x8192-coef-inner, 1024, 12, 6827, 3412, 0, 0, 10251, 3.41334e+06
n250x8192-coef-inner, 1024, 12, 6835, 3405, 0, 0, 10252, 3.41334e+06
n250x8192-coef-inner, 1024, 12, 6845, 3408, 0, 0, 10265, 3.41334e+06
n250x8192-coef-inner, 1024, 12, 6846, 3418, 0, 0, 10276, 3.41334e+06
n250x8192-coef-inner, 1024, 12, 6821, 3404, 0, 0, 10237, 3.41334e+06
n250x8192-coef-inner, 1024, 13, 6829, 3389, 0, 0, 10231, 3.41334e+06
n250x8192-coef-inner, 1024, 12, 6832, 3412, 0, 0, 10256, 3.41334e+06
n250x8192-coef-inner, 1024, 12, 6839, 3385, 0, 0, 10236, 3.41334e+06
n250x8192-coef-inner, 1024, 12, 6893, 3399, 0, 0, 10304, 3.41334e+06
n250x8192-coef-inner, 1024, 12, 6852, 3400, 0, 0, 10264, 3.41334e+06
n250x8192-coef-inner, 1024, 12, 6856, 3420, 0, 0, 10288, 3.41334e+06
n250x8192-coef-inner, 1024, 11, 6827, 3520, 0, 0, 10358, 3.41334e+06
n500x8192-coef-sum, 8192, 60, 6875, 197, 1, 0, 7133, 1
n500x8192-coef-sum, 8192, 59, 6905, 192, 1, 0, 7157, 1
n500x8192-coef-sum, 8192, 58, 6919, 192, 1, 0, 7170, 1
n500x8192-coef-sum, 8192, 57, 6923, 191, 1, 0, 7172, 1
n500x8192-coef-sum, 8192, 57, 6866, 193, 1, 0, 7117, 1
n500x8192-coef-sum, 8192, 61, 6926, 192, 1, 0, 7180, 1
n500x8192-coef-sum, 8192, 59, 6922, 190, 1, 0, 7172, 1
n500x8192-coef-sum, 8192, 59, 6916, 194, 1, 0, 7170, 1
n500x8192-coef-sum, 8192, 75, 6914, 190, 1, 0, 7180, 1
n500x8192-coef-sum, 8192, 60, 6943, 190, 1, 0, 7194, 1
n500x8192-coef-sum, 8192, 58, 6999, 192, 1, 0, 7250, 1
n500x8192-coef-sum, 8192, 59, 6971, 205, 1, 0, 7236, 1
n500x8192-coef-sum, 8192, 60, 6929, 195, 1, 0, 7185, 1
n500x8192-coef-sum, 8192, 58, 6988, 192, 1, 0, 7239, 1
n500x8192-coef-sum, 8192, 56, 6927, 198, 1, 0, 7182, 1
n500x8192-coef-sum, 8192, 64, 6944, 191, 1, 0, 7200, 1
n500x8192-coef-sum, 8192, 58, 6918, 193, 1, 0, 7170, 1
n500x8192-coef-sum, 8192, 59, 6903, 189, 1, 0, 7152, 1
n500x8192-coef-sum, 8192, 56, 6906, 191, 1, 0, 7154, 1
n500x8192-coef-sum, 8192, 71, 6896, 194, 1, 0, 7162, 1
n500x8192-coef-sum, 8192, 58, 6925, 190, 7, 0, 7180, 1
n500x8192-coef-sum, 8192, 59, 6883, 193, 1, 0, 7136, 1
n500x8192-coef-sum, 8192, 58, 6904, 189, 1, 0, 7152, 1
n500x8192-coef-sum, 8192, 58, 6951, 189, 1, 0, 7199, 1
n500x8192-coef-sum, 8192, 57, 6906, 191, 1, 0, 7155, 1
n500x8192-coef-sum, 8192, 59, 6858, 189, 1, 0, 7107, 1
n500x8192-coef-sum, 8192, 59, 6914, 192, 1, 0, 7166, 1
n500x8192-coef-sum, 8192, 59, 6922, 191, 1, 0, 7173, 1
n500x8192-coef-sum, 8192, 60, 6850, 190, 1, 0, 7101, 1
n500x8192-coef-sum, 8192, 58, 6889, 193, 1, 0, 7141, 1
n500x8192-coef-sum, 8192, 58, 6861, 190, 1, 0, 7110, 1
n500x8192-coef-sum, 8192, 59, 6883, 192, 1, 0, 7135, 1
n500x8192-coef-sum, 8192, 58, 6865, 191, 1, 0, 7115, 1
n500x8192-coef-sum, 8192, 59, 6868, 189, 1, 0, 7117, 1
n500x8192-coef-sum, 8192, 59, 6866, 196, 1, 0, 7122, 1
n500x8192-coef-sum, 8192, 57, 6963, 191, 1, 0, 7212, 1
n500x8192-coef-sum, 8192, 60, 6887, 197, 1, 0, 7145, 1
n500x8192-coef-sum, 8192, 61, 6917, 191, 1, 0, 7170, 1
n500x8192-coef-sum, 8192, 59, 6869, 192, 1, 0, 7121, 1
n500x8192-coef-sum, 8192, 57, 6852, 191, 1, 0, 7101, 1
n500x8192-coef-sum, 8192, 60, 6911, 192, 1, 0, 7164, 1
n500x8192-coef-sum, 8192, 59, 6900, 192, 1, 0, 7152, 1
n500x8192-coef-sum, 8192, 60, 6921, 191, 1, 0, 7173, 1
n500x8192-coef-sum, 8192, 58, 6888, 191, 1, 0, 7138, 1
n500x8192-coef-sum, 8192, 57, 6918, 190, 1, 0, 7166, 1
n500x8192-coef-sum, 8192, 60, 6899, 195, 1, 0, 7155, 1
n500x8192-coef-sum, 8192, 58, 6897, 192, 1, 0, 7148, 1
n500x8192-coef-sum, 8192, 58, 6895, 191, 1, 0, 7145, 1
n500x8192-coef-sum, 8192, 57, 6885, 190, 1, 0, 7133, 1
n500x8192-coef-sum, 8192, 64, 6883, 188, 1, 0, 7136, 1
n500x8192-coef-sum, 8192, 60, 6899, 192, 1, 0, 7152, 1
n500x8192-coef-sum, 8192, 58, 6904, 193, 1, 0, 7156, 1
n500x8192-coef-sum, 8192, 57, 6947, 190, 1, 0, 7195, 1
n500x8192-coef-sum, 8192, 56, 6914, 190, 1, 0, 7161, 1
n500x8192-coef-sum, 8192, 59, 6886, 190, 1, 0, 7136, 1
n500x8192-coef-sum, 8192, 59, 6876, 191, 1, 0, 7127, 1
n500x8192-coef-sum, 8192, 58, 6896, 189, 1, 0, 7144, 1
n500x8192-coef-sum, 8192, 58, 6877, 187, 1, 0, 7123, 1
n500x8192-coef-sum, 8192, 57, 6897, 192, 1, 0, 7147, 1
n500x8192-coef-sum, 8192, 58, 6922, 192, 1, 0, 7173, 1
n500x8192-coef-sum, 8192, 64, 6884, 192, 1, 0, 7141, 1
n500x8192-coef-sum, 8192, 56, 6872, 190, 1, 0, 7119, 1
n500x8192-coef-sum, 8192, 59, 6872, 190, 1, 0, 7122, 1
n500x8192-coef-sum, 8192, 58, 6902, 189, 1, 0, 7150, 1
n500x8192-coef-sum, 8192, 57, 6876, 191, 1, 0, 7125, 1
n500x8192-coef-sum, 8192, 59, 6857, 194, 1, 0, 7111, 1
n500x8192-coef-sum, 8192, 60, 6858, 189, 1, 0, 7108, 1
n500x8192-coef-sum, 8192, 58, 6928, 192, 1, 0, 7179, 1
n500x8192-coef-sum, 8192, 57, 6852, 193, 1, 0, 7103, 1
n500x8192-coef-sum, 8192, 57, 6857, 190, 1, 0, 7105, 1
n500x8192-coef-sum, 8192, 64, 6863, 190, 1, 0, 7118, 1
n500x8192-coef-sum, 8192, 58, 6895, 190, 1, 0, 7144, 1
n500x8192-coef-sum, 8192, 58, 6871, 189, 1, 0, 7119, 1
n500x8192-coef-sum, 8192, 60, 6904, 194, 1, 0, 7159, 1
n500x8192-coef-sum, 8192, 59, 6871, 190, 1, 0, 7121, 1
n500x8192-coef-sum, 8192, 58, 6883, 194, 1, 0, 7136, 1
n500x8192-coef-sum, 8192, 59, 6927, 195, 1, 0, 7182, 1
n500x8192-coef-sum, 8192, 57, 6852, 190, 1, 0, 7100, 1
n500x8192-coef-sum, 8192, 59, 6923, 192, 1, 0, 7175, 1
n500x8192-coef-sum, 8192, 61, 6903, 190, 1, 0, 7155, 1
n500x8192-coef-sum, 8192, 56, 6863, 192, 1, 0, 7112, 1
n500x8192-coef-sum, 8192, 67, 6892, 191, 1, 0, 7151, 1
n500x8192-coef-sum, 8192, 59, 6907, 198, 1, 0, 7165, 1
n500x8192-coef-sum, 8192, 59, 7012, 193, 1, 0, 7265, 1
n500x8192-coef-sum, 8192, 60, 6960, 194, 1, 0, 7215, 1
n500x8192-coef-sum, 8192, 60, 6909, 191, 1, 0, 7161, 1
n500x8192-coef-sum, 8192, 62, 6977, 206, 1, 0, 7246, 1
n500x8192-coef-sum, 8192, 57, 6923, 193, 1, 0, 7174, 1
n500x8192-coef-sum, 8192, 59, 6915, 191, 1, 0, 7166, 1
n500x8192-coef-sum, 8192, 57, 6890, 190, 1, 0, 7138, 1
n500x8192-coef-sum, 8192, 60, 6895, 189, 1, 0, 7145, 1
n500x8192-coef-sum, 8192, 60, 6874, 191, 1, 0, 7126, 1
n500x8192-coef-sum, 8192, 60, 6925, 191, 1, 0, 7177, 1
n500x8192-coef-sum, 8192, 59, 6912, 191, 1, 0, 7163, 1
n500x8192-coef-sum, 8192, 62, 6896, 192, 1, 0, 7151, 1
n500x8192-coef-sum, 8192, 60, 6919, 188, 1, 0, 7168, 1
n500x8192-coef-sum, 8192, 59, 6856, 192, 1, 0, 7108, 1
n500x8192-coef-sum, 8192, 58, 6858, 191, 1, 0, 7108, 1
n500x8192-coef-sum, 8192, 56, 6855, 187, 1, 0, 7099, 1
n500x8192-coef-sum, 8192, 56, 6873, 190, 1, 0, 7120, 1
n500x8192-coef-sum, 4096, 32, 6817, 194, 0, 0, 7043, 1
n500x8192-coef-sum, 4096, 32, 6839, 196, 0, 0, 7067, 1
n500x8192-coef-sum, 4096, 30, 6812, 197, 0, 0, 7039, 1
n500x8192-coef-sum, 4096, 35, 6803, 196, 0, 0, 7034, 1
n500x8192-coef-sum, 4096, 35, 6840, 196, 0, 0, 7071, 1
n500x8192-coef-sum, 4096, 30, 6808, 194, 0, 0, 7032, 1
n500x8192-coef-sum, 4096, 35, 6815, 196, 0, 0, 7046, 1
n500x8192-coef-sum, 4096, 30, 6828, 193, 0, 0, 7051, 1
n500x8192-coef-sum, 4096, 30, 6815, 196, 0, 0, 7041, 1
n500x8192-coef-sum, 4096, 31, 6785, 194, 0, 0, 7010, 1
n500x8192-coef-sum, 4096, 33, 6803, 196, 0, 0, 7032, 1
n500x8192-coef-sum, 4096, 31, 6813, 195, 0, 0, 7039, 1
n500x8192-coef-sum, 4096, 34, 6814, 197, 0, 0, 7045, 1
n500x8192-coef-sum, 4096, 30, 6793, 194, 0, 0, 7017, 1
n500x8192-coef-sum, 4096, 33, 6811, 197, 0, 0, 7041, 1
n500x8192-coef-sum, 4096, 35, 6849, 197, 0, 0, 7081, 1
n500x8192-coef-sum, 4096, 31, 6830, 193, 0, 0, 7054, 1
n500x8192-coef-sum, 4096, 31, 6786, 200, 0, 0, 7017, 1
n500x8192-coef-sum, 4096, 30, 6785, 194, 0, 0, 7009, 1
n500x8192-coef-sum, 4096, 33, 6842, 195, 0, 0, 7070, 1
n500x8192-coef-sum, 4096, 36, 6816, 197, 0, 0, 7049, 1
n500x8192-coef-sum, 4096, 38, 6812, 192, 0, 0, 7042, 1
n500x8192-coef-sum, 4096, 33, 6819, 199, 0, 0, 7051, 1
n500x8192-coef-sum, 4096, 31, 6816, 197, 0, 0, 7044, 1
n500x8192-coef-sum, 4096, 30, 6823, 193, 0, 0, 7046, 1
n500x8192-coef-sum, 4096, 31, 6813, 194, 0, 0, 7038, 1
n500x8192-coef-sum, 4096, 30, 6825, 201, 0, 0, 7056, 1
n500x8192-coef-sum, 4096, 42, 6864, 200, 0, 0, 7106, 1
n500x8192-coef-sum, 4096, 30, 6816, 193, 0, 0, 7039, 1
n500x8192-coef-sum, 4096, 31, 6832, 199, 0, 0, 7062, 1
n500x8192-coef-sum, 4096, 32, 6811, 193, 0, 0, 7036, 1
n500x8192-coef-sum, 4096, 30, 6807, 194, 0, 0, 7031, 1
n500x8192-coef-sum, 4096, 33, 6811, 195, 0, 0, 7039, 1
n500x8192-coef-sum, 4096, 35, 6802, 194, 0, 0, 7031, 1
n500x8192-coef-sum, 4096, 33, 6811, 194, 0, 0, 7038, 1
n500x8192-coef-sum, 4096, 36, 6833, 199, 0, 0, 7068, 1
n500x8192-coef-sum, 4096, 31, 6846, 196, 0, 0, 7073, 1
n500x8192-coef-sum, 4096, 41, 6844, 193, 0, 0, 7078, 1
n500x8192-coef-sum, 4096, 32, 6809, 194, 0, 0, 7035, 1
n500x8192-coef-sum, 4096, 31, 6813, 193, 0, 0, 7037, 1
n500x8192-coef-sum, 4096, 33, 6844, 193, 0, 0, 7070, 1
n500x8192-coef-sum, 4096, 34, 6850, 197, 0, 0, 7081, 1
n500x8192-coef-sum, 4096, 32, 6804, 197, 0, 0, 7033, 1
n500x8192-coef-sum, 4096, 31, 6815, 197, 0, 0, 7043, 1
n500x8192-coef-sum, 4096, 34, 6818, 195, 0, 0, 7047, 1
n500x8192-coef-sum, 4096, 34, 6808, 194, 0, 0, 7036, 1
n500x8192-coef-sum, 4096, 31, 6803, 193, 0, 0, 7027, 1
n500x8192-coef-sum, 4096, 32, 6816, 193, 0, 0, 7041, 1
n500x8192-coef-sum, 4096, 30, 6814, 196, 0, 0, 7040, 1
n500x8192-coef-sum, 4096, 31, 6817, 192, 0, 0, 7040, 1
n500x8192-coef-sum, 4096, 33, 6843, 196, 0, 0, 7072, 1
n500x8192-coef-sum, 4096, 31, 6822, 193, 0, 0, 7046, 1
n500x8192-coef-sum, 4096, 33, 6808, 195, 0, 0, 7036, 1
n500x8192-coef-sum, 4096, 33, 6810, 196, 0, 0, 7039, 1
n500x8192-coef-sum, 4096, 34, 6818, 195, 0, 0, 7047, 1
n500x8192-coef-sum, 4096, 33, 6825, 193, 0, 0, 7051, 1
n500x8192-coef-sum, 4096, 30, 6822, 196, 0, 0, 7048, 1
n500x8192-coef-sum, 4096, 34, 6834, 192, 0, 0, 7060, 1
n500x8192-coef-sum, 4096, 31, 6845, 198, 0, 0, 7074, 1
n500x8192-coef-sum, 4096, 30, 6814, 196, 0, 0, 7040, 1
n500x8192-coef-sum, 4096, 31, 6819, 195, 0, 0, 7045, 1
n500x8192-coef-sum, 4096, 30, 6801, 193, 0, 0, 7024, 1
n500x8192-coef-sum, 4096, 33, 6819, 199, 0, 0, 7051, 1
n500x8192-coef-sum, 4096, 31, 6812, 191, 0, 0, 7034, 1
n500x8192-coef-sum, 4096, 34, 6830, 193, 0, 0, 7057, 1
n500x8192-coef-sum, 4096, 41, 6817, 205, 0, 0, 7063, 1
n500x8192-coef-sum, 4096, 32, 6837, 196, 0, 0, 7065, 1
n500x8192-coef-sum, 4096, 31, 6788, 194, 0, 0, 7013, 1
n500x8192-coef-sum, 4096, 33, 6815, 199, 0, 0, 7047, 1
n500x8192-coef-sum, 4096, 31, 6816, 193, 0, 0, 7040, 1
n500x8192-coef-sum, 4096, 33, 6806, 193, 0, 0, 7032, 1
n500x8192-coef-sum, 4096, 30, 6832, 194, 0, 0, 7056, 1
n500x8192-coef-sum, 4096, 30, 6820, 196, 0, 0, 7046, 1
n500x8192-coef-sum, 4096, 32, 6870, 199, 0, 0, 7101, 1
n500x8192-coef-sum, 4096, 30, 6794, 197, 0, 0, 7021, 1
n500x8192-coef-sum, 4096, 31, 6825, 196, 0, 0, 7052, 1
n500x8192-coef-sum, 4096, 42, 6812, 197, 0, 0, 7051, 1
n500x8192-coef-sum, 4096, 33, 6822, 194, 0, 0, 7049, 1
n500x8192-coef-sum, 4096, 30, 6833, 196, 0, 0, 7059, 1
n500x8192-coef-sum, 4096, 41, 6871, 199, 0, 0, 7111, 1
n500x8192-coef-sum, 4096, 31, 6832, 194, 0, 0, 7057, 1
n500x8192-coef-sum, 4096, 31, 6817, 199, 0, 0, 7047, 1
n500x8192-coef-sum, 4096, 33, 6842, 198, 0, 0, 7073, 1
n500x8192-coef-sum, 4096, 41, 6794, 194, 0, 0, 7029, 1
n500x8192-coef-sum, 4096, 42, 6795, 198, 0, 0, 7035, 1
n500x8192-coef-sum, 4096, 41, 6828, 199, 0, 0, 7068, 1
n500x8192-coef-sum, 4096, 30, 6826, 195, 0, 0, 7051, 1
n500x8192-coef-sum, 4096, 31, 6822, 194, 0, 0, 7047, 1
n500x8192-coef-sum, 4096, 32, 6811, 197, 0, 0, 7040, 1
n500x8192-coef-sum, 4096, 30, 6810, 198, 0, 0, 7038, 1
n500x8192-coef-sum, 4096, 31, 6820, 193, 0, 0, 7044, 1
n500x8192-coef-sum, 4096, 33, 6830, 195, 0, 0, 7058, 1
n500x8192-coef-sum, 4096, 30, 6796, 196, 0, 0, 7022, 1
n500x8192-coef-sum, 4096, 32, 6832, 193, 0, 0, 7057, 1
n500x8192-coef-sum, 4096, 34, 6853, 202, 4, 0, 7093, 1
n500x8192-coef-sum, 4096, 31, 6821, 194, 0, 0, 7046, 1
n500x8192-coef-sum, 4096, 30, 6832, 198, 0, 0, 7060, 1
n500x8192-coef-sum, 4096, 41, 6844, 197, 0, 0, 7082, 1
n500x8192-coef-sum, 4096, 35, 6883, 192, 0, 0, 7110, 1
n500x8192-coef-sum, 4096, 36, 6880, 198, 0, 0, 7114, 1
n500x8192-coef-sum, 2048, 18, 6732, 208, 0, 0, 6958, 1
n500x8192-coef-sum, 2048, 18, 6946, 206, 0, 0, 7170, 1
n500x8192-coef-sum, 2048, 18, 6748, 203, 0, 0, 6969, 1
n500x8192-coef-sum, 2048, 18, 6728, 206, 0, 0, 6952, 1
n500x8192-coef-sum, 2048, 22, 6747, 207, 0, 0, 6976, 1
n500x8192-coef-sum, 2048, 18, 6830, 208, 0, 0, 7056, 1
n500x8192-coef-sum, 2048, 18, 6840, 210, 0, 0, 7068, 1
n500x8192-coef-sum, 2048, 18, 6818, 209, 0, 0, 7045, 1
n500x8192-coef-sum, 2048, 18, 6824, 207, 0, 0, 7049, 1
n500x8192-coef-sum, 2048, 21, 6817, 209, 0, 0, 7047, 1
n500x8192-coef-sum, 2048, 22, 6786, 212, 0, 0, 7020, 1
n500x8192-coef-sum, 2048, 18, 6756, 206, 0, 0, 6980, 1
n500x8192-coef-sum, 2048, 17, 6774, 207, 0, 0, 6998, 1
n500x8192-coef-sum, 2048, 17, 6752, 207, 0, 0, 6976, 1
n500x8192-coef-sum, 2048, 29, 6761, 206, 0, 0, 6996, 1
n500x8192-coef-sum, 2048, 18, 6761, 206, 0, 0, 6985, 1
n500x8192-coef-sum, 2048, 18, 6744, 204, 0, 0, 6966, 1
n500x8192-coef-sum, 2048, 18, 6780, 208, 0, 0, 7006, 1
n500x8192-coef-sum, 2048, 18, 6767, 210, 0, 0, 6995, 1
n500x8192-coef-sum, 2048, 18, 6738, 206, 0, 0, 6962, 1
n500x8192-coef-sum, 2048, 25, 6774, 208, 0, 0, 7007, 1
n500x8192-coef-sum, 2048, 18, 6767, 212, 0, 0, 6997, 1
n500x8192-coef-sum, 2048, 18, 6790, 212, 0, 0, 7020, 1
n500x8192-coef-sum, 2048, 21, 6823, 210, 0, 0, 7054, 1
n500x8192-coef-sum, 2048, 18, 6813, 211, 0, 0, 7042, 1
n500x8192-coef-sum, 2048, 21, 6752, 208, 0, 0, 6981, 1
n500x8192-coef-sum, 2048, 19, 6755, 209, 0, 0, 6983, 1
n500x8192-coef-sum, 2048, 17, 6791, 209, 0, 0, 7017, 1
n500x8192-coef-sum, 2048, 18, 6780, 207, 0, 0, 7005, 1
n500x8192-coef-sum, 2048, 22, 6733, 204, 0, 0, 6959, 1
n500x8192-coef-sum, 2048, 18, 6757, 204, 0, 0, 6979, 1
n500x8192-coef-sum, 2048, 18, 6750, 205, 0, 0, 6973, 1
n500x8192-coef-sum, 2048, 17, 6738, 206, 0, 0, 6961, 1
n500x8192-coef-sum, 2048, 18, 6719, 205, 0, 0, 6942, 1
n500x8192-coef-sum, 2048, 18, 6744, 209, 0, 0, 6971, 1
n500x8192-coef-sum, 2048, 18, 6738, 206, 0, 0, 6962, 1
n500x8192-coef-sum, 2048, 18, 6757, 206, 0, 0, 6981, 1
n500x8192-coef-sum, 2048, 18, 6748, 204, 0, 0, 6970, 1
n500x8192-coef-sum, 2048, 18, 6792, 209, 0, 0, 7019, 1
n500x8192-coef-sum, 2048, 18, 6763, 206, 0, 0, 6987, 1
n500x8192-coef-sum, 2048, 18, 6724, 204, 0, 0, 6946, 1
n500x8192-coef-sum, 2048, 18, 6755, 207, 0, 0, 6980, 1
n500x8192-coef-sum, 2048, 18, 6721, 209, 0, 0, 6948, 1
n500x8192-coef-sum, 2048, 18, 6719, 207, 0, 0, 6944, 1
n500x8192-coef-sum, 2048, 18, 6717, 206, 0, 0, 6941, 1
n500x8192-coef-sum, 2048, 18, 6726, 207, 0, 0, 6951, 1
n500x8192-coef-sum, 2048, 18, 6753, 208, 0, 0, 6979, 1
n500x8192-coef-sum, 2048, 18, 6754, 205, 0, 0, 6977, 1
n500x8192-coef-sum, 2048, 18, 6722, 206, 0, 0, 6946, 1
n500x8192-coef-sum, 2048, 18, 6732, 205, 0, 0, 6955, 1
n500x8192-coef-sum, 2048, 18, 6709, 205, 0, 0, 6932, 1
n500x8192-coef-sum, 2048, 18, 6728, 208, 0, 0, 6954, 1
n500x8192-coef-sum, 2048, 20, 6720, 206, 0, 0, 6946, 1
n500x8192-coef-sum, 2048, 18, 6731, 206, 0, 0, 6955, 1
n500x8192-coef-sum, 2048, 18, 6727, 205, 0, 0, 6950, 1
n500x8192-coef-sum, 2048, 17, 6757, 208, 0, 0, 6982, 1
n500x8192-coef-sum, 2048, 18, 6743, 205, 0, 0, 6966, 1
n500x8192-coef-sum, 2048, 18, 6733, 206, 0, 0, 6957, 1
n500x8192-coef-sum, 2048, 18, 6734, 207, 0, 0, 6959, 1
n500x8192-coef-sum, 2048, 18, 6745, 205, 0, 0, 6968, 1
n500x8192-coef-sum, 2048, 18, 6728, 206, 0, 0, 6952, 1
n500x8192-coef-sum, 2048, 18, 6732, 206, 0, 0, 6956, 1
n500x8192-coef-sum, 2048, 18, 6718, 208, 0, 0, 6944, 1
n500x8192-coef-sum, 2048, 18, 6775, 207, 0, 0, 7000, 1
n500x8192-coef-sum, 2048, 20, 6759, 204, 0, 0, 6983, 1
n500x8192-coef-sum, 2048, 18, 6749, 205, 0, 0, 6972, 1
n500x8192-coef-sum, 2048, 25, 6730, 205, 0, 0, 6960, 1
n500x8192-coef-sum, 2048, 18, 6751, 210, 0, 0, 6979, 1
n500x8192-coef-sum, 2048, 20, 6758, 205, 0, 0, 6983, 1
n500x8192-coef-sum, 2048, 18, 6742, 205, 0, 0, 6965, 1
n500x8192-coef-sum, 2048, 18, 6756, 208, 0, 0, 6982, 1
n500x8192-coef-sum, 2048, 20, 6780, 209, 0, 0, 7009, 1
n500x8192-coef-sum, 2048, 18, 6773, 210, 0, 0, 7001, 1
n500x8192-coef-sum, 2048, 20, 6761, 205, 0, 0, 6986, 1
n500x8192-coef-sum, 2048, 18, 7598, 236, 0, 0, 7852, 1
n500x8192-coef-sum, 2048, 18, 8084, 214, 0, 0, 8316, 1
n500x8192-coef-sum, 2048, 18, 6792, 217, 0, 0, 7027, 1
n500x8192-coef-sum, 2048, 22, 6850, 213, 0, 0, 7085, 1
n500x8192-coef-sum, 2048, 18, 7595, 212, 0, 0, 7825, 1
n500x8192-coef-sum, 2048, 18, 7493, 213, 0, 0, 7724, 1
n500x8192-coef-sum, 2048, 18, 7654, 290, 0, 0, 7962, 1
n500x8192-coef-sum, 2048, 33, 7712, 252, 3, 0, 8000, 1
n500x8192-coef-sum, 2048, 18, 7506, 212, 0, 0, 7736, 1
n500x8192-coef-sum, 2048, 18, 6973, 217, 0, 0, 7208, 1
n500x8192-coef-sum, 2048, 21, 6885, 210, 0, 0, 7116, 1
n500x8192-coef-sum, 2048, 18, 7251, 255, 0, 0, 7524, 1
n500x8192-coef-sum, 2048, 18, 7365, 225, 0, 0, 7608, 1
n500x8192-coef-sum, 2048, 23, 7281, 291, 3, 0, 7598, 1
n500x8192-coef-sum, 2048, 21, 7071, 221, 0, 0, 7313, 1
n500x8192-coef-sum, 2048, 22, 7380, 289, 5, 0, 7696, 1
n500x8192-coef-sum, 2048, 30, 7907, 210, 0, 0, 8147, 1
n500x8192-coef-sum, 2048, 18, 7259, 217, 0, 0, 7494, 1
n500x8192-coef-sum, 2048, 18, 7521, 212, 0, 0, 7751, 1
n500x8192-coef-sum, 2048, 18, 6739, 204, 0, 0, 6961, 1
n500x8192-coef-sum, 2048, 18, 6768, 206, 0, 0, 6992, 1
n500x8192-coef-sum, 2048, 18, 6750, 208, 0, 0, 6976, 1
n500x8192-coef-sum, 2048, 18, 6741, 203, 0, 0, 6962, 1
n500x8192-coef-sum, 2048, 18, 6743, 204, 0, 0, 6965, 1
n500x8192-coef-sum, 2048, 18, 6742, 205, 0, 0, 6965, 1
n500x8192-coef-sum, 2048, 18, 6769, 204, 0, 0, 6991, 1
n500x8192-coef-sum, 1024, 13, 6819, 231, 0, 0, 7063, 1
n500x8192-coef-sum, 1024, 13, 6858, 230, 0, 0, 7101, 1
n500x8192-coef-sum, 1024, 13, 7143, 230, 0, 0, 7386, 1
n500x8192-coef-sum, 1024, 12, 6869, 231, 0, 0, 7112, 1
n500x8192-coef-sum, 1024, 13, 6878, 230, 0, 0, 7121, 1
n500x8192-coef-sum, 1024, 12, 6887, 231, 0, 0, 7130, 1
n500x8192-coef-sum, 1024, 12, 6830, 230, 0, 0, 7072, 1
n500x8192-coef-sum, 1024, 13, 6854, 227, 0, 0, 7094, 1
n500x8192-coef-sum, 1024, 13, 6867, 233, 0, 0, 7113, 1
n500x8192-coef-sum, 1024, 13, 6930, 234, 0, 0, 7177, 1
n500x8192-coef-sum, 1024, 13, 6843, 238, 0, 0, 7094, 1
n500x8192-coef-sum, 1024, 13, 6919, 232, 0, 0, 7164, 1
n500x8192-coef-sum, 1024, 13, 6871, 229, 0, 0, 7113, 1
n500x8192-coef-sum, 1024, 13, 6843, 233, 0, 0, 7089, 1
n500x8192-coef-sum, 1024, 14, 6852, 232, 0, 0, 7098, 1
n500x8192-coef-sum, 1024, 14, 6881, 231, 0, 0, 7126, 1
n500x8192-coef-sum, 1024, 12, 6865, 227, 0, 0, 7104, 1
n500x8192-coef-sum, 1024, 12, 6901, 231, 0, 0, 7144, 1
n500x8192-coef-sum, 1024, 13, 6906, 227, 0, 0, 7146, 1
n500x8192-coef-sum, 1024, 12, 6895, 227, 0, 0, 7134, 1
n500x8192-coef-sum, 1024, 13, 6879, 231, 0, 0, 7123, 1
n500x8192-coef-sum, 1024, 12, 6837, 232, 0, 0, 7081, 1
n500x8192-coef-sum, 1024, 14, 6831, 228, 0, 0, 7073, 1
n500x8192-coef-sum, 1024, 12, 6831, 230, 0, 0, 7073, 1
n500x8192-coef-sum, 1024, 14, 6837, 229, 0, 0, 7080, 1
n500x8192-coef-sum, 1024, 13, 6848, 228, 0, 0, 7089, 1
n500x8192-coef-sum, 1024, 15, 6839, 229, 0, 0, 7083, 1
n500x8192-coef-sum, 1024, 13, 7099, 233, 0, 0, 7345, 1
n500x8192-coef-sum, 1024, 13, 6916, 227, 0, 0, 7156, 1
n500x8192-coef-sum, 1024, 12, 6906, 229, 0, 0, 7147, 1
n500x8192-coef-sum, 1024, 14, 6914, 231, 0, 0, 7159, 1
n500x8192-coef-sum, 1024, 12, 6931, 232, 0, 0, 7175, 1
n500x8192-coef-sum, 1024, 12, 7043, 234, 0, 0, 7289, 1
n500x8192-coef-sum, 1024, 14, 6958, 230, 0, 0, 7202, 1
n500x8192-coef-sum, 1024, 13, 6928, 234, 0, 0, 7175, 1
n500x8192-coef-sum, 1024, 13, 6950, 231, 0, 0, 7194, 1
n500x8192-coef-sum, 1024, 13, 6893, 229, 0, 0, 7135, 1
n500x8192-coef-sum, 1024, 13, 6875, 233, 0, 0, 7121, 1
n500x8192-coef-sum, 1024, 13, 6908, 237, 0, 0, 7158, 1
n500x8192-coef-sum, 1024, 13, 6845, 230, 0, 0, 7088, 1
n500x8192-coef-sum, 1024, 13, 6858, 231, 0, 0, 7102, 1
n500x8192-coef-sum, 1024, 13, 6863, 235, 0, 0, 7111, 1
n500x8192-coef-sum, 1024, 13, 6894, 231, 0, 0, 7138, 1
n500x8192-coef-sum, 1024, 15, 6879, 230, 0, 0, 7124, 1
n500x8192-coef-sum, 1024, 13, 6862, 230, 0, 0, 7105, 1
n500x8192-coef-sum, 1024, 14, 6796, 227, 0, 0, 7037, 1
n500x8192-coef-sum, 1024, 13, 6852, 226, 0, 0, 7091, 1
n500x8192-coef-sum, 1024, 12, 6865, 231, 0, 0, 7108, 1
n500x8192-coef-sum, 1024, 13, 6829, 236, 0, 0, 7078, 1
n500x8192-coef-sum, 1024, 13, 6857, 225, 0, 0, 7095, 1
n500x8192-coef-sum, 1024, 13, 6830, 228, 0, 0, 7071, 1
n500x8192-coef-sum, 1024, 13, 6873, 231, 0, 0, 7117, 1
n500x8192-coef-sum, 1024, 13, 6857, 227, 0, 0, 7097, 1
n500x8192-coef-sum, 1024, 12, 6816, 229, 0, 0, 7057, 1
n500x8192-coef-sum, 1024, 13, 6819, 234, 0, 0, 7066, 1
n500x8192-coef-sum, 1024, 13, 6819, 229, 0, 0, 7061, 1
n500x8192-coef-sum, 1024, 13, 6825, 230, 0, 0, 7068, 1
n500x8192-coef-sum, 1024, 13, 6840, 228, 0, 0, 7081, 1
n500x8192-coef-sum, 1024, 12, 6809, 235, 0, 0, 7056, 1
n500x8192-coef-sum, 1024, 13, 6836, 230, 0, 0, 7079, 1
n500x8192-coef-sum, 1024, 12, 6858, 229, 0, 0, 7099, 1
n500x8192-coef-sum, 1024, 13, 6830, 236, 0, 0, 7079, 1
n500x8192-coef-sum, 1024, 12, 6844, 226, 0, 0, 7082, 1
n500x8192-coef-sum, 1024, 13, 6826, 226, 0, 0, 7065, 1
n500x8192-coef-sum, 1024, 13, 6823, 230, 0, 0, 7066, 1
n500x8192-coef-sum, 1024, 12, 6848, 226, 0, 0, 7086, 1
n500x8192-coef-sum, 1024, 13, 6828, 225, 0, 0, 7066, 1
n500x8192-coef-sum, 1024, 13, 6858, 231, 0, 0, 7102, 1
n500x8192-coef-sum, 1024, 13, 6842, 227, 0, 0, 7082, 1
n500x8192-coef-sum, 1024, 14, 6839, 228, 0, 0, 7081, 1
n500x8192-coef-sum, 1024, 14, 6858, 228, 0, 0, 7100, 1
n500x8192-coef-sum, 1024, 13, 6809, 228, 0, 0, 7050, 1
n500x8192-coef-sum, 1024, 13, 6831, 229, 0, 0, 7073, 1
n500x8192-coef-sum, 1024, 13, 6850, 227, 0, 0, 7090, 1
n500x8192-coef-sum, 1024, 13, 6831, 234, 0, 0, 7078, 1
n500x8192-coef-sum, 1024, 14, 6833, 228, 0, 0, 7075, 1
n500x8192-coef-sum, 1024, 14, 6847, 226, 0, 0, 7087, 1
n500x8192-coef-sum, 1024, 12, 6828, 229, 0, 0, 7069, 1
n500x8192-coef-sum, 1024, 13, 6804, 230, 0, 0, 7047, 1
n500x8192-coef-sum, 1024, 12, 6841, 230, 0, 0, 7083, 1
n500x8192-coef-sum, 1024, 13, 6855, 229, 0, 0, 7097, 1
n500x8192-coef-sum, 1024, 12, 6814, 227, 0, 0, 7053, 1
n500x8192-coef-sum, 1024, 13, 6842, 230, 0, 0, 7085, 1
n500x8192-coef-sum, 1024, 12, 6837, 232, 0, 0, 7081, 1
n500x8192-coef-sum, 1024, 13, 6918, 233, 0, 0, 7164, 1
n500x8192-coef-sum, 1024, 13, 6860, 232, 0, 0, 7105, 1
n500x8192-coef-sum, 1024, 12, 6863, 234, 0, 0, 7109, 1
n500x8192-coef-sum, 1024, 13, 6852, 229, 0, 0, 7094, 1
n500x8192-coef-sum, 1024, 13, 6890, 233, 0, 0, 7136, 1
n500x8192-coef-sum, 1024, 12, 6881, 229, 0, 0, 7122, 1
n500x8192-coef-sum, 1024, 13, 6840, 231, 0, 0, 7084, 1
n500x8192-coef-sum, 1024, 13, 6843, 228, 0, 0, 7084, 1
n500x8192-coef-sum, 1024, 14, 6852, 231, 0, 0, 7097, 1
n500x8192-coef-sum, 1024, 13, 6843, 228, 0, 0, 7084, 1
n500x8192-coef-sum, 1024, 13, 6808, 230, 0, 0, 7051, 1
n500x8192-coef-sum, 1024, 13, 6851, 226, 0, 0, 7090, 1
n500x8192-coef-sum, 1024, 13, 6830, 230, 0, 0, 7073, 1
n500x8192-coef-sum, 1024, 13, 6831, 231, 0, 0, 7075, 1
n500x8192-coef-sum, 1024, 13, 6850, 228, 0, 0, 7091, 1
n500x8192-coef-sum, 1024, 13, 6829, 225, 0, 0, 7067, 1
n500x8192-slot-sum, 8192, 267, 4043, 232, 1, 0, 4543, 1
n500x8192-slot-sum, 8192, 270, 4011, 221, 1, 0, 4503, 1
n500x8192-slot-sum, 8192, 266, 4028, 222, 1, 0, 4517, 1
n500x8192-slot-sum, 8192, 266, 4025, 229, 1, 0, 4521, 1
n500x8192-slot-sum, 8192, 267, 4008, 225, 1, 0, 4501, 1
n500x8192-slot-sum, 8192, 265, 4013, 231, 1, 0, 4510, 1
n500x8192-slot-sum, 8192, 269, 4030, 230, 1, 0, 4530, 1
n500x8192-slot-sum, 8192, 267, 4028, 226, 1, 0, 4522, 1
n500x8192-slot-sum, 8192, 273, 4033, 228, 1, 0, 4535, 1
n500x8192-slot-sum, 8192, 270, 4029, 227, 1, 0, 4527, 1
n500x8192-slot-sum, 8192, 268, 4010, 228, 1, 0, 4507, 1
n500x8192-slot-sum, 8192, 271, 4028, 226, 1, 0, 4526, 1
n500x8192-slot-sum, 8192, 270, 4025, 226, 1, 0, 4522, 1
n500x8192-slot-sum, 8192, 271, 4048, 222, 1, 0, 4542, 1
n500x8192-slot-sum, 8192, 267, 4032, 222, 1, 0, 4522, 1
n500x8192-slot-sum, 8192, 266, 4030, 225, 1, 0, 4522, 1
n500x8192-slot-sum, 8192, 265, 4000, 222, 1, 0, 4488, 1
n500x8192-slot-sum, 8192, 267, 4032, 227, 1, 0, 4527, 1
n500x8192-slot-sum, 8192, 270, 4014, 227, 1, 0, 4512, 1
n500x8192-slot-sum, 8192, 269, 4011, 222, 1, 0, 4503, 1
n500x8192-slot-sum, 8192, 267, 4025, 225, 1, 0, 4518, 1
n500x8192-slot-sum, 8192, 270, 4010, 223, 1, 0, 4504, 1
n500x8192-slot-sum, 8192, 266, 4029, 222, 1, 0, 4518, 1
n500x8192-slot-sum, 8192, 272, 4033, 226, 1, 0, 4532, 1
n500x8192-slot-sum, 8192, 269, 4010, 226, 1, 0, 4506, 1
n500x8192-slot-sum, 8192, 275, 4049, 231, 1, 0, 4556, 1
n500x8192-slot-sum, 8192, 272, 4026, 223, 1, 0, 4522, 1
n500x8192-slot-sum, 8192, 265, 4018, 223, 1, 0, 4507, 1
n500x8192-slot-sum, 8192, 265, 4033, 222, 1, 0, 4521, 1
n500x8192-slot-sum, 8192, 265, 3996, 225, 1, 0, 4487, 1
n500x8192-slot-sum, 8192, 265, 4000, 224, 1, 0, 4490, 1
n500x8192-slot-sum, 8192, 264, 4039, 228, 1, 0, 4532, 1
n500x8192-slot-sum, 8192, 265, 4044, 226, 1, 0, 4536, 1
n500x8192-slot-sum, 8192, 267, 3993, 222, 1, 0, 4483, 1
n500x8192-slot-sum, 8192, 268, 3998, 222, 1, 0, 4489, 1
n500x8192-slot-sum, 8192, 275, 3979, 222, 1, 0, 4477, 1
n500x8192-slot-sum, 8192, 266, 4000, 223, 1, 0, 4490, 1
n500x8192-slot-sum, 8192, 267, 4005, 222, 1, 0, 4495, 1
n500x8192-slot-sum, 8192, 267, 4060, 225, 1, 0, 4553, 1
n500x8192-slot-sum, 8192, 269, 4020, 222, 1, 0, 4512, 1
n500x8192-slot-sum, 8192, 269, 3992, 224, 1, 0, 4486, 1
n500x8192-slot-sum, 8192, 269, 4002, 224, 1, 0, 4496, 1
n500x8192-slot-sum, 8192, 268, 4057, 233, 1, 0, 4559, 1
n500x8192-slot-sum, 8192, 268, 4029, 231, 1, 0, 4529, 1
n500x8192-slot-sum, 8192, 266, 3997, 225, 1, 0, 4489, 1
n500x8192-slot-sum, 8192, 270, 4052, 224, 1, 0, 4547, 1
n500x8192-slot-sum, 8192, 269, 4015, 225, 1, 0, 4510, 1
n500x8192-slot-sum, 8192, 267, 4051, 226, 1, 0, 4545, 1
n500x8192-slot-sum, 8192, 271, 4063, 230, 1, 0, 4565, 1
n500x8192-slot-sum, 8192, 276, 3995, 223, 1, 0, 4495, 1
n500x8192-slot-sum, 8192, 266, 4010, 224, 1, 0, 4501, 1
n500x8192-slot-sum, 8192, 267, 4011, 222, 1, 0, 4501, 1
n500x8192-slot-sum, 8192, 268, 4041, 226, 1, 0, 4536, 1
n500x8192-slot-sum, 8192, 268, 4026, 223, 1, 0, 4518, 1
n500x8192-slot-sum, 8192, 263, 4018, 223, 1, 0, 4505, 1
n500x8192-slot-sum, 8192, 264, 4012, 224, 1, 0, 4501, 1
n500x8192-slot-sum, 8192, 270, 4013, 230, 1, 0, 4514, 1
n500x8192-slot-sum, 8192, 265, 4044, 229, 1, 0, 4539, 1
n500x8192-slot-sum, 8192, 267, 4046, 235, 1, 0, 4549, 1
n500x8192-slot-sum, 8192, 264, 4005, 224, 1, 0, 4494, 1
n500x8192-slot-sum, 8192, 268, 4030, 229, 1, 0, 4528, 1
n500x8192-slot-sum, 8192, 275, 4023, 224, 1, 0, 4523, 1
n500x8192-slot-sum, 8192, 268, 4012, 223, 1, 0, 4504, 1
n500x8192-slot-sum, 8192, 267, 4005, 222, 1, 0, 4495, 1
n500x8192-slot-sum, 8192, 273, 4042, 221, 1, 0, 4537, 1
n500x8192-slot-sum, 8192, 263, 4000, 223, 1, 0, 4487, 1
n500x8192-slot-sum, 8192, 271, 4038, 231, 1, 0, 4541, 1
n500x8192-slot-sum, 8192, 271, 4016, 225, 1, 0, 4513, 1
n500x8192-slot-sum, 8192, 263, 4008, 228, 1, 0, 4500, 1
n500x8192-slot-sum, 8192, 270, 4005, 223, 1, 0, 4499, 1
n500x8192-slot-sum, 8192, 264, 3993, 223, 1, 0, 4481, 1
n500x8192-slot-sum, 8192, 277, 3999, 222, 1, 0, 4499, 1
n500x8192-slot-sum, 8192, 265, 4042, 226, 1, 0, 4534, 1
n500x8192-slot-sum, 8192, 269, 4055, 224, 1, 0, 4549, 1
n500x8192-slot-sum, 8192, 267, 4029, 230, 1, 0, 4527, 1
n500x8192-slot-sum, 8192, 272, 4093, 233, 1, 0, 4599, 1
n500x8192-slot-sum, 8192, 272, 4083, 231, 1, 0, 4587, 1
n500x8192-slot-sum, 8192, 276, 4026, 225, 1, 0, 4528, 1
n500x8192-slot-sum, 8192, 266, 4067, 226, 1, 0, 4560, 1
n500x8192-slot-sum, 8192, 269, 4055, 230, 1, 0, 4555, 1
n500x8192-slot-sum, 8192, 301, 5766, 319, 1, 0, 6387, 1
n500x8192-slot-sum, 8192, 350, 7243, 272, 1, 0, 7866, 1
n500x8192-slot-sum, 8192, 425, 7991, 404, 1, 0, 8821, 1
n500x8192-slot-sum, 8192, 456, 5810, 301, 1, 0, 6568, 1
n500x8192-slot-sum, 8192, 320, 5214, 308, 1, 0, 5843, 1
n500x8192-slot-sum, 8192, 377, 6196, 321, 1, 0, 6895, 1
n500x8192-slot-sum, 8192, 322, 5428, 274, 1, 0, 6025, 1
n500x8192-slot-sum, 8192, 577, 8650, 290, 1, 0, 9518, 1
n500x8192-slot-sum, 8192, 507, 5404, 1100, 1, 0, 7012, 1
n500x8192-slot-sum, 8192, 840, 4728, 232, 1, 0, 5801, 1
n500x8192-slot-sum, 8192, 266, 4070, 229, 1, 0, 4566, 1
n500x8192-slot-sum, 8192, 273, 4194, 270, 1, 0, 4738, 1
n500x8192-slot-sum, 8192, 301, 4347, 268, 1, 0, 4917, 1
n500x8192-slot-sum, 8192, 265, 4045, 231, 1, 0, 4542, 1
n500x8192-slot-sum, 8192, 273, 4222, 240, 1, 0, 4736, 1
n500x8192-slot-sum, 8192, 270, 4083, 232, 1, 0, 4586, 1
n500x8192-slot-sum, 8192, 274, 4123, 226, 1, 0, 4624, 1
n500x8192-slot-sum, 8192, 267, 4098, 234, 1, 0, 4600, 1
n500x8192-slot-sum, 8192, 283, 4162, 234, 1, 0, 4680, 1
n500x8192-slot-sum, 8192, 278, 4097, 239, 1, 0, 4615, 1
n500x8192-slot-sum, 4096, 129, 3990, 217, 0, 0, 4336, 1
n500x8192-slot-sum, 4096, 127, 3945, 212, 1, 0, 4285, 1
n500x8192-slot-sum, 4096, 124, 3922, 213, 0, 0, 4259, 1
n500x8192-slot-sum, 4096, 130, 3982, 217, 0, 0, 4329, 1
n500x8192-slot-sum, 4096, 127, 3916, 209, 0, 0, 4252, 1
n500x8192-slot-sum, 4096, 128, 3988, 218, 0, 0, 4334, 1
n500x8192-slot-sum, 4096, 126, 3919, 211, 0, 0, 4256, 1
n500x8192-slot-sum, 4096, 134, 3944, 212, 0, 0, 4290, 1
n500x8192-slot-sum, 4096, 123, 3906, 218, 0, 0, 4247, 1
n500x8192-slot-sum, 4096, 127, 3975, 213, 0, 0, 4315, 1
n500x8192-slot-sum, 4096, 136, 4005, 217, 0, 0, 4358, 1
n500x8192-slot-sum, 4096, 132, 3997, 222, 0, 0, 4351, 1
n500x8192-slot-sum, 4096, 131, 3885, 211, 0, 0, 4227, 1
n500x8192-slot-sum, 4096, 133, 3903, 214, 0, 0, 4250, 1
n500x8192-slot-sum, 4096, 128, 4079, 224, 0, 0, 4431, 1
n500x8192-slot-sum, 4096, 128, 3881, 215, 0, 0, 4224, 1
n500x8192-slot-sum, 4096, 128, 3916, 210, 0, 0, 4254, 1
n500x8192-slot-sum, 4096, 132, 3894, 210, 0, 0, 4236, 1
n500x8192-slot-sum, 4096, 130, 3991, 214, 0, 0, 4335, 1
n500x8192-slot-sum, 4096, 133, 4003, 211, 0, 0, 4347, 1
n500x8192-slot-sum, 4096, 127, 4002, 211, 0, 0, 4340, 1
n500x8192-slot-sum, 4096, 128, 3942, 210, 0, 0, 4280, 1
n500x8192-slot-sum, 4096, 125, 3894, 209, 0, 0, 4228, 1
n500x8192-slot-sum, 4096, 135, 4014, 214, 0, 0, 4363, 1
n500x8192-slot-sum, 4096, 127, 3894, 212, 0, 0, 4233, 1
n500x8192-slot-sum, 4096, 123, 3933, 211, 0, 0, 4267, 1
n500x8192-slot-sum, 4096, 124, 3889, 213, 0, 0, 4226, 1
n500x8192-slot-sum, 4096, 125, 3885, 209, 0, 0, 4219, 1
n500x8192-slot-sum, 4096, 125, 3883, 208, 0, 0, 4216, 1
n500x8192-slot-sum, 4096, 124, 3881, 210, 0, 0, 4215, 1
n500x8192-slot-sum, 4096, 127, 3898, 209, 0, 0, 4234, 1
n500x8192-slot-sum, 4096, 129, 3869, 213, 0, 0, 4211, 1
n500x8192-slot-sum, 4096, 124, 3885, 207, 0, 0, 4216, 1
n500x8192-slot-sum, 4096, 128, 3910, 212, 0, 0, 4250, 1
n500x8192-slot-sum, 4096, 126, 3908, 218, 0, 0, 4252, 1
n500x8192-slot-sum, 4096, 128, 3945, 217, 0, 0, 4290, 1
n500x8192-slot-sum, 4096, 125, 3894, 210, 0, 0, 4229, 1
n500x8192-slot-sum, 4096, 129, 3955, 212, 0, 0, 4296, 1
n500x8192-slot-sum, 4096, 128, 3891, 213, 0, 0, 4232, 1
n500x8192-slot-sum, 4096, 130, 3922, 210, 0, 0, 4262, 1
n500x8192-slot-sum, 4096, 129, 4039, 220, 0, 0, 4388, 1
n500x8192-slot-sum, 4096, 129, 3902, 212, 0, 0, 4243, 1
n500x8192-slot-sum, 4096, 135, 4005, 212, 0, 0, 4352, 1
n500x8192-slot-sum, 4096, 126, 3906, 210, 0, 0, 4242, 1
n500x8192-slot-sum, 4096, 128, 3885, 214, 0, 0, 4227, 1
n500x8192-slot-sum, 4096, 128, 3979, 212, 0, 0, 4319, 1
n500x8192-slot-sum, 4096, 135, 3952, 219, 0, 0, 4306, 1
n500x8192-slot-sum, 4096, 127, 3960, 215, 0, 0, 4302, 1
n500x8192-slot-sum, 4096, 137, 3964, 222, 0, 0, 4323, 1
n500x8192-slot-sum, 4096, 129, 3926, 216, 0, 0, 4271, 1
n500x8192-slot-sum, 4096, 127, 3945, 215, 0, 0, 4287, 1
n500x8192-slot-sum, 4096, 126, 3903, 215, 0, 0, 4244, 1
n500x8192-slot-sum, 4096, 134, 4036, 214, 0, 0, 4384, 1
n500x8192-slot-sum, 4096, 125, 3973, 219, 0, 0, 4317, 1
n500x8192-slot-sum, 4096, 127, 3924, 216, 0, 0, 4267, 1
n500x8192-slot-sum, 4096, 127, 3918, 212, 0, 0, 4257, 1
n500x8192-slot-sum, 4096, 127, 3984, 215, 0, 0, 4326, 1
n500x8192-slot-sum, 4096, 128, 3978, 215, 0, 0, 4321, 1
n500x8192-slot-sum, 4096, 127, 3901, 209, 0, 0, 4237, 1
n500x8192-slot-sum, 4096, 128, 4018, 215, 0, 0, 4361, 1
n500x8192-slot-sum, 4096, 127, 3904, 211, 0, 0, 4242, 1
n500x8192-slot-sum, 4096, 126, 3955, 218, 0, 0, 4299, 1
n500x8192-slot-sum, 4096, 127, 3936, 216, 0, 0, 4279, 1
n500x8192-slot-sum, 4096, 125, 3917, 214, 0, 0, 4256, 1
n500x8192-slot-sum, 4096, 127, 3907, 208, 0, 0, 4242, 1
n500x8192-slot-sum, 4096, 126, 3883, 222, 0, 0, 4231, 1
n500x8192-slot-sum, 4096, 124, 3904, 215, 0, 0, 4243, 1
n500x8192-slot-sum, 4096, 134, 3947, 211, 0, 0, 4292, 1
n500x8192-slot-sum, 4096, 130, 4000, 221, 0, 0, 4351, 1
n500x8192-slot-sum, 4096, 133, 3922, 211, 0, 0, 4266, 1
n500x8192-slot-sum, 4096, 128, 3992, 219, 0, 0, 4339, 1
n500x8192-slot-sum, 4096, 129, 4001, 212, 0, 0, 4342, 1
n500x8192-slot-sum, 4096, 131, 4018, 212, 0, 0, 4361, 1
n500x8192-slot-sum, 4096, 128, 4018, 233, 0, 0, 4379, 1
n500x8192-slot-sum, 4096, 129, 4082, 212, 0, 0, 4423, 1
n500x8192-slot-sum, 4096, 131, 3986, 216, 0, 0, 4333, 1
n500x8192-slot-sum, 4096, 124, 4000, 211, 0, 0, 4335, 1
n500x8192-slot-sum, 4096, 124, 3946, 220, 0, 0, 4290, 1
n500x8192-slot-sum, 4096, 125, 3934, 212, 0, 0, 4271, 1
n500x8192-slot-sum, 4096, 131, 4026, 214, 0, 0, 4371, 1
n500x8192-slot-sum, 4096, 129, 3916, 211, 0, 0, 4256, 1
n500x8192-slot-sum, 4096, 139, 4000, 211, 0, 0, 4350, 1
n500x8192-slot-sum, 4096, 133, 3998, 217, 0, 0, 4348, 1
n500x8192-slot-sum, 4096, 127, 4014, 227, 0, 0, 4368, 1
n500x8192-slot-sum, 4096, 129, 4030, 215, 0, 0, 4374, 1
n500x8192-slot-sum, 4096, 130, 4094, 221, 0, 0, 4445, 1
n500x8192-slot-sum, 4096, 127, 4021, 218, 0, 0, 4366, 1
n500x8192-slot-sum, 4096, 130, 3980, 212, 0, 0, 4322, 1
n500x8192-slot-sum, 4096, 137, 4036, 215, 0, 0, 4388, 1
n500x8192-slot-sum, 4096, 128, 4021, 229, 0, 0, 4378, 1
n500x8192-slot-sum, 4096, 129, 3939, 209, 0, 0, 4277, 1
n500x8192-slot-sum, 4096, 129, 3926, 217, 0, 0, 4272, 1
n500x8192-slot-sum, 4096, 125, 3898, 211, 0, 0, 4234, 1
n500x8192-slot-sum, 4096, 127, 3933, 219, 0, 0, 4279, 1
n500x8192-slot-sum, 4096, 129, 3970, 215, 0, 0, 4314, 1
n500x8192-slot-sum, 4096, 127, 3955, 212, 0, 0, 4294, 1
n500x8192-slot-sum, 4096, 130, 3971, 210, 0, 0, 4311, 1
n500x8192-slot-sum, 4096, 128, 3904, 211, 0, 0, 4243, 1
n500x8192-slot-sum, 4096, 125, 3943, 212, 0, 0, 4280, 1
n500x8192-slot-sum, 4096, 128, 3941, 215, 0, 0, 4284, 1
n500x8192-slot-sum, 2048, 60, 3884, 218, 0, 0, 4162, 1
n500x8192-slot-sum, 2048, 72, 3873, 218, 0, 0, 4163, 1
n500x8192-slot-sum, 2048, 60, 3841, 220, 0, 0, 4121, 1
n500x8192-slot-sum, 2048, 59, 3893, 214, 0, 0, 4166, 1
n500x8192-slot-sum, 2048, 59, 3859, 214, 0, 0, 4132, 1
n500x8192-slot-sum, 2048, 59, 3842, 218, 0, 0, 4119, 1
n500x8192-slot-sum, 2048, 63, 3834, 215, 0, 0, 4112, 1
n500x8192-slot-sum, 2048, 65, 3844, 225, 0, 0, 4134, 1
n500x8192-slot-sum, 2048, 60, 3894, 216, 0, 0, 4170, 1
n500x8192-slot-sum, 2048, 60, 3890, 215, 0, 0, 4165, 1
n500x8192-slot-sum, 2048, 60, 3878, 214, 0, 0, 4152, 1
n500x8192-slot-sum, 2048, 60, 3828, 220, 0, 0, 4108, 1
n500x8192-slot-sum, 2048, 60, 3872, 216, 0, 0, 4148, 1
n500x8192-slot-sum, 2048, 61, 3861, 214, 0, 0, 4136, 1
n500x8192-slot-sum, 2048, 60, 3902, 214, 0, 0, 4176, 1
n500x8192-slot-sum, 2048, 60, 3901, 216, 0, 0, 4177, 1
n500x8192-slot-sum, 2048, 61, 3907, 214, 0, 0, 4182, 1
n500x8192-slot-sum, 2048, 61, 3850, 224, 0, 0, 4135, 1
n500x8192-slot-sum, 2048, 60, 3872, 216, 0, 0, 4148, 1
n500x8192-slot-sum, 2048, 60, 3819, 216, 0, 0, 4095, 1
n500x8192-slot-sum, 2048, 60, 3883, 215, 0, 0, 4158, 1
n500x8192-slot-sum, 2048, 60, 3868, 217, 0, 0, 4145, 1
n500x8192-slot-sum, 2048, 61, 3884, 218, 0, 0, 4163, 1
n500x8192-slot-sum, 2048, 62, 3887, 214, 0, 0, 4163, 1
n500x8192-slot-sum, 2048, 60, 3835, 214, 0, 0, 4109, 1
n500x8192-slot-sum, 2048, 60, 3863, 218, 0, 0, 4141, 1
n500x8192-slot-sum, 2048, 66, 3853, 217, 0, 0, 4136, 1
n500x8192-slot-sum, 2048, 59, 3848, 214, 0, 0, 4121, 1
n500x8192-slot-sum, 2048, 61, 3911, 214, 0, 0, 4186, 1
n500x8192-slot-sum, 2048, 61, 3915, 219, 0, 0, 4195, 1
n500x8192-slot-sum, 2048, 66, 3890, 217, 0, 0, 4173, 1
n500x8192-slot-sum, 2048, 60, 3838, 215, 0, 0, 4113, 1
n500x8192-slot-sum, 2048, 66, 4053, 240, 0, 0, 4359, 1
n500x8192-slot-sum, 2048, 76, 4162, 235, 0, 0, 4473, 1
n500x8192-slot-sum, 2048, 60, 3849, 223, 0, 0, 4132, 1
n500x8192-slot-sum, 2048, 60, 3883, 221, 0, 0, 4164, 1
n500x8192-slot-sum, 2048, 62, 4273, 221, 0, 0, 4556, 1
n500x8192-slot-sum, 2048, 60, 3937, 217, 0, 0, 4214, 1
n500x8192-slot-sum, 2048, 61, 7882, 318, 0, 0, 8261, 1
n500x8192-slot-sum, 2048, 61, 3912, 219, 0, 0, 4192, 1
n500x8192-slot-sum, 2048, 60, 3891, 218, 0, 0, 4169, 1
n500x8192-slot-sum, 2048, 62, 4310, 214, 0, 0, 4586, 1
n500x8192-slot-sum, 2048, 64, 3851, 221, 0, 0, 4136, 1
n500x8192-slot-sum, 2048, 60, 3824, 211, 0, 0, 4095, 1
n500x8192-slot-sum, 2048, 63, 3835, 213, 0, 0, 4111, 1
n500x8192-slot-sum, 2048, 64, 3825, 217, 0, 0, 4106, 1
n500x8192-slot-sum, 2048, 59, 3784, 210, 0, 0, 4053, 1
n500x8192-slot-sum, 2048, 60, 3784, 209, 0, 0, 4053, 1
n500x8192-slot-sum, 2048, 59, 3779, 207, 0, 0, 4045, 1
n500x8192-slot-sum, 2048, 61, 3784, 209, 0, 0, 4054, 1
n500x8192-slot-sum, 2048, 60, 3778, 209, 0, 0, 4047, 1
n500x8192-slot-sum, 2048, 59, 3799, 206, 0, 0, 4064, 1
n500x8192-slot-sum, 2048, 64, 3788, 208, 0, 0, 4060, 1
n500x8192-slot-sum, 2048, 60, 3803, 211, 0, 0, 4074, 1
n500x8192-slot-sum, 2048, 64, 3788, 210, 0, 0, 4062, 1
n500x8192-slot-sum, 2048, 60, 3819, 212, 0, 0, 4091, 1
n500x8192-slot-sum, 2048, 59, 3778, 209, 0, 0, 4046, 1
n500x8192-slot-sum, 2048, 60, 3770, 208, 0, 0, 4038, 1
n500x8192-slot-sum, 2048, 61, 3775, 212, 0, 0, 4048, 1
n500x8192-slot-sum, 2048, 59, 3757, 207, 0, 0, 4023, 1
n500x8192-slot-sum, 2048, 60, 3768, 209, 0, 0, 4037, 1
n500x8192-slot-sum, 2048, 62, 3779, 210, 0, 0, 4051, 1
n500x8192-slot-sum, 2048, 59, 3793, 208, 0, 0, 4060, 1
n500x8192-slot-sum, 2048, 59, 3790, 211, 0, 0, 4060, 1
n500x8192-slot-sum, 2048, 60, 3768, 209, 0, 0, 4037, 1
n500x8192-slot-sum, 2048, 60, 3910, 215, 0, 0, 4185, 1
n500x8192-slot-sum, 2048, 62, 3852, 212, 0, 0, 4126, 1
n500x8192-slot-sum, 2048, 62, 3833, 211, 0, 0, 4106, 1
n500x8192-slot-sum, 2048, 60, 3798, 212, 0, 0, 4070, 1
n500x8192-slot-sum, 2048, 62, 3814, 210, 0, 0, 4086, 1
n500x8192-slot-sum, 2048, 61, 3819, 207, 0, 0, 4087, 1
n500x8192-slot-sum, 2048, 60, 3802, 210, 0, 0, 4072, 1
n500x8192-slot-sum, 2048, 60, 3807, 212, 0, 0, 4079, 1
n500x8192-slot-sum, 2048, 61, 3798, 214, 0, 0, 4073, 1
n500x8192-slot-sum, 2048, 60, 3779, 208, 0, 0, 4047, 1
n500x8192-slot-sum, 2048, 62, 3762, 209, 0, 0, 4033, 1
n500x8192-slot-sum, 2048, 60, 3776, 210, 0, 0, 4046, 1
n500x8192-slot-sum, 2048, 62, 3783, 206, 0, 0, 4051, 1
n500x8192-slot-sum, 2048, 63, 3761, 210, 0, 0, 4034, 1
n500x8192-slot-sum, 2048, 61, 3790, 213, 0, 0, 4064, 1
n500x8192-slot-sum, 2048, 61, 3779, 212, 0, 0, 4052, 1
n500x8192-slot-sum, 2048, 63, 3782, 208, 0, 0, 4053, 1
n500x8192-slot-sum, 2048, 62, 3769, 210, 0, 0, 4041, 1
n500x8192-slot-sum, 2048, 61, 3799, 209, 0, 0, 4069, 1
n500x8192-slot-sum, 2048, 60, 3791, 211, 0, 0, 4062, 1
n500x8192-slot-sum, 2048, 59, 3776, 210, 0, 0, 4045, 1
n500x8192-slot-sum, 2048, 73, 3835, 212, 0, 0, 4120, 1
n500x8192-slot-sum, 2048, 59, 3779, 209, 0, 0, 4047, 1
n500x8192-slot-sum, 2048, 60, 3772, 211, 0, 0, 4043, 1
n500x8192-slot-sum, 2048, 62, 3755, 211, 0, 0, 4028, 1
n500x8192-slot-sum, 2048, 60, 3771, 212, 0, 0, 4043, 1
n500x8192-slot-sum, 2048, 60, 3771, 207, 0, 0, 4038, 1
n500x8192-slot-sum, 2048, 60, 3769, 216, 0, 0, 4045, 1
n500x8192-slot-sum, 2048, 64, 3794, 209, 0, 0, 4067, 1
n500x8192-slot-sum, 2048, 60, 3782, 207, 0, 0, 4049, 1
n500x8192-slot-sum, 2048, 69, 3787, 210, 0, 0, 4066, 1
n500x8192-slot-sum, 2048, 60, 3760, 208, 0, 0, 4028, 1
n500x8192-slot-sum, 2048, 60, 3775, 210, 0, 0, 4045, 1
n500x8192-slot-sum, 2048, 61, 3778, 209, 0, 0, 4048, 1
n500x8192-slot-sum, 2048, 60, 3770, 210, 0, 0, 4040, 1
n500x8192-slot-sum, 1024, 32, 3787, 228, 0, 0, 4047, 1
n500x8192-slot-sum, 1024, 32, 3790, 231, 0, 0, 4053, 1
n500x8192-slot-sum, 1024, 32, 3773, 229, 0, 0, 4034, 1
n500x8192-slot-sum, 1024, 33, 3778, 229, 0, 0, 4040, 1
n500x8192-slot-sum, 1024, 32, 3802, 231, 0, 0, 4065, 1
n500x8192-slot-sum, 1024, 32, 3767, 227, 0, 0, 4026, 1
n500x8192-slot-sum, 1024, 32, 3799, 234, 0, 0, 4065, 1
n500x8192-slot-sum, 1024, 32, 3798, 231, 0, 0, 4061, 1
n500x8192-slot-sum, 1024, 31, 3805, 229, 0, 0, 4065, 1
n500x8192-slot-sum, 1024, 32, 3787, 233, 0, 0, 4052, 1
n500x8192-slot-sum, 1024, 31, 3808, 231, 0, 0, 4070, 1
n500x8192-slot-sum, 1024, 31, 3791, 229, 0, 0, 4051, 1
n500x8192-slot-sum, 1024, 32, 3807, 232, 0, 0, 4071, 1
n500x8192-slot-sum, 1024, 32, 3798, 233, 0, 0, 4063, 1
n500x8192-slot-sum, 1024, 32, 3808, 228, 0, 0, 4068, 1
n500x8192-slot-sum, 1024, 32, 3799, 230, 0, 0, 4061, 1
n500x8192-slot-sum, 1024, 31, 3788, 228, 0, 0, 4047, 1
n500x8192-slot-sum, 1024, 32, 3797, 228, 0, 0, 4057, 1
n500x8192-slot-sum, 1024, 31, 3801, 231, 0, 0, 4063, 1
n500x8192-slot-sum, 1024, 33, 3763, 226, 0, 0, 4022, 1
n500x8192-slot-sum, 1024, 32, 3807, 228, 0, 0, 4067, 1
n500x8192-slot-sum, 1024, 33, 3803, 227, 0, 0, 4063, 1
n500x8192-slot-sum, 1024, 33, 3795, 232, 0, 0, 4060, 1
n500x8192-slot-sum, 1024, 32, 3780, 232, 0, 0, 4044, 1
n500x8192-slot-sum, 1024, 32, 3792, 230, 0, 0, 4054, 1
n500x8192-slot-sum, 1024, 32, 3790, 229, 0, 0, 4051, 1
n500x8192-slot-sum, 1024, 32, 3793, 231, 0, 0, 4056, 1
n500x8192-slot-sum, 1024, 32, 3808, 232, 0, 0, 4072, 1
n500x8192-slot-sum, 1024, 32, 3789, 231, 0, 0, 4052, 1
n500x8192-slot-sum, 1024, 37, 3771, 230, 0, 0, 4038, 1
n500x8192-slot-sum, 1024, 31, 3809, 231, 0, 0, 4071, 1
n500x8192-slot-sum, 1024, 32, 3779, 226, 0, 0, 4037, 1
n500x8192-slot-sum, 1024, 32, 3796, 228, 0, 0, 4056, 1
n500x8192-slot-sum, 1024, 31, 3772, 233, 0, 0, 4036, 1
n500x8192-slot-sum, 1024, 31, 3809, 230, 0, 0, 4070, 1
n500x8192-slot-sum, 1024, 33, 3787, 234, 0, 0, 4054, 1
n500x8192-slot-sum, 1024, 32, 3809, 233, 0, 0, 4074, 1
n500x8192-slot-sum, 1024, 32, 3777, 229, 0, 0, 4038, 1
n500x8192-slot-sum, 1024, 32, 3772, 235, 0, 0, 4039, 1
n500x8192-slot-sum, 1024, 32, 3791, 228, 0, 0, 4051, 1
n500x8192-slot-sum, 1024, 31, 3795, 229, 0, 0, 4055, 1
n500x8192-slot-sum, 1024, 33, 3786, 232, 0, 0, 4051, 1
n500x8192-slot-sum, 1024, 32, 3774, 231, 0, 0, 4037, 1
n500x8192-slot-sum, 1024, 32, 3769, 233, 0, 0, 4034, 1
n500x8192-slot-sum, 1024, 31, 3794, 230, 0, 0, 4055, 1
n500x8192-slot-sum, 1024, 32, 3782, 229, 0, 0, 4043, 1
n500x8192-slot-sum, 1024, 35, 3832, 227, 0, 0, 4094, 1
n500x8192-slot-sum, 1024, 31, 3792, 233, 0, 0, 4056, 1
n500x8192-slot-sum, 1024, 32, 3806, 228, 0, 0, 4066, 1
n500x8192-slot-sum, 1024, 33, 3810, 229, 0, 0, 4072, 1
n500x8192-slot-sum, 1024, 31, 3795, 230, 0, 0, 4056, 1
n500x8192-slot-sum, 1024, 32, 3800, 231, 0, 0, 4063, 1
n500x8192-slot-sum, 1024, 32, 3778, 228, 0, 0, 4038, 1
n500x8192-slot-sum, 1024, 32, 3802, 231, 0, 0, 4065, 1
n500x8192-slot-sum, 1024, 35, 3786, 230, 0, 0, 4051, 1
n500x8192-slot-sum, 1024, 32, 3804, 229, 0, 0, 4065, 1
n500x8192-slot-sum, 1024, 32, 3803, 228, 0, 0, 4063, 1
n500x8192-slot-sum, 1024, 32, 3787, 233, 0, 0, 4052, 1
n500x8192-slot-sum, 1024, 32, 3787, 230, 0, 0, 4049, 1
n500x8192-slot-sum, 1024, 32, 3796, 231, 0, 0, 4059, 1
n500x8192-slot-sum, 1024, 32, 3791, 229, 0, 0, 4052, 1
n500x8192-slot-sum, 1024, 32, 3803, 234, 0, 0, 4069, 1
n500x8192-slot-sum, 1024, 31, 3832, 232, 0, 0, 4095, 1
n500x8192-slot-sum, 1024, 32, 3823, 244, 0, 0, 4099, 1
n500x8192-slot-sum, 1024, 32, 3820, 230, 0, 0, 4082, 1
n500x8192-slot-sum, 1024, 32, 3797, 231, 0, 0, 4060, 1
n500x8192-slot-sum, 1024, 32, 3781, 235, 0, 0, 4048, 1
n500x8192-slot-sum, 1024, 33, 3795, 232, 0, 0, 4060, 1
n500x8192-slot-sum, 1024, 32, 3794, 233, 0, 0, 4059, 1
n500x8192-slot-sum, 1024, 32, 3800, 229, 0, 0, 4061, 1
n500x8192-slot-sum, 1024, 32, 3794, 227, 0, 0, 4053, 1
n500x8192-slot-sum, 1024, 32, 3798, 235, 0, 0, 4065, 1
n500x8192-slot-sum, 1024, 33, 3789, 229, 0, 0, 4051, 1
n500x8192-slot-sum, 1024, 32, 3812, 231, 0, 0, 4075, 1
n500x8192-slot-sum, 1024, 33, 3780, 232, 0, 0, 4045, 1
n500x8192-slot-sum, 1024, 31, 3815, 227, 0, 0, 4073, 1
n500x8192-slot-sum, 1024, 32, 3807, 229, 0, 0, 4068, 1
n500x8192-slot-sum, 1024, 32, 3817, 227, 0, 0, 4076, 1
n500x8192-slot-sum, 1024, 31, 3774, 228, 0, 0, 4033, 1
n500x8192-slot-sum, 1024, 32, 3794, 230, 0, 0, 4056, 1
n500x8192-slot-sum, 1024, 31, 3779, 225, 0, 0, 4035, 1
n500x8192-slot-sum, 1024, 32, 3791, 232, 0, 0, 4055, 1
n500x8192-slot-sum, 1024, 32, 3775, 234, 0, 0, 4041, 1
n500x8192-slot-sum, 1024, 32, 3780, 235, 0, 0, 4047, 1
n500x8192-slot-sum, 1024, 32, 3816, 229, 0, 0, 4077, 1
n500x8192-slot-sum, 1024, 31, 3793, 234, 0, 0, 4058, 1
n500x8192-slot-sum, 1024, 32, 3804, 225, 0, 0, 4061, 1
n500x8192-slot-sum, 1024, 32, 3785, 229, 0, 0, 4046, 1
n500x8192-slot-sum, 1024, 32, 3784, 230, 0, 0, 4046, 1
n500x8192-slot-sum, 1024, 32, 3799, 228, 0, 0, 4059, 1
n500x8192-slot-sum, 1024, 33, 3790, 230, 0, 0, 4053, 1
n500x8192-slot-sum, 1024, 33, 3799, 229, 0, 0, 4061, 1
n500x8192-slot-sum, 1024, 31, 3780, 236, 0, 0, 4047, 1
n500x8192-slot-sum, 1024, 33, 3779, 228, 0, 0, 4040, 1
n500x8192-slot-sum, 1024, 33, 3781, 227, 0, 0, 4041, 1
n500x8192-slot-sum, 1024, 33, 3830, 230, 0, 0, 4093, 1
n500x8192-slot-sum, 1024, 33, 3786, 236, 0, 0, 4055, 1
n500x8192-slot-sum, 1024, 32, 3766, 234, 0, 0, 4032, 1
n500x8192-slot-sum, 1024, 32, 3770, 235, 0, 0, 4037, 1
n500x8192-slot-sum, 1024, 33, 3775, 230, 0, 0, 4038, 1
n500x8192-slot-inner, 8192, 290, 3994, 6800, 1, 0, 11085, 6.82667e+06
n500x8192-slot-inner, 8192, 283, 4026, 7145, 1, 0, 11455, 6.82667e+06
n500x8192-slot-inner, 8192, 286, 4007, 6830, 1, 0, 11124, 6.82667e+06
n500x8192-slot-inner, 8192, 284, 4017, 6870, 1, 0, 11172, 6.82667e+06
n500x8192-slot-inner, 8192, 288, 4000, 7083, 1, 0, 11372, 6.82667e+06
n500x8192-slot-inner, 8192, 288, 4009, 6817, 1, 0, 11115, 6.82667e+06
n500x8192-slot-inner, 8192, 286, 4004, 7129, 1, 0, 11420, 6.82667e+06
n500x8192-slot-inner, 8192, 289, 4010, 6811, 1, 0, 11111, 6.82667e+06
n500x8192-slot-inner, 8192, 288, 4004, 6813, 1, 0, 11106, 6.82667e+06
n500x8192-slot-inner, 8192, 291, 4008, 6812, 1, 0, 11112, 6.82667e+06
n500x8192-slot-inner, 8192, 286, 4013, 6825, 1, 0, 11125, 6.82667e+06
n500x8192-slot-inner, 8192, 285, 4001, 7141, 1, 0, 11428, 6.82667e+06
n500x8192-slot-inner, 8192, 282, 4021, 7110, 1, 0, 11414, 6.82667e+06
n500x8192-slot-inner, 8192, 285, 3994, 6784, 1, 0, 11064, 6.82667e+06
n500x8192-slot-inner, 8192, 290, 4001, 6828, 1, 0, 11120, 6.82667e+06
n500x8192-slot-inner, 8192, 284, 4002, 7097, 1, 0, 11384, 6.82667e+06
n500x8192-slot-inner, 8192, 284, 4262, 6849, 1, 0, 11396, 6.82667e+06
n500x8192-slot-inner, 8192, 288, 4042, 6836, 1, 0, 11167, 6.82667e+06
n500x8192-slot-inner, 8192, 286, 4018, 6854, 1, 0, 11159, 6.82667e+06
n500x8192-slot-inner, 8192, 285, 4001, 6818, 1, 0, 11105, 6.82667e+06
n500x8192-slot-inner, 8192, 288, 3993, 6817, 1, 0, 11099, 6.82667e+06
n500x8192-slot-inner, 8192, 284, 4017, 6822, 1, 0, 11124, 6.82667e+06
n500x8192-slot-inner, 8192, 284, 4033, 6846, 1, 0, 11164, 6.82667e+06
n500x8192-slot-inner, 8192, 286, 3989, 7118, 1, 0, 11394, 6.82667e+06
n500x8192-slot-inner, 8192, 281, 3994, 6821, 1, 0, 11097, 6.82667e+06
n500x8192-slot-inner, 8192, 291, 4005, 6803, 1, 0, 11100, 6.82667e+06
n500x8192-slot-inner, 8192, 285, 4011, 6855, 1, 0, 11152, 6.82667e+06
n500x8192-slot-inner, 8192, 293, 4084, 7224, 1, 0, 11602, 6.82667e+06
n500x8192-slot-inner, 8192, 290, 4044, 6897, 1, 0, 11232, 6.82667e+06
n500x8192-slot-inner, 8192, 289, 4057, 6919, 1, 0, 11266, 6.82667e+06
n500x8192-slot-inner, 8192, 292, 4060, 6895, 1, 0, 11248, 6.82667e+06
n500x8192-slot-inner, 8192, 290, 4023, 6847, 1, 0, 11161, 6.82667e+06
n500x8192-slot-inner, 8192, 288, 4029, 6830, 1, 0, 11148, 6.82667e+06
n500x8192-slot-inner, 8192, 289, 4024, 6809, 1, 0, 11123, 6.82667e+06
n500x8192-slot-inner, 8192, 282, 3990, 7120, 1, 0, 11393, 6.82667e+06
n500x8192-slot-inner, 8192, 283, 4015, 6820, 1, 0, 11119, 6.82667e+06
n500x8192-slot-inner, 8192, 292, 4005, 6802, 1, 0, 11100, 6.82667e+06
n500x8192-slot-inner, 8192, 294, 3999, 7144, 1, 0, 11438, 6.82667e+06
n500x8192-slot-inner, 8192, 286, 4019, 7075, 1, 0, 11381, 6.82667e+06
n500x8192-slot-inner, 8192, 289, 4010, 6802, 1, 0, 11102, 6.82667e+06
n500x8192-slot-inner, 8192, 287, 4025, 6820, 1, 0, 11133, 6.82667e+06
n500x8192-slot-inner, 8192, 285, 4016, 7101, 1, 0, 11403, 6.82667e+06
n500x8192-slot-inner, 8192, 285, 4043, 6827, 1, 0, 11156, 6.82667e+06
n500x8192-slot-inner, 8192, 286, 4036, 6971, 1, 0, 11294, 6.82667e+06
n500x8192-slot-inner, 8192, 284, 4008, 7122, 1, 0, 11415, 6.82667e+06
n500x8192-slot-inner, 8192, 285, 4004, 6793, 1, 0, 11083, 6.82667e+06
n500x8192-slot-inner, 8192, 288, 4017, 6782, 1, 0, 11088, 6.82667e+06
n500x8192-slot-inner, 8192, 286, 4023, 6831, 1, 0, 11141, 6.82667e+06
n500x8192-slot-inner, 8192, 285, 4048, 6920, 1, 0, 11254, 6.82667e+06
n500x8192-slot-inner, 8192, 285, 4011, 6835, 1, 0, 11132, 6.82667e+06
n500x8192-slot-inner, 8192, 285, 3991, 6814, 1, 0, 11091, 6.82667e+06
n500x8192-slot-inner, 8192, 287, 4030, 6824, 1, 0, 11142, 6.82667e+06
n500x8192-slot-inner, 8192, 285, 3992, 7096, 1, 0, 11374, 6.82667e+06
n500x8192-slot-inner, 8192, 284, 4031, 6896, 1, 0, 11212, 6.82667e+06
n500x8192-slot-inner, 8192, 287, 4005, 6791, 1, 0, 11084, 6.82667e+06
n500x8192-slot-inner, 8192, 286, 4012, 6823, 1, 0, 11122, 6.82667e+06
n500x8192-slot-inner, 8192, 282, 4012, 7095, 1, 0, 11390, 6.82667e+06
n500x8192-slot-inner, 8192, 287, 3989, 6807, 1, 0, 11084, 6.82667e+06
n500x8192-slot-inner, 8192, 288, 3998, 7138, 1, 0, 11425, 6.82667e+06
n500x8192-slot-inner, 8192, 285, 4023, 6992, 1, 0, 11301, 6.82667e+06
n500x8192-slot-inner, 8192, 286, 4042, 6826, 1, 0, 11155, 6.82667e+06
n500x8192-slot-inner, 8192, 287, 4027, 6837, 1, 0, 11152, 6.82667e+06
n500x8192-slot-inner, 8192, 285, 4032, 6838, 1, 0, 11156, 6.82667e+06
n500x8192-slot-inner, 8192, 289, 4018, 6818, 1, 0, 11126, 6.82667e+06
n500x8192-slot-inner, 8192, 286, 4030, 7067, 1, 0, 11384, 6.82667e+06
n500x8192-slot-inner, 8192, 286, 3994, 7097, 1, 0, 11378, 6.82667e+06
n500x8192-slot-inner, 8192, 287, 3999, 7140, 1, 0, 11427, 6.82667e+06
n500x8192-slot-inner, 8192, 288, 4031, 6851, 1, 0, 11171, 6.82667e+06
n500x8192-slot-inner, 8192, 284, 4038, 6850, 1, 0, 11173, 6.82667e+06
n500x8192-slot-inner, 8192, 283, 4009, 6853, 1, 0, 11146, 6.82667e+06
n500x8192-slot-inner, 8192, 290, 4042, 6872, 1, 0, 11205, 6.82667e+06
n500x8192-slot-inner, 8192, 289, 4018, 6839, 1, 0, 11147, 6.82667e+06
n500x8192-slot-inner, 8192, 284, 4008, 7157, 1, 0, 11450, 6.82667e+06
n500x8192-slot-inner, 8192, 287, 4012, 7132, 1, 0, 11432, 6.82667e+06
n500x8192-slot-inner, 8192, 284, 4051, 6918, 1, 0, 11254, 6.82667e+06
n500x8192-slot-inner, 8192, 295, 4029, 6884, 1, 0, 11209, 6.82667e+06
n500x8192-slot-inner, 8192, 283, 4029, 6860, 1, 0, 11173, 6.82667e+06
n500x8192-slot-inner, 8192, 288, 4039, 6860, 1, 0, 11188, 6.82667e+06
n500x8192-slot-inner, 8192, 286, 4036, 6868, 1, 0, 11191, 6.82667e+06
n500x8192-slot-inner, 8192, 283, 4023, 7169, 1, 0, 11476, 6.82667e+06
n500x8192-slot-inner, 8192, 285, 4011, 6886, 1, 0, 11183, 6.82667e+06
n500x8192-slot-inner, 8192, 288, 4034, 6858, 1, 0, 11181, 6.82667e+06
n500x8192-slot-inner, 8192, 297, 4004, 7105, 1, 0, 11407, 6.82667e+06
n500x8192-slot-inner, 8192, 288, 3995, 6819, 1, 0, 11103, 6.82667e+06
n500x8192-slot-inner, 8192, 285, 4002, 7134, 1, 0, 11422, 6.82667e+06
n500x8192-slot-inner, 8192, 284, 4018, 6788, 1, 0, 11091, 6.82667e+06
n500x8192-slot-inner, 8192, 284, 4001, 6844, 1, 0, 11130, 6.82667e+06
n500x8192-slot-inner, 8192, 286, 4003, 6846, 1, 0, 11136, 6.82667e+06
n500x8192-slot-inner, 8192, 283, 4022, 6857, 1, 0, 11163, 6.82667e+06
n500x8192-slot-inner, 8192, 287, 4012, 7154, 1, 0, 11454, 6.82667e+06
n500x8192-slot-inner, 8192, 285, 4024, 6846, 1, 0, 11156, 6.82667e+06
n500x8192-slot-inner, 8192, 287, 4011, 7115, 1, 0, 11414, 6.82667e+06
n500x8192-slot-inner, 8192, 286, 3998, 7119, 1, 0, 11404, 6.82667e+06
n500x8192-slot-inner, 8192, 282, 3997, 6816, 1, 0, 11096, 6.82667e+06
n500x8192-slot-inner, 8192, 287, 4021, 6860, 1, 0, 11169, 6.82667e+06
n500x8192-slot-inner, 8192, 286, 4020, 6884, 1, 0, 11191, 6.82667e+06
n500x8192-slot-inner, 8192, 284, 4008, 6842, 1, 0, 11135, 6.82667e+06
n500x8192-slot-inner, 8192, 295, 4006, 7141, 1, 0, 11443, 6.82667e+06
n500x8192-slot-inner, 8192, 283, 4023, 6850, 1, 0, 11157, 6.82667e+06
n500x8192-slot-inner, 8192, 291, 4020, 6852, 1, 0, 11164, 6.82667e+06
n500x8192-slot-inner, 4096, 136, 3931, 6712, 0, 0, 10779, 6.82667e+06
n500x8192-slot-inner, 4096, 132, 3877, 6686, 0, 0, 10695, 6.82667e+06
n500x8192-slot-inner, 4096, 136, 3872, 6631, 0, 0, 10639, 6.82667e+06
n500x8192-slot-inner, 4096, 133, 3859, 6605, 0, 0, 10597, 6.82667e+06
n500x8192-slot-inner, 4096, 134, 3863, 6601, 0, 0, 10598, 6.82667e+06
n500x8192-slot-inner, 4096, 133, 3846, 6759, 0, 0, 10738, 6.82667e+06
n500x8192-slot-inner, 4096, 136, 3945, 6703, 0, 0, 10784, 6.82667e+06
n500x8192-slot-inner, 4096, 134, 3901, 6663, 0, 0, 10698, 6.82667e+06
n500x8192-slot-inner, 4096, 139, 3950, 6756, 0, 0, 10845, 6.82667e+06
n500x8192-slot-inner, 4096, 134, 3906, 6703, 0, 0, 10743, 6.82667e+06
n500x8192-slot-inner, 4096, 132, 3901, 6767, 0, 0, 10800, 6.82667e+06
n500x8192-slot-inner, 4096, 135, 3930, 6704, 0, 0, 10769, 6.82667e+06
n500x8192-slot-inner, 4096, 133, 3856, 6667, 0, 0, 10656, 6.82667e+06
n500x8192-slot-inner, 4096, 138, 3939, 6759, 0, 0, 10836, 6.82667e+06
n500x8192-slot-inner, 4096, 134, 3940, 6755, 0, 0, 10829, 6.82667e+06
n500x8192-slot-inner, 4096, 132, 3861, 6627, 0, 0, 10620, 6.82667e+06
n500x8192-slot-inner, 4096, 131, 3854, 6644, 0, 0, 10629, 6.82667e+06
n500x8192-slot-inner, 4096, 135, 3930, 6705, 0, 0, 10770, 6.82667e+06
n500x8192-slot-inner, 4096, 134, 3850, 6600, 0, 0, 10584, 6.82667e+06
n500x8192-slot-inner, 4096, 134, 3842, 6604, 0, 0, 10580, 6.82667e+06
n500x8192-slot-inner, 4096, 133, 3858, 6589, 0, 0, 10580, 6.82667e+06
n500x8192-slot-inner, 4096, 131, 3858, 6667, 0, 0, 10656, 6.82667e+06
n500x8192-slot-inner, 4096, 137, 3866, 6841, 0, 0, 10844, 6.82667e+06
n500x8192-slot-inner, 4096, 133, 3877, 6630, 0, 0, 10640, 6.82667e+06
n500x8192-slot-inner, 4096, 136, 3856, 6600, 0, 0, 10592, 6.82667e+06
n500x8192-slot-inner, 4096, 133, 3852, 6626, 0, 0, 10611, 6.82667e+06
n500x8192-slot-inner, 4096, 158, 3925, 6748, 0, 0, 10831, 6.82667e+06
n500x8192-slot-inner, 4096, 143, 3935, 6780, 0, 0, 10858, 6.82667e+06
n500x8192-slot-inner, 4096, 138, 3931, 6957, 0, 0, 11026, 6.82667e+06
n500x8192-slot-inner, 4096, 132, 3881, 6703, 0, 0, 10716, 6.82667e+06
n500x8192-slot-inner, 4096, 136, 3925, 6718, 0, 0, 10779, 6.82667e+06
n500x8192-slot-inner, 4096, 142, 3898, 6885, 0, 0, 10925, 6.82667e+06
n500x8192-slot-inner, 4096, 135, 3879, 6734, 0, 0, 10748, 6.82667e+06
n500x8192-slot-inner, 4096, 145, 3896, 6873, 0, 0, 10914, 6.82667e+06
n500x8192-slot-inner, 4096, 134, 3928, 6757, 0, 0, 10819, 6.82667e+06
n500x8192-slot-inner, 4096, 138, 3865, 6664, 0, 0, 10667, 6.82667e+06
n500x8192-slot-inner, 4096, 136, 3917, 6740, 0, 0, 10793, 6.82667e+06
n500x8192-slot-inner, 4096, 132, 3869, 6647, 0, 0, 10648, 6.82667e+06
n500x8192-slot-inner, 4096, 133, 3911, 6696, 0, 0, 10740, 6.82667e+06
n500x8192-slot-inner, 4096, 136, 3889, 6648, 0, 0, 10673, 6.82667e+06
n500x8192-slot-inner, 4096, 134, 3871, 6593, 0, 0, 10598, 6.82667e+06
n500x8192-slot-inner, 4096, 135, 3869, 6599, 0, 0, 10603, 6.82667e+06
n500x8192-slot-inner, 4096, 134, 3878, 6603, 0, 0, 10615, 6.82667e+06
n500x8192-slot-inner, 4096, 133, 3865, 6656, 0, 0, 10654, 6.82667e+06
n500x8192-slot-inner, 4096, 135, 3939, 6694, 0, 0, 10768, 6.82667e+06
n500x8192-slot-inner, 4096, 132, 3885, 6622, 0, 0, 10639, 6.82667e+06
n500x8192-slot-inner, 4096, 134, 3880, 6612, 0, 0, 10626, 6.82667e+06
n500x8192-slot-inner, 4096, 138, 3879, 6659, 0, 0, 10676, 6.82667e+06
n500x8192-slot-inner, 4096, 137, 3873, 6659, 0, 0, 10669, 6.82667e+06
n500x8192-slot-inner, 4096, 136, 3906, 6689, 0, 0, 10731, 6.82667e+06
n500x8192-slot-inner, 4096, 132, 3880, 6657, 0, 0, 10669, 6.82667e+06
n500x8192-slot-inner, 4096, 133, 3878, 6637, 0, 0, 10648, 6.82667e+06
n500x8192-slot-inner, 4096, 134, 3872, 6627, 0, 0, 10633, 6.82667e+06
n500x8192-slot-inner, 4096, 137, 3870, 6659, 0, 0, 10666, 6.82667e+06
n500x8192-slot-inner, 4096, 133, 3869, 6633, 0, 0, 10635, 6.82667e+06
n500x8192-slot-inner, 4096, 138, 3870, 6617, 0, 0, 10625, 6.82667e+06
n500x8192-slot-inner, 4096, 134, 3911, 6705, 0, 0, 10750, 6.82667e+06
n500x8192-slot-inner, 4096, 134, 3892, 6658, 0, 0, 10684, 6.82667e+06
n500x8192-slot-inner, 4096, 138, 3883, 6680, 0, 0, 10701, 6.82667e+06
n500x8192-slot-inner, 4096, 134, 3913, 6653, 0, 0, 10700, 6.82667e+06
n500x8192-slot-inner, 4096, 134, 3946, 6751, 0, 0, 10831, 6.82667e+06
n500x8192-slot-inner, 4096, 133, 3920, 6724, 0, 0, 10777, 6.82667e+06
n500x8192-slot-inner, 4096, 135, 3858, 6590, 0, 0, 10583, 6.82667e+06
n500x8192-slot-inner, 4096, 137, 3870, 6605, 0, 0, 10612, 6.82667e+06
n500x8192-slot-inner, 4096, 133, 3861, 7650, 0, 0, 11644, 6.82667e+06
n500x8192-slot-inner, 4096, 194, 4136, 7539, 0, 0, 11869, 6.82667e+06
n500x8192-slot-inner, 4096, 141, 4409, 6940, 0, 0, 11490, 6.82667e+06
n500x8192-slot-inner, 4096, 136, 4003, 7136, 0, 0, 11275, 6.82667e+06
n500x8192-slot-inner, 4096, 152, 4124, 6908, 0, 0, 11184, 6.82667e+06
n500x8192-slot-inner, 4096, 138, 3987, 7006, 0, 0, 11131, 6.82667e+06
n500x8192-slot-inner, 4096, 141, 3974, 6983, 0, 0, 11098, 6.82667e+06
n500x8192-slot-inner, 4096, 133, 3950, 6912, 0, 0, 10995, 6.82667e+06
n500x8192-slot-inner, 4096, 140, 3969, 6865, 0, 0, 10974, 6.82667e+06
n500x8192-slot-inner, 4096, 136, 3931, 7152, 0, 0, 11219, 6.82667e+06
n500x8192-slot-inner, 4096, 135, 3930, 6863, 0, 0, 10928, 6.82667e+06
n500x8192-slot-inner, 4096, 141, 3948, 7148, 0, 0, 11237, 6.82667e+06
n500x8192-slot-inner, 4096, 136, 3995, 6926, 0, 0, 11057, 6.82667e+06
n500x8192-slot-inner, 4096, 133, 3945, 6867, 0, 0, 10945, 6.82667e+06
n500x8192-slot-inner, 4096, 137, 3918, 7152, 0, 0, 11207, 6.82667e+06
n500x8192-slot-inner, 4096, 137, 3939, 7041, 0, 0, 11117, 6.82667e+06
n500x8192-slot-inner, 4096, 135, 3901, 7102, 0, 0, 11138, 6.82667e+06
n500x8192-slot-inner, 4096, 134, 3938, 6833, 0, 0, 10905, 6.82667e+06
n500x8192-slot-inner, 4096, 139, 3894, 6824, 0, 0, 10857, 6.82667e+06
n500x8192-slot-inner, 4096, 134, 3955, 6924, 0, 0, 11013, 6.82667e+06
n500x8192-slot-inner, 4096, 132, 3910, 6874, 0, 0, 10916, 6.82667e+06
n500x8192-slot-inner, 4096, 136, 3969, 6998, 0, 0, 11103, 6.82667e+06
n500x8192-slot-inner, 4096, 136, 3987, 7078, 0, 0, 11201, 6.82667e+06
n500x8192-slot-inner, 4096, 135, 3987, 7187, 0, 0, 11309, 6.82667e+06
n500x8192-slot-inner, 4096, 135, 3995, 6924, 0, 0, 11054, 6.82667e+06
n500x8192-slot-inner, 4096, 136, 3963, 6922, 0, 0, 11021, 6.82667e+06
n500x8192-slot-inner, 4096, 138, 3954, 6894, 0, 0, 10986, 6.82667e+06
n500x8192-slot-inner, 4096, 136, 3996, 6927, 0, 0, 11059, 6.82667e+06
n500x8192-slot-inner, 4096, 134, 3922, 7010, 0, 0, 11066, 6.82667e+06
n500x8192-slot-inner, 4096, 136, 4000, 6850, 0, 0, 10986, 6.82667e+06
n500x8192-slot-inner, 4096, 139, 3976, 6844, 0, 0, 10959, 6.82667e+06
n500x8192-slot-inner, 4096, 142, 3963, 6820, 0, 0, 10925, 6.82667e+06
n500x8192-slot-inner, 4096, 138, 3962, 6837, 0, 0, 10937, 6.82667e+06
n500x8192-slot-inner, 4096, 133, 3996, 6920, 0, 0, 11049, 6.82667e+06
n500x8192-slot-inner, 4096, 136, 3923, 6833, 0, 0, 10892, 6.82667e+06
n500x8192-slot-inner, 4096, 135, 4004, 6847, 0, 0, 10986, 6.82667e+06
n500x8192-slot-inner, 2048, 64, 3824, 6784, 0, 0, 10672, 6.82667e+06
n500x8192-slot-inner, 2048, 65, 3880, 6801, 0, 0, 10746, 6.82667e+06
n500x8192-slot-inner, 2048, 69, 3840, 6873, 0, 0, 10782, 6.82667e+06
n500x8192-slot-inner, 2048, 64, 3873, 6814, 0, 0, 10751, 6.82667e+06
n500x8192-slot-inner, 2048, 66, 3848, 7078, 0, 0, 10992, 6.82667e+06
n500x8192-slot-inner, 2048, 65, 3875, 6786, 0, 0, 10726, 6.82667e+06
n500x8192-slot-inner, 2048, 66, 3839, 6778, 0, 0, 10683, 6.82667e+06
n500x8192-slot-inner, 2048, 65, 3895, 6809, 0, 0, 10769, 6.82667e+06
n500x8192-slot-inner, 2048, 64, 3823, 6809, 0, 0, 10696, 6.82667e+06
n500x8192-slot-inner, 2048, 64, 3887, 6770, 0, 0, 10721, 6.82667e+06
n500x8192-slot-inner, 2048, 66, 3908, 7025, 0, 0, 10999, 6.82667e+06
n500x8192-slot-inner, 2048, 64, 3894, 6734, 0, 0, 10692, 6.82667e+06
n500x8192-slot-inner, 2048, 67, 3894, 6819, 0, 0, 10780, 6.82667e+06
n500x8192-slot-inner, 2048, 66, 3906, 6925, 0, 0, 10897, 6.82667e+06
n500x8192-slot-inner, 2048, 64, 3832, 7013, 0, 0, 10909, 6.82667e+06
n500x8192-slot-inner, 2048, 64, 3868, 6838, 0, 0, 10770, 6.82667e+06
n500x8192-slot-inner, 2048, 75, 4641, 7094, 0, 0, 11810, 6.82667e+06
n500x8192-slot-inner, 2048, 66, 3915, 6937, 0, 0, 10918, 6.82667e+06
n500x8192-slot-inner, 2048, 74, 4352, 7030, 0, 0, 11456, 6.82667e+06
n500x8192-slot-inner, 2048, 64, 3927, 6919, 0, 0, 10910, 6.82667e+06
n500x8192-slot-inner, 2048, 64, 3850, 6969, 0, 0, 10883, 6.82667e+06
n500x8192-slot-inner, 2048, 65, 3838, 6772, 0, 0, 10675, 6.82667e+06
n500x8192-slot-inner, 2048, 65, 3913, 6819, 0, 0, 10797, 6.82667e+06
n500x8192-slot-inner, 2048, 65, 3869, 6843, 0, 0, 10777, 6.82667e+06
n500x8192-slot-inner, 2048, 68, 3825, 6781, 0, 0, 10674, 6.82667e+06
n500x8192-slot-inner, 2048, 70, 3863, 6839, 0, 0, 10772, 6.82667e+06
n500x8192-slot-inner, 2048, 64, 3859, 6783, 0, 0, 10706, 6.82667e+06
n500x8192-slot-inner, 2048, 64, 3837, 6795, 0, 0, 10696, 6.82667e+06
n500x8192-slot-inner, 2048, 68, 3859, 6785, 0, 0, 10712, 6.82667e+06
n500x8192-slot-inner, 2048, 64, 3858, 6872, 0, 0, 10794, 6.82667e+06
n500x8192-slot-inner, 2048, 65, 3876, 7074, 0, 0, 11015, 6.82667e+06
n500x8192-slot-inner, 2048, 64, 3857, 6799, 0, 0, 10720, 6.82667e+06
n500x8192-slot-inner, 2048, 63, 3821, 6774, 0, 0, 10658, 6.82667e+06
n500x8192-slot-inner, 2048, 64, 3838, 6755, 0, 0, 10657, 6.82667e+06
n500x8192-slot-inner, 2048, 67, 3839, 6797, 0, 0, 10703, 6.82667e+06
n500x8192-slot-inner, 2048, 65, 3853, 6784, 0, 0, 10702, 6.82667e+06
n500x8192-slot-inner, 2048, 64, 3892, 6798, 0, 0, 10754, 6.82667e+06
n500x8192-slot-inner, 2048, 65, 3877, 6831, 0, 0, 10773, 6.82667e+06
n500x8192-slot-inner, 2048, 64, 3832, 6724, 0, 0, 10620, 6.82667e+06
n500x8192-slot-inner, 2048, 64, 3824, 6787, 0, 0, 10675, 6.82667e+06
n500x8192-slot-inner, 2048, 63, 3902, 6871, 0, 0, 10836, 6.82667e+06
n500x8192-slot-inner, 2048, 65, 3889, 6883, 0, 0, 10837, 6.82667e+06
n500x8192-slot-inner, 2048, 65, 3841, 6826, 0, 0, 10732, 6.82667e+06
n500x8192-slot-inner, 2048, 65, 3860, 7281, 0, 0, 11206, 6.82667e+06
n500x8192-slot-inner, 2048, 64, 3961, 6800, 0, 0, 10825, 6.82667e+06
n500x8192-slot-inner, 2048, 64, 3855, 6791, 0, 0, 10710, 6.82667e+06
n500x8192-slot-inner, 2048, 70, 3957, 6824, 0, 0, 10851, 6.82667e+06
n500x8192-slot-inner, 2048, 68, 3847, 6736, 0, 0, 10651, 6.82667e+06
n500x8192-slot-inner, 2048, 64, 3862, 6792, 0, 0, 10718, 6.82667e+06
n500x8192-slot-inner, 2048, 65, 3855, 6785, 0, 0, 10705, 6.82667e+06
n500x8192-slot-inner, 2048, 64, 3832, 6829, 0, 0, 10725, 6.82667e+06
n500x8192-slot-inner, 2048, 66, 3853, 6824, 0, 0, 10743, 6.82667e+06
n500x8192-slot-inner, 2048, 64, 3862, 6838, 0, 0, 10764, 6.82667e+06
n500x8192-slot-inner, 2048, 64, 3856, 6842, 0, 0, 10762, 6.82667e+06
n500x8192-slot-inner, 2048, 65, 3827, 6773, 0, 0, 10665, 6.82667e+06
n500x8192-slot-inner, 2048, 69, 3837, 7080, 0, 0, 10986, 6.82667e+06
n500x8192-slot-inner, 2048, 68, 3827, 6786, 0, 0, 10681, 6.82667e+06
n500x8192-slot-inner, 2048, 67, 3995, 6804, 0, 0, 10866, 6.82667e+06
n500x8192-slot-inner, 2048, 69, 3841, 6749, 0, 0, 10659, 6.82667e+06
n500x8192-slot-inner, 2048, 65, 3814, 6762, 0, 0, 10641, 6.82667e+06
n500x8192-slot-inner, 2048, 69, 3829, 7085, 0, 0, 10983, 6.82667e+06
n500x8192-slot-inner, 2048, 65, 4027, 6925, 0, 0, 11017, 6.82667e+06
n500x8192-slot-inner, 2048, 63, 3860, 6813, 0, 0, 10736, 6.82667e+06
n500x8192-slot-inner, 2048, 64, 3827, 6783, 0, 0, 10674, 6.82667e+06
n500x8192-slot-inner, 2048, 67, 3899, 6772, 0, 0, 10738, 6.82667e+06
n500x8192-slot-inner, 2048, 65, 3812, 7017, 0, 0, 10894, 6.82667e+06
n500x8192-slot-inner, 2048, 64, 3834, 6750, 0, 0, 10648, 6.82667e+06
n500x8192-slot-inner, 2048, 66, 3909, 6956, 0, 0, 10931, 6.82667e+06
n500x8192-slot-inner, 2048, 65, 3892, 6891, 0, 0, 10848, 6.82667e+06
n500x8192-slot-inner, 2048, 65, 3897, 6899, 0, 0, 10861, 6.82667e+06
n500x8192-slot-inner, 2048, 70, 3897, 7175, 0, 0, 11142, 6.82667e+06
n500x8192-slot-inner, 2048, 64, 3829, 6830, 0, 0, 10723, 6.82667e+06
n500x8192-slot-inner, 2048, 65, 3831, 7142, 0, 0, 11038, 6.82667e+06
n500x8192-slot-inner, 2048, 66, 3917, 6866, 0, 0, 10849, 6.82667e+06
n500x8192-slot-inner, 2048, 65, 3885, 6845, 0, 0, 10795, 6.82667e+06
n500x8192-slot-inner, 2048, 65, 3871, 6808, 0, 0, 10744, 6.82667e+06
n500x8192-slot-inner, 2048, 65, 3809, 6769, 0, 0, 10643, 6.82667e+06
n500x8192-slot-inner, 2048, 63, 3820, 6996, 0, 0, 10879, 6.82667e+06
n500x8192-slot-inner, 2048, 64, 3858, 6807, 0, 0, 10729, 6.82667e+06
n500x8192-slot-inner, 2048, 64, 3801, 6761, 0, 0, 10626, 6.82667e+06
n500x8192-slot-inner, 2048, 67, 3830, 6794, 0, 0, 10691, 6.82667e+06
n500x8192-slot-inner, 2048, 66, 3869, 6746, 0, 0, 10681, 6.82667e+06
n500x8192-slot-inner, 2048, 63, 3836, 6774, 0, 0, 10673, 6.82667e+06
n500x8192-slot-inner, 2048, 64, 3855, 6815, 0, 0, 10734, 6.82667e+06
n500x8192-slot-inner, 2048, 64, 3873, 7181, 0, 0, 11118, 6.82667e+06
n500x8192-slot-inner, 2048, 65, 3969, 6814, 0, 0, 10848, 6.82667e+06
n500x8192-slot-inner, 2048, 65, 3823, 6775, 0, 0, 10663, 6.82667e+06
n500x8192-slot-inner, 2048, 64, 3820, 6762, 0, 0, 10646, 6.82667e+06
n500x8192-slot-inner, 2048, 65, 3862, 7502, 0, 0, 11429, 6.82667e+06
n500x8192-slot-inner, 2048, 77, 5133, 7519, 0, 0, 12729, 6.82667e+06
n500x8192-slot-inner, 2048, 68, 3870, 6844, 0, 0, 10782, 6.82667e+06
n500x8192-slot-inner, 2048, 65, 4352, 6849, 0, 0, 11266, 6.82667e+06
n500x8192-slot-inner, 2048, 65, 3842, 6816, 0, 0, 10723, 6.82667e+06
n500x8192-slot-inner, 2048, 65, 3833, 6807, 0, 0, 10705, 6.82667e+06
n500x8192-slot-inner, 2048, 69, 3854, 6894, 0, 0, 10817, 6.82667e+06
n500x8192-slot-inner, 2048, 63, 3822, 6810, 0, 0, 10695, 6.82667e+06
n500x8192-slot-inner, 2048, 64, 3885, 6886, 0, 0, 10835, 6.82667e+06
n500x8192-slot-inner, 2048, 64, 3829, 6839, 0, 0, 10732, 6.82667e+06
n500x8192-slot-inner, 2048, 63, 3855, 6829, 0, 0, 10747, 6.82667e+06
n500x8192-slot-inner, 2048, 64, 3907, 6836, 0, 0, 10807, 6.82667e+06
n500x8192-slot-inner, 1024, 35, 3864, 7012, 0, 0, 10911, 6.82667e+06
n500x8192-slot-inner, 1024, 34, 3844, 7110, 0, 0, 10988, 6.82667e+06
n500x8192-slot-inner, 1024, 35, 3907, 7128, 0, 0, 11070, 6.82667e+06
n500x8192-slot-inner, 1024, 34, 3915, 7120, 0, 0, 11069, 6.82667e+06
n500x8192-slot-inner, 1024, 34, 3908, 7132, 0, 0, 11074, 6.82667e+06
n500x8192-slot-inner, 1024, 34, 3892, 7293, 0, 0, 11219, 6.82667e+06
n500x8192-slot-inner, 1024, 34, 3889, 7123, 0, 0, 11046, 6.82667e+06
n500x8192-slot-inner, 1024, 34, 3893, 7176, 0, 0, 11103, 6.82667e+06
n500x8192-slot-inner, 1024, 35, 3873, 7083, 0, 0, 10991, 6.82667e+06
n500x8192-slot-inner, 1024, 34, 3868, 7164, 0, 0, 11066, 6.82667e+06
n500x8192-slot-inner, 1024, 34, 3911, 7209, 0, 0, 11154, 6.82667e+06
n500x8192-slot-inner, 1024, 40, 3843, 7104, 0, 0, 10987, 6.82667e+06
n500x8192-slot-inner, 1024, 34, 3849, 7728, 0, 0, 11611, 6.82667e+06
n500x8192-slot-inner, 1024, 38, 3855, 7104, 0, 0, 10997, 6.82667e+06
n500x8192-slot-inner, 1024, 35, 3871, 7143, 0, 0, 11049, 6.82667e+06
n500x8192-slot-inner, 1024, 34, 3900, 7208, 0, 0, 11142, 6.82667e+06
n500x8192-slot-inner, 1024, 34, 3929, 7275, 0, 0, 11238, 6.82667e+06
n500x8192-slot-inner, 1024, 36, 3872, 7210, 0, 0, 11118, 6.82667e+06
n500x8192-slot-inner, 1024, 34, 3847, 7123, 0, 0, 11004, 6.82667e+06
n500x8192-slot-inner, 1024, 34, 3855, 7128, 0, 0, 11017, 6.82667e+06
n500x8192-slot-inner, 1024, 34, 3874, 7273, 0, 0, 11181, 6.82667e+06
n500x8192-slot-inner, 1024, 34, 3941, 7250, 0, 0, 11225, 6.82667e+06
n500x8192-slot-inner, 1024, 35, 4023, 7174, 0, 0, 11232, 6.82667e+06
n500x8192-slot-inner, 1024, 34, 3918, 7210, 0, 0, 11162, 6.82667e+06
n500x8192-slot-inner, 1024, 35, 3903, 7216, 0, 0, 11154, 6.82667e+06
n500x8192-slot-inner, 1024, 35, 3858, 7182, 0, 0, 11075, 6.82667e+06
n500x8192-slot-inner, 1024, 35, 3862, 7251, 0, 0, 11148, 6.82667e+06
n500x8192-slot-inner, 1024, 33, 3881, 7119, 0, 0, 11033, 6.82667e+06
n500x8192-slot-inner, 1024, 35, 3868, 7136, 0, 0, 11039, 6.82667e+06
n500x8192-slot-inner, 1024, 34, 3856, 7133, 0, 0, 11023, 6.82667e+06
n500x8192-slot-inner, 1024, 34, 3850, 7352, 0, 0, 11236, 6.82667e+06
n500x8192-slot-inner, 1024, 34, 3881, 7180, 0, 0, 11095, 6.82667e+06
n500x8192-slot-inner, 1024, 34, 3821, 7110, 0, 0, 10965, 6.82667e+06
n500x8192-slot-inner, 1024, 34, 4281, 7750, 0, 0, 12065, 6.82667e+06
n500x8192-slot-inner, 1024, 39, 4334, 7351, 0, 0, 11724, 6.82667e+06
n500x8192-slot-inner, 1024, 39, 3901, 7464, 0, 0, 11404, 6.82667e+06
n500x8192-slot-inner, 1024, 34, 3940, 7237, 0, 0, 11211, 6.82667e+06
n500x8192-slot-inner, 1024, 34, 3932, 7200, 0, 0, 11166, 6.82667e+06
n500x8192-slot-inner, 1024, 34, 3887, 7156, 0, 0, 11077, 6.82667e+06
n500x8192-slot-inner, 1024, 35, 3859, 7170, 0, 0, 11064, 6.82667e+06
n500x8192-slot-inner, 1024, 33, 3872, 7099, 0, 0, 11004, 6.82667e+06
n500x8192-slot-inner, 1024, 40, 3878, 7236, 0, 0, 11154, 6.82667e+06
n500x8192-slot-inner, 1024, 39, 3889, 7157, 0, 0, 11085, 6.82667e+06
n500x8192-slot-inner, 1024, 35, 3901, 7125, 0, 0, 11061, 6.82667e+06
n500x8192-slot-inner, 1024, 34, 3897, 7175, 0, 0, 11106, 6.82667e+06
n500x8192-slot-inner, 1024, 36, 3898, 7167, 0, 0, 11101, 6.82667e+06
n500x8192-slot-inner, 1024, 34, 3867, 7366, 0, 0, 11267, 6.82667e+06
n500x8192-slot-inner, 1024, 35, 3970, 7336, 0, 0, 11341, 6.82667e+06
n500x8192-slot-inner, 1024, 35, 4010, 7231, 0, 0, 11276, 6.82667e+06
n500x8192-slot-inner, 1024, 34, 3891, 7164, 0, 0, 11089, 6.82667e+06
n500x8192-slot-inner, 1024, 34, 3864, 7072, 0, 0, 10970, 6.82667e+06
n500x8192-slot-inner, 1024, 37, 3911, 7382, 0, 0, 11330, 6.82667e+06
n500x8192-slot-inner, 1024, 34, 3922, 7097, 0, 0, 11053, 6.82667e+06
n500x8192-slot-inner, 1024, 40, 3828, 7273, 0, 0, 11141, 6.82667e+06
n500x8192-slot-inner, 1024, 34, 3882, 7068, 0, 0, 10984, 6.82667e+06
n500x8192-slot-inner, 1024, 35, 3985, 7250, 0, 0, 11270, 6.82667e+06
n500x8192-slot-inner, 1024, 38, 3886, 7275, 0, 0, 11199, 6.82667e+06
n500x8192-slot-inner, 1024, 35, 3934, 7065, 0, 0, 11034, 6.82667e+06
n500x8192-slot-inner, 1024, 34, 3874, 7222, 0, 0, 11130, 6.82667e+06
n500x8192-slot-inner, 1024, 34, 3903, 7062, 0, 0, 10999, 6.82667e+06
n500x8192-slot-inner, 1024, 37, 3874, 7271, 0, 0, 11182, 6.82667e+06
n500x8192-slot-inner, 1024, 38, 3828, 7277, 0, 0, 11143, 6.82667e+06
n500x8192-slot-inner, 1024, 34, 3901, 7098, 0, 0, 11033, 6.82667e+06
n500x8192-slot-inner, 1024, 34, 3865, 7078, 0, 0, 10977, 6.82667e+06
n500x8192-slot-inner, 1024, 35, 3885, 7153, 0, 0, 11073, 6.82667e+06
n500x8192-slot-inner, 1024, 40, 3918, 7301, 0, 0, 11259, 6.82667e+06
n500x8192-slot-inner, 1024, 33, 3865, 7113, 0, 0, 11011, 6.82667e+06
n500x8192-slot-inner, 1024, 36, 3904, 7081, 0, 0, 11021, 6.82667e+06
n500x8192-slot-inner, 1024, 35, 3915, 7081, 0, 0, 11031, 6.82667e+06
n500x8192-slot-inner, 1024, 35, 3899, 7229, 0, 0, 11163, 6.82667e+06
n500x8192-slot-inner, 1024, 35, 3904, 7229, 0, 0, 11168, 6.82667e+06
n500x8192-slot-inner, 1024, 35, 3846, 7079, 0, 0, 10960, 6.82667e+06
n500x8192-slot-inner, 1024, 34, 3875, 7074, 0, 0, 10983, 6.82667e+06
n500x8192-slot-inner, 1024, 35, 3981, 7175, 0, 0, 11191, 6.82667e+06
n500x8192-slot-inner, 1024, 34, 3876, 7072, 0, 0, 10982, 6.82667e+06
n500x8192-slot-inner, 1024, 34, 3846, 6990, 0, 0, 10870, 6.82667e+06
n500x8192-slot-inner, 1024, 34, 3870, 7190, 0, 0, 11094, 6.82667e+06
n500x8192-slot-inner, 1024, 34, 3875, 7184, 0, 0, 11093, 6.82667e+06
n500x8192-slot-inner, 1024, 34, 3877, 7433, 0, 0, 11344, 6.82667e+06
n500x8192-slot-inner, 1024, 34, 3963, 7298, 0, 0, 11295, 6.82667e+06
n500x8192-slot-inner, 1024, 33, 3905, 7082, 0, 0, 11020, 6.82667e+06
n500x8192-slot-inner, 1024, 33, 3864, 7136, 0, 0, 11033, 6.82667e+06
n500x8192-slot-inner, 1024, 36, 3936, 7277, 0, 0, 11249, 6.82667e+06
n500x8192-slot-inner, 1024, 33, 3859, 7172, 0, 0, 11064, 6.82667e+06
n500x8192-slot-inner, 1024, 36, 3913, 7282, 0, 0, 11231, 6.82667e+06
n500x8192-slot-inner, 1024, 35, 3899, 7190, 0, 0, 11124, 6.82667e+06
n500x8192-slot-inner, 1024, 34, 3883, 7217, 0, 0, 11134, 6.82667e+06
n500x8192-slot-inner, 1024, 34, 3883, 7365, 0, 0, 11282, 6.82667e+06
n500x8192-slot-inner, 1024, 35, 3906, 7419, 0, 0, 11360, 6.82667e+06
n500x8192-slot-inner, 1024, 34, 4130, 7322, 0, 0, 11486, 6.82667e+06
n500x8192-slot-inner, 1024, 37, 3887, 7341, 0, 0, 11265, 6.82667e+06
n500x8192-slot-inner, 1024, 35, 3936, 7260, 0, 0, 11231, 6.82667e+06
n500x8192-slot-inner, 1024, 37, 3859, 7154, 0, 0, 11050, 6.82667e+06
n500x8192-slot-inner, 1024, 34, 3868, 7096, 0, 0, 10998, 6.82667e+06
n500x8192-slot-inner, 1024, 35, 3881, 7125, 0, 0, 11041, 6.82667e+06
n500x8192-slot-inner, 1024, 34, 3860, 7155, 0, 0, 11049, 6.82667e+06
n500x8192-slot-inner, 1024, 34, 3863, 7089, 0, 0, 10986, 6.82667e+06
n500x8192-slot-inner, 1024, 33, 3839, 7046, 0, 0, 10918, 6.82667e+06
n500x8192-slot-inner, 1024, 34, 3923, 7108, 0, 0, 11065, 6.82667e+06
n500x8192-slot-inner, 1024, 34, 3899, 7124, 0, 0, 11057, 6.82667e+06
n500x8192-coef-inner, 8192, 57, 13896, 7343, 1, 0, 21297, 6.82667e+06
n500x8192-coef-inner, 8192, 50, 13880, 7000, 1, 0, 20931, 6.82667e+06
n500x8192-coef-inner, 8192, 50, 13894, 7614, 1, 0, 21559, 6.82667e+06
n500x8192-coef-inner, 8192, 53, 14130, 7324, 1, 0, 21508, 6.82667e+06
n500x8192-coef-inner, 8192, 53, 14282, 7374, 1, 0, 21710, 6.82667e+06
n500x8192-coef-inner, 8192, 52, 14088, 7092, 1, 0, 21233, 6.82667e+06
n500x8192-coef-inner, 8192, 51, 14094, 7334, 1, 0, 21480, 6.82667e+06
n500x8192-coef-inner, 8192, 51, 14031, 6997, 1, 0, 21080, 6.82667e+06
n500x8192-coef-inner, 8192, 53, 14031, 7307, 1, 0, 21392, 6.82667e+06
n500x8192-coef-inner, 8192, 55, 13978, 7314, 1, 0, 21348, 6.82667e+06
n500x8192-coef-inner, 8192, 52, 14034, 7001, 1, 0, 21088, 6.82667e+06
n500x8192-coef-inner, 8192, 55, 14181, 7078, 1, 0, 21315, 6.82667e+06
n500x8192-coef-inner, 8192, 53, 13766, 6840, 1, 0, 20660, 6.82667e+06
n500x8192-coef-inner, 8192, 67, 13782, 6916, 1, 0, 20766, 6.82667e+06
n500x8192-coef-inner, 8192, 51, 13807, 6869, 1, 0, 20728, 6.82667e+06
n500x8192-coef-inner, 8192, 54, 13912, 6843, 1, 0, 20810, 6.82667e+06
n500x8192-coef-inner, 8192, 51, 13797, 7005, 1, 0, 20854, 6.82667e+06
n500x8192-coef-inner, 8192, 52, 13789, 6816, 1, 0, 20658, 6.82667e+06
n500x8192-coef-inner, 8192, 54, 13706, 7096, 1, 0, 20857, 6.82667e+06
n500x8192-coef-inner, 8192, 51, 13772, 7075, 1, 0, 20899, 6.82667e+06
n500x8192-coef-inner, 8192, 53, 13799, 6841, 1, 0, 20694, 6.82667e+06
n500x8192-coef-inner, 8192, 51, 13816, 6818, 1, 0, 20686, 6.82667e+06
n500x8192-coef-inner, 8192, 53, 13743, 6812, 1, 0, 20609, 6.82667e+06
n500x8192-coef-inner, 8192, 51, 13864, 6849, 1, 0, 20765, 6.82667e+06
n500x8192-coef-inner, 8192, 54, 13861, 6892, 1, 0, 20808, 6.82667e+06
n500x8192-coef-inner, 8192, 60, 13739, 6846, 1, 0, 20646, 6.82667e+06
n500x8192-coef-inner, 8192, 53, 13723, 6790, 1, 0, 20567, 6.82667e+06
n500x8192-coef-inner, 8192, 50, 13708, 6850, 1, 0, 20609, 6.82667e+06
n500x8192-coef-inner, 8192, 53, 13735, 6817, 1, 0, 20606, 6.82667e+06
n500x8192-coef-inner, 8192, 52, 13727, 7098, 1, 0, 20878, 6.82667e+06
n500x8192-coef-inner, 8192, 57, 13761, 6817, 1, 0, 20636, 6.82667e+06
n500x8192-coef-inner, 8192, 54, 13706, 7107, 1, 0, 20868, 6.82667e+06
n500x8192-coef-inner, 8192, 50, 13939, 6952, 1, 0, 20942, 6.82667e+06
n500x8192-coef-inner, 8192, 51, 13938, 6848, 1, 0, 20838, 6.82667e+06
n500x8192-coef-inner, 8192, 51, 13745, 7116, 1, 0, 20913, 6.82667e+06
n500x8192-coef-inner, 8192, 50, 13865, 6862, 1, 0, 20778, 6.82667e+06
n500x8192-coef-inner, 8192, 53, 13830, 6828, 1, 0, 20712, 6.82667e+06
n500x8192-coef-inner, 8192, 53, 13800, 6825, 1, 0, 20679, 6.82667e+06
n500x8192-coef-inner, 8192, 50, 13815, 6858, 1, 0, 20724, 6.82667e+06
n500x8192-coef-inner, 8192, 53, 13747, 6966, 1, 0, 20767, 6.82667e+06
n500x8192-coef-inner, 8192, 53, 13754, 6843, 1, 0, 20651, 6.82667e+06
n500x8192-coef-inner, 8192, 59, 13719, 6809, 1, 0, 20588, 6.82667e+06
n500x8192-coef-inner, 8192, 55, 13784, 6825, 1, 0, 20665, 6.82667e+06
n500x8192-coef-inner, 8192, 52, 13782, 6836, 1, 0, 20671, 6.82667e+06
n500x8192-coef-inner, 8192, 52, 13786, 6858, 1, 0, 20697, 6.82667e+06
n500x8192-coef-inner, 8192, 51, 13732, 7116, 1, 0, 20900, 6.82667e+06
n500x8192-coef-inner, 8192, 50, 13732, 6826, 1, 0, 20609, 6.82667e+06
n500x8192-coef-inner, 8192, 51, 13793, 6864, 1, 0, 20709, 6.82667e+06
n500x8192-coef-inner, 8192, 54, 13764, 7123, 1, 0, 20942, 6.82667e+06
n500x8192-coef-inner, 8192, 54, 13843, 6826, 1, 0, 20724, 6.82667e+06
n500x8192-coef-inner, 8192, 51, 13735, 6821, 1, 0, 20608, 6.82667e+06
n500x8192-coef-inner, 8192, 50, 13834, 6833, 1, 0, 20718, 6.82667e+06
n500x8192-coef-inner, 8192, 50, 13706, 6838, 1, 0, 20595, 6.82667e+06
n500x8192-coef-inner, 8192, 54, 13773, 6985, 1, 0, 20813, 6.82667e+06
n500x8192-coef-inner, 8192, 51, 13733, 6823, 1, 0, 20608, 6.82667e+06
n500x8192-coef-inner, 8192, 59, 13743, 6810, 1, 0, 20613, 6.82667e+06
n500x8192-coef-inner, 8192, 57, 13870, 7128, 1, 0, 21056, 6.82667e+06
n500x8192-coef-inner, 8192, 52, 13930, 6896, 1, 0, 20879, 6.82667e+06
n500x8192-coef-inner, 8192, 62, 13736, 7087, 1, 0, 20886, 6.82667e+06
n500x8192-coef-inner, 8192, 53, 13746, 6782, 1, 0, 20582, 6.82667e+06
n500x8192-coef-inner, 8192, 54, 13794, 6817, 1, 0, 20666, 6.82667e+06
n500x8192-coef-inner, 8192, 50, 13746, 6853, 1, 0, 20650, 6.82667e+06
n500x8192-coef-inner, 8192, 52, 13798, 6841, 1, 0, 20692, 6.82667e+06
n500x8192-coef-inner, 8192, 50, 13809, 6832, 1, 0, 20692, 6.82667e+06
n500x8192-coef-inner, 8192, 58, 13727, 7109, 1, 0, 20895, 6.82667e+06
n500x8192-coef-inner, 8192, 52, 13754, 6799, 1, 0, 20606, 6.82667e+06
n500x8192-coef-inner, 8192, 52, 13784, 6799, 1, 0, 20636, 6.82667e+06
n500x8192-coef-inner, 8192, 50, 13727, 6786, 1, 0, 20564, 6.82667e+06
n500x8192-coef-inner, 8192, 51, 13804, 6813, 1, 0, 20669, 6.82667e+06
n500x8192-coef-inner, 8192, 55, 13755, 6770, 1, 0, 20581, 6.82667e+06
n500x8192-coef-inner, 8192, 50, 13724, 6801, 1, 0, 20576, 6.82667e+06
n500x8192-coef-inner, 8192, 53, 13718, 6794, 1, 0, 20566, 6.82667e+06
n500x8192-coef-inner, 8192, 52, 13791, 6785, 1, 0, 20629, 6.82667e+06
n500x8192-coef-inner, 8192, 51, 13746, 6815, 1, 0, 20613, 6.82667e+06
n500x8192-coef-inner, 8192, 52, 13732, 6813, 1, 0, 20598, 6.82667e+06
n500x8192-coef-inner, 8192, 51, 13797, 6843, 1, 0, 20692, 6.82667e+06
n500x8192-coef-inner, 8192, 50, 13860, 6872, 1, 0, 20783, 6.82667e+06
n500x8192-coef-inner, 8192, 52, 13716, 7124, 1, 0, 20893, 6.82667e+06
n500x8192-coef-inner, 8192, 51, 13800, 6825, 1, 0, 20677, 6.82667e+06
n500x8192-coef-inner, 8192, 53, 13817, 6834, 1, 0, 20705, 6.82667e+06
n500x8192-coef-inner, 8192, 54, 13799, 6836, 1, 0, 20690, 6.82667e+06
n500x8192-coef-inner, 8192, 50, 13694, 7073, 1, 0, 20818, 6.82667e+06
n500x8192-coef-inner, 8192, 54, 13721, 6801, 1, 0, 20577, 6.82667e+06
n500x8192-coef-inner, 8192, 53, 13816, 6824, 1, 0, 20694, 6.82667e+06
n500x8192-coef-inner, 8192, 51, 13694, 6811, 1, 0, 20557, 6.82667e+06
n500x8192-coef-inner, 8192, 51, 13780, 7083, 1, 0, 20915, 6.82667e+06
n500x8192-coef-inner, 8192, 51, 13746, 6844, 1, 0, 20642, 6.82667e+06
n500x8192-coef-inner, 8192, 53, 13957, 6836, 1, 0, 20847, 6.82667e+06
n500x8192-coef-inner, 8192, 54, 13689, 6816, 1, 0, 20560, 6.82667e+06
n500x8192-coef-inner, 8192, 54, 13822, 6815, 1, 0, 20692, 6.82667e+06
n500x8192-coef-inner, 8192, 52, 13782, 6860, 1, 0, 20695, 6.82667e+06
n500x8192-coef-inner, 8192, 50, 13779, 6832, 1, 0, 20662, 6.82667e+06
n500x8192-coef-inner, 8192, 54, 13743, 6821, 1, 0, 20619, 6.82667e+06
n500x8192-coef-inner, 8192, 53, 13797, 6922, 1, 0, 20773, 6.82667e+06
n500x8192-coef-inner, 8192, 54, 13688, 6767, 1, 0, 20510, 6.82667e+06
n500x8192-coef-inner, 8192, 53, 13703, 6794, 1, 0, 20551, 6.82667e+06
n500x8192-coef-inner, 8192, 50, 14479, 7104, 1, 0, 21634, 6.82667e+06
n500x8192-coef-inner, 8192, 53, 13739, 6810, 1, 0, 20603, 6.82667e+06
n500x8192-coef-inner, 8192, 52, 13716, 6826, 1, 0, 20595, 6.82667e+06
n500x8192-coef-inner, 8192, 51, 13849, 6856, 1, 0, 20757, 6.82667e+06
n500x8192-coef-inner, 4096, 31, 13721, 6692, 0, 0, 20444, 6.82667e+06
n500x8192-coef-inner, 4096, 28, 13687, 6666, 0, 0, 20381, 6.82667e+06
n500x8192-coef-inner, 4096, 31, 13667, 6829, 0, 0, 20527, 6.82667e+06
n500x8192-coef-inner, 4096, 27, 13627, 6875, 0, 0, 20529, 6.82667e+06
n500x8192-coef-inner, 4096, 27, 13636, 6669, 0, 0, 20332, 6.82667e+06
n500x8192-coef-inner, 4096, 31, 13622, 6854, 0, 0, 20507, 6.82667e+06
n500x8192-coef-inner, 4096, 28, 13671, 6620, 0, 0, 20319, 6.82667e+06
n500x8192-coef-inner, 4096, 30, 13664, 6664, 0, 0, 20358, 6.82667e+06
n500x8192-coef-inner, 4096, 31, 13606, 6925, 0, 0, 20562, 6.82667e+06
n500x8192-coef-inner, 4096, 38, 13602, 6676, 0, 0, 20316, 6.82667e+06
n500x8192-coef-inner, 4096, 28, 13654, 6726, 0, 0, 20408, 6.82667e+06
n500x8192-coef-inner, 4096, 31, 13646, 6683, 0, 0, 20360, 6.82667e+06
n500x8192-coef-inner, 4096, 30, 13709, 6666, 0, 0, 20405, 6.82667e+06
n500x8192-coef-inner, 4096, 29, 13631, 6726, 0, 0, 20386, 6.82667e+06
n500x8192-coef-inner, 4096, 30, 13636, 6948, 0, 0, 20614, 6.82667e+06
n500x8192-coef-inner, 4096, 28, 13603, 6898, 0, 0, 20529, 6.82667e+06
n500x8192-coef-inner, 4096, 28, 13650, 6752, 0, 0, 20430, 6.82667e+06
n500x8192-coef-inner, 4096, 27, 13693, 6671, 0, 0, 20391, 6.82667e+06
n500x8192-coef-inner, 4096, 27, 13590, 6670, 0, 0, 20287, 6.82667e+06
n500x8192-coef-inner, 4096, 28, 13674, 6651, 0, 0, 20353, 6.82667e+06
n500x8192-coef-inner, 4096, 32, 13738, 6724, 0, 0, 20494, 6.82667e+06
n500x8192-coef-inner, 4096, 27, 13657, 6677, 0, 0, 20361, 6.82667e+06
n500x8192-coef-inner, 4096, 29, 13634, 6650, 0, 0, 20313, 6.82667e+06
n500x8192-coef-inner, 4096, 27, 13653, 6667, 0, 0, 20347, 6.82667e+06
n500x8192-coef-inner, 4096, 27, 13611, 6663, 0, 0, 20301, 6.82667e+06
n500x8192-coef-inner, 4096, 31, 13790, 6708, 0, 0, 20529, 6.82667e+06
n500x8192-coef-inner, 4096, 27, 13607, 6633, 0, 0, 20267, 6.82667e+06
n500x8192-coef-inner, 4096, 31, 13603, 6655, 0, 0, 20289, 6.82667e+06
n500x8192-coef-inner, 4096, 28, 13673, 6935, 0, 0, 20636, 6.82667e+06
n500x8192-coef-inner, 4096, 27, 13631, 6669, 0, 0, 20327, 6.82667e+06
n500x8192-coef-inner, 4096, 29, 13692, 6693, 0, 0, 20414, 6.82667e+06
n500x8192-coef-inner, 4096, 33, 13700, 6836, 0, 0, 20569, 6.82667e+06
n500x8192-coef-inner, 4096, 28, 13604, 6662, 0, 0, 20294, 6.82667e+06
n500x8192-coef-inner, 4096, 29, 13713, 6704, 0, 0, 20446, 6.82667e+06
n500x8192-coef-inner, 4096, 27, 13613, 6590, 0, 0, 20230, 6.82667e+06
n500x8192-coef-inner, 4096, 29, 13625, 6941, 0, 0, 20595, 6.82667e+06
n500x8192-coef-inner, 4096, 29, 13657, 6690, 0, 0, 20376, 6.82667e+06
n500x8192-coef-inner, 4096, 30, 13695, 6705, 0, 0, 20430, 6.82667e+06
n500x8192-coef-inner, 4096, 27, 13598, 6655, 0, 0, 20280, 6.82667e+06
n500x8192-coef-inner, 4096, 27, 13608, 6641, 0, 0, 20276, 6.82667e+06
n500x8192-coef-inner, 4096, 27, 13591, 6644, 0, 0, 20262, 6.82667e+06
n500x8192-coef-inner, 4096, 31, 13597, 6595, 0, 0, 20223, 6.82667e+06
n500x8192-coef-inner, 4096, 32, 13799, 6784, 0, 0, 20615, 6.82667e+06
n500x8192-coef-inner, 4096, 28, 13752, 6700, 0, 0, 20480, 6.82667e+06
n500x8192-coef-inner, 4096, 28, 13699, 6663, 0, 0, 20390, 6.82667e+06
n500x8192-coef-inner, 4096, 28, 13639, 6686, 0, 0, 20353, 6.82667e+06
n500x8192-coef-inner, 4096, 30, 13605, 6643, 0, 0, 20278, 6.82667e+06
n500x8192-coef-inner, 4096, 32, 13700, 8077, 0, 0, 21809, 6.82667e+06
n500x8192-coef-inner, 4096, 29, 13750, 7089, 0, 0, 20868, 6.82667e+06
n500x8192-coef-inner, 4096, 28, 13669, 6828, 0, 0, 20525, 6.82667e+06
n500x8192-coef-inner, 4096, 30, 14073, 6886, 0, 0, 20989, 6.82667e+06
n500x8192-coef-inner, 4096, 27, 13845, 7101, 0, 0, 20973, 6.82667e+06
n500x8192-coef-inner, 4096, 28, 13680, 7062, 0, 0, 20770, 6.82667e+06
n500x8192-coef-inner, 4096, 28, 13798, 6755, 0, 0, 20581, 6.82667e+06
n500x8192-coef-inner, 4096, 27, 13727, 6903, 0, 0, 20657, 6.82667e+06
n500x8192-coef-inner, 4096, 31, 13812, 6803, 0, 0, 20646, 6.82667e+06
n500x8192-coef-inner, 4096, 35, 13673, 6793, 0, 0, 20501, 6.82667e+06
n500x8192-coef-inner, 4096, 29, 13836, 6816, 0, 0, 20681, 6.82667e+06
n500x8192-coef-inner, 4096, 39, 13679, 6850, 0, 0, 20568, 6.82667e+06
n500x8192-coef-inner, 4096, 29, 13826, 6905, 0, 0, 20760, 6.82667e+06
n500x8192-coef-inner, 4096, 28, 13856, 6815, 0, 0, 20699, 6.82667e+06
n500x8192-coef-inner, 4096, 31, 13778, 6752, 0, 0, 20561, 6.82667e+06
n500x8192-coef-inner, 4096, 28, 13703, 6751, 0, 0, 20482, 6.82667e+06
n500x8192-coef-inner, 4096, 29, 13661, 6991, 0, 0, 20681, 6.82667e+06
n500x8192-coef-inner, 4096, 32, 14483, 6815, 0, 0, 21330, 6.82667e+06
n500x8192-coef-inner, 4096, 28, 13829, 7000, 0, 0, 20857, 6.82667e+06
n500x8192-coef-inner, 4096, 28, 13750, 6771, 0, 0, 20549, 6.82667e+06
n500x8192-coef-inner, 4096, 32, 13762, 6751, 0, 0, 20545, 6.82667e+06
n500x8192-coef-inner, 4096, 27, 13770, 6785, 0, 0, 20582, 6.82667e+06
n500x8192-coef-inner, 4096, 30, 13947, 6997, 0, 0, 20974, 6.82667e+06
n500x8192-coef-inner, 4096, 27, 13736, 6730, 0, 0, 20493, 6.82667e+06
n500x8192-coef-inner, 4096, 27, 13775, 6927, 0, 0, 20729, 6.82667e+06
n500x8192-coef-inner, 4096, 33, 13988, 6799, 0, 0, 20820, 6.82667e+06
n500x8192-coef-inner, 4096, 31, 13756, 6753, 0, 0, 20540, 6.82667e+06
n500x8192-coef-inner, 4096, 31, 13724, 6819, 0, 0, 20574, 6.82667e+06
n500x8192-coef-inner, 4096, 29, 13775, 6776, 0, 0, 20580, 6.82667e+06
n500x8192-coef-inner, 4096, 27, 13728, 7161, 0, 0, 20916, 6.82667e+06
n500x8192-coef-inner, 4096, 28, 13939, 6852, 0, 0, 20819, 6.82667e+06
n500x8192-coef-inner, 4096, 31, 14071, 6862, 0, 0, 20964, 6.82667e+06
n500x8192-coef-inner, 4096, 28, 13698, 7080, 0, 0, 20806, 6.82667e+06
n500x8192-coef-inner, 4096, 36, 13763, 7119, 0, 0, 20918, 6.82667e+06
n500x8192-coef-inner, 4096, 30, 13892, 6785, 0, 0, 20707, 6.82667e+06
n500x8192-coef-inner, 4096, 37, 13941, 7062, 0, 0, 21040, 6.82667e+06
n500x8192-coef-inner, 4096, 29, 14021, 7650, 0, 0, 21700, 6.82667e+06
n500x8192-coef-inner, 4096, 33, 14740, 7944, 0, 0, 22717, 6.82667e+06
n500x8192-coef-inner, 4096, 88, 20952, 7889, 0, 0, 28929, 6.82667e+06
n500x8192-coef-inner, 4096, 29, 15061, 8505, 0, 0, 23595, 6.82667e+06
n500x8192-coef-inner, 4096, 28, 14830, 6893, 0, 0, 21751, 6.82667e+06
n500x8192-coef-inner, 4096, 38, 17015, 7733, 0, 0, 24786, 6.82667e+06
n500x8192-coef-inner, 4096, 27, 14370, 6906, 0, 0, 21303, 6.82667e+06
n500x8192-coef-inner, 4096, 28, 14164, 7107, 0, 0, 21299, 6.82667e+06
n500x8192-coef-inner, 4096, 29, 14108, 7081, 0, 0, 21218, 6.82667e+06
n500x8192-coef-inner, 4096, 34, 13966, 7110, 0, 0, 21110, 6.82667e+06
n500x8192-coef-inner, 4096, 27, 14072, 6822, 0, 0, 20921, 6.82667e+06
n500x8192-coef-inner, 4096, 27, 13715, 7062, 0, 0, 20804, 6.82667e+06
n500x8192-coef-inner, 4096, 29, 14200, 7509, 0, 0, 21738, 6.82667e+06
n500x8192-coef-inner, 4096, 27, 13763, 7049, 0, 0, 20839, 6.82667e+06
n500x8192-coef-inner, 4096, 28, 13706, 7086, 0, 0, 20820, 6.82667e+06
n500x8192-coef-inner, 4096, 29, 13959, 7572, 0, 0, 21560, 6.82667e+06
n500x8192-coef-inner, 4096, 29, 13881, 6848, 0, 0, 20758, 6.82667e+06
n500x8192-coef-inner, 2048, 18, 13867, 6841, 0, 0, 20726, 6.82667e+06
n500x8192-coef-inner, 2048, 16, 15513, 6938, 0, 0, 22467, 6.82667e+06
n500x8192-coef-inner, 2048, 16, 14089, 6834, 0, 0, 20939, 6.82667e+06
n500x8192-coef-inner, 2048, 16, 13530, 6567, 0, 0, 20113, 6.82667e+06
n500x8192-coef-inner, 2048, 16, 13583, 6784, 0, 0, 20383, 6.82667e+06
n500x8192-coef-inner, 2048, 23, 13581, 6613, 0, 0, 20217, 6.82667e+06
n500x8192-coef-inner, 2048, 16, 13592, 6550, 0, 0, 20158, 6.82667e+06
n500x8192-coef-inner, 2048, 19, 13565, 6581, 0, 0, 20165, 6.82667e+06
n500x8192-coef-inner, 2048, 18, 13534, 6873, 0, 0, 20425, 6.82667e+06
n500x8192-coef-inner, 2048, 16, 13601, 6786, 0, 0, 20403, 6.82667e+06
n500x8192-coef-inner, 2048, 16, 13600, 6682, 0, 0, 20298, 6.82667e+06
n500x8192-coef-inner, 2048, 24, 13546, 6552, 0, 0, 20122, 6.82667e+06
n500x8192-coef-inner, 2048, 19, 13513, 6608, 0, 0, 20140, 6.82667e+06
n500x8192-coef-inner, 2048, 18, 13696, 6866, 0, 0, 20580, 6.82667e+06
n500x8192-coef-inner, 2048, 16, 13524, 6539, 0, 0, 20079, 6.82667e+06
n500x8192-coef-inner, 2048, 16, 13520, 6559, 0, 0, 20095, 6.82667e+06
n500x8192-coef-inner, 2048, 16, 13623, 6804, 0, 0, 20443, 6.82667e+06
n500x8192-coef-inner, 2048, 16, 13580, 6690, 0, 0, 20286, 6.82667e+06
n500x8192-coef-inner, 2048, 16, 13504, 6619, 0, 0, 20139, 6.82667e+06
n500x8192-coef-inner, 2048, 23, 13568, 6693, 0, 0, 20284, 6.82667e+06
n500x8192-coef-inner, 2048, 16, 13559, 6724, 0, 0, 20299, 6.82667e+06
n500x8192-coef-inner, 2048, 16, 13543, 6786, 0, 0, 20345, 6.82667e+06
n500x8192-coef-inner, 2048, 16, 13571, 6839, 0, 0, 20426, 6.82667e+06
n500x8192-coef-inner, 2048, 16, 13518, 6564, 0, 0, 20098, 6.82667e+06
n500x8192-coef-inner, 2048, 16, 13583, 6597, 0, 0, 20196, 6.82667e+06
n500x8192-coef-inner, 2048, 20, 13480, 6718, 0, 0, 20218, 6.82667e+06
n500x8192-coef-inner, 2048, 16, 13507, 6566, 0, 0, 20089, 6.82667e+06
n500x8192-coef-inner, 2048, 16, 13651, 6700, 0, 0, 20367, 6.82667e+06
n500x8192-coef-inner, 2048, 16, 13721, 6698, 0, 0, 20435, 6.82667e+06
n500x8192-coef-inner, 2048, 16, 13844, 6858, 0, 0, 20718, 6.82667e+06
n500x8192-coef-inner, 2048, 16, 13542, 6550, 0, 0, 20108, 6.82667e+06
n500x8192-coef-inner, 2048, 16, 13517, 6548, 0, 0, 20081, 6.82667e+06
n500x8192-coef-inner, 2048, 16, 13496, 6537, 0, 0, 20049, 6.82667e+06
n500x8192-coef-inner, 2048, 16, 13563, 6517, 0, 0, 20096, 6.82667e+06
n500x8192-coef-inner, 2048, 16, 13612, 6630, 0, 0, 20258, 6.82667e+06
n500x8192-coef-inner, 2048, 18, 13647, 6614, 0, 0, 20279, 6.82667e+06
n500x8192-coef-inner, 2048, 16, 13542, 6525, 0, 0, 20083, 6.82667e+06
n500x8192-coef-inner, 2048, 18, 13617, 6686, 0, 0, 20321, 6.82667e+06
n500x8192-coef-inner, 2048, 16, 13516, 6561, 0, 0, 20093, 6.82667e+06
n500x8192-coef-inner, 2048, 16, 13653, 6688, 0, 0, 20357, 6.82667e+06
n500x8192-coef-inner, 2048, 16, 13540, 6549, 0, 0, 20105, 6.82667e+06
n500x8192-coef-inner, 2048, 17, 13487, 6528, 0, 0, 20032, 6.82667e+06
n500x8192-coef-inner, 2048, 16, 13617, 6564, 0, 0, 20197, 6.82667e+06
n500x8192-coef-inner, 2048, 16, 13504, 6518, 0, 0, 20038, 6.82667e+06
n500x8192-coef-inner, 2048, 16, 13517, 6547, 0, 0, 20080, 6.82667e+06
n500x8192-coef-inner, 2048, 16, 13538, 6569, 0, 0, 20123, 6.82667e+06
n500x8192-coef-inner, 2048, 16, 13587, 6551, 0, 0, 20154, 6.82667e+06
n500x8192-coef-inner, 2048, 27, 13488, 6787, 0, 0, 20302, 6.82667e+06
n500x8192-coef-inner, 2048, 16, 13538, 6560, 0, 0, 20114, 6.82667e+06
n500x8192-coef-inner, 2048, 16, 13520, 6557, 0, 0, 20093, 6.82667e+06
n500x8192-coef-inner, 2048, 16, 13529, 6564, 0, 0, 20109, 6.82667e+06
n500x8192-coef-inner, 2048, 16, 13569, 6655, 0, 0, 20240, 6.82667e+06
n500x8192-coef-inner, 2048, 16, 13513, 6545, 0, 0, 20074, 6.82667e+06
n500x8192-coef-inner, 2048, 16, 13536, 6579, 0, 0, 20131, 6.82667e+06
n500x8192-coef-inner, 2048, 16, 13580, 6575, 0, 0, 20171, 6.82667e+06
n500x8192-coef-inner, 2048, 18, 13614, 6660, 0, 0, 20292, 6.82667e+06
n500x8192-coef-inner, 2048, 16, 13503, 6615, 0, 0, 20134, 6.82667e+06
n500x8192-coef-inner, 2048, 16, 13554, 6846, 0, 0, 20416, 6.82667e+06
n500x8192-coef-inner, 2048, 16, 13512, 6560, 0, 0, 20088, 6.82667e+06
n500x8192-coef-inner, 2048, 16, 13513, 6576, 0, 0, 20105, 6.82667e+06
n500x8192-coef-inner, 2048, 16, 13521, 6560, 0, 0, 20097, 6.82667e+06
n500x8192-coef-inner, 2048, 16, 13695, 6609, 0, 0, 20320, 6.82667e+06
n500x8192-coef-inner, 2048, 16, 13527, 6559, 0, 0, 20102, 6.82667e+06
n500x8192-coef-inner, 2048, 17, 13643, 6725, 0, 0, 20385, 6.82667e+06
n500x8192-coef-inner, 2048, 16, 13508, 6527, 0, 0, 20051, 6.82667e+06
n500x8192-coef-inner, 2048, 19, 13520, 6579, 0, 0, 20118, 6.82667e+06
n500x8192-coef-inner, 2048, 16, 13513, 6769, 0, 0, 20298, 6.82667e+06
n500x8192-coef-inner, 2048, 16, 13492, 6522, 0, 0, 20030, 6.82667e+06
n500x8192-coef-inner, 2048, 16, 13527, 6605, 0, 0, 20148, 6.82667e+06
n500x8192-coef-inner, 2048, 16, 13604, 6676, 0, 0, 20296, 6.82667e+06
n500x8192-coef-inner, 2048, 16, 13549, 6611, 0, 0, 20176, 6.82667e+06
n500x8192-coef-inner, 2048, 16, 13743, 6675, 0, 0, 20434, 6.82667e+06
n500x8192-coef-inner, 2048, 16, 13632, 6626, 0, 0, 20274, 6.82667e+06
n500x8192-coef-inner, 2048, 16, 13523, 6530, 0, 0, 20069, 6.82667e+06
n500x8192-coef-inner, 2048, 16, 13681, 6570, 0, 0, 20267, 6.82667e+06
n500x8192-coef-inner, 2048, 17, 13545, 6841, 0, 0, 20403, 6.82667e+06
n500x8192-coef-inner, 2048, 16, 13492, 6540, 0, 0, 20048, 6.82667e+06
n500x8192-coef-inner, 2048, 16, 13548, 6525, 0, 0, 20089, 6.82667e+06
n500x8192-coef-inner, 2048, 18, 13493, 6817, 0, 0, 20328, 6.82667e+06
n500x8192-coef-inner, 2048, 16, 13539, 6551, 0, 0, 20106, 6.82667e+06
n500x8192-coef-inner, 2048, 20, 13565, 6826, 0, 0, 20411, 6.82667e+06
n500x8192-coef-inner, 2048, 19, 13677, 6662, 0, 0, 20358, 6.82667e+06
n500x8192-coef-inner, 2048, 16, 13518, 6810, 0, 0, 20344, 6.82667e+06
n500x8192-coef-inner, 2048, 16, 13541, 6821, 0, 0, 20378, 6.82667e+06
n500x8192-coef-inner, 2048, 16, 13572, 7699, 0, 0, 21287, 6.82667e+06
n500x8192-coef-inner, 2048, 20, 13550, 6605, 0, 0, 20175, 6.82667e+06
n500x8192-coef-inner, 2048, 16, 13573, 6796, 0, 0, 20385, 6.82667e+06
n500x8192-coef-inner, 2048, 16, 13658, 6865, 0, 0, 20539, 6.82667e+06
n500x8192-coef-inner, 2048, 16, 13604, 6803, 0, 0, 20423, 6.82667e+06
n500x8192-coef-inner, 2048, 19, 13570, 6691, 0, 0, 20280, 6.82667e+06
n500x8192-coef-inner, 2048, 16, 13649, 6729, 0, 0, 20394, 6.82667e+06
n500x8192-coef-inner, 2048, 16, 13506, 6630, 0, 0, 20152, 6.82667e+06
n500x8192-coef-inner, 2048, 19, 13557, 6849, 0, 0, 20425, 6.82667e+06
n500x8192-coef-inner, 2048, 16, 13562, 6624, 0, 0, 20202, 6.82667e+06
n500x8192-coef-inner, 2048, 19, 13510, 6633, 0, 0, 20162, 6.82667e+06
n500x8192-coef-inner, 2048, 16, 13536, 6863, 0, 0, 20415, 6.82667e+06
n500x8192-coef-inner, 2048, 21, 13520, 6828, 0, 0, 20369, 6.82667e+06
n500x8192-coef-inner, 2048, 19, 13679, 6675, 0, 0, 20373, 6.82667e+06
n500x8192-coef-inner, 2048, 16, 13674, 6690, 0, 0, 20380, 6.82667e+06
n500x8192-coef-inner, 2048, 19, 13685, 6680, 0, 0, 20384, 6.82667e+06
n500x8192-coef-inner, 1024, 12, 13974, 6906, 0, 0, 20892, 6.82667e+06
n500x8192-coef-inner, 1024, 12, 13932, 6864, 0, 0, 20808, 6.82667e+06
n500x8192-coef-inner, 1024, 12, 13940, 6883, 0, 0, 20835, 6.82667e+06
n500x8192-coef-inner, 1024, 12, 13958, 6871, 0, 0, 20841, 6.82667e+06
n500x8192-coef-inner, 1024, 13, 13998, 6902, 0, 0, 20913, 6.82667e+06
n500x8192-coef-inner, 1024, 12, 13926, 6888, 0, 0, 20826, 6.82667e+06
n500x8192-coef-inner, 1024, 12, 13977, 6827, 0, 0, 20816, 6.82667e+06
n500x8192-coef-inner, 1024, 13, 13897, 6811, 0, 0, 20721, 6.82667e+06
n500x8192-coef-inner, 1024, 13, 13879, 6905, 0, 0, 20797, 6.82667e+06
n500x8192-coef-inner, 1024, 13, 13937, 6818, 0, 0, 20768, 6.82667e+06
n500x8192-coef-inner, 1024, 12, 13905, 6806, 0, 0, 20723, 6.82667e+06
n500x8192-coef-inner, 1024, 12, 13951, 6840, 0, 0, 20803, 6.82667e+06
n500x8192-coef-inner, 1024, 12, 13909, 6870, 0, 0, 20791, 6.82667e+06
n500x8192-coef-inner, 1024, 12, 13969, 6855, 0, 0, 20836, 6.82667e+06
n500x8192-coef-inner, 1024, 12, 14034, 7018, 0, 0, 21064, 6.82667e+06
n500x8192-coef-inner, 1024, 12, 14156, 7061, 0, 0, 21229, 6.82667e+06
n500x8192-coef-inner, 1024, 13, 13997, 6816, 0, 0, 20826, 6.82667e+06
n500x8192-coef-inner, 1024, 12, 13986, 6883, 0, 0, 20881, 6.82667e+06
n500x8192-coef-inner, 1024, 11, 13885, 6840, 0, 0, 20736, 6.82667e+06
n500x8192-coef-inner, 1024, 12, 13895, 6886, 0, 0, 20793, 6.82667e+06
n500x8192-coef-inner, 1024, 12, 14011, 6956, 0, 0, 20979, 6.82667e+06
n500x8192-coef-inner, 1024, 12, 14025, 7057, 0, 0, 21094, 6.82667e+06
n500x8192-coef-inner, 1024, 13, 13944, 6873, 0, 0, 20830, 6.82667e+06
n500x8192-coef-inner, 1024, 13, 13961, 6813, 0, 0, 20787, 6.82667e+06
n500x8192-coef-inner, 1024, 12, 13888, 6805, 0, 0, 20705, 6.82667e+06
n500x8192-coef-inner, 1024, 12, 13908, 6866, 0, 0, 20786, 6.82667e+06
n500x8192-coef-inner, 1024, 11, 13931, 6952, 0, 0, 20894, 6.82667e+06
n500x8192-coef-inner, 1024, 12, 13917, 6836, 0, 0, 20765, 6.82667e+06
n500x8192-coef-inner, 1024, 12, 13891, 7125, 0, 0, 21028, 6.82667e+06
n500x8192-coef-inner, 1024, 11, 13999, 7167, 0, 0, 21177, 6.82667e+06
n500x8192-coef-inner, 1024, 12, 13908, 6875, 0, 0, 20795, 6.82667e+06
n500x8192-coef-inner, 1024, 12, 13982, 6947, 0, 0, 20941, 6.82667e+06
n500x8192-coef-inner, 1024, 12, 14020, 7031, 0, 0, 21063, 6.82667e+06
n500x8192-coef-inner, 1024, 12, 14453, 7047, 0, 0, 21512, 6.82667e+06
n500x8192-coef-inner, 1024, 13, 13973, 6991, 0, 0, 20977, 6.82667e+06
n500x8192-coef-inner, 1024, 13, 13964, 6892, 0, 0, 20869, 6.82667e+06
n500x8192-coef-inner, 1024, 12, 13910, 6850, 0, 0, 20772, 6.82667e+06
n500x8192-coef-inner, 1024, 12, 13970, 6979, 0, 0, 20961, 6.82667e+06
n500x8192-coef-inner, 1024, 13, 13905, 7027, 0, 0, 20945, 6.82667e+06
n500x8192-coef-inner, 1024, 12, 14075, 6994, 9, 0, 21090, 6.82667e+06
n500x8192-coef-inner, 1024, 12, 13921, 7059, 0, 0, 20992, 6.82667e+06
n500x8192-coef-inner, 1024, 12, 13955, 6880, 0, 0, 20847, 6.82667e+06
n500x8192-coef-inner, 1024, 12, 13955, 6939, 0, 0, 20906, 6.82667e+06
n500x8192-coef-inner, 1024, 12, 13990, 7155, 0, 0, 21157, 6.82667e+06
n500x8192-coef-inner, 1024, 12, 13935, 6901, 0, 0, 20848, 6.82667e+06
n500x8192-coef-inner, 1024, 11, 13915, 6932, 0, 0, 20858, 6.82667e+06
n500x8192-coef-inner, 1024, 13, 13870, 7051, 0, 0, 20934, 6.82667e+06
n500x8192-coef-inner, 1024, 13, 13923, 6791, 0, 0, 20727, 6.82667e+06
n500x8192-coef-inner, 1024, 12, 13946, 6890, 0, 0, 20848, 6.82667e+06
n500x8192-coef-inner, 1024, 12, 13942, 6807, 0, 0, 20761, 6.82667e+06
n500x8192-coef-inner, 1024, 13, 13926, 6777, 0, 0, 20716, 6.82667e+06
n500x8192-coef-inner, 1024, 12, 13929, 6795, 0, 0, 20736, 6.82667e+06
n500x8192-coef-inner, 1024, 13, 13902, 6762, 0, 0, 20677, 6.82667e+06
n500x8192-coef-inner, 1024, 12, 13878, 6804, 0, 0, 20694, 6.82667e+06
n500x8192-coef-inner, 1024, 12, 14015, 6925, 0, 0, 20952, 6.82667e+06
n500x8192-coef-inner, 1024, 13, 14024, 6919, 0, 0, 20956, 6.82667e+06
n500x8192-coef-inner, 1024, 12, 13869, 6818, 0, 0, 20699, 6.82667e+06
n500x8192-coef-inner, 1024, 12, 14250, 6868, 0, 0, 21130, 6.82667e+06
n500x8192-coef-inner, 1024, 12, 14230, 6895, 0, 0, 21137, 6.82667e+06
n500x8192-coef-inner, 1024, 12, 14026, 6867, 0, 0, 20905, 6.82667e+06
n500x8192-coef-inner, 1024, 14, 13916, 7024, 0, 0, 20954, 6.82667e+06
n500x8192-coef-inner, 1024, 12, 13880, 6822, 0, 0, 20714, 6.82667e+06
n500x8192-coef-inner, 1024, 12, 13872, 6794, 0, 0, 20678, 6.82667e+06
n500x8192-coef-inner, 1024, 13, 13907, 6789, 0, 0, 20709, 6.82667e+06
n500x8192-coef-inner, 1024, 12, 13878, 6819, 0, 0, 20709, 6.82667e+06
n500x8192-coef-inner, 1024, 12, 13909, 6853, 0, 0, 20774, 6.82667e+06
n500x8192-coef-inner, 1024, 12, 13915, 6973, 0, 0, 20900, 6.82667e+06
n500x8192-coef-inner, 1024, 11, 13905, 6828, 0, 0, 20744, 6.82667e+06
n500x8192-coef-inner, 1024, 12, 13927, 6954, 0, 0, 20893, 6.82667e+06
n500x8192-coef-inner, 1024, 13, 13885, 6860, 0, 0, 20758, 6.82667e+06
n500x8192-coef-inner, 1024, 12, 13898, 6790, 0, 0, 20700, 6.82667e+06
n500x8192-coef-inner, 1024, 11, 13944, 6805, 0, 0, 20760, 6.82667e+06
n500x8192-coef-inner, 1024, 12, 13971, 6924, 0, 0, 20907, 6.82667e+06
n500x8192-coef-inner, 1024, 12, 13984, 6924, 0, 0, 20920, 6.82667e+06
n500x8192-coef-inner, 1024, 12, 13943, 6786, 0, 0, 20741, 6.82667e+06
n500x8192-coef-inner, 1024, 12, 13858, 6826, 0, 0, 20696, 6.82667e+06
n500x8192-coef-inner, 1024, 12, 13938, 6841, 0, 0, 20791, 6.82667e+06
n500x8192-coef-inner, 1024, 13, 13934, 6845, 0, 0, 20792, 6.82667e+06
n500x8192-coef-inner, 1024, 14, 13909, 6814, 0, 0, 20737, 6.82667e+06
n500x8192-coef-inner, 1024, 13, 13849, 6852, 0, 0, 20714, 6.82667e+06
n500x8192-coef-inner, 1024, 12, 13944, 6811, 0, 0, 20767, 6.82667e+06
n500x8192-coef-inner, 1024, 12, 13928, 6869, 0, 0, 20809, 6.82667e+06
n500x8192-coef-inner, 1024, 12, 14007, 6890, 0, 0, 20909, 6.82667e+06
n500x8192-coef-inner, 1024, 12, 13938, 6836, 0, 0, 20786, 6.82667e+06
n500x8192-coef-inner, 1024, 12, 13910, 6848, 0, 0, 20770, 6.82667e+06
n500x8192-coef-inner, 1024, 12, 13960, 6820, 0, 0, 20792, 6.82667e+06
n500x8192-coef-inner, 1024, 12, 13891, 6885, 0, 0, 20788, 6.82667e+06
n500x8192-coef-inner, 1024, 12, 14001, 6892, 0, 0, 20905, 6.82667e+06
n500x8192-coef-inner, 1024, 13, 14002, 6918, 0, 0, 20933, 6.82667e+06
n500x8192-coef-inner, 1024, 14, 13907, 6882, 0, 0, 20803, 6.82667e+06
n500x8192-coef-inner, 1024, 12, 13905, 6805, 0, 0, 20722, 6.82667e+06
n500x8192-coef-inner, 1024, 12, 14028, 6930, 0, 0, 20970, 6.82667e+06
n500x8192-coef-inner, 1024, 12, 13921, 7110, 0, 0, 21043, 6.82667e+06
n500x8192-coef-inner, 1024, 11, 13874, 6837, 0, 0, 20722, 6.82667e+06
n500x8192-coef-inner, 1024, 12, 13934, 6822, 0, 0, 20768, 6.82667e+06
n500x8192-coef-inner, 1024, 12, 13865, 6818, 0, 0, 20695, 6.82667e+06
n500x8192-coef-inner, 1024, 12, 13894, 6857, 0, 0, 20763, 6.82667e+06
n500x8192-coef-inner, 1024, 13, 14007, 6822, 0, 0, 20842, 6.82667e+06
n500x8192-coef-inner, 1024, 11, 13897, 6797, 0, 0, 20705, 6.82667e+06
n500x8192-coef-inner, 1024, 12, 14013, 6973, 0, 0, 20998, 6.82667e+06
n1000x8192-coef-sum, 8192, 57, 13834, 427, 1, 0, 14319, 1
n1000x8192-coef-sum, 8192, 63, 13713, 383, 1, 0, 14160, 1
n1000x8192-coef-sum, 8192, 58, 13797, 389, 1, 0, 14245, 1
n1000x8192-coef-sum, 8192, 57, 13833, 379, 1, 0, 14270, 1
n1000x8192-coef-sum, 8192, 56, 13705, 379, 1, 0, 14141, 1
n1000x8192-coef-sum, 8192, 60, 13808, 384, 1, 0, 14253, 1
n1000x8192-coef-sum, 8192, 57, 13685, 386, 1, 0, 14129, 1
n1000x8192-coef-sum, 8192, 57, 13716, 396, 1, 0, 14170, 1
n1000x8192-coef-sum, 8192, 57, 13682, 386, 1, 0, 14126, 1
n1000x8192-coef-sum, 8192, 59, 13828, 384, 1, 0, 14272, 1
n1000x8192-coef-sum, 8192, 60, 13674, 382, 1, 0, 14117, 1
n1000x8192-coef-sum, 8192, 58, 13795, 387, 1, 0, 14241, 1
n1000x8192-coef-sum, 8192, 59, 13745, 379, 1, 0, 14184, 1
n1000x8192-coef-sum, 8192, 58, 13671, 381, 1, 0, 14111, 1
n1000x8192-coef-sum, 8192, 58, 13770, 386, 1, 0, 14215, 1
n1000x8192-coef-sum, 8192, 59, 13795, 391, 1, 0, 14246, 1
n1000x8192-coef-sum, 8192, 57, 13735, 380, 1, 0, 14173, 1
n1000x8192-coef-sum, 8192, 64, 13779, 407, 1, 0, 14251, 1
n1000x8192-coef-sum, 8192, 57, 13763, 391, 1, 0, 14212, 1
n1000x8192-coef-sum, 8192, 60, 13727, 383, 1, 0, 14171, 1
n1000x8192-coef-sum, 8192, 56, 13744, 386, 1, 0, 14187, 1
n1000x8192-coef-sum, 8192, 56, 13679, 396, 1, 0, 14132, 1
n1000x8192-coef-sum, 8192, 58, 13738, 386, 1, 0, 14183, 1
n1000x8192-coef-sum, 8192, 60, 13770, 385, 1, 0, 14216, 1
n1000x8192-coef-sum, 8192, 56, 13808, 387, 1, 0, 14252, 1
n1000x8192-coef-sum, 8192, 60, 13715, 386, 1, 0, 14162, 1
n1000x8192-coef-sum, 8192, 59, 13700, 380, 1, 0, 14140, 1
n1000x8192-coef-sum, 8192, 57, 13725, 383, 1, 0, 14166, 1
n1000x8192-coef-sum, 8192, 60, 13766, 382, 1, 0, 14209, 1
n1000x8192-coef-sum, 8192, 60, 13750, 388, 1, 0, 14199, 1
n1000x8192-coef-sum, 8192, 56, 13783, 398, 1, 0, 14238, 1
n1000x8192-coef-sum, 8192, 63, 13771, 395, 1, 0, 14230, 1
n1000x8192-coef-sum, 8192, 60, 13720, 383, 1, 0, 14164, 1
n1000x8192-coef-sum, 8192, 57, 13763, 389, 1, 0, 14210, 1
n1000x8192-coef-sum, 8192, 59, 13686, 381, 1, 0, 14127, 1
n1000x8192-coef-sum, 8192, 58, 13727, 388, 1, 0, 14174, 1
n1000x8192-coef-sum, 8192, 58, 13713, 381, 1, 0, 14153, 1
n1000x8192-coef-sum, 8192, 57, 13705, 382, 1, 0, 14145, 1
n1000x8192-coef-sum, 8192, 58, 13693, 380, 1, 0, 14132, 1
n1000x8192-coef-sum, 8192, 57, 13784, 391, 1, 0, 14233, 1
n1000x8192-coef-sum, 8192, 59, 13762, 384, 1, 0, 14206, 1
n1000x8192-coef-sum, 8192, 57, 13717, 380, 1, 0, 14155, 1
n1000x8192-coef-sum, 8192, 56, 13715, 396, 1, 0, 14168, 1
n1000x8192-coef-sum, 8192, 56, 13703, 386, 1, 0, 14146, 1
n1000x8192-coef-sum, 8192, 57, 13738, 399, 1, 0, 14195, 1
n1000x8192-coef-sum, 8192, 58, 13737, 380, 1, 0, 14176, 1
n1000x8192-coef-sum, 8192, 63, 13727, 380, 1, 0, 14171, 1
n1000x8192-coef-sum, 8192, 58, 13726, 389, 1, 0, 14174, 1
n1000x8192-coef-sum, 8192, 58, 13787, 389, 1, 0, 14235, 1
n1000x8192-coef-sum, 8192, 59, 13729, 382, 1, 0, 14171, 1
n1000x8192-coef-sum, 8192, 56, 13784, 384, 1, 0, 14225, 1
n1000x8192-coef-sum, 8192, 59, 13709, 384, 1, 0, 14153, 1
n1000x8192-coef-sum, 8192, 58, 13807, 384, 1, 0, 14250, 1
n1000x8192-coef-sum, 8192, 57, 13750, 384, 1, 0, 14192, 1
n1000x8192-coef-sum, 8192, 56, 13782, 384, 1, 0, 14223, 1
n1000x8192-coef-sum, 8192, 60, 13722, 382, 1, 0, 14165, 1
n1000x8192-coef-sum, 8192, 57, 13790, 383, 1, 0, 14231, 1
n1000x8192-coef-sum, 8192, 59, 13795, 389, 1, 0, 14244, 1
n1000x8192-coef-sum, 8192, 56, 13732, 383, 1, 0, 14172, 1
n1000x8192-coef-sum, 8192, 58, 13741, 386, 1, 0, 14186, 1
n1000x8192-coef-sum, 8192, 57, 13921, 389, 1, 0, 14368, 1
n1000x8192-coef-sum, 8192, 59, 13743, 381, 1, 0, 14184, 1
n1000x8192-coef-sum, 8192, 58, 13696, 381, 1, 0, 14136, 1
n1000x8192-coef-sum, 8192, 57, 13683, 381, 1, 0, 14122, 1
n1000x8192-coef-sum, 8192, 57, 13698, 381, 1, 0, 14137, 1
n1000x8192-coef-sum, 8192, 57, 13717, 385, 1, 0, 14160, 1
n1000x8192-coef-sum, 8192, 58, 13724, 382, 1, 0, 14165, 1
n1000x8192-coef-sum, 8192, 57, 13696, 383, 1, 0, 14137, 1
n1000x8192-coef-sum, 8192, 59, 15407, 423, 1, 0, 15890, 1
n1000x8192-coef-sum, 8192, 56, 13911, 403, 1, 0, 14371, 1
n1000x8192-coef-sum, 8192, 61, 13924, 391, 1, 0, 14377, 1
n1000x8192-coef-sum, 8192, 56, 13875, 400, 1, 0, 14332, 1
n1000x8192-coef-sum, 8192, 58, 13954, 398, 2, 0, 14412, 1
n1000x8192-coef-sum, 8192, 59, 13890, 397, 1, 0, 14347, 1
n1000x8192-coef-sum, 8192, 56, 13973, 393, 1, 0, 14423, 1
n1000x8192-coef-sum, 8192, 60, 13901, 394, 1, 0, 14356, 1
n1000x8192-coef-sum, 8192, 58, 13963, 386, 1, 0, 14408, 1
n1000x8192-coef-sum, 8192, 59, 13946, 392, 1, 0, 14398, 1
n1000x8192-coef-sum, 8192, 58, 14227, 396, 1, 0, 14682, 1
n1000x8192-coef-sum, 8192, 61, 13899, 393, 1, 0, 14354, 1
n1000x8192-coef-sum, 8192, 56, 13951, 391, 1, 0, 14399, 1
n1000x8192-coef-sum, 8192, 64, 13811, 401, 1, 0, 14277, 1
n1000x8192-coef-sum, 8192, 60, 13846, 416, 1, 0, 14323, 1
n1000x8192-coef-sum, 8192, 66, 13998, 398, 2, 0, 14464, 1
n1000x8192-coef-sum, 8192, 64, 13879, 387, 1, 0, 14331, 1
n1000x8192-coef-sum, 8192, 57, 13804, 388, 1, 0, 14250, 1
n1000x8192-coef-sum, 8192, 60, 13855, 387, 1, 0, 14303, 1
n1000x8192-coef-sum, 8192, 59, 13823, 385, 1, 0, 14268, 1
n1000x8192-coef-sum, 8192, 57, 13917, 399, 1, 0, 14374, 1
n1000x8192-coef-sum, 8192, 57, 13775, 390, 1, 0, 14223, 1
n1000x8192-coef-sum, 8192, 58, 13828, 395, 1, 0, 14282, 1
n1000x8192-coef-sum, 8192, 56, 13834, 392, 1, 0, 14283, 1
n1000x8192-coef-sum, 8192, 56, 13837, 388, 1, 0, 14282, 1
n1000x8192-coef-sum, 8192, 59, 13982, 387, 1, 0, 14429, 1
n1000x8192-coef-sum, 8192, 62, 13881, 390, 2, 0, 14335, 1
n1000x8192-coef-sum, 8192, 58, 13924, 391, 1, 0, 14374, 1
n1000x8192-coef-sum, 8192, 59, 13865, 386, 1, 0, 14311, 1
n1000x8192-coef-sum, 8192, 56, 13921, 401, 1, 0, 14379, 1
n1000x8192-coef-sum, 8192, 57, 13839, 384, 1, 0, 14281, 1
n1000x8192-coef-sum, 8192, 61, 13805, 391, 4, 0, 14261, 1
n1000x8192-coef-sum, 4096, 32, 13956, 419, 0, 0, 14407, 1
n1000x8192-coef-sum, 4096, 30, 13808, 399, 0, 0, 14237, 1
n1000x8192-coef-sum, 4096, 34, 14058, 411, 1, 0, 14504, 1
n1000x8192-coef-sum, 4096, 30, 13759, 409, 0, 0, 14198, 1
n1000x8192-coef-sum, 4096, 31, 13799, 415, 0, 0, 14245, 1
n1000x8192-coef-sum, 4096, 31, 13789, 413, 0, 0, 14233, 1
n1000x8192-coef-sum, 4096, 30, 13711, 400, 0, 0, 14141, 1
n1000x8192-coef-sum, 4096, 34, 13851, 414, 0, 0, 14299, 1
n1000x8192-coef-sum, 4096, 32, 13817, 415, 0, 0, 14264, 1
n1000x8192-coef-sum, 4096, 31, 13664, 394, 0, 0, 14089, 1
n1000x8192-coef-sum, 4096, 32, 13896, 405, 0, 0, 14333, 1
n1000x8192-coef-sum, 4096, 42, 13677, 395, 0, 0, 14114, 1
n1000x8192-coef-sum, 4096, 32, 13850, 397, 0, 0, 14279, 1
n1000x8192-coef-sum, 4096, 32, 13816, 403, 3, 0, 14254, 1
n1000x8192-coef-sum, 4096, 32, 13862, 400, 0, 0, 14294, 1
n1000x8192-coef-sum, 4096, 30, 13631, 396, 0, 0, 14057, 1
n1000x8192-coef-sum, 4096, 30, 13689, 402, 0, 0, 14121, 1
n1000x8192-coef-sum, 4096, 31, 13797, 401, 0, 0, 14229, 1
n1000x8192-coef-sum, 4096, 31, 13646, 397, 0, 0, 14074, 1
n1000x8192-coef-sum, 4096, 34, 13722, 399, 0, 0, 14155, 1
n1000x8192-coef-sum, 4096, 33, 14120, 422, 0, 0, 14575, 1
n1000x8192-coef-sum, 4096, 31, 13802, 404, 0, 0, 14237, 1
n1000x8192-coef-sum, 4096, 32, 13997, 405, 0, 0, 14434, 1
n1000x8192-coef-sum, 4096, 30, 13709, 398, 0, 0, 14137, 1
n1000x8192-coef-sum, 4096, 33, 13699, 396, 0, 0, 14128, 1
n1000x8192-coef-sum, 4096, 30, 13779, 395, 0, 0, 14204, 1
n1000x8192-coef-sum, 4096, 30, 13643, 400, 0, 0, 14073, 1
n1000x8192-coef-sum, 4096, 34, 13811, 403, 0, 0, 14248, 1
n1000x8192-coef-sum, 4096, 32, 14142, 453, 0, 0, 14627, 1
n1000x8192-coef-sum, 4096, 148, 17184, 416, 0, 0, 17748, 1
n1000x8192-coef-sum, 4096, 34, 14318, 414, 0, 0, 14766, 1
n1000x8192-coef-sum, 4096, 34, 13884, 396, 0, 0, 14314, 1
n1000x8192-coef-sum, 4096, 30, 13829, 395, 0, 0, 14254, 1
n1000x8192-coef-sum, 4096, 32, 13809, 413, 0, 0, 14254, 1
n1000x8192-coef-sum, 4096, 31, 13680, 398, 0, 0, 14109, 1
n1000x8192-coef-sum, 4096, 30, 13661, 397, 0, 0, 14088, 1
n1000x8192-coef-sum, 4096, 31, 13731, 400, 0, 0, 14162, 1
n1000x8192-coef-sum, 4096, 36, 13902, 400, 0, 0, 14338, 1
n1000x8192-coef-sum, 4096, 33, 13664, 399, 0, 0, 14096, 1
n1000x8192-coef-sum, 4096, 30, 13685, 399, 0, 0, 14114, 1
n1000x8192-coef-sum, 4096, 32, 13872, 406, 0, 0, 14310, 1
n1000x8192-coef-sum, 4096, 33, 13714, 396, 0, 0, 14143, 1
n1000x8192-coef-sum, 4096, 34, 13708, 399, 0, 0, 14141, 1
n1000x8192-coef-sum, 4096, 32, 13600, 399, 0, 0, 14031, 1
n1000x8192-coef-sum, 4096, 34, 13897, 407, 0, 0, 14338, 1
n1000x8192-coef-sum, 4096, 36, 13854, 400, 1, 0, 14291, 1
n1000x8192-coef-sum, 4096, 31, 13944, 404, 0, 0, 14379, 1
n1000x8192-coef-sum, 4096, 31, 13745, 405, 0, 0, 14181, 1
n1000x8192-coef-sum, 4096, 38, 13962, 401, 0, 0, 14401, 1
n1000x8192-coef-sum, 4096, 33, 13634, 391, 0, 0, 14058, 1
n1000x8192-coef-sum, 4096, 31, 13618, 394, 0, 0, 14043, 1
n1000x8192-coef-sum, 4096, 32, 13648, 393, 0, 0, 14073, 1
n1000x8192-coef-sum, 4096, 32, 13659, 406, 0, 0, 14097, 1
n1000x8192-coef-sum, 4096, 30, 13551, 390, 0, 0, 13971, 1
n1000x8192-coef-sum, 4096, 33, 13679, 396, 0, 0, 14108, 1
n1000x8192-coef-sum, 4096, 33, 13567, 388, 0, 0, 13988, 1
n1000x8192-coef-sum, 4096, 30, 13554, 389, 0, 0, 13973, 1
n1000x8192-coef-sum, 4096, 39, 13619, 393, 0, 0, 14051, 1
n1000x8192-coef-sum, 4096, 32, 13538, 387, 0, 0, 13957, 1
n1000x8192-coef-sum, 4096, 30, 13563, 386, 0, 0, 13979, 1
n1000x8192-coef-sum, 4096, 35, 13545, 390, 0, 0, 13970, 1
n1000x8192-coef-sum, 4096, 30, 13690, 399, 0, 0, 14119, 1
n1000x8192-coef-sum, 4096, 31, 13655, 387, 0, 0, 14073, 1
n1000x8192-coef-sum, 4096, 34, 13664, 410, 0, 0, 14108, 1
n1000x8192-coef-sum, 4096, 30, 13598, 387, 0, 0, 14015, 1
n1000x8192-coef-sum, 4096, 33, 13588, 387, 0, 0, 14008, 1
n1000x8192-coef-sum, 4096, 30, 13519, 386, 0, 0, 13935, 1
n1000x8192-coef-sum, 4096, 30, 13557, 395, 0, 0, 13982, 1
n1000x8192-coef-sum, 4096, 31, 13569, 386, 0, 0, 13986, 1
n1000x8192-coef-sum, 4096, 30, 13601, 388, 0, 0, 14019, 1
n1000x8192-coef-sum, 4096, 35, 13673, 394, 0, 0, 14102, 1
n1000x8192-coef-sum, 4096, 31, 13655, 392, 0, 0, 14078, 1
n1000x8192-coef-sum, 4096, 34, 13549, 393, 0, 0, 13976, 1
n1000x8192-coef-sum, 4096, 30, 13555, 389, 0, 0, 13974, 1
n1000x8192-coef-sum, 4096, 31, 13632, 396, 0, 0, 14059, 1
n1000x8192-coef-sum, 4096, 31, 13527, 390, 0, 0, 13948, 1
n1000x8192-coef-sum, 4096, 30, 13566, 387, 0, 0, 13983, 1
n1000x8192-coef-sum, 4096, 34, 13709, 396, 0, 0, 14139, 1
n1000x8192-coef-sum, 4096, 31, 13615, 395, 0, 0, 14041, 1
n1000x8192-coef-sum, 4096, 31, 13670, 394, 0, 0, 14095, 1
n1000x8192-coef-sum, 4096, 34, 13634, 395, 0, 0, 14063, 1
n1000x8192-coef-sum, 4096, 30, 13689, 393, 0, 0, 14112, 1
n1000x8192-coef-sum, 4096, 31, 13721, 394, 0, 0, 14146, 1
n1000x8192-coef-sum, 4096, 30, 13568, 398, 0, 0, 13996, 1
n1000x8192-coef-sum, 4096, 33, 13634, 392, 0, 0, 14059, 1
n1000x8192-coef-sum, 4096, 30, 13693, 397, 0, 0, 14120, 1
n1000x8192-coef-sum, 4096, 31, 13647, 397, 0, 0, 14075, 1
n1000x8192-coef-sum, 4096, 33, 13696, 400, 0, 0, 14129, 1
n1000x8192-coef-sum, 4096, 33, 13566, 388, 0, 0, 13987, 1
n1000x8192-coef-sum, 4096, 30, 13564, 391, 0, 0, 13985, 1
n1000x8192-coef-sum, 4096, 32, 13624, 391, 0, 0, 14047, 1
n1000x8192-coef-sum, 4096, 31, 13733, 400, 0, 0, 14164, 1
n1000x8192-coef-sum, 4096, 30, 13722, 390, 0, 0, 14142, 1
n1000x8192-coef-sum, 4096, 31, 13793, 397, 0, 0, 14221, 1
n1000x8192-coef-sum, 4096, 34, 13716, 393, 0, 0, 14143, 1
n1000x8192-coef-sum, 4096, 32, 13550, 391, 0, 0, 13973, 1
n1000x8192-coef-sum, 4096, 30, 13559, 396, 0, 0, 13985, 1
n1000x8192-coef-sum, 4096, 31, 13574, 388, 0, 0, 13993, 1
n1000x8192-coef-sum, 4096, 30, 13571, 390, 0, 0, 13991, 1
n1000x8192-coef-sum, 4096, 33, 13545, 388, 0, 0, 13966, 1
n1000x8192-coef-sum, 2048, 18, 13480, 427, 0, 0, 13925, 1
n1000x8192-coef-sum, 2048, 17, 13462, 409, 0, 0, 13888, 1
n1000x8192-coef-sum, 2048, 21, 13584, 416, 0, 0, 14021, 1
n1000x8192-coef-sum, 2048, 18, 13535, 414, 0, 0, 13967, 1
n1000x8192-coef-sum, 2048, 17, 13541, 412, 0, 0, 13970, 1
n1000x8192-coef-sum, 2048, 18, 13491, 412, 0, 0, 13921, 1
n1000x8192-coef-sum, 2048, 17, 13562, 410, 0, 0, 13989, 1
n1000x8192-coef-sum, 2048, 17, 13489, 410, 0, 0, 13916, 1
n1000x8192-coef-sum, 2048, 18, 13518, 419, 0, 0, 13955, 1
n1000x8192-coef-sum, 2048, 18, 13513, 410, 0, 0, 13941, 1
n1000x8192-coef-sum, 2048, 17, 13674, 417, 0, 0, 14108, 1
n1000x8192-coef-sum, 2048, 18, 13617, 416, 0, 0, 14051, 1
n1000x8192-coef-sum, 2048, 18, 13674, 412, 0, 0, 14104, 1
n1000x8192-coef-sum, 2048, 18, 13591, 414, 0, 0, 14023, 1
n1000x8192-coef-sum, 2048, 18, 13581, 411, 0, 0, 14010, 1
n1000x8192-coef-sum, 2048, 17, 13533, 411, 0, 0, 13961, 1
n1000x8192-coef-sum, 2048, 17, 13869, 415, 0, 0, 14301, 1
n1000x8192-coef-sum, 2048, 25, 13498, 408, 0, 0, 13931, 1
n1000x8192-coef-sum, 2048, 21, 13569, 416, 0, 0, 14006, 1
n1000x8192-coef-sum, 2048, 18, 13502, 413, 0, 0, 13933, 1
n1000x8192-coef-sum, 2048, 18, 13482, 416, 0, 0, 13916, 1
n1000x8192-coef-sum, 2048, 17, 13564, 417, 0, 0, 13998, 1
n1000x8192-coef-sum, 2048, 18, 13580, 420, 0, 0, 14018, 1
n1000x8192-coef-sum, 2048, 18, 13670, 411, 0, 0, 14099, 1
n1000x8192-coef-sum, 2048, 18, 13626, 412, 0, 0, 14056, 1
n1000x8192-coef-sum, 2048, 18, 13596, 420, 0, 0, 14034, 1
n1000x8192-coef-sum, 2048, 18, 13578, 414, 0, 0, 14010, 1
n1000x8192-coef-sum, 2048, 17, 13559, 415, 0, 0, 13991, 1
n1000x8192-coef-sum, 2048, 18, 13543, 419, 0, 0, 13980, 1
n1000x8192-coef-sum, 2048, 18, 13572, 416, 0, 0, 14006, 1
n1000x8192-coef-sum, 2048, 18, 13543, 410, 0, 0, 13971, 1
n1000x8192-coef-sum, 2048, 18, 13626, 412, 0, 0, 14056, 1
n1000x8192-coef-sum, 2048, 18, 13471, 411, 0, 0, 13900, 1
n1000x8192-coef-sum, 2048, 18, 13516, 410, 0, 0, 13944, 1
n1000x8192-coef-sum, 2048, 18, 13549, 409, 0, 0, 13976, 1
n1000x8192-coef-sum, 2048, 18, 13522, 411, 0, 0, 13951, 1
n1000x8192-coef-sum, 2048, 18, 13490, 413, 0, 0, 13921, 1
n1000x8192-coef-sum, 2048, 18, 13451, 423, 0, 0, 13892, 1
n1000x8192-coef-sum, 2048, 17, 13444, 412, 0, 0, 13873, 1
n1000x8192-coef-sum, 2048, 21, 13490, 409, 0, 0, 13920, 1
n1000x8192-coef-sum, 2048, 19, 13485, 414, 0, 0, 13918, 1
n1000x8192-coef-sum, 2048, 21, 13515, 413, 0, 0, 13949, 1
n1000x8192-coef-sum, 2048, 20, 13513, 420, 0, 0, 13953, 1
n1000x8192-coef-sum, 2048, 18, 13618, 416, 0, 0, 14052, 1
n1000x8192-coef-sum, 2048, 18, 13599, 422, 0, 0, 14039, 1
n1000x8192-coef-sum, 2048, 18, 13475, 410, 0, 0, 13903, 1
n1000x8192-coef-sum, 2048, 17, 13461, 411, 0, 0, 13889, 1
n1000x8192-coef-sum, 2048, 18, 13504, 416, 0, 0, 13938, 1
n1000x8192-coef-sum, 2048, 27, 13510, 416, 0, 0, 13953, 1
n1000x8192-coef-sum, 2048, 22, 13504, 413, 0, 0, 13939, 1
n1000x8192-coef-sum, 2048, 18, 13467, 411, 0, 0, 13896, 1
n1000x8192-coef-sum, 2048, 18, 13527, 411, 0, 0, 13956, 1
n1000x8192-coef-sum, 2048, 18, 13557, 416, 0, 0, 13991, 1
n1000x8192-coef-sum, 2048, 18, 13486, 418, 0, 0, 13922, 1
n1000x8192-coef-sum, 2048, 18, 13505, 411, 0, 0, 13934, 1
n1000x8192-coef-sum, 2048, 18, 13540, 418, 0, 0, 13976, 1
n1000x8192-coef-sum, 2048, 18, 13563, 413, 0, 0, 13994, 1
n1000x8192-coef-sum, 2048, 17, 13583, 412, 0, 0, 14012, 1
n1000x8192-coef-sum, 2048, 17, 13599, 412, 0, 0, 14028, 1
n1000x8192-coef-sum, 2048, 18, 13589, 432, 0, 0, 14039, 1
n1000x8192-coef-sum, 2048, 21, 13553, 417, 0, 0, 13991, 1
n1000x8192-coef-sum, 2048, 18, 13480, 413, 0, 0, 13911, 1
n1000x8192-coef-sum, 2048, 18, 13538, 414, 0, 0, 13970, 1
n1000x8192-coef-sum, 2048, 21, 13522, 413, 0, 0, 13956, 1
n1000x8192-coef-sum, 2048, 21, 13511, 409, 0, 0, 13941, 1
n1000x8192-coef-sum, 2048, 18, 13451, 411, 0, 0, 13880, 1
n1000x8192-coef-sum, 2048, 17, 13459, 407, 0, 0, 13883, 1
n1000x8192-coef-sum, 2048, 17, 13448, 413, 0, 0, 13878, 1
n1000x8192-coef-sum, 2048, 18, 13506, 410, 0, 0, 13934, 1
n1000x8192-coef-sum, 2048, 18, 13506, 425, 0, 0, 13949, 1
n1000x8192-coef-sum, 2048, 17, 13485, 409, 0, 0, 13911, 1
n1000x8192-coef-sum, 2048, 18, 13478, 408, 0, 0, 13904, 1
n1000x8192-coef-sum, 2048, 18, 13557, 413, 0, 0, 13988, 1
n1000x8192-coef-sum, 2048, 19, 13432, 415, 0, 0, 13866, 1
n1000x8192-coef-sum, 2048, 17, 13437, 408, 0, 0, 13862, 1
n1000x8192-coef-sum, 2048, 18, 13433, 412, 0, 0, 13863, 1
n1000x8192-coef-sum, 2048, 17, 13494, 411, 0, 0, 13922, 1
n1000x8192-coef-sum, 2048, 18, 13616, 425, 0, 0, 14059, 1
n1000x8192-coef-sum, 2048, 18, 13551, 411, 0, 0, 13980, 1
n1000x8192-coef-sum, 2048, 18, 13501, 413, 0, 0, 13932, 1
n1000x8192-coef-sum, 2048, 18, 13551, 412, 0, 0, 13981, 1
n1000x8192-coef-sum, 2048, 17, 13603, 415, 0, 0, 14035, 1
n1000x8192-coef-sum, 2048, 18, 13625, 411, 0, 0, 14054, 1
n1000x8192-coef-sum, 2048, 18, 13937, 420, 0, 0, 14375, 1
n1000x8192-coef-sum, 2048, 18, 13655, 416, 0, 0, 14089, 1
n1000x8192-coef-sum, 2048, 17, 13502, 414, 0, 0, 13933, 1
n1000x8192-coef-sum, 2048, 17, 13496, 413, 0, 0, 13926, 1
n1000x8192-coef-sum, 2048, 18, 13495, 412, 0, 0, 13925, 1
n1000x8192-coef-sum, 2048, 18, 13522, 418, 0, 0, 13958, 1
n1000x8192-coef-sum, 2048, 17, 13481, 412, 0, 0, 13910, 1
n1000x8192-coef-sum, 2048, 17, 13419, 411, 0, 0, 13847, 1
n1000x8192-coef-sum, 2048, 18, 13467, 410, 0, 0, 13895, 1
n1000x8192-coef-sum, 2048, 17, 13463, 411, 0, 0, 13891, 1
n1000x8192-coef-sum, 2048, 28, 13453, 408, 0, 0, 13889, 1
n1000x8192-coef-sum, 2048, 22, 13476, 418, 0, 0, 13916, 1
n1000x8192-coef-sum, 2048, 22, 13564, 415, 0, 0, 14001, 1
n1000x8192-coef-sum, 2048, 18, 13451, 414, 0, 0, 13883, 1
n1000x8192-coef-sum, 2048, 17, 13551, 417, 0, 0, 13985, 1
n1000x8192-coef-sum, 2048, 18, 13556, 418, 0, 0, 13992, 1
n1000x8192-coef-sum, 2048, 20, 13488, 414, 0, 0, 13922, 1
n1000x8192-coef-sum, 1024, 13, 13991, 456, 0, 0, 14460, 1
n1000x8192-coef-sum, 1024, 13, 14060, 458, 0, 0, 14531, 1
n1000x8192-coef-sum, 1024, 12, 14085, 472, 0, 0, 14569, 1
n1000x8192-coef-sum, 1024, 13, 14085, 461, 0, 0, 14559, 1
n1000x8192-coef-sum, 1024, 13, 14018, 455, 0, 0, 14486, 1
n1000x8192-coef-sum, 1024, 13, 14172, 458, 0, 0, 14643, 1
n1000x8192-coef-sum, 1024, 13, 14089, 458, 0, 0, 14560, 1
n1000x8192-coef-sum, 1024, 13, 14002, 459, 0, 0, 14474, 1
n1000x8192-coef-sum, 1024, 12, 14011, 459, 0, 0, 14482, 1
n1000x8192-coef-sum, 1024, 13, 14076, 458, 0, 0, 14547, 1
n1000x8192-coef-sum, 1024, 13, 13987, 457, 0, 0, 14457, 1
n1000x8192-coef-sum, 1024, 14, 14039, 463, 0, 0, 14516, 1
n1000x8192-coef-sum, 1024, 12, 14062, 454, 0, 0, 14528, 1
n1000x8192-coef-sum, 1024, 13, 14088, 458, 0, 0, 14559, 1
n1000x8192-coef-sum, 1024, 13, 14044, 455, 0, 0, 14512, 1
n1000x8192-coef-sum, 1024, 12, 14061, 457, 0, 0, 14530, 1
n1000x8192-coef-sum, 1024, 13, 14126, 457, 0, 0, 14596, 1
n1000x8192-coef-sum, 1024, 13, 14158, 456, 0, 0, 14627, 1
n1000x8192-coef-sum, 1024, 13, 14162, 467, 0, 0, 14642, 1
n1000x8192-coef-sum, 1024, 13, 14235, 460, 0, 0, 14708, 1
n1000x8192-coef-sum, 1024, 13, 14194, 461, 0, 0, 14668, 1
n1000x8192-coef-sum, 1024, 13, 14183, 459, 0, 0, 14655, 1
n1000x8192-coef-sum, 1024, 12, 14045, 469, 0, 0, 14526, 1
n1000x8192-coef-sum, 1024, 13, 14001, 456, 0, 0, 14470, 1
n1000x8192-coef-sum, 1024, 13, 14000, 460, 0, 0, 14473, 1
n1000x8192-coef-sum, 1024, 13, 14090, 458, 0, 0, 14561, 1
n1000x8192-coef-sum, 1024, 13, 14034, 465, 0, 0, 14512, 1
n1000x8192-coef-sum, 1024, 13, 13963, 456, 0, 0, 14432, 1
n1000x8192-coef-sum, 1024, 13, 14031, 460, 0, 0, 14504, 1
n1000x8192-coef-sum, 1024, 13, 14032, 457, 0, 0, 14502, 1
n1000x8192-coef-sum, 1024, 13, 14033, 459, 0, 0, 14505, 1
n1000x8192-coef-sum, 1024, 13, 13992, 456, 0, 0, 14461, 1
n1000x8192-coef-sum, 1024, 13, 14059, 457, 0, 0, 14529, 1
n1000x8192-coef-sum, 1024, 12, 14009, 462, 0, 0, 14483, 1
n1000x8192-coef-sum, 1024, 13, 14006, 455, 0, 0, 14474, 1
n1000x8192-coef-sum, 1024, 13, 13987, 456, 0, 0, 14456, 1
n1000x8192-coef-sum, 1024, 12, 13964, 458, 0, 0, 14434, 1
n1000x8192-coef-sum, 1024, 12, 14054, 457, 0, 0, 14523, 1
n1000x8192-coef-sum, 1024, 12, 13988, 463, 0, 0, 14463, 1
n1000x8192-coef-sum, 1024, 12, 13998, 457, 0, 0, 14467, 1
n1000x8192-coef-sum, 1024, 13, 14015, 455, 0, 0, 14483, 1
n1000x8192-coef-sum, 1024, 13, 14050, 465, 0, 0, 14528, 1
n1000x8192-coef-sum, 1024, 13, 14080, 463, 0, 0, 14556, 1
n1000x8192-coef-sum, 1024, 15, 14018, 463, 0, 0, 14496, 1
n1000x8192-coef-sum, 1024, 14, 14056, 460, 0, 0, 14530, 1
n1000x8192-coef-sum, 1024, 12, 14091, 458, 0, 0, 14561, 1
n1000x8192-coef-sum, 1024, 13, 14013, 453, 0, 0, 14479, 1
n1000x8192-coef-sum, 1024, 13, 14129, 460, 0, 0, 14602, 1
n1000x8192-coef-sum, 1024, 13, 13990, 455, 0, 0, 14458, 1
n1000x8192-coef-sum, 1024, 13, 14047, 471, 0, 0, 14531, 1
n1000x8192-coef-sum, 1024, 13, 14016, 459, 0, 0, 14488, 1
n1000x8192-coef-sum, 1024, 13, 13989, 461, 0, 0, 14463, 1
n1000x8192-coef-sum, 1024, 13, 13992, 456, 0, 0, 14461, 1
n1000x8192-coef-sum, 1024, 13, 14060, 461, 0, 0, 14534, 1
n1000x8192-coef-sum, 1024, 12, 14027, 457, 0, 0, 14496, 1
n1000x8192-coef-sum, 1024, 13, 13985, 455, 0, 0, 14453, 1
n1000x8192-coef-sum, 1024, 13, 13987, 465, 0, 0, 14465, 1
n1000x8192-coef-sum, 1024, 13, 14028, 470, 0, 0, 14511, 1
n1000x8192-coef-sum, 1024, 14, 13991, 458, 0, 0, 14463, 1
n1000x8192-coef-sum, 1024, 13, 14001, 457, 0, 0, 14471, 1
n1000x8192-coef-sum, 1024, 12, 14094, 463, 0, 0, 14569, 1
n1000x8192-coef-sum, 1024, 13, 14015, 454, 0, 0, 14482, 1
n1000x8192-coef-sum, 1024, 13, 13980, 490, 0, 0, 14483, 1
n1000x8192-coef-sum, 1024, 13, 13971, 455, 0, 0, 14439, 1
n1000x8192-coef-sum, 1024, 13, 14220, 467, 0, 0, 14700, 1
n1000x8192-coef-sum, 1024, 12, 14330, 463, 0, 0, 14805, 1
n1000x8192-coef-sum, 1024, 13, 13968, 458, 0, 0, 14439, 1
n1000x8192-coef-sum, 1024, 13, 14023, 460, 0, 0, 14496, 1
n1000x8192-coef-sum, 1024, 13, 14028, 455, 0, 0, 14496, 1
n1000x8192-coef-sum, 1024, 12, 14016, 465, 0, 0, 14493, 1
n1000x8192-coef-sum, 1024, 12, 13986, 459, 0, 0, 14457, 1
n1000x8192-coef-sum, 1024, 14, 14060, 455, 0, 0, 14529, 1
n1000x8192-coef-sum, 1024, 13, 14092, 461, 0, 0, 14566, 1
n1000x8192-coef-sum, 1024, 13, 14077, 469, 0, 0, 14559, 1
n1000x8192-coef-sum, 1024, 12, 14127, 470, 0, 0, 14609, 1
n1000x8192-coef-sum, 1024, 13, 14037, 457, 0, 0, 14507, 1
n1000x8192-coef-sum, 1024, 13, 14149, 457, 0, 0, 14619, 1
n1000x8192-coef-sum, 1024, 13, 14003, 459, 0, 0, 14475, 1
n1000x8192-coef-sum, 1024, 13, 14112, 458, 0, 0, 14583, 1
n1000x8192-coef-sum, 1024, 13, 14061, 458, 0, 0, 14532, 1
n1000x8192-coef-sum, 1024, 12, 14198, 461, 0, 0, 14671, 1
n1000x8192-coef-sum, 1024, 13, 14103, 460, 0, 0, 14576, 1
n1000x8192-coef-sum, 1024, 13, 14075, 458, 0, 0, 14546, 1
n1000x8192-coef-sum, 1024, 13, 14078, 461, 0, 0, 14552, 1
n1000x8192-coef-sum, 1024, 13, 14121, 456, 0, 0, 14590, 1
n1000x8192-coef-sum, 1024, 12, 14039, 456, 0, 0, 14507, 1
n1000x8192-coef-sum, 1024, 13, 13976, 457, 0, 0, 14446, 1
n1000x8192-coef-sum, 1024, 13, 14030, 461, 0, 0, 14504, 1
n1000x8192-coef-sum, 1024, 12, 14065, 459, 0, 0, 14536, 1
n1000x8192-coef-sum, 1024, 13, 14028, 457, 0, 0, 14498, 1
n1000x8192-coef-sum, 1024, 13, 13979, 455, 0, 0, 14447, 1
n1000x8192-coef-sum, 1024, 12, 14036, 455, 0, 0, 14503, 1
n1000x8192-coef-sum, 1024, 14, 14057, 455, 0, 0, 14526, 1
n1000x8192-coef-sum, 1024, 13, 13998, 458, 0, 0, 14469, 1
n1000x8192-coef-sum, 1024, 12, 14068, 467, 0, 0, 14547, 1
n1000x8192-coef-sum, 1024, 14, 14013, 457, 0, 0, 14484, 1
n1000x8192-coef-sum, 1024, 12, 14091, 457, 0, 0, 14560, 1
n1000x8192-coef-sum, 1024, 12, 14081, 457, 0, 0, 14550, 1
n1000x8192-coef-sum, 1024, 14, 14052, 456, 0, 0, 14522, 1
n1000x8192-coef-sum, 1024, 12, 13990, 460, 0, 0, 14462, 1
n1000x8192-slot-sum, 8192, 267, 7936, 404, 1, 0, 8608, 1
n1000x8192-slot-sum, 8192, 269, 8028, 410, 1, 0, 8708, 1
n1000x8192-slot-sum, 8192, 279, 8031, 414, 1, 0, 8725, 1
n1000x8192-slot-sum, 8192, 264, 7942, 407, 1, 0, 8614, 1
n1000x8192-slot-sum, 8192, 263, 7940, 404, 1, 0, 8608, 1
n1000x8192-slot-sum, 8192, 272, 7948, 406, 1, 0, 8627, 1
n1000x8192-slot-sum, 8192, 264, 7946, 406, 1, 0, 8617, 1
n1000x8192-slot-sum, 8192, 267, 8021, 408, 1, 0, 8697, 1
n1000x8192-slot-sum, 8192, 266, 7984, 409, 1, 0, 8660, 1
n1000x8192-slot-sum, 8192, 264, 7947, 412, 1, 0, 8624, 1
n1000x8192-slot-sum, 8192, 262, 7968, 421, 1, 0, 8652, 1
n1000x8192-slot-sum, 8192, 269, 7928, 407, 1, 0, 8605, 1
n1000x8192-slot-sum, 8192, 263, 7937, 406, 1, 0, 8607, 1
n1000x8192-slot-sum, 8192, 268, 7951, 407, 1, 0, 8627, 1
n1000x8192-slot-sum, 8192, 269, 7991, 409, 1, 0, 8670, 1
n1000x8192-slot-sum, 8192, 263, 7934, 404, 1, 0, 8602, 1
n1000x8192-slot-sum, 8192, 271, 7966, 415, 1, 0, 8653, 1
n1000x8192-slot-sum, 8192, 266, 7951, 412, 1, 0, 8630, 1
n1000x8192-slot-sum, 8192, 268, 7979, 412, 1, 0, 8660, 1
n1000x8192-slot-sum, 8192, 265, 7956, 405, 1, 0, 8627, 1
n1000x8192-slot-sum, 8192, 266, 8017, 414, 1, 0, 8698, 1
n1000x8192-slot-sum, 8192, 268, 7965, 405, 1, 0, 8639, 1
n1000x8192-slot-sum, 8192, 265, 8003, 412, 1, 0, 8681, 1
n1000x8192-slot-sum, 8192, 265, 7953, 410, 1, 0, 8629, 1
n1000x8192-slot-sum, 8192, 263, 7996, 407, 1, 0, 8667, 1
n1000x8192-slot-sum, 8192, 266, 7966, 410, 1, 0, 8643, 1
n1000x8192-slot-sum, 8192, 269, 7971, 419, 1, 0, 8660, 1
n1000x8192-slot-sum, 8192, 264, 7955, 403, 1, 0, 8623, 1
n1000x8192-slot-sum, 8192, 265, 7955, 413, 1, 0, 8634, 1
n1000x8192-slot-sum, 8192, 262, 7942, 406, 1, 0, 8611, 1
n1000x8192-slot-sum, 8192, 264, 7933, 404, 1, 0, 8602, 1
n1000x8192-slot-sum, 8192, 265, 7957, 404, 1, 0, 8627, 1
n1000x8192-slot-sum, 8192, 265, 7999, 412, 1, 0, 8677, 1
n1000x8192-slot-sum, 8192, 265, 7968, 409, 1, 0, 8643, 1
n1000x8192-slot-sum, 8192, 263, 7967, 418, 1, 0, 8649, 1
n1000x8192-slot-sum, 8192, 266, 8001, 408, 1, 0, 8676, 1
n1000x8192-slot-sum, 8192, 271, 7963, 409, 1, 0, 8644, 1
n1000x8192-slot-sum, 8192, 264, 8012, 408, 1, 0, 8685, 1
n1000x8192-slot-sum, 8192, 264, 7971, 410, 1, 0, 8646, 1
n1000x8192-slot-sum, 8192, 267, 7977, 404, 1, 0, 8649, 1
n1000x8192-slot-sum, 8192, 269, 8153, 418, 1, 0, 8841, 1
n1000x8192-slot-sum, 8192, 269, 8048, 409, 1, 0, 8727, 1
n1000x8192-slot-sum, 8192, 266, 8016, 414, 1, 0, 8697, 1
n1000x8192-slot-sum, 8192, 267, 7988, 412, 1, 0, 8668, 1
n1000x8192-slot-sum, 8192, 271, 8063, 414, 1, 0, 8749, 1
n1000x8192-slot-sum, 8192, 266, 8069, 421, 1, 0, 8757, 1
n1000x8192-slot-sum, 8192, 264, 8108, 417, 1, 0, 8790, 1
n1000x8192-slot-sum, 8192, 266, 7964, 405, 1, 0, 8636, 1
n1000x8192-slot-sum, 8192, 267, 7959, 412, 1, 0, 8639, 1
n1000x8192-slot-sum, 8192, 264, 7948, 419, 1, 0, 8632, 1
n1000x8192-slot-sum, 8192, 265, 7972, 411, 1, 0, 8649, 1
n1000x8192-slot-sum, 8192, 263, 7951, 406, 1, 0, 8621, 1
n1000x8192-slot-sum, 8192, 263, 7936, 404, 1, 0, 8604, 1
n1000x8192-slot-sum, 8192, 268, 7968, 406, 1, 0, 8643, 1
n1000x8192-slot-sum, 8192, 268, 7938, 409, 1, 0, 8616, 1
n1000x8192-slot-sum, 8192, 269, 7983, 409, 1, 0, 8662, 1
n1000x8192-slot-sum, 8192, 266, 7963, 408, 1, 0, 8638, 1
n1000x8192-slot-sum, 8192, 270, 7973, 410, 1, 0, 8654, 1
n1000x8192-slot-sum, 8192, 262, 7982, 411, 1, 0, 8656, 1
n1000x8192-slot-sum, 8192, 271, 7944, 413, 1, 0, 8629, 1
n1000x8192-slot-sum, 8192, 268, 7953, 416, 1, 0, 8638, 1
n1000x8192-slot-sum, 8192, 264, 7990, 413, 1, 0, 8668, 1
n1000x8192-slot-sum, 8192, 263, 7952, 408, 1, 0, 8624, 1
n1000x8192-slot-sum, 8192, 263, 7937, 407, 1, 0, 8608, 1
n1000x8192-slot-sum, 8192, 264, 7941, 406, 1, 0, 8612, 1
n1000x8192-slot-sum, 8192, 265, 7941, 406, 1, 0, 8613, 1
n1000x8192-slot-sum, 8192, 268, 8036, 408, 1, 0, 8713, 1
n1000x8192-slot-sum, 8192, 268, 7996, 406, 1, 0, 8671, 1
n1000x8192-slot-sum, 8192, 266, 7975, 409, 1, 0, 8651, 1
n1000x8192-slot-sum, 8192, 269, 8004, 413, 1, 0, 8687, 1
n1000x8192-slot-sum, 8192, 268, 7964, 406, 1, 0, 8639, 1
n1000x8192-slot-sum, 8192, 269, 7970, 417, 1, 0, 8657, 1
n1000x8192-slot-sum, 8192, 262, 7960, 405, 1, 0, 8628, 1
n1000x8192-slot-sum, 8192, 264, 7946, 404, 1, 0, 8615, 1
n1000x8192-slot-sum, 8192, 266, 7965, 416, 1, 0, 8648, 1
n1000x8192-slot-sum, 8192, 266, 7943, 405, 1, 0, 8615, 1
n1000x8192-slot-sum, 8192, 266, 7926, 406, 1, 0, 8599, 1
n1000x8192-slot-sum, 8192, 265, 7935, 414, 1, 0, 8615, 1
n1000x8192-slot-sum, 8192, 266, 7957, 403, 1, 0, 8627, 1
n1000x8192-slot-sum, 8192, 266, 7981, 421, 1, 0, 8669, 1
n1000x8192-slot-sum, 8192, 268, 7939, 424, 1, 0, 8632, 1
n1000x8192-slot-sum, 8192, 264, 7963, 411, 1, 0, 8639, 1
n1000x8192-slot-sum, 8192, 271, 8007, 417, 1, 0, 8696, 1
n1000x8192-slot-sum, 8192, 263, 7929, 404, 1, 0, 8597, 1
n1000x8192-slot-sum, 8192, 270, 7992, 405, 1, 0, 8668, 1
n1000x8192-slot-sum, 8192, 260, 7935, 407, 1, 0, 8603, 1
n1000x8192-slot-sum, 8192, 264, 7997, 407, 1, 0, 8669, 1
n1000x8192-slot-sum, 8192, 263, 7932, 414, 1, 0, 8610, 1
n1000x8192-slot-sum, 8192, 267, 7978, 410, 1, 0, 8656, 1
n1000x8192-slot-sum, 8192, 264, 7943, 402, 1, 0, 8610, 1
n1000x8192-slot-sum, 8192, 266, 7971, 404, 1, 0, 8642, 1
n1000x8192-slot-sum, 8192, 263, 7919, 404, 1, 0, 8587, 1
n1000x8192-slot-sum, 8192, 261, 7938, 404, 1, 0, 8604, 1
n1000x8192-slot-sum, 8192, 265, 7926, 411, 1, 0, 8603, 1
n1000x8192-slot-sum, 8192, 266, 7918, 402, 1, 0, 8587, 1
n1000x8192-slot-sum, 8192, 266, 7954, 403, 1, 0, 8624, 1
n1000x8192-slot-sum, 8192, 267, 7948, 408, 1, 0, 8624, 1
n1000x8192-slot-sum, 8192, 264, 7916, 404, 1, 0, 8585, 1
n1000x8192-slot-sum, 8192, 271, 7958, 413, 1, 0, 8643, 1
n1000x8192-slot-sum, 8192, 263, 7989, 407, 1, 0, 8660, 1
n1000x8192-slot-sum, 4096, 124, 7697, 401, 0, 0, 8222, 1
n1000x8192-slot-sum, 4096, 125, 7706, 406, 0, 0, 8237, 1
n1000x8192-slot-sum, 4096, 128, 7704, 416, 0, 0, 8248, 1
n1000x8192-slot-sum, 4096, 126, 7688, 394, 0, 0, 8208, 1
n1000x8192-slot-sum, 4096, 126, 7694, 405, 0, 0, 8225, 1
n1000x8192-slot-sum, 4096, 123, 7686, 395, 0, 0, 8204, 1
n1000x8192-slot-sum, 4096, 125, 7693, 394, 0, 0, 8212, 1
n1000x8192-slot-sum, 4096, 123, 7677, 395, 0, 0, 8195, 1
n1000x8192-slot-sum, 4096, 123, 7639, 395, 0, 0, 8157, 1
n1000x8192-slot-sum, 4096, 127, 7685, 404, 0, 0, 8216, 1
n1000x8192-slot-sum, 4096, 125, 7701, 397, 0, 0, 8223, 1
n1000x8192-slot-sum, 4096, 128, 7730, 400, 0, 0, 8258, 1
n1000x8192-slot-sum, 4096, 123, 7680, 396, 0, 0, 8199, 1
n1000x8192-slot-sum, 4096, 125, 7681, 399, 0, 0, 8205, 1
n1000x8192-slot-sum, 4096, 124, 7656, 392, 0, 0, 8172, 1
n1000x8192-slot-sum, 4096, 124, 7657, 396, 0, 0, 8177, 1
n1000x8192-slot-sum, 4096, 125, 7688, 403, 0, 0, 8216, 1
n1000x8192-slot-sum, 4096, 127, 7681, 397, 0, 0, 8205, 1
n1000x8192-slot-sum, 4096, 127, 7703, 403, 0, 0, 8233, 1
n1000x8192-slot-sum, 4096, 123, 7679, 392, 0, 0, 8194, 1
n1000x8192-slot-sum, 4096, 125, 7739, 392, 0, 0, 8256, 1
n1000x8192-slot-sum, 4096, 127, 7712, 389, 0, 0, 8228, 1
n1000x8192-slot-sum, 4096, 124, 7643, 396, 0, 0, 8163, 1
n1000x8192-slot-sum, 4096, 124, 7751, 402, 0, 0, 8277, 1
n1000x8192-slot-sum, 4096, 125, 7653, 394, 0, 0, 8172, 1
n1000x8192-slot-sum, 4096, 123, 7668, 395, 0, 0, 8186, 1
n1000x8192-slot-sum, 4096, 123, 7676, 397, 0, 0, 8196, 1
n1000x8192-slot-sum, 4096, 127, 7662, 394, 0, 0, 8183, 1
n1000x8192-slot-sum, 4096, 128, 7678, 393, 0, 0, 8199, 1
n1000x8192-slot-sum, 4096, 125, 7709, 398, 0, 0, 8232, 1
n1000x8192-slot-sum, 4096, 123, 7694, 397, 0, 0, 8214, 1
n1000x8192-slot-sum, 4096, 123, 7710, 401, 0, 0, 8234, 1
n1000x8192-slot-sum, 4096, 129, 7692, 400, 0, 0, 8221, 1
n1000x8192-slot-sum, 4096, 127, 7769, 403, 0, 0, 8299, 1
n1000x8192-slot-sum, 4096, 124, 7677, 392, 0, 0, 8193, 1
n1000x8192-slot-sum, 4096, 125, 7662, 394, 0, 0, 8181, 1
n1000x8192-slot-sum, 4096, 124, 7671, 400, 0, 0, 8195, 1
n1000x8192-slot-sum, 4096, 134, 7665, 393, 0, 0, 8192, 1
n1000x8192-slot-sum, 4096, 125, 7677, 393, 0, 0, 8195, 1
n1000x8192-slot-sum, 4096, 125, 7790, 403, 0, 0, 8318, 1
n1000x8192-slot-sum, 4096, 134, 7737, 400, 0, 0, 8271, 1
n1000x8192-slot-sum, 4096, 129, 7791, 402, 0, 0, 8322, 1
n1000x8192-slot-sum, 4096, 122, 7673, 395, 0, 0, 8190, 1
n1000x8192-slot-sum, 4096, 130, 7747, 402, 0, 0, 8279, 1
n1000x8192-slot-sum, 4096, 123, 7652, 397, 0, 0, 8172, 1
n1000x8192-slot-sum, 4096, 126, 7663, 392, 0, 0, 8181, 1
n1000x8192-slot-sum, 4096, 123, 7687, 392, 0, 0, 8202, 1
n1000x8192-slot-sum, 4096, 124, 7696, 391, 0, 0, 8211, 1
n1000x8192-slot-sum, 4096, 124, 7678, 392, 0, 0, 8194, 1
n1000x8192-slot-sum, 4096, 126, 7751, 401, 0, 0, 8278, 1
n1000x8192-slot-sum, 4096, 125, 7700, 393, 0, 0, 8218, 1
n1000x8192-slot-sum, 4096, 125, 7681, 400, 0, 0, 8206, 1
n1000x8192-slot-sum, 4096, 126, 7724, 402, 0, 0, 8252, 1
n1000x8192-slot-sum, 4096, 124, 7762, 401, 0, 0, 8287, 1
n1000x8192-slot-sum, 4096, 123, 7681, 392, 0, 0, 8196, 1
n1000x8192-slot-sum, 4096, 127, 7692, 392, 0, 0, 8211, 1
n1000x8192-slot-sum, 4096, 123, 7674, 394, 0, 0, 8191, 1
n1000x8192-slot-sum, 4096, 126, 7662, 394, 0, 0, 8182, 1
n1000x8192-slot-sum, 4096, 125, 7651, 392, 0, 0, 8168, 1
n1000x8192-slot-sum, 4096, 133, 7668, 397, 0, 0, 8198, 1
n1000x8192-slot-sum, 4096, 124, 7704, 397, 0, 0, 8225, 1
n1000x8192-slot-sum, 4096, 129, 7664, 392, 0, 0, 8185, 1
n1000x8192-slot-sum, 4096, 127, 7696, 400, 0, 0, 8223, 1
n1000x8192-slot-sum, 4096, 124, 7625, 393, 0, 0, 8142, 1
n1000x8192-slot-sum, 4096, 124, 7659, 396, 0, 0, 8179, 1
n1000x8192-slot-sum, 4096, 125, 7714, 401, 0, 0, 8240, 1
n1000x8192-slot-sum, 4096, 128, 7665, 397, 0, 0, 8190, 1
n1000x8192-slot-sum, 4096, 124, 7687, 389, 0, 0, 8200, 1
n1000x8192-slot-sum, 4096, 123, 7655, 400, 0, 0, 8178, 1
n1000x8192-slot-sum, 4096, 123, 7647, 392, 0, 0, 8162, 1
n1000x8192-slot-sum, 4096, 126, 7686, 395, 0, 0, 8207, 1
n1000x8192-slot-sum, 4096, 131, 7738, 400, 0, 0, 8269, 1
n1000x8192-slot-sum, 4096, 125, 7703, 396, 0, 0, 8224, 1
n1000x8192-slot-sum, 4096, 125, 7689, 395, 0, 0, 8209, 1
n1000x8192-slot-sum, 4096, 125, 7747, 392, 0, 0, 8264, 1
n1000x8192-slot-sum, 4096, 127, 7682, 392, 0, 0, 8201, 1
n1000x8192-slot-sum, 4096, 124, 7659, 394, 0, 0, 8177, 1
n1000x8192-slot-sum, 4096, 125, 7718, 405, 0, 0, 8248, 1
n1000x8192-slot-sum, 4096, 128, 7723, 428, 0, 0, 8279, 1
n1000x8192-slot-sum, 4096, 125, 7736, 399, 0, 0, 8260, 1
n1000x8192-slot-sum, 4096, 125, 7678, 395, 0, 0, 8198, 1
n1000x8192-slot-sum, 4096, 129, 7678, 390, 0, 0, 8197, 1
n1000x8192-slot-sum, 4096, 126, 7697, 392, 0, 0, 8215, 1
n1000x8192-slot-sum, 4096, 135, 7673, 394, 0, 0, 8202, 1
n1000x8192-slot-sum, 4096, 130, 7678, 394, 0, 0, 8202, 1
n1000x8192-slot-sum, 4096, 125, 7737, 408, 0, 0, 8270, 1
n1000x8192-slot-sum, 4096, 126, 7678, 401, 0, 0, 8205, 1
n1000x8192-slot-sum, 4096, 123, 7722, 392, 0, 0, 8237, 1
n1000x8192-slot-sum, 4096, 123, 7691, 399, 0, 0, 8213, 1
n1000x8192-slot-sum, 4096, 124, 7686, 408, 0, 0, 8218, 1
n1000x8192-slot-sum, 4096, 123, 7645, 392, 0, 0, 8160, 1
n1000x8192-slot-sum, 4096, 126, 7674, 404, 0, 0, 8204, 1
n1000x8192-slot-sum, 4096, 127, 7700, 402, 0, 0, 8229, 1
n1000x8192-slot-sum, 4096, 126, 7685, 400, 0, 0, 8211, 1
n1000x8192-slot-sum, 4096, 126, 7759, 403, 0, 0, 8288, 1
n1000x8192-slot-sum, 4096, 125, 7715, 400, 0, 0, 8240, 1
n1000x8192-slot-sum, 4096, 127, 7695, 400, 0, 0, 8222, 1
n1000x8192-slot-sum, 4096, 127, 7651, 395, 0, 0, 8173, 1
n1000x8192-slot-sum, 4096, 124, 7655, 393, 0, 0, 8172, 1
n1000x8192-slot-sum, 4096, 123, 7653, 395, 0, 0, 8171, 1
n1000x8192-slot-sum, 2048, 59, 7492, 405, 0, 0, 7956, 1
n1000x8192-slot-sum, 2048, 62, 7565, 413, 0, 0, 8040, 1
n1000x8192-slot-sum, 2048, 59, 7536, 418, 0, 0, 8013, 1
n1000x8192-slot-sum, 2048, 59, 7492, 416, 0, 0, 7967, 1
n1000x8192-slot-sum, 2048, 59, 7522, 414, 0, 0, 7995, 1
n1000x8192-slot-sum, 2048, 59, 7509, 420, 0, 0, 7988, 1
n1000x8192-slot-sum, 2048, 62, 7513, 406, 0, 0, 7981, 1
n1000x8192-slot-sum, 2048, 59, 7503, 409, 0, 0, 7971, 1
n1000x8192-slot-sum, 2048, 59, 7519, 407, 0, 0, 7985, 1
n1000x8192-slot-sum, 2048, 60, 7545, 408, 0, 0, 8013, 1
n1000x8192-slot-sum, 2048, 59, 7529, 412, 0, 0, 8000, 1
n1000x8192-slot-sum, 2048, 62, 7490, 407, 0, 0, 7959, 1
n1000x8192-slot-sum, 2048, 71, 7499, 411, 0, 0, 7981, 1
n1000x8192-slot-sum, 2048, 59, 7492, 406, 0, 0, 7957, 1
n1000x8192-slot-sum, 2048, 59, 7499, 412, 0, 0, 7970, 1
n1000x8192-slot-sum, 2048, 61, 7526, 405, 0, 0, 7992, 1
n1000x8192-slot-sum, 2048, 59, 7511, 406, 0, 0, 7976, 1
n1000x8192-slot-sum, 2048, 60, 7509, 408, 0, 0, 7977, 1
n1000x8192-slot-sum, 2048, 59, 7504, 410, 0, 0, 7973, 1
n1000x8192-slot-sum, 2048, 60, 7512, 408, 0, 0, 7980, 1
n1000x8192-slot-sum, 2048, 59, 7500, 406, 0, 0, 7965, 1
n1000x8192-slot-sum, 2048, 59, 7497, 409, 0, 0, 7965, 1
n1000x8192-slot-sum, 2048, 59, 7519, 416, 0, 0, 7994, 1
n1000x8192-slot-sum, 2048, 60, 7492, 417, 0, 0, 7969, 1
n1000x8192-slot-sum, 2048, 60, 7524, 410, 0, 0, 7994, 1
n1000x8192-slot-sum, 2048, 59, 7537, 409, 0, 0, 8005, 1
n1000x8192-slot-sum, 2048, 62, 7539, 407, 0, 0, 8008, 1
n1000x8192-slot-sum, 2048, 59, 7492, 406, 0, 0, 7957, 1
n1000x8192-slot-sum, 2048, 59, 7560, 409, 0, 0, 8028, 1
n1000x8192-slot-sum, 2048, 60, 7534, 416, 0, 0, 8010, 1
n1000x8192-slot-sum, 2048, 60, 7507, 407, 0, 0, 7974, 1
n1000x8192-slot-sum, 2048, 59, 7492, 405, 0, 0, 7956, 1
n1000x8192-slot-sum, 2048, 59, 7499, 425, 0, 0, 7983, 1
n1000x8192-slot-sum, 2048, 59, 7501, 410, 0, 0, 7970, 1
n1000x8192-slot-sum, 2048, 59, 7521, 406, 0, 0, 7986, 1
n1000x8192-slot-sum, 2048, 59, 7535, 414, 0, 0, 8008, 1
n1000x8192-slot-sum, 2048, 59, 7544, 416, 0, 0, 8019, 1
n1000x8192-slot-sum, 2048, 59, 7526, 409, 0, 0, 7994, 1
n1000x8192-slot-sum, 2048, 59, 7570, 412, 0, 0, 8041, 1
n1000x8192-slot-sum, 2048, 63, 7533, 407, 0, 0, 8003, 1
n1000x8192-slot-sum, 2048, 60, 7501, 407, 0, 0, 7968, 1
n1000x8192-slot-sum, 2048, 59, 7535, 409, 0, 0, 8003, 1
n1000x8192-slot-sum, 2048, 59, 7505, 413, 0, 0, 7977, 1
n1000x8192-slot-sum, 2048, 63, 7562, 411, 0, 0, 8036, 1
n1000x8192-slot-sum, 2048, 60, 7545, 409, 0, 0, 8014, 1
n1000x8192-slot-sum, 2048, 60, 7511, 413, 0, 0, 7984, 1
n1000x8192-slot-sum, 2048, 59, 7521, 410, 0, 0, 7990, 1
n1000x8192-slot-sum, 2048, 60, 7540, 407, 0, 0, 8007, 1
n1000x8192-slot-sum, 2048, 69, 7525, 412, 0, 0, 8006, 1
n1000x8192-slot-sum, 2048, 59, 7536, 407, 0, 0, 8002, 1
n1000x8192-slot-sum, 2048, 61, 7799, 410, 0, 0, 8270, 1
n1000x8192-slot-sum, 2048, 59, 7500, 408, 0, 0, 7967, 1
n1000x8192-slot-sum, 2048, 59, 7553, 408, 0, 0, 8020, 1
n1000x8192-slot-sum, 2048, 59, 7510, 407, 0, 0, 7976, 1
n1000x8192-slot-sum, 2048, 59, 7522, 407, 0, 0, 7988, 1
n1000x8192-slot-sum, 2048, 62, 7498, 405, 0, 0, 7965, 1
n1000x8192-slot-sum, 2048, 59, 7529, 404, 0, 0, 7992, 1
n1000x8192-slot-sum, 2048, 69, 7599, 419, 0, 0, 8087, 1
n1000x8192-slot-sum, 2048, 65, 7596, 420, 0, 0, 8081, 1
n1000x8192-slot-sum, 2048, 59, 7522, 414, 0, 0, 7995, 1
n1000x8192-slot-sum, 2048, 59, 7539, 408, 0, 0, 8006, 1
n1000x8192-slot-sum, 2048, 59, 7535, 420, 0, 0, 8014, 1
n1000x8192-slot-sum, 2048, 59, 7505, 409, 0, 0, 7973, 1
n1000x8192-slot-sum, 2048, 62, 7508, 417, 0, 0, 7987, 1
n1000x8192-slot-sum, 2048, 61, 7533, 407, 0, 0, 8001, 1
n1000x8192-slot-sum, 2048, 62, 7533, 410, 0, 0, 8005, 1
n1000x8192-slot-sum, 2048, 59, 7529, 410, 0, 0, 7998, 1
n1000x8192-slot-sum, 2048, 59, 7545, 415, 0, 0, 8019, 1
n1000x8192-slot-sum, 2048, 59, 7508, 408, 0, 0, 7975, 1
n1000x8192-slot-sum, 2048, 59, 7491, 412, 0, 0, 7962, 1
n1000x8192-slot-sum, 2048, 59, 7498, 416, 0, 0, 7973, 1
n1000x8192-slot-sum, 2048, 59, 7568, 411, 0, 0, 8038, 1
n1000x8192-slot-sum, 2048, 61, 7503, 406, 0, 0, 7970, 1
n1000x8192-slot-sum, 2048, 59, 7524, 408, 0, 0, 7991, 1
n1000x8192-slot-sum, 2048, 59, 7502, 413, 0, 0, 7974, 1
n1000x8192-slot-sum, 2048, 59, 7561, 408, 0, 0, 8028, 1
n1000x8192-slot-sum, 2048, 63, 7563, 410, 0, 0, 8036, 1
n1000x8192-slot-sum, 2048, 63, 7504, 410, 0, 0, 7977, 1
n1000x8192-slot-sum, 2048, 59, 7532, 407, 0, 0, 7998, 1
n1000x8192-slot-sum, 2048, 61, 7572, 414, 0, 0, 8047, 1
n1000x8192-slot-sum, 2048, 60, 7506, 415, 0, 0, 7981, 1
n1000x8192-slot-sum, 2048, 60, 7547, 408, 0, 0, 8015, 1
n1000x8192-slot-sum, 2048, 61, 7554, 410, 0, 0, 8025, 1
n1000x8192-slot-sum, 2048, 59, 7540, 410, 0, 0, 8009, 1
n1000x8192-slot-sum, 2048, 59, 7540, 414, 0, 0, 8013, 1
n1000x8192-slot-sum, 2048, 61, 7564, 416, 0, 0, 8041, 1
n1000x8192-slot-sum, 2048, 59, 7562, 415, 0, 0, 8036, 1
n1000x8192-slot-sum, 2048, 62, 7534, 409, 0, 0, 8005, 1
n1000x8192-slot-sum, 2048, 60, 7586, 418, 0, 0, 8064, 1
n1000x8192-slot-sum, 2048, 59, 7500, 407, 0, 0, 7966, 1
n1000x8192-slot-sum, 2048, 63, 7555, 417, 0, 0, 8035, 1
n1000x8192-slot-sum, 2048, 59, 7539, 413, 0, 0, 8011, 1
n1000x8192-slot-sum, 2048, 59, 7595, 417, 0, 0, 8071, 1
n1000x8192-slot-sum, 2048, 59, 7529, 412, 0, 0, 8000, 1
n1000x8192-slot-sum, 2048, 61, 7520, 410, 0, 0, 7991, 1
n1000x8192-slot-sum, 2048, 59, 7509, 413, 0, 0, 7981, 1
n1000x8192-slot-sum, 2048, 59, 7515, 407, 0, 0, 7981, 1
n1000x8192-slot-sum, 2048, 61, 7504, 409, 0, 0, 7974, 1
n1000x8192-slot-sum, 2048, 59, 7499, 409, 0, 0, 7967, 1
n1000x8192-slot-sum, 2048, 60, 7521, 414, 0, 0, 7995, 1
n1000x8192-slot-sum, 1024, 32, 7522, 453, 0, 0, 8007, 1
n1000x8192-slot-sum, 1024, 32, 7519, 456, 0, 0, 8007, 1
n1000x8192-slot-sum, 1024, 31, 7524, 455, 0, 0, 8010, 1
n1000x8192-slot-sum, 1024, 32, 7574, 449, 0, 0, 8055, 1
n1000x8192-slot-sum, 1024, 32, 7557, 462, 0, 0, 8051, 1
n1000x8192-slot-sum, 1024, 32, 7537, 455, 0, 0, 8024, 1
n1000x8192-slot-sum, 1024, 31, 7572, 462, 0, 0, 8065, 1
n1000x8192-slot-sum, 1024, 32, 7543, 456, 0, 0, 8031, 1
n1000x8192-slot-sum, 1024, 32, 7546, 458, 0, 0, 8036, 1
n1000x8192-slot-sum, 1024, 32, 7537, 459, 0, 0, 8028, 1
n1000x8192-slot-sum, 1024, 31, 7557, 457, 0, 0, 8045, 1
n1000x8192-slot-sum, 1024, 31, 7550, 458, 0, 0, 8039, 1
n1000x8192-slot-sum, 1024, 32, 7506, 454, 0, 0, 7992, 1
n1000x8192-slot-sum, 1024, 33, 7553, 456, 0, 0, 8042, 1
n1000x8192-slot-sum, 1024, 32, 7504, 446, 0, 0, 7982, 1
n1000x8192-slot-sum, 1024, 32, 7495, 451, 0, 0, 7978, 1
n1000x8192-slot-sum, 1024, 31, 7513, 466, 0, 0, 8010, 1
n1000x8192-slot-sum, 1024, 31, 7518, 453, 0, 0, 8002, 1
n1000x8192-slot-sum, 1024, 31, 7570, 458, 0, 0, 8059, 1
n1000x8192-slot-sum, 1024, 31, 7537, 457, 0, 0, 8025, 1
n1000x8192-slot-sum, 1024, 31, 7542, 454, 0, 0, 8027, 1
n1000x8192-slot-sum, 1024, 32, 7572, 455, 0, 0, 8059, 1
n1000x8192-slot-sum, 1024, 32, 7516, 454, 0, 0, 8002, 1
n1000x8192-slot-sum, 1024, 31, 7514, 453, 0, 0, 7998, 1
n1000x8192-slot-sum, 1024, 32, 7513, 452, 0, 0, 7997, 1
n1000x8192-slot-sum, 1024, 31, 7504, 459, 0, 0, 7994, 1
n1000x8192-slot-sum, 1024, 31, 7494, 454, 0, 0, 7979, 1
n1000x8192-slot-sum, 1024, 32, 7534, 462, 0, 0, 8028, 1
n1000x8192-slot-sum, 1024, 32, 7509, 455, 0, 0, 7996, 1
n1000x8192-slot-sum, 1024, 33, 7526, 450, 0, 0, 8009, 1
n1000x8192-slot-sum, 1024, 32, 7518, 459, 0, 0, 8009, 1
n1000x8192-slot-sum, 1024, 31, 7530, 451, 0, 0, 8012, 1
n1000x8192-slot-sum, 1024, 31, 7490, 454, 0, 0, 7975, 1
n1000x8192-slot-sum, 1024, 31, 7495, 458, 0, 0, 7984, 1
n1000x8192-slot-sum, 1024, 31, 7532, 455, 0, 0, 8018, 1
n1000x8192-slot-sum, 1024, 47, 7501, 458, 0, 0, 8006, 1
n1000x8192-slot-sum, 1024, 31, 7507, 452, 0, 0, 7990, 1
n1000x8192-slot-sum, 1024, 31, 7499, 456, 0, 0, 7986, 1
n1000x8192-slot-sum, 1024, 32, 7520, 450, 0, 0, 8002, 1
n1000x8192-slot-sum, 1024, 32, 7517, 455, 0, 0, 8004, 1
n1000x8192-slot-sum, 1024, 31, 7496, 451, 0, 0, 7978, 1
n1000x8192-slot-sum, 1024, 33, 7530, 451, 0, 0, 8014, 1
n1000x8192-slot-sum, 1024, 31, 7514, 454, 0, 0, 7999, 1
n1000x8192-slot-sum, 1024, 31, 7503, 454, 0, 0, 7988, 1
n1000x8192-slot-sum, 1024, 31, 7497, 467, 0, 0, 7995, 1
n1000x8192-slot-sum, 1024, 32, 7494, 447, 0, 0, 7973, 1
n1000x8192-slot-sum, 1024, 32, 7534, 458, 0, 0, 8024, 1
n1000x8192-slot-sum, 1024, 31, 7539, 467, 0, 0, 8037, 1
n1000x8192-slot-sum, 1024, 32, 7630, 460, 0, 0, 8122, 1
n1000x8192-slot-sum, 1024, 31, 7573, 460, 0, 0, 8064, 1
n1000x8192-slot-sum, 1024, 32, 7506, 454, 0, 0, 7992, 1
n1000x8192-slot-sum, 1024, 33, 7517, 456, 0, 0, 8006, 1
n1000x8192-slot-sum, 1024, 31, 7504, 456, 0, 0, 7991, 1
n1000x8192-slot-sum, 1024, 31, 7497, 466, 0, 0, 7994, 1
n1000x8192-slot-sum, 1024, 31, 7508, 468, 0, 0, 8007, 1
n1000x8192-slot-sum, 1024, 32, 7525, 451, 0, 0, 8008, 1
n1000x8192-slot-sum, 1024, 31, 7481, 451, 0, 0, 7963, 1
n1000x8192-slot-sum, 1024, 32, 7494, 452, 0, 0, 7978, 1
n1000x8192-slot-sum, 1024, 32, 7475, 458, 0, 0, 7965, 1
n1000x8192-slot-sum, 1024, 33, 7503, 458, 0, 0, 7994, 1
n1000x8192-slot-sum, 1024, 31, 7501, 457, 0, 0, 7989, 1
n1000x8192-slot-sum, 1024, 32, 7500, 460, 0, 0, 7992, 1
n1000x8192-slot-sum, 1024, 32, 7527, 455, 0, 0, 8014, 1
n1000x8192-slot-sum, 1024, 32, 7504, 454, 0, 0, 7990, 1
n1000x8192-slot-sum, 1024, 32, 7508, 449, 0, 0, 7989, 1
n1000x8192-slot-sum, 1024, 32, 7505, 456, 0, 0, 7993, 1
n1000x8192-slot-sum, 1024, 31, 7496, 454, 0, 0, 7981, 1
n1000x8192-slot-sum, 1024, 31, 7478, 459, 0, 0, 7968, 1
n1000x8192-slot-sum, 1024, 32, 7504, 462, 0, 0, 7998, 1
n1000x8192-slot-sum, 1024, 33, 7503, 458, 0, 0, 7994, 1
n1000x8192-slot-sum, 1024, 32, 7503, 452, 0, 0, 7987, 1
n1000x8192-slot-sum, 1024, 31, 7487, 453, 0, 0, 7971, 1
n1000x8192-slot-sum, 1024, 32, 7480, 453, 0, 0, 7965, 1
n1000x8192-slot-sum, 1024, 32, 7482, 452, 0, 0, 7966, 1
n1000x8192-slot-sum, 1024, 34, 7491, 461, 0, 0, 7986, 1
n1000x8192-slot-sum, 1024, 32, 7541, 470, 0, 0, 8043, 1
n1000x8192-slot-sum, 1024, 33, 7556, 453, 0, 0, 8042, 1
n1000x8192-slot-sum, 1024, 31, 7510, 452, 0, 0, 7993, 1
n1000x8192-slot-sum, 1024, 31, 7512, 453, 0, 0, 7996, 1
n1000x8192-slot-sum, 1024, 31, 7531, 452, 0, 0, 8014, 1
n1000x8192-slot-sum, 1024, 33, 7559, 457, 0, 0, 8049, 1
n1000x8192-slot-sum, 1024, 31, 7541, 457, 0, 0, 8029, 1
n1000x8192-slot-sum, 1024, 32, 7537, 464, 0, 0, 8033, 1
n1000x8192-slot-sum, 1024, 33, 7545, 469, 0, 0, 8047, 1
n1000x8192-slot-sum, 1024, 32, 7544, 456, 0, 0, 8032, 1
n1000x8192-slot-sum, 1024, 31, 7525, 453, 0, 0, 8009, 1
n1000x8192-slot-sum, 1024, 32, 7518, 451, 0, 0, 8001, 1
n1000x8192-slot-sum, 1024, 32, 7567, 457, 0, 0, 8056, 1
n1000x8192-slot-sum, 1024, 32, 7513, 454, 0, 0, 7999, 1
n1000x8192-slot-sum, 1024, 32, 7562, 480, 0, 0, 8074, 1
n1000x8192-slot-sum, 1024, 32, 7599, 460, 0, 0, 8091, 1
n1000x8192-slot-sum, 1024, 35, 7540, 473, 0, 0, 8048, 1
n1000x8192-slot-sum, 1024, 32, 7508, 458, 0, 0, 7998, 1
n1000x8192-slot-sum, 1024, 31, 7528, 457, 0, 0, 8016, 1
n1000x8192-slot-sum, 1024, 32, 7550, 459, 0, 0, 8041, 1
n1000x8192-slot-sum, 1024, 32, 7558, 458, 0, 0, 8048, 1
n1000x8192-slot-sum, 1024, 31, 7557, 457, 0, 0, 8045, 1
n1000x8192-slot-sum, 1024, 31, 7596, 455, 0, 0, 8082, 1
n1000x8192-slot-sum, 1024, 33, 7544, 459, 0, 0, 8036, 1
n1000x8192-slot-sum, 1024, 37, 7524, 460, 0, 0, 8021, 1
n1000x8192-slot-inner, 8192, 294, 8028, 13551, 1, 0, 21874, 1.36533e+07
n1000x8192-slot-inner, 8192, 283, 7975, 13594, 1, 0, 21853, 1.36533e+07
n1000x8192-slot-inner, 8192, 285, 7960, 13564, 1, 0, 21810, 1.36533e+07
n1000x8192-slot-inner, 8192, 288, 7992, 13536, 1, 0, 21817, 1.36533e+07
n1000x8192-slot-inner, 8192, 284, 8006, 13536, 1, 0, 21827, 1.36533e+07
n1000x8192-slot-inner, 8192, 284, 7948, 14068, 1, 0, 22301, 1.36533e+07
n1000x8192-slot-inner, 8192, 281, 7949, 13552, 1, 0, 21783, 1.36533e+07
n1000x8192-slot-inner, 8192, 293, 8012, 13573, 1, 0, 21879, 1.36533e+07
n1000x8192-slot-inner, 8192, 285, 7998, 13610, 1, 0, 21894, 1.36533e+07
n1000x8192-slot-inner, 8192, 289, 7987, 13613, 1, 0, 21890, 1.36533e+07
n1000x8192-slot-inner, 8192, 284, 8006, 13677, 1, 0, 21968, 1.36533e+07
n1000x8192-slot-inner, 8192, 286, 8005, 13568, 1, 0, 21860, 1.36533e+07
n1000x8192-slot-inner, 8192, 285, 8054, 14128, 1, 0, 22468, 1.36533e+07
n1000x8192-slot-inner, 8192, 285, 7984, 13515, 1, 0, 21785, 1.36533e+07
n1000x8192-slot-inner, 8192, 287, 8015, 13596, 1, 0, 21899, 1.36533e+07
n1000x8192-slot-inner, 8192, 282, 7991, 13648, 1, 0, 21922, 1.36533e+07
n1000x8192-slot-inner, 8192, 285, 7986, 13515, 1, 0, 21787, 1.36533e+07
n1000x8192-slot-inner, 8192, 283, 7986, 13691, 1, 0, 21961, 1.36533e+07
n1000x8192-slot-inner, 8192, 283, 7993, 13564, 1, 0, 21841, 1.36533e+07
n1000x8192-slot-inner, 8192, 282, 7994, 13554, 1, 0, 21831, 1.36533e+07
n1000x8192-slot-inner, 8192, 285, 8037, 13489, 1, 0, 21812, 1.36533e+07
n1000x8192-slot-inner, 8192, 292, 7962, 13591, 1, 0, 21846, 1.36533e+07
n1000x8192-slot-inner, 8192, 284, 8027, 13659, 1, 0, 21971, 1.36533e+07
n1000x8192-slot-inner, 8192, 285, 7973, 13583, 1, 0, 21842, 1.36533e+07
n1000x8192-slot-inner, 8192, 281, 7962, 13465, 1, 0, 21709, 1.36533e+07
n1000x8192-slot-inner, 8192, 287, 7988, 13569, 1, 0, 21845, 1.36533e+07
n1000x8192-slot-inner, 8192, 283, 7976, 13493, 1, 0, 21753, 1.36533e+07
n1000x8192-slot-inner, 8192, 292, 7962, 13507, 1, 0, 21762, 1.36533e+07
n1000x8192-slot-inner, 8192, 282, 7968, 14095, 1, 0, 22346, 1.36533e+07
n1000x8192-slot-inner, 8192, 282, 7955, 13449, 1, 0, 21687, 1.36533e+07
n1000x8192-slot-inner, 8192, 283, 7924, 14084, 1, 0, 22292, 1.36533e+07
n1000x8192-slot-inner, 8192, 282, 7934, 14061, 1, 0, 22278, 1.36533e+07
n1000x8192-slot-inner, 8192, 281, 7931, 13455, 1, 0, 21668, 1.36533e+07
n1000x8192-slot-inner, 8192, 284, 7933, 14122, 1, 0, 22340, 1.36533e+07
n1000x8192-slot-inner, 8192, 283, 7985, 13502, 1, 0, 21771, 1.36533e+07
n1000x8192-slot-inner, 8192, 280, 7941, 13483, 1, 0, 21705, 1.36533e+07
n1000x8192-slot-inner, 8192, 287, 8002, 13541, 1, 0, 21831, 1.36533e+07
n1000x8192-slot-inner, 8192, 282, 7944, 13509, 1, 0, 21736, 1.36533e+07
n1000x8192-slot-inner, 8192, 286, 7957, 13588, 1, 0, 21832, 1.36533e+07
n1000x8192-slot-inner, 8192, 285, 7992, 13590, 1, 0, 21868, 1.36533e+07
n1000x8192-slot-inner, 8192, 284, 7968, 13565, 1, 0, 21818, 1.36533e+07
n1000x8192-slot-inner, 8192, 285, 7989, 13686, 1, 0, 21961, 1.36533e+07
n1000x8192-slot-inner, 8192, 281, 7986, 13590, 1, 0, 21858, 1.36533e+07
n1000x8192-slot-inner, 8192, 292, 7980, 13520, 1, 0, 21793, 1.36533e+07
n1000x8192-slot-inner, 8192, 286, 8012, 13576, 1, 0, 21875, 1.36533e+07
n1000x8192-slot-inner, 8192, 283, 7934, 13475, 1, 0, 21693, 1.36533e+07
n1000x8192-slot-inner, 8192, 283, 7940, 13543, 1, 0, 21767, 1.36533e+07
n1000x8192-slot-inner, 8192, 283, 8004, 13575, 1, 0, 21863, 1.36533e+07
n1000x8192-slot-inner, 8192, 283, 7967, 13523, 1, 0, 21774, 1.36533e+07
n1000x8192-slot-inner, 8192, 284, 7953, 13581, 1, 0, 21819, 1.36533e+07
n1000x8192-slot-inner, 8192, 280, 7963, 13536, 1, 0, 21780, 1.36533e+07
n1000x8192-slot-inner, 8192, 291, 7986, 13578, 1, 0, 21856, 1.36533e+07
n1000x8192-slot-inner, 8192, 285, 7972, 13429, 1, 0, 21687, 1.36533e+07
n1000x8192-slot-inner, 8192, 285, 7998, 13628, 1, 0, 21912, 1.36533e+07
n1000x8192-slot-inner, 8192, 284, 7955, 13534, 1, 0, 21774, 1.36533e+07
n1000x8192-slot-inner, 8192, 287, 7972, 13544, 1, 0, 21804, 1.36533e+07
n1000x8192-slot-inner, 8192, 286, 7953, 13468, 1, 0, 21708, 1.36533e+07
n1000x8192-slot-inner, 8192, 285, 7998, 13591, 1, 0, 21875, 1.36533e+07
n1000x8192-slot-inner, 8192, 283, 7942, 13458, 1, 0, 21684, 1.36533e+07
n1000x8192-slot-inner, 8192, 288, 7939, 14173, 1, 0, 22401, 1.36533e+07
n1000x8192-slot-inner, 8192, 283, 8051, 13763, 1, 0, 22098, 1.36533e+07
n1000x8192-slot-inner, 8192, 284, 8009, 13553, 1, 0, 21847, 1.36533e+07
n1000x8192-slot-inner, 8192, 283, 7987, 13613, 1, 0, 21884, 1.36533e+07
n1000x8192-slot-inner, 8192, 288, 7995, 14066, 1, 0, 22350, 1.36533e+07
n1000x8192-slot-inner, 8192, 289, 8024, 13678, 1, 0, 21992, 1.36533e+07
n1000x8192-slot-inner, 8192, 285, 8024, 14300, 1, 0, 22610, 1.36533e+07
n1000x8192-slot-inner, 8192, 285, 7982, 13577, 1, 0, 21845, 1.36533e+07
n1000x8192-slot-inner, 8192, 291, 8002, 13619, 1, 0, 21913, 1.36533e+07
n1000x8192-slot-inner, 8192, 283, 8030, 13578, 1, 0, 21892, 1.36533e+07
n1000x8192-slot-inner, 8192, 283, 7995, 13534, 1, 0, 21813, 1.36533e+07
n1000x8192-slot-inner, 8192, 283, 7969, 13568, 1, 0, 21821, 1.36533e+07
n1000x8192-slot-inner, 8192, 288, 7978, 13593, 1, 0, 21860, 1.36533e+07
n1000x8192-slot-inner, 8192, 285, 7995, 14275, 1, 0, 22556, 1.36533e+07
n1000x8192-slot-inner, 8192, 284, 7954, 14158, 1, 0, 22397, 1.36533e+07
n1000x8192-slot-inner, 8192, 282, 7953, 13466, 1, 0, 21702, 1.36533e+07
n1000x8192-slot-inner, 8192, 287, 7977, 13549, 1, 0, 21814, 1.36533e+07
n1000x8192-slot-inner, 8192, 287, 8025, 13499, 1, 0, 21812, 1.36533e+07
n1000x8192-slot-inner, 8192, 286, 7974, 13495, 1, 0, 21756, 1.36533e+07
n1000x8192-slot-inner, 8192, 279, 7919, 13536, 1, 0, 21735, 1.36533e+07
n1000x8192-slot-inner, 8192, 291, 8018, 13475, 1, 0, 21785, 1.36533e+07
n1000x8192-slot-inner, 8192, 282, 7988, 13549, 1, 0, 21820, 1.36533e+07
n1000x8192-slot-inner, 8192, 286, 7951, 13623, 1, 0, 21861, 1.36533e+07
n1000x8192-slot-inner, 8192, 281, 7965, 13580, 1, 0, 21827, 1.36533e+07
n1000x8192-slot-inner, 8192, 282, 7980, 13566, 1, 0, 21829, 1.36533e+07
n1000x8192-slot-inner, 8192, 282, 8003, 13910, 1, 0, 22196, 1.36533e+07
n1000x8192-slot-inner, 8192, 284, 7978, 13541, 1, 0, 21804, 1.36533e+07
n1000x8192-slot-inner, 8192, 285, 7958, 14418, 1, 0, 22662, 1.36533e+07
n1000x8192-slot-inner, 8192, 283, 7942, 13531, 1, 0, 21757, 1.36533e+07
n1000x8192-slot-inner, 8192, 285, 7961, 13471, 1, 0, 21718, 1.36533e+07
n1000x8192-slot-inner, 8192, 283, 8006, 14174, 1, 0, 22464, 1.36533e+07
n1000x8192-slot-inner, 8192, 282, 7989, 13570, 1, 0, 21842, 1.36533e+07
n1000x8192-slot-inner, 8192, 284, 8032, 13587, 1, 0, 21904, 1.36533e+07
n1000x8192-slot-inner, 8192, 281, 8060, 14036, 1, 0, 22378, 1.36533e+07
n1000x8192-slot-inner, 8192, 284, 8032, 13627, 1, 0, 21944, 1.36533e+07
n1000x8192-slot-inner, 8192, 288, 7984, 14162, 1, 0, 22435, 1.36533e+07
n1000x8192-slot-inner, 8192, 281, 7960, 14105, 1, 0, 22347, 1.36533e+07
n1000x8192-slot-inner, 8192, 283, 8001, 13586, 1, 0, 21871, 1.36533e+07
n1000x8192-slot-inner, 8192, 284, 7969, 13564, 1, 0, 21818, 1.36533e+07
n1000x8192-slot-inner, 8192, 280, 7978, 13711, 1, 0, 21970, 1.36533e+07
n1000x8192-slot-inner, 8192, 289, 8087, 13640, 1, 0, 22017, 1.36533e+07
n1000x8192-slot-inner, 4096, 139, 7873, 13342, 0, 0, 21354, 1.36533e+07
n1000x8192-slot-inner, 4096, 133, 7711, 13704, 0, 0, 21548, 1.36533e+07
n1000x8192-slot-inner, 4096, 133, 7701, 13229, 0, 0, 21063, 1.36533e+07
n1000x8192-slot-inner, 4096, 136, 7737, 13246, 0, 0, 21119, 1.36533e+07
n1000x8192-slot-inner, 4096, 133, 7674, 13138, 0, 0, 20945, 1.36533e+07
n1000x8192-slot-inner, 4096, 135, 7691, 13122, 0, 0, 20948, 1.36533e+07
n1000x8192-slot-inner, 4096, 133, 7720, 13078, 0, 0, 20931, 1.36533e+07
n1000x8192-slot-inner, 4096, 132, 7702, 13569, 0, 0, 21403, 1.36533e+07
n1000x8192-slot-inner, 4096, 132, 7720, 13332, 0, 0, 21184, 1.36533e+07
n1000x8192-slot-inner, 4096, 135, 7703, 13171, 0, 0, 21009, 1.36533e+07
n1000x8192-slot-inner, 4096, 133, 7641, 13106, 0, 0, 20880, 1.36533e+07
n1000x8192-slot-inner, 4096, 133, 7689, 13081, 0, 0, 20903, 1.36533e+07
n1000x8192-slot-inner, 4096, 138, 7669, 13070, 0, 0, 20877, 1.36533e+07
n1000x8192-slot-inner, 4096, 134, 7653, 13145, 0, 0, 20932, 1.36533e+07
n1000x8192-slot-inner, 4096, 134, 7743, 13660, 0, 0, 21537, 1.36533e+07
n1000x8192-slot-inner, 4096, 134, 7702, 13152, 0, 0, 20988, 1.36533e+07
n1000x8192-slot-inner, 4096, 133, 7677, 13175, 0, 0, 20985, 1.36533e+07
n1000x8192-slot-inner, 4096, 132, 7670, 13086, 0, 0, 20888, 1.36533e+07
n1000x8192-slot-inner, 4096, 133, 7675, 13117, 0, 0, 20925, 1.36533e+07
n1000x8192-slot-inner, 4096, 137, 7723, 13265, 0, 0, 21125, 1.36533e+07
n1000x8192-slot-inner, 4096, 131, 7670, 13135, 0, 0, 20936, 1.36533e+07
n1000x8192-slot-inner, 4096, 136, 7709, 13278, 0, 0, 21123, 1.36533e+07
n1000x8192-slot-inner, 4096, 143, 7711, 13172, 0, 0, 21026, 1.36533e+07
n1000x8192-slot-inner, 4096, 134, 7727, 13032, 0, 0, 20893, 1.36533e+07
n1000x8192-slot-inner, 4096, 136, 7674, 13108, 0, 0, 20918, 1.36533e+07
n1000x8192-slot-inner, 4096, 136, 7724, 13590, 0, 0, 21450, 1.36533e+07
n1000x8192-slot-inner, 4096, 133, 7745, 13158, 0, 0, 21036, 1.36533e+07
n1000x8192-slot-inner, 4096, 133, 7715, 13237, 0, 0, 21085, 1.36533e+07
n1000x8192-slot-inner, 4096, 134, 7689, 13178, 0, 0, 21001, 1.36533e+07
n1000x8192-slot-inner, 4096, 133, 7690, 13098, 0, 0, 20921, 1.36533e+07
n1000x8192-slot-inner, 4096, 133, 7662, 13112, 0, 0, 20907, 1.36533e+07
n1000x8192-slot-inner, 4096, 132, 7695, 13182, 0, 0, 21009, 1.36533e+07
n1000x8192-slot-inner, 4096, 134, 7660, 13645, 0, 0, 21439, 1.36533e+07
n1000x8192-slot-inner, 4096, 136, 7697, 13631, 0, 0, 21464, 1.36533e+07
n1000x8192-slot-inner, 4096, 133, 7646, 13084, 0, 0, 20863, 1.36533e+07
n1000x8192-slot-inner, 4096, 132, 7707, 13129, 0, 0, 20968, 1.36533e+07
n1000x8192-slot-inner, 4096, 133, 7718, 13529, 0, 0, 21380, 1.36533e+07
n1000x8192-slot-inner, 4096, 137, 7674, 13627, 0, 0, 21438, 1.36533e+07
n1000x8192-slot-inner, 4096, 133, 7710, 13175, 0, 0, 21018, 1.36533e+07
n1000x8192-slot-inner, 4096, 132, 7688, 13064, 0, 0, 20884, 1.36533e+07
n1000x8192-slot-inner, 4096, 133, 7675, 13164, 0, 0, 20972, 1.36533e+07
n1000x8192-slot-inner, 4096, 135, 7711, 13299, 0, 0, 21145, 1.36533e+07
n1000x8192-slot-inner, 4096, 136, 7757, 13365, 0, 0, 21258, 1.36533e+07
n1000x8192-slot-inner, 4096, 137, 7729, 13265, 0, 0, 21131, 1.36533e+07
n1000x8192-slot-inner, 4096, 134, 7676, 13224, 0, 0, 21034, 1.36533e+07
n1000x8192-slot-inner, 4096, 133, 7651, 13130, 0, 0, 20914, 1.36533e+07
n1000x8192-slot-inner, 4096, 136, 7668, 13053, 0, 0, 20857, 1.36533e+07
n1000x8192-slot-inner, 4096, 135, 7724, 13140, 0, 0, 20999, 1.36533e+07
n1000x8192-slot-inner, 4096, 133, 7741, 13190, 0, 0, 21064, 1.36533e+07
n1000x8192-slot-inner, 4096, 136, 7677, 13187, 0, 0, 21000, 1.36533e+07
n1000x8192-slot-inner, 4096, 133, 7726, 13645, 0, 0, 21504, 1.36533e+07
n1000x8192-slot-inner, 4096, 138, 7745, 13219, 0, 0, 21102, 1.36533e+07
n1000x8192-slot-inner, 4096, 133, 7680, 13239, 0, 0, 21052, 1.36533e+07
n1000x8192-slot-inner, 4096, 132, 7689, 13132, 0, 0, 20953, 1.36533e+07
n1000x8192-slot-inner, 4096, 132, 7670, 13089, 0, 0, 20891, 1.36533e+07
n1000x8192-slot-inner, 4096, 143, 7660, 13750, 0, 0, 21553, 1.36533e+07
n1000x8192-slot-inner, 4096, 133, 7654, 13137, 0, 0, 20924, 1.36533e+07
n1000x8192-slot-inner, 4096, 134, 7723, 13113, 0, 0, 20970, 1.36533e+07
n1000x8192-slot-inner, 4096, 137, 7753, 13205, 0, 0, 21095, 1.36533e+07
n1000x8192-slot-inner, 4096, 132, 7680, 13271, 0, 0, 21083, 1.36533e+07
n1000x8192-slot-inner, 4096, 133, 7675, 13056, 0, 0, 20864, 1.36533e+07
n1000x8192-slot-inner, 4096, 133, 7688, 13093, 0, 0, 20914, 1.36533e+07
n1000x8192-slot-inner, 4096, 131, 7650, 13249, 0, 0, 21030, 1.36533e+07
n1000x8192-slot-inner, 4096, 140, 7790, 13614, 0, 0, 21544, 1.36533e+07
n1000x8192-slot-inner, 4096, 134, 7702, 13271, 0, 0, 21107, 1.36533e+07
n1000x8192-slot-inner, 4096, 134, 7667, 13104, 0, 0, 20905, 1.36533e+07
n1000x8192-slot-inner, 4096, 135, 7730, 13200, 0, 0, 21065, 1.36533e+07
n1000x8192-slot-inner, 4096, 136, 7758, 13233, 0, 0, 21127, 1.36533e+07
n1000x8192-slot-inner, 4096, 135, 7702, 13153, 0, 0, 20990, 1.36533e+07
n1000x8192-slot-inner, 4096, 134, 7709, 13440, 0, 0, 21283, 1.36533e+07
n1000x8192-slot-inner, 4096, 146, 7656, 13660, 0, 0, 21462, 1.36533e+07
n1000x8192-slot-inner, 4096, 131, 7657, 13058, 0, 0, 20846, 1.36533e+07
n1000x8192-slot-inner, 4096, 131, 7676, 13079, 0, 0, 20886, 1.36533e+07
n1000x8192-slot-inner, 4096, 136, 7690, 13151, 0, 0, 20977, 1.36533e+07
n1000x8192-slot-inner, 4096, 132, 7659, 13069, 0, 0, 20860, 1.36533e+07
n1000x8192-slot-inner, 4096, 132, 7695, 13100, 0, 0, 20927, 1.36533e+07
n1000x8192-slot-inner, 4096, 146, 7661, 13676, 0, 0, 21483, 1.36533e+07
n1000x8192-slot-inner, 4096, 133, 7694, 13179, 0, 0, 21006, 1.36533e+07
n1000x8192-slot-inner, 4096, 137, 7692, 13145, 0, 0, 20974, 1.36533e+07
n1000x8192-slot-inner, 4096, 134, 7663, 13585, 0, 0, 21382, 1.36533e+07
n1000x8192-slot-inner, 4096, 133, 7670, 13121, 0, 0, 20924, 1.36533e+07
n1000x8192-slot-inner, 4096, 135, 7654, 13229, 0, 0, 21018, 1.36533e+07
n1000x8192-slot-inner, 4096, 136, 7707, 13143, 0, 0, 20986, 1.36533e+07
n1000x8192-slot-inner, 4096, 132, 8055, 13428, 0, 0, 21615, 1.36533e+07
n1000x8192-slot-inner, 4096, 138, 7720, 13258, 0, 0, 21116, 1.36533e+07
n1000x8192-slot-inner, 4096, 132, 7712, 13188, 0, 0, 21032, 1.36533e+07
n1000x8192-slot-inner, 4096, 142, 7743, 13100, 0, 0, 20985, 1.36533e+07
n1000x8192-slot-inner, 4096, 134, 7661, 13050, 0, 0, 20845, 1.36533e+07
n1000x8192-slot-inner, 4096, 132, 7664, 13110, 0, 0, 20906, 1.36533e+07
n1000x8192-slot-inner, 4096, 132, 7703, 13020, 0, 0, 20855, 1.36533e+07
n1000x8192-slot-inner, 4096, 137, 7696, 13174, 0, 0, 21007, 1.36533e+07
n1000x8192-slot-inner, 4096, 135, 7673, 13669, 0, 0, 21477, 1.36533e+07
n1000x8192-slot-inner, 4096, 132, 7689, 13115, 0, 0, 20936, 1.36533e+07
n1000x8192-slot-inner, 4096, 136, 7682, 13060, 0, 0, 20878, 1.36533e+07
n1000x8192-slot-inner, 4096, 132, 7673, 13449, 0, 0, 21254, 1.36533e+07
n1000x8192-slot-inner, 4096, 134, 7654, 13042, 0, 0, 20830, 1.36533e+07
n1000x8192-slot-inner, 4096, 135, 7692, 13114, 0, 0, 20941, 1.36533e+07
n1000x8192-slot-inner, 4096, 131, 7661, 13450, 0, 0, 21242, 1.36533e+07
n1000x8192-slot-inner, 4096, 134, 7647, 13586, 0, 0, 21367, 1.36533e+07
n1000x8192-slot-inner, 4096, 132, 7635, 13049, 0, 0, 20816, 1.36533e+07
n1000x8192-slot-inner, 2048, 64, 7510, 12957, 0, 0, 20531, 1.36533e+07
n1000x8192-slot-inner, 2048, 63, 7503, 12976, 0, 0, 20542, 1.36533e+07
n1000x8192-slot-inner, 2048, 63, 7493, 12993, 0, 0, 20549, 1.36533e+07
n1000x8192-slot-inner, 2048, 65, 7529, 13068, 0, 0, 20662, 1.36533e+07
n1000x8192-slot-inner, 2048, 64, 7497, 12914, 0, 0, 20475, 1.36533e+07
n1000x8192-slot-inner, 2048, 68, 7489, 12985, 0, 0, 20542, 1.36533e+07
n1000x8192-slot-inner, 2048, 63, 7454, 13503, 0, 0, 21020, 1.36533e+07
n1000x8192-slot-inner, 2048, 63, 7500, 12967, 0, 0, 20530, 1.36533e+07
n1000x8192-slot-inner, 2048, 63, 7500, 13037, 0, 0, 20600, 1.36533e+07
n1000x8192-slot-inner, 2048, 63, 7497, 13009, 0, 0, 20569, 1.36533e+07
n1000x8192-slot-inner, 2048, 65, 7469, 12888, 0, 0, 20422, 1.36533e+07
n1000x8192-slot-inner, 2048, 63, 7519, 12945, 0, 0, 20527, 1.36533e+07
n1000x8192-slot-inner, 2048, 63, 7486, 12900, 0, 0, 20449, 1.36533e+07
n1000x8192-slot-inner, 2048, 63, 7471, 12908, 0, 0, 20442, 1.36533e+07
n1000x8192-slot-inner, 2048, 67, 7512, 13013, 0, 0, 20592, 1.36533e+07
n1000x8192-slot-inner, 2048, 63, 7528, 13471, 0, 0, 21062, 1.36533e+07
n1000x8192-slot-inner, 2048, 63, 7494, 13128, 0, 0, 20685, 1.36533e+07
n1000x8192-slot-inner, 2048, 63, 7527, 13578, 0, 0, 21168, 1.36533e+07
n1000x8192-slot-inner, 2048, 68, 7511, 13645, 0, 0, 21224, 1.36533e+07
n1000x8192-slot-inner, 2048, 63, 7482, 13007, 0, 0, 20552, 1.36533e+07
n1000x8192-slot-inner, 2048, 65, 7582, 13152, 0, 0, 20799, 1.36533e+07
n1000x8192-slot-inner, 2048, 65, 7513, 13559, 0, 0, 21137, 1.36533e+07
n1000x8192-slot-inner, 2048, 63, 7568, 13070, 0, 0, 20701, 1.36533e+07
n1000x8192-slot-inner, 2048, 64, 7477, 12999, 0, 0, 20540, 1.36533e+07
n1000x8192-slot-inner, 2048, 63, 7528, 12976, 0, 0, 20567, 1.36533e+07
n1000x8192-slot-inner, 2048, 64, 7551, 13422, 0, 0, 21037, 1.36533e+07
n1000x8192-slot-inner, 2048, 64, 7515, 13548, 0, 0, 21127, 1.36533e+07
n1000x8192-slot-inner, 2048, 79, 7795, 13465, 0, 0, 21339, 1.36533e+07
n1000x8192-slot-inner, 2048, 64, 7502, 13008, 0, 0, 20574, 1.36533e+07
n1000x8192-slot-inner, 2048, 63, 7478, 13009, 0, 0, 20550, 1.36533e+07
n1000x8192-slot-inner, 2048, 64, 7483, 13085, 0, 0, 20632, 1.36533e+07
n1000x8192-slot-inner, 2048, 75, 7497, 13505, 0, 0, 21077, 1.36533e+07
n1000x8192-slot-inner, 2048, 64, 7481, 13039, 0, 0, 20584, 1.36533e+07
n1000x8192-slot-inner, 2048, 64, 7496, 13052, 0, 0, 20612, 1.36533e+07
n1000x8192-slot-inner, 2048, 63, 7549, 13500, 0, 0, 21112, 1.36533e+07
n1000x8192-slot-inner, 2048, 63, 7505, 13200, 0, 0, 20768, 1.36533e+07
n1000x8192-slot-inner, 2048, 64, 7512, 13124, 0, 0, 20700, 1.36533e+07
n1000x8192-slot-inner, 2048, 66, 7508, 13510, 0, 0, 21084, 1.36533e+07
n1000x8192-slot-inner, 2048, 64, 7546, 13164, 0, 0, 20774, 1.36533e+07
n1000x8192-slot-inner, 2048, 63, 7504, 13160, 0, 0, 20727, 1.36533e+07
n1000x8192-slot-inner, 2048, 64, 7494, 12997, 0, 0, 20555, 1.36533e+07
n1000x8192-slot-inner, 2048, 66, 7482, 13482, 0, 0, 21030, 1.36533e+07
n1000x8192-slot-inner, 2048, 67, 7510, 12994, 0, 0, 20571, 1.36533e+07
n1000x8192-slot-inner, 2048, 64, 7503, 13132, 0, 0, 20699, 1.36533e+07
n1000x8192-slot-inner, 2048, 63, 7489, 12994, 0, 0, 20546, 1.36533e+07
n1000x8192-slot-inner, 2048, 63, 7500, 12978, 0, 0, 20541, 1.36533e+07
n1000x8192-slot-inner, 2048, 65, 7549, 13213, 0, 0, 20827, 1.36533e+07
n1000x8192-slot-inner, 2048, 67, 7558, 13157, 0, 0, 20782, 1.36533e+07
n1000x8192-slot-inner, 2048, 63, 7504, 13008, 0, 0, 20575, 1.36533e+07
n1000x8192-slot-inner, 2048, 64, 7506, 12991, 0, 0, 20561, 1.36533e+07
n1000x8192-slot-inner, 2048, 64, 7513, 12993, 0, 0, 20570, 1.36533e+07
n1000x8192-slot-inner, 2048, 63, 7527, 13121, 0, 0, 20711, 1.36533e+07
n1000x8192-slot-inner, 2048, 63, 7498, 12968, 0, 0, 20529, 1.36533e+07
n1000x8192-slot-inner, 2048, 63, 7508, 13083, 0, 0, 20654, 1.36533e+07
n1000x8192-slot-inner, 2048, 64, 7511, 13010, 0, 0, 20585, 1.36533e+07
n1000x8192-slot-inner, 2048, 64, 7481, 12982, 0, 0, 20527, 1.36533e+07
n1000x8192-slot-inner, 2048, 63, 7496, 12992, 0, 0, 20551, 1.36533e+07
n1000x8192-slot-inner, 2048, 63, 7488, 13142, 0, 0, 20693, 1.36533e+07
n1000x8192-slot-inner, 2048, 63, 7518, 13073, 0, 0, 20654, 1.36533e+07
n1000x8192-slot-inner, 2048, 64, 7552, 13089, 0, 0, 20705, 1.36533e+07
n1000x8192-slot-inner, 2048, 65, 7491, 12985, 0, 0, 20541, 1.36533e+07
n1000x8192-slot-inner, 2048, 78, 7490, 12922, 0, 0, 20490, 1.36533e+07
n1000x8192-slot-inner, 2048, 63, 7565, 13028, 0, 0, 20656, 1.36533e+07
n1000x8192-slot-inner, 2048, 64, 7506, 13151, 0, 0, 20721, 1.36533e+07
n1000x8192-slot-inner, 2048, 63, 7488, 12986, 0, 0, 20537, 1.36533e+07
n1000x8192-slot-inner, 2048, 64, 7513, 13187, 0, 0, 20764, 1.36533e+07
n1000x8192-slot-inner, 2048, 65, 7524, 13047, 0, 0, 20636, 1.36533e+07
n1000x8192-slot-inner, 2048, 64, 7535, 13193, 0, 0, 20792, 1.36533e+07
n1000x8192-slot-inner, 2048, 63, 7528, 12948, 0, 0, 20539, 1.36533e+07
n1000x8192-slot-inner, 2048, 63, 7502, 12923, 0, 0, 20488, 1.36533e+07
n1000x8192-slot-inner, 2048, 64, 7492, 13017, 0, 0, 20573, 1.36533e+07
n1000x8192-slot-inner, 2048, 64, 7482, 13334, 0, 0, 20880, 1.36533e+07
n1000x8192-slot-inner, 2048, 63, 7487, 13441, 0, 0, 20991, 1.36533e+07
n1000x8192-slot-inner, 2048, 63, 7499, 13012, 0, 0, 20574, 1.36533e+07
n1000x8192-slot-inner, 2048, 63, 7491, 12976, 0, 0, 20530, 1.36533e+07
n1000x8192-slot-inner, 2048, 64, 7477, 12975, 0, 0, 20516, 1.36533e+07
n1000x8192-slot-inner, 2048, 68, 7498, 13096, 0, 0, 20662, 1.36533e+07
n1000x8192-slot-inner, 2048, 63, 7483, 12921, 0, 0, 20467, 1.36533e+07
n1000x8192-slot-inner, 2048, 63, 7475, 12919, 0, 0, 20457, 1.36533e+07
n1000x8192-slot-inner, 2048, 63, 7510, 13014, 0, 0, 20587, 1.36533e+07
n1000x8192-slot-inner, 2048, 63, 7489, 13008, 0, 0, 20560, 1.36533e+07
n1000x8192-slot-inner, 2048, 64, 7488, 12941, 0, 0, 20493, 1.36533e+07
n1000x8192-slot-inner, 2048, 74, 7494, 12986, 0, 0, 20554, 1.36533e+07
n1000x8192-slot-inner, 2048, 63, 7486, 12904, 0, 0, 20453, 1.36533e+07
n1000x8192-slot-inner, 2048, 63, 7476, 12964, 0, 0, 20503, 1.36533e+07
n1000x8192-slot-inner, 2048, 65, 7498, 13499, 0, 0, 21062, 1.36533e+07
n1000x8192-slot-inner, 2048, 65, 7555, 13061, 0, 0, 20681, 1.36533e+07
n1000x8192-slot-inner, 2048, 64, 7502, 13071, 0, 0, 20637, 1.36533e+07
n1000x8192-slot-inner, 2048, 63, 7515, 13001, 0, 0, 20579, 1.36533e+07
n1000x8192-slot-inner, 2048, 63, 7501, 13049, 0, 0, 20613, 1.36533e+07
n1000x8192-slot-inner, 2048, 64, 7528, 13288, 0, 0, 20880, 1.36533e+07
n1000x8192-slot-inner, 2048, 64, 7482, 12964, 0, 0, 20510, 1.36533e+07
n1000x8192-slot-inner, 2048, 72, 7470, 13522, 0, 0, 21064, 1.36533e+07
n1000x8192-slot-inner, 2048, 63, 7499, 13008, 0, 0, 20570, 1.36533e+07
n1000x8192-slot-inner, 2048, 63, 7482, 13494, 0, 0, 21039, 1.36533e+07
n1000x8192-slot-inner, 2048, 66, 7507, 13528, 0, 0, 21101, 1.36533e+07
n1000x8192-slot-inner, 2048, 64, 7496, 12971, 0, 0, 20531, 1.36533e+07
n1000x8192-slot-inner, 2048, 64, 7494, 13020, 0, 0, 20578, 1.36533e+07
n1000x8192-slot-inner, 2048, 63, 7504, 13076, 0, 0, 20643, 1.36533e+07
n1000x8192-slot-inner, 2048, 71, 7512, 13358, 0, 0, 20941, 1.36533e+07
n1000x8192-slot-inner, 1024, 33, 7491, 13515, 0, 0, 21039, 1.36533e+07
n1000x8192-slot-inner, 1024, 34, 7486, 13490, 0, 0, 21010, 1.36533e+07
n1000x8192-slot-inner, 1024, 34, 7510, 13641, 0, 0, 21185, 1.36533e+07
n1000x8192-slot-inner, 1024, 34, 7517, 13512, 0, 0, 21063, 1.36533e+07
n1000x8192-slot-inner, 1024, 34, 7518, 13565, 0, 0, 21117, 1.36533e+07
n1000x8192-slot-inner, 1024, 34, 7513, 13495, 0, 0, 21042, 1.36533e+07
n1000x8192-slot-inner, 1024, 33, 7513, 13543, 0, 0, 21089, 1.36533e+07
n1000x8192-slot-inner, 1024, 34, 7515, 13482, 0, 0, 21031, 1.36533e+07
n1000x8192-slot-inner, 1024, 34, 7487, 13510, 0, 0, 21031, 1.36533e+07
n1000x8192-slot-inner, 1024, 34, 7490, 13614, 0, 0, 21138, 1.36533e+07
n1000x8192-slot-inner, 1024, 34, 7538, 13657, 0, 0, 21229, 1.36533e+07
n1000x8192-slot-inner, 1024, 33, 7528, 13693, 0, 0, 21254, 1.36533e+07
n1000x8192-slot-inner, 1024, 34, 7541, 13700, 0, 0, 21275, 1.36533e+07
n1000x8192-slot-inner, 1024, 33, 7505, 13487, 0, 0, 21025, 1.36533e+07
n1000x8192-slot-inner, 1024, 33, 7519, 13481, 0, 0, 21033, 1.36533e+07
n1000x8192-slot-inner, 1024, 33, 7521, 13743, 0, 0, 21297, 1.36533e+07
n1000x8192-slot-inner, 1024, 33, 7581, 13638, 0, 0, 21252, 1.36533e+07
n1000x8192-slot-inner, 1024, 33, 7524, 13596, 0, 0, 21153, 1.36533e+07
n1000x8192-slot-inner, 1024, 33, 7572, 13655, 0, 0, 21260, 1.36533e+07
n1000x8192-slot-inner, 1024, 34, 7526, 13680, 0, 0, 21240, 1.36533e+07
n1000x8192-slot-inner, 1024, 34, 7508, 13607, 0, 0, 21149, 1.36533e+07
n1000x8192-slot-inner, 1024, 33, 7581, 13965, 0, 0, 21579, 1.36533e+07
n1000x8192-slot-inner, 1024, 33, 7609, 13841, 0, 0, 21483, 1.36533e+07
n1000x8192-slot-inner, 1024, 34, 7651, 14139, 0, 0, 21824, 1.36533e+07
n1000x8192-slot-inner, 1024, 33, 7636, 13966, 0, 0, 21635, 1.36533e+07
n1000x8192-slot-inner, 1024, 34, 7583, 14068, 0, 0, 21685, 1.36533e+07
n1000x8192-slot-inner, 1024, 34, 7634, 13779, 0, 0, 21447, 1.36533e+07
n1000x8192-slot-inner, 1024, 34, 7505, 14011, 0, 0, 21550, 1.36533e+07
n1000x8192-slot-inner, 1024, 34, 7538, 13707, 0, 0, 21279, 1.36533e+07
n1000x8192-slot-inner, 1024, 33, 7530, 13559, 0, 0, 21122, 1.36533e+07
n1000x8192-slot-inner, 1024, 33, 7502, 13514, 0, 0, 21049, 1.36533e+07
n1000x8192-slot-inner, 1024, 33, 7492, 13542, 0, 0, 21067, 1.36533e+07
n1000x8192-slot-inner, 1024, 35, 7519, 13486, 0, 0, 21040, 1.36533e+07
n1000x8192-slot-inner, 1024, 34, 7497, 13437, 0, 0, 20968, 1.36533e+07
n1000x8192-slot-inner, 1024, 33, 7523, 13591, 0, 0, 21147, 1.36533e+07
n1000x8192-slot-inner, 1024, 33, 7516, 13573, 0, 0, 21122, 1.36533e+07
n1000x8192-slot-inner, 1024, 33, 7521, 13508, 0, 0, 21062, 1.36533e+07
n1000x8192-slot-inner, 1024, 33, 7565, 13650, 0, 0, 21248, 1.36533e+07
n1000x8192-slot-inner, 1024, 36, 7539, 14103, 0, 0, 21678, 1.36533e+07
n1000x8192-slot-inner, 1024, 33, 7534, 13524, 0, 0, 21091, 1.36533e+07
n1000x8192-slot-inner, 1024, 33, 7592, 13937, 0, 0, 21562, 1.36533e+07
n1000x8192-slot-inner, 1024, 33, 7505, 13560, 0, 0, 21098, 1.36533e+07
n1000x8192-slot-inner, 1024, 33, 7528, 13526, 0, 0, 21087, 1.36533e+07
n1000x8192-slot-inner, 1024, 34, 7560, 13647, 0, 0, 21241, 1.36533e+07
n1000x8192-slot-inner, 1024, 33, 7516, 13546, 0, 0, 21095, 1.36533e+07
n1000x8192-slot-inner, 1024, 33, 7486, 13570, 0, 0, 21089, 1.36533e+07
n1000x8192-slot-inner, 1024, 33, 7494, 13420, 0, 0, 20947, 1.36533e+07
n1000x8192-slot-inner, 1024, 33, 7489, 13440, 0, 0, 20962, 1.36533e+07
n1000x8192-slot-inner, 1024, 34, 7514, 13508, 0, 0, 21056, 1.36533e+07
n1000x8192-slot-inner, 1024, 34, 7525, 13984, 0, 0, 21543, 1.36533e+07
n1000x8192-slot-inner, 1024, 34, 7479, 13536, 0, 0, 21049, 1.36533e+07
n1000x8192-slot-inner, 1024, 33, 7566, 13974, 0, 0, 21573, 1.36533e+07
n1000x8192-slot-inner, 1024, 33, 7549, 13504, 0, 0, 21086, 1.36533e+07
n1000x8192-slot-inner, 1024, 33, 7493, 13523, 0, 0, 21049, 1.36533e+07
n1000x8192-slot-inner, 1024, 35, 7513, 13976, 0, 0, 21524, 1.36533e+07
n1000x8192-slot-inner, 1024, 33, 7510, 13489, 0, 0, 21032, 1.36533e+07
n1000x8192-slot-inner, 1024, 34, 7519, 13555, 0, 0, 21108, 1.36533e+07
n1000x8192-slot-inner, 1024, 34, 7496, 13490, 0, 0, 21020, 1.36533e+07
n1000x8192-slot-inner, 1024, 33, 7510, 13817, 0, 0, 21360, 1.36533e+07
n1000x8192-slot-inner, 1024, 35, 7610, 13826, 0, 0, 21471, 1.36533e+07
n1000x8192-slot-inner, 1024, 34, 7578, 13800, 0, 0, 21412, 1.36533e+07
n1000x8192-slot-inner, 1024, 34, 7541, 13598, 0, 0, 21173, 1.36533e+07
n1000x8192-slot-inner, 1024, 33, 7607, 13883, 0, 0, 21523, 1.36533e+07
n1000x8192-slot-inner, 1024, 33, 7523, 13749, 0, 0, 21305, 1.36533e+07
n1000x8192-slot-inner, 1024, 34, 7568, 13697, 0, 0, 21299, 1.36533e+07
n1000x8192-slot-inner, 1024, 34, 7559, 13481, 0, 0, 21074, 1.36533e+07
n1000x8192-slot-inner, 1024, 33, 7515, 13493, 0, 0, 21041, 1.36533e+07
n1000x8192-slot-inner, 1024, 34, 7489, 13567, 0, 0, 21090, 1.36533e+07
n1000x8192-slot-inner, 1024, 33, 7493, 13486, 0, 0, 21012, 1.36533e+07
n1000x8192-slot-inner, 1024, 33, 7503, 13477, 0, 0, 21013, 1.36533e+07
n1000x8192-slot-inner, 1024, 33, 7523, 13561, 0, 0, 21117, 1.36533e+07
n1000x8192-slot-inner, 1024, 33, 7519, 13689, 0, 0, 21241, 1.36533e+07
n1000x8192-slot-inner, 1024, 33, 7517, 13557, 0, 0, 21107, 1.36533e+07
n1000x8192-slot-inner, 1024, 34, 7541, 13592, 0, 0, 21167, 1.36533e+07
n1000x8192-slot-inner, 1024, 33, 7521, 13641, 0, 0, 21195, 1.36533e+07
n1000x8192-slot-inner, 1024, 35, 7497, 13483, 0, 0, 21015, 1.36533e+07
n1000x8192-slot-inner, 1024, 34, 7540, 13511, 0, 0, 21085, 1.36533e+07
n1000x8192-slot-inner, 1024, 33, 7507, 13485, 0, 0, 21025, 1.36533e+07
n1000x8192-slot-inner, 1024, 34, 7503, 13557, 0, 0, 21094, 1.36533e+07
n1000x8192-slot-inner, 1024, 35, 7505, 13525, 0, 0, 21065, 1.36533e+07
n1000x8192-slot-inner, 1024, 33, 7504, 13622, 0, 0, 21159, 1.36533e+07
n1000x8192-slot-inner, 1024, 34, 7542, 13574, 0, 0, 21150, 1.36533e+07
n1000x8192-slot-inner, 1024, 33, 7507, 13605, 0, 0, 21145, 1.36533e+07
n1000x8192-slot-inner, 1024, 34, 7498, 13587, 0, 0, 21119, 1.36533e+07
n1000x8192-slot-inner, 1024, 33, 7539, 13675, 0, 0, 21247, 1.36533e+07
n1000x8192-slot-inner, 1024, 33, 7502, 13573, 0, 0, 21108, 1.36533e+07
n1000x8192-slot-inner, 1024, 33, 7505, 13566, 0, 0, 21104, 1.36533e+07
n1000x8192-slot-inner, 1024, 34, 7515, 13956, 0, 0, 21505, 1.36533e+07
n1000x8192-slot-inner, 1024, 33, 7778, 13507, 0, 0, 21318, 1.36533e+07
n1000x8192-slot-inner, 1024, 34, 7507, 13583, 0, 0, 21124, 1.36533e+07
n1000x8192-slot-inner, 1024, 33, 7496, 13496, 0, 0, 21025, 1.36533e+07
n1000x8192-slot-inner, 1024, 34, 7513, 13462, 0, 0, 21009, 1.36533e+07
n1000x8192-slot-inner, 1024, 33, 7528, 13597, 0, 0, 21158, 1.36533e+07
n1000x8192-slot-inner, 1024, 33, 7495, 13515, 0, 0, 21043, 1.36533e+07
n1000x8192-slot-inner, 1024, 34, 7529, 13626, 0, 0, 21189, 1.36533e+07
n1000x8192-slot-inner, 1024, 34, 7575, 13884, 0, 0, 21493, 1.36533e+07
n1000x8192-slot-inner, 1024, 34, 7508, 13584, 0, 0, 21126, 1.36533e+07
n1000x8192-slot-inner, 1024, 33, 7511, 13581, 0, 0, 21125, 1.36533e+07
n1000x8192-slot-inner, 1024, 34, 7521, 13522, 0, 0, 21077, 1.36533e+07
n1000x8192-slot-inner, 1024, 34, 7487, 13885, 0, 0, 21406, 1.36533e+07
n1000x8192-coef-inner, 8192, 52, 27373, 13550, 1, 0, 40976, 1.36533e+07
n1000x8192-coef-inner, 8192, 54, 27350, 13597, 1, 0, 41002, 1.36533e+07
n1000x8192-coef-inner, 8192, 52, 27383, 14027, 1, 0, 41463, 1.36533e+07
n1000x8192-coef-inner, 8192, 50, 27356, 14084, 1, 0, 41491, 1.36533e+07
n1000x8192-coef-inner, 8192, 51, 27445, 13596, 1, 0, 41093, 1.36533e+07
n1000x8192-coef-inner, 8192, 52, 27335, 13531, 1, 0, 40919, 1.36533e+07
n1000x8192-coef-inner, 8192, 52, 27369, 13503, 1, 0, 40925, 1.36533e+07
n1000x8192-coef-inner, 8192, 50, 27441, 13507, 1, 0, 40999, 1.36533e+07
n1000x8192-coef-inner, 8192, 51, 27360, 13484, 1, 0, 40896, 1.36533e+07
n1000x8192-coef-inner, 8192, 53, 27420, 13468, 1, 0, 40942, 1.36533e+07
n1000x8192-coef-inner, 8192, 50, 27332, 14076, 1, 0, 41459, 1.36533e+07
n1000x8192-coef-inner, 8192, 50, 27361, 13464, 1, 0, 40876, 1.36533e+07
n1000x8192-coef-inner, 8192, 50, 27415, 13437, 1, 0, 40903, 1.36533e+07
n1000x8192-coef-inner, 8192, 55, 27322, 13492, 1, 0, 40870, 1.36533e+07
n1000x8192-coef-inner, 8192, 56, 27323, 14089, 1, 0, 41469, 1.36533e+07
n1000x8192-coef-inner, 8192, 51, 27397, 13508, 1, 0, 40957, 1.36533e+07
n1000x8192-coef-inner, 8192, 52, 27403, 13847, 1, 0, 41303, 1.36533e+07
n1000x8192-coef-inner, 8192, 53, 27507, 13931, 1, 0, 41492, 1.36533e+07
n1000x8192-coef-inner, 8192, 51, 27291, 13420, 1, 0, 40763, 1.36533e+07
n1000x8192-coef-inner, 8192, 52, 27416, 13514, 1, 0, 40983, 1.36533e+07
n1000x8192-coef-inner, 8192, 53, 27355, 14081, 1, 0, 41490, 1.36533e+07
n1000x8192-coef-inner, 8192, 57, 27402, 13501, 1, 0, 40961, 1.36533e+07
n1000x8192-coef-inner, 8192, 57, 27375, 13449, 1, 0, 40882, 1.36533e+07
n1000x8192-coef-inner, 8192, 52, 27381, 14107, 1, 0, 41541, 1.36533e+07
n1000x8192-coef-inner, 8192, 52, 27314, 13493, 1, 0, 40860, 1.36533e+07
n1000x8192-coef-inner, 8192, 53, 27401, 13480, 1, 0, 40935, 1.36533e+07
n1000x8192-coef-inner, 8192, 53, 27372, 13476, 1, 0, 40902, 1.36533e+07
n1000x8192-coef-inner, 8192, 54, 27423, 13516, 1, 0, 40994, 1.36533e+07
n1000x8192-coef-inner, 8192, 54, 27415, 13474, 1, 0, 40944, 1.36533e+07
n1000x8192-coef-inner, 8192, 52, 27421, 14349, 1, 0, 41823, 1.36533e+07
n1000x8192-coef-inner, 8192, 57, 27363, 13714, 1, 0, 41135, 1.36533e+07
n1000x8192-coef-inner, 8192, 51, 27309, 13418, 1, 0, 40779, 1.36533e+07
n1000x8192-coef-inner, 8192, 52, 27361, 13480, 1, 0, 40894, 1.36533e+07
n1000x8192-coef-inner, 8192, 50, 27385, 13459, 1, 0, 40895, 1.36533e+07
n1000x8192-coef-inner, 8192, 52, 27495, 13571, 1, 0, 41119, 1.36533e+07
n1000x8192-coef-inner, 8192, 52, 27345, 13448, 1, 0, 40846, 1.36533e+07
n1000x8192-coef-inner, 8192, 51, 27459, 13937, 1, 0, 41448, 1.36533e+07
n1000x8192-coef-inner, 8192, 51, 27360, 14104, 1, 0, 41516, 1.36533e+07
n1000x8192-coef-inner, 8192, 54, 27366, 14069, 1, 0, 41490, 1.36533e+07
n1000x8192-coef-inner, 8192, 54, 27547, 13469, 1, 0, 41071, 1.36533e+07
n1000x8192-coef-inner, 8192, 52, 27392, 13491, 1, 0, 40936, 1.36533e+07
n1000x8192-coef-inner, 8192, 52, 27435, 13535, 1, 0, 41023, 1.36533e+07
n1000x8192-coef-inner, 8192, 50, 27530, 13437, 1, 0, 41018, 1.36533e+07
n1000x8192-coef-inner, 8192, 52, 27404, 13450, 1, 0, 40907, 1.36533e+07
n1000x8192-coef-inner, 8192, 51, 27389, 13468, 1, 0, 40909, 1.36533e+07
n1000x8192-coef-inner, 8192, 52, 27403, 13465, 1, 0, 40921, 1.36533e+07
n1000x8192-coef-inner, 8192, 55, 27454, 14020, 1, 0, 41530, 1.36533e+07
n1000x8192-coef-inner, 8192, 53, 27331, 14090, 1, 0, 41475, 1.36533e+07
n1000x8192-coef-inner, 8192, 52, 27353, 13477, 1, 0, 40883, 1.36533e+07
n1000x8192-coef-inner, 8192, 49, 27366, 13431, 1, 0, 40847, 1.36533e+07
n1000x8192-coef-inner, 8192, 50, 27324, 13630, 1, 0, 41005, 1.36533e+07
n1000x8192-coef-inner, 8192, 50, 27309, 13444, 1, 0, 40804, 1.36533e+07
n1000x8192-coef-inner, 8192, 51, 27473, 13534, 1, 0, 41059, 1.36533e+07
n1000x8192-coef-inner, 8192, 54, 27380, 13463, 1, 0, 40898, 1.36533e+07
n1000x8192-coef-inner, 8192, 60, 27333, 14049, 1, 0, 41443, 1.36533e+07
n1000x8192-coef-inner, 8192, 51, 27350, 14063, 1, 0, 41465, 1.36533e+07
n1000x8192-coef-inner, 8192, 54, 27484, 14099, 1, 0, 41638, 1.36533e+07
n1000x8192-coef-inner, 8192, 54, 27425, 13534, 1, 0, 41014, 1.36533e+07
n1000x8192-coef-inner, 8192, 51, 27399, 13518, 1, 0, 40969, 1.36533e+07
n1000x8192-coef-inner, 8192, 50, 27402, 14024, 1, 0, 41477, 1.36533e+07
n1000x8192-coef-inner, 8192, 51, 27408, 13694, 1, 0, 41154, 1.36533e+07
n1000x8192-coef-inner, 8192, 50, 27483, 13683, 1, 0, 41217, 1.36533e+07
n1000x8192-coef-inner, 8192, 54, 27488, 13745, 1, 0, 41288, 1.36533e+07
n1000x8192-coef-inner, 8192, 53, 27537, 13578, 1, 0, 41169, 1.36533e+07
n1000x8192-coef-inner, 8192, 59, 27585, 13553, 1, 0, 41198, 1.36533e+07
n1000x8192-coef-inner, 8192, 50, 27415, 14122, 1, 0, 41588, 1.36533e+07
n1000x8192-coef-inner, 8192, 55, 27555, 13523, 1, 0, 41134, 1.36533e+07
n1000x8192-coef-inner, 8192, 54, 27459, 13568, 1, 0, 41082, 1.36533e+07
n1000x8192-coef-inner, 8192, 51, 27495, 13489, 1, 0, 41036, 1.36533e+07
n1000x8192-coef-inner, 8192, 52, 27523, 13578, 1, 0, 41154, 1.36533e+07
n1000x8192-coef-inner, 8192, 53, 27640, 13635, 1, 0, 41329, 1.36533e+07
n1000x8192-coef-inner, 8192, 53, 27569, 13645, 1, 0, 41268, 1.36533e+07
n1000x8192-coef-inner, 8192, 57, 27531, 13533, 1, 0, 41122, 1.36533e+07
n1000x8192-coef-inner, 8192, 53, 27491, 13705, 1, 0, 41250, 1.36533e+07
n1000x8192-coef-inner, 8192, 50, 27390, 13484, 1, 0, 40925, 1.36533e+07
n1000x8192-coef-inner, 8192, 53, 27546, 13507, 1, 0, 41107, 1.36533e+07
n1000x8192-coef-inner, 8192, 52, 27543, 13957, 1, 0, 41553, 1.36533e+07
n1000x8192-coef-inner, 8192, 51, 27363, 14120, 1, 0, 41535, 1.36533e+07
n1000x8192-coef-inner, 8192, 51, 27418, 14147, 1, 0, 41617, 1.36533e+07
n1000x8192-coef-inner, 8192, 51, 27449, 13667, 1, 0, 41168, 1.36533e+07
n1000x8192-coef-inner, 8192, 53, 27399, 16192, 1, 0, 43645, 1.36533e+07
n1000x8192-coef-inner, 8192, 50, 27790, 14194, 1, 0, 42035, 1.36533e+07
n1000x8192-coef-inner, 8192, 53, 27561, 14064, 1, 0, 41679, 1.36533e+07
n1000x8192-coef-inner, 8192, 54, 27564, 13773, 1, 0, 41392, 1.36533e+07
n1000x8192-coef-inner, 8192, 51, 27447, 13586, 1, 0, 41085, 1.36533e+07
n1000x8192-coef-inner, 8192, 53, 27575, 13681, 1, 0, 41310, 1.36533e+07
n1000x8192-coef-inner, 8192, 58, 27704, 13584, 1, 0, 41347, 1.36533e+07
n1000x8192-coef-inner, 8192, 54, 27564, 13910, 1, 0, 41529, 1.36533e+07
n1000x8192-coef-inner, 8192, 52, 27704, 13658, 1, 0, 41415, 1.36533e+07
n1000x8192-coef-inner, 8192, 53, 27690, 13724, 3, 0, 41470, 1.36533e+07
n1000x8192-coef-inner, 8192, 53, 27483, 14074, 1, 0, 41611, 1.36533e+07
n1000x8192-coef-inner, 8192, 54, 27401, 14147, 1, 0, 41603, 1.36533e+07
n1000x8192-coef-inner, 8192, 51, 27415, 13553, 1, 0, 41020, 1.36533e+07
n1000x8192-coef-inner, 8192, 52, 27389, 13539, 1, 0, 40981, 1.36533e+07
n1000x8192-coef-inner, 8192, 50, 27378, 13504, 1, 0, 40933, 1.36533e+07
n1000x8192-coef-inner, 8192, 53, 27476, 13511, 1, 0, 41041, 1.36533e+07
n1000x8192-coef-inner, 8192, 51, 27503, 14136, 1, 0, 41691, 1.36533e+07
n1000x8192-coef-inner, 8192, 52, 27426, 14132, 1, 0, 41611, 1.36533e+07
n1000x8192-coef-inner, 8192, 50, 27520, 14167, 1, 0, 41738, 1.36533e+07
n1000x8192-coef-inner, 8192, 50, 27548, 13517, 1, 0, 41116, 1.36533e+07
n1000x8192-coef-inner, 4096, 29, 27355, 13690, 0, 0, 41074, 1.36533e+07
n1000x8192-coef-inner, 4096, 27, 27273, 13184, 0, 0, 40484, 1.36533e+07
n1000x8192-coef-inner, 4096, 31, 27269, 13372, 0, 0, 40672, 1.36533e+07
n1000x8192-coef-inner, 4096, 29, 27278, 13346, 0, 0, 40653, 1.36533e+07
n1000x8192-coef-inner, 4096, 29, 27250, 13728, 0, 0, 41007, 1.36533e+07
n1000x8192-coef-inner, 4096, 27, 27241, 13668, 0, 0, 40936, 1.36533e+07
n1000x8192-coef-inner, 4096, 28, 27311, 13486, 0, 0, 40825, 1.36533e+07
n1000x8192-coef-inner, 4096, 28, 27337, 13215, 0, 0, 40580, 1.36533e+07
n1000x8192-coef-inner, 4096, 28, 27373, 13858, 0, 0, 41259, 1.36533e+07
n1000x8192-coef-inner, 4096, 28, 27367, 13178, 0, 0, 40573, 1.36533e+07
n1000x8192-coef-inner, 4096, 27, 27391, 13240, 0, 0, 40658, 1.36533e+07
n1000x8192-coef-inner, 4096, 27, 27462, 13224, 0, 0, 40713, 1.36533e+07
n1000x8192-coef-inner, 4096, 27, 27363, 13235, 0, 0, 40625, 1.36533e+07
n1000x8192-coef-inner, 4096, 38, 27308, 13752, 0, 0, 41098, 1.36533e+07
n1000x8192-coef-inner, 4096, 28, 27325, 13197, 0, 0, 40550, 1.36533e+07
n1000x8192-coef-inner, 4096, 33, 27501, 13713, 0, 0, 41247, 1.36533e+07
n1000x8192-coef-inner, 4096, 27, 27461, 13176, 0, 0, 40664, 1.36533e+07
n1000x8192-coef-inner, 4096, 31, 27281, 13683, 0, 0, 40995, 1.36533e+07
n1000x8192-coef-inner, 4096, 31, 27244, 13690, 0, 0, 40965, 1.36533e+07
n1000x8192-coef-inner, 4096, 27, 27236, 13118, 0, 0, 40381, 1.36533e+07
n1000x8192-coef-inner, 4096, 30, 27262, 13116, 0, 0, 40408, 1.36533e+07
n1000x8192-coef-inner, 4096, 28, 27246, 13636, 0, 0, 40910, 1.36533e+07
n1000x8192-coef-inner, 4096, 31, 27333, 13251, 0, 0, 40615, 1.36533e+07
n1000x8192-coef-inner, 4096, 30, 27255, 13317, 0, 0, 40602, 1.36533e+07
n1000x8192-coef-inner, 4096, 34, 27274, 13103, 0, 0, 40411, 1.36533e+07
n1000x8192-coef-inner, 4096, 30, 27463, 13667, 0, 0, 41160, 1.36533e+07
n1000x8192-coef-inner, 4096, 27, 27271, 13161, 0, 0, 40459, 1.36533e+07
n1000x8192-coef-inner, 4096, 28, 27256, 13244, 0, 0, 40528, 1.36533e+07
n1000x8192-coef-inner, 4096, 30, 27294, 13383, 0, 0, 40707, 1.36533e+07
n1000x8192-coef-inner, 4096, 27, 27308, 13118, 0, 0, 40453, 1.36533e+07
n1000x8192-coef-inner, 4096, 38, 27214, 13688, 0, 0, 40940, 1.36533e+07
n1000x8192-coef-inner, 4096, 28, 27355, 13168, 0, 0, 40551, 1.36533e+07
n1000x8192-coef-inner, 4096, 29, 27207, 13190, 0, 0, 40426, 1.36533e+07
n1000x8192-coef-inner, 4096, 30, 27217, 13187, 0, 0, 40434, 1.36533e+07
n1000x8192-coef-inner, 4096, 28, 28273, 13435, 0, 0, 41736, 1.36533e+07
n1000x8192-coef-inner, 4096, 27, 27213, 13147, 0, 0, 40387, 1.36533e+07
n1000x8192-coef-inner, 4096, 28, 27217, 13127, 0, 0, 40372, 1.36533e+07
n1000x8192-coef-inner, 4096, 27, 27361, 13674, 0, 0, 41062, 1.36533e+07
n1000x8192-coef-inner, 4096, 28, 27275, 13175, 0, 0, 40478, 1.36533e+07
n1000x8192-coef-inner, 4096, 28, 27189, 13190, 0, 0, 40407, 1.36533e+07
n1000x8192-coef-inner, 4096, 27, 27233, 13129, 0, 0, 40389, 1.36533e+07
n1000x8192-coef-inner, 4096, 28, 27328, 13130, 0, 0, 40486, 1.36533e+07
n1000x8192-coef-inner, 4096, 27, 27234, 13142, 0, 0, 40403, 1.36533e+07
n1000x8192-coef-inner, 4096, 27, 27284, 13185, 0, 0, 40496, 1.36533e+07
n1000x8192-coef-inner, 4096, 28, 27543, 13727, 0, 0, 41298, 1.36533e+07
n1000x8192-coef-inner, 4096, 27, 27253, 13204, 0, 0, 40484, 1.36533e+07
n1000x8192-coef-inner, 4096, 30, 27366, 13133, 0, 0, 40529, 1.36533e+07
n1000x8192-coef-inner, 4096, 30, 27644, 13336, 0, 0, 41010, 1.36533e+07
n1000x8192-coef-inner, 4096, 30, 27603, 13510, 0, 0, 41143, 1.36533e+07
n1000x8192-coef-inner, 4096, 30, 27457, 13273, 0, 0, 40760, 1.36533e+07
n1000x8192-coef-inner, 4096, 33, 27499, 13310, 0, 0, 40842, 1.36533e+07
n1000x8192-coef-inner, 4096, 32, 27664, 13570, 0, 0, 41266, 1.36533e+07
n1000x8192-coef-inner, 4096, 31, 27350, 13275, 0, 0, 40656, 1.36533e+07
n1000x8192-coef-inner, 4096, 27, 27325, 13271, 0, 0, 40623, 1.36533e+07
n1000x8192-coef-inner, 4096, 31, 27675, 13831, 0, 0, 41537, 1.36533e+07
n1000x8192-coef-inner, 4096, 28, 27546, 13273, 0, 0, 40847, 1.36533e+07
n1000x8192-coef-inner, 4096, 28, 27308, 13216, 0, 0, 40552, 1.36533e+07
n1000x8192-coef-inner, 4096, 27, 27295, 13353, 0, 0, 40675, 1.36533e+07
n1000x8192-coef-inner, 4096, 31, 27327, 13299, 0, 0, 40657, 1.36533e+07
n1000x8192-coef-inner, 4096, 27, 27272, 13229, 0, 0, 40528, 1.36533e+07
n1000x8192-coef-inner, 4096, 30, 27323, 13360, 0, 0, 40713, 1.36533e+07
n1000x8192-coef-inner, 4096, 28, 27334, 13308, 0, 0, 40670, 1.36533e+07
n1000x8192-coef-inner, 4096, 27, 27271, 13136, 0, 0, 40434, 1.36533e+07
n1000x8192-coef-inner, 4096, 30, 27320, 13513, 0, 0, 40863, 1.36533e+07
n1000x8192-coef-inner, 4096, 27, 27286, 13310, 0, 0, 40623, 1.36533e+07
n1000x8192-coef-inner, 4096, 27, 27383, 13198, 0, 0, 40608, 1.36533e+07
n1000x8192-coef-inner, 4096, 41, 27763, 13663, 0, 0, 41467, 1.36533e+07
n1000x8192-coef-inner, 4096, 31, 27662, 13478, 0, 0, 41171, 1.36533e+07
n1000x8192-coef-inner, 4096, 27, 27275, 13271, 0, 0, 40573, 1.36533e+07
n1000x8192-coef-inner, 4096, 27, 27378, 13235, 0, 0, 40640, 1.36533e+07
n1000x8192-coef-inner, 4096, 28, 27476, 13179, 0, 0, 40683, 1.36533e+07
n1000x8192-coef-inner, 4096, 31, 27303, 13825, 0, 0, 41159, 1.36533e+07
n1000x8192-coef-inner, 4096, 31, 27258, 13794, 0, 0, 41083, 1.36533e+07
n1000x8192-coef-inner, 4096, 27, 27334, 13295, 0, 0, 40656, 1.36533e+07
n1000x8192-coef-inner, 4096, 27, 27247, 13272, 0, 0, 40546, 1.36533e+07
n1000x8192-coef-inner, 4096, 32, 27278, 13167, 0, 0, 40477, 1.36533e+07
n1000x8192-coef-inner, 4096, 29, 27447, 13761, 0, 0, 41237, 1.36533e+07
n1000x8192-coef-inner, 4096, 29, 27431, 13323, 0, 0, 40783, 1.36533e+07
n1000x8192-coef-inner, 4096, 29, 27202, 13183, 0, 0, 40414, 1.36533e+07
n1000x8192-coef-inner, 4096, 30, 27262, 13730, 0, 0, 41022, 1.36533e+07
n1000x8192-coef-inner, 4096, 28, 27273, 13179, 0, 0, 40480, 1.36533e+07
n1000x8192-coef-inner, 4096, 29, 27458, 13216, 0, 0, 40703, 1.36533e+07
n1000x8192-coef-inner, 4096, 27, 27298, 13216, 0, 0, 40541, 1.36533e+07
n1000x8192-coef-inner, 4096, 27, 27284, 13300, 0, 0, 40611, 1.36533e+07
n1000x8192-coef-inner, 4096, 35, 27250, 13200, 0, 0, 40485, 1.36533e+07
n1000x8192-coef-inner, 4096, 27, 27227, 13176, 0, 0, 40430, 1.36533e+07
n1000x8192-coef-inner, 4096, 27, 27304, 13718, 0, 0, 41049, 1.36533e+07
n1000x8192-coef-inner, 4096, 27, 27379, 13242, 0, 0, 40648, 1.36533e+07
n1000x8192-coef-inner, 4096, 35, 27208, 13147, 0, 0, 40390, 1.36533e+07
n1000x8192-coef-inner, 4096, 29, 27416, 13746, 0, 0, 41191, 1.36533e+07
n1000x8192-coef-inner, 4096, 28, 27257, 13367, 0, 0, 40652, 1.36533e+07
n1000x8192-coef-inner, 4096, 28, 27367, 13169, 0, 0, 40564, 1.36533e+07
n1000x8192-coef-inner, 4096, 30, 27286, 13805, 0, 0, 41121, 1.36533e+07
n1000x8192-coef-inner, 4096, 28, 27228, 13755, 0, 0, 41011, 1.36533e+07
n1000x8192-coef-inner, 4096, 39, 27213, 13804, 0, 0, 41056, 1.36533e+07
n1000x8192-coef-inner, 4096, 37, 27287, 13717, 0, 0, 41041, 1.36533e+07
n1000x8192-coef-inner, 4096, 29, 27478, 13270, 0, 0, 40777, 1.36533e+07
n1000x8192-coef-inner, 4096, 28, 27266, 13198, 0, 0, 40492, 1.36533e+07
n1000x8192-coef-inner, 4096, 35, 27271, 13689, 0, 0, 40995, 1.36533e+07
n1000x8192-coef-inner, 4096, 29, 27263, 13097, 0, 0, 40389, 1.36533e+07
n1000x8192-coef-inner, 2048, 16, 27465, 13778, 0, 0, 41259, 1.36533e+07
n1000x8192-coef-inner, 2048, 16, 28203, 13218, 0, 0, 41437, 1.36533e+07
n1000x8192-coef-inner, 2048, 21, 27667, 13172, 0, 0, 40860, 1.36533e+07
n1000x8192-coef-inner, 2048, 16, 27411, 13142, 0, 0, 40569, 1.36533e+07
n1000x8192-coef-inner, 2048, 16, 27517, 13201, 0, 0, 40734, 1.36533e+07
n1000x8192-coef-inner, 2048, 16, 27456, 13649, 0, 0, 41121, 1.36533e+07
n1000x8192-coef-inner, 2048, 16, 27445, 13145, 0, 0, 40606, 1.36533e+07
n1000x8192-coef-inner, 2048, 16, 27457, 13166, 0, 0, 40639, 1.36533e+07
n1000x8192-coef-inner, 2048, 16, 27489, 13190, 0, 0, 40695, 1.36533e+07
n1000x8192-coef-inner, 2048, 16, 27419, 13354, 0, 0, 40789, 1.36533e+07
n1000x8192-coef-inner, 2048, 16, 27502, 13170, 0, 0, 40688, 1.36533e+07
n1000x8192-coef-inner, 2048, 18, 27377, 13613, 0, 0, 41008, 1.36533e+07
n1000x8192-coef-inner, 2048, 16, 27528, 13098, 0, 0, 40642, 1.36533e+07
n1000x8192-coef-inner, 2048, 16, 27411, 13103, 0, 0, 40530, 1.36533e+07
n1000x8192-coef-inner, 2048, 18, 27437, 13103, 0, 0, 40558, 1.36533e+07
n1000x8192-coef-inner, 2048, 16, 27468, 13235, 0, 0, 40719, 1.36533e+07
n1000x8192-coef-inner, 2048, 17, 27615, 13665, 0, 0, 41297, 1.36533e+07
n1000x8192-coef-inner, 2048, 21, 27432, 13667, 0, 0, 41120, 1.36533e+07
n1000x8192-coef-inner, 2048, 16, 27596, 13158, 0, 0, 40770, 1.36533e+07
n1000x8192-coef-inner, 2048, 16, 27399, 13175, 0, 0, 40590, 1.36533e+07
n1000x8192-coef-inner, 2048, 16, 27390, 13167, 0, 0, 40573, 1.36533e+07
n1000x8192-coef-inner, 2048, 16, 27528, 13322, 0, 0, 40866, 1.36533e+07
n1000x8192-coef-inner, 2048, 16, 27478, 13464, 0, 0, 40958, 1.36533e+07
n1000x8192-coef-inner, 2048, 16, 27434, 13081, 0, 0, 40531, 1.36533e+07
n1000x8192-coef-inner, 2048, 19, 27482, 13291, 0, 0, 40792, 1.36533e+07
n1000x8192-coef-inner, 2048, 17, 27473, 13184, 0, 0, 40674, 1.36533e+07
n1000x8192-coef-inner, 2048, 16, 27377, 13190, 0, 0, 40583, 1.36533e+07
n1000x8192-coef-inner, 2048, 17, 27584, 13223, 0, 0, 40824, 1.36533e+07
n1000x8192-coef-inner, 2048, 16, 27476, 13636, 0, 0, 41128, 1.36533e+07
n1000x8192-coef-inner, 2048, 16, 27419, 13113, 0, 0, 40548, 1.36533e+07
n1000x8192-coef-inner, 2048, 16, 27446, 13608, 0, 0, 41070, 1.36533e+07
n1000x8192-coef-inner, 2048, 24, 27418, 13560, 0, 0, 41002, 1.36533e+07
n1000x8192-coef-inner, 2048, 16, 27458, 13187, 0, 0, 40661, 1.36533e+07
n1000x8192-coef-inner, 2048, 16, 27488, 13658, 0, 0, 41162, 1.36533e+07
n1000x8192-coef-inner, 2048, 19, 27810, 13268, 0, 0, 41097, 1.36533e+07
n1000x8192-coef-inner, 2048, 16, 27694, 13247, 0, 0, 40957, 1.36533e+07
n1000x8192-coef-inner, 2048, 16, 27560, 13074, 0, 0, 40650, 1.36533e+07
n1000x8192-coef-inner, 2048, 16, 27446, 13167, 0, 0, 40629, 1.36533e+07
n1000x8192-coef-inner, 2048, 16, 27511, 13161, 0, 0, 40688, 1.36533e+07
n1000x8192-coef-inner, 2048, 16, 27588, 13235, 0, 0, 40839, 1.36533e+07
n1000x8192-coef-inner, 2048, 16, 27485, 13302, 0, 0, 40803, 1.36533e+07
n1000x8192-coef-inner, 2048, 16, 27616, 13295, 0, 0, 40927, 1.36533e+07
n1000x8192-coef-inner, 2048, 17, 27429, 13161, 0, 0, 40607, 1.36533e+07
n1000x8192-coef-inner, 2048, 16, 27387, 13221, 0, 0, 40624, 1.36533e+07
n1000x8192-coef-inner, 2048, 16, 27492, 13074, 0, 0, 40582, 1.36533e+07
n1000x8192-coef-inner, 2048, 16, 27477, 13190, 0, 0, 40683, 1.36533e+07
n1000x8192-coef-inner, 2048, 16, 27732, 13185, 0, 0, 40933, 1.36533e+07
n1000x8192-coef-inner, 2048, 16, 27475, 13274, 0, 0, 40765, 1.36533e+07
n1000x8192-coef-inner, 2048, 23, 27420, 13186, 0, 0, 40629, 1.36533e+07
n1000x8192-coef-inner, 2048, 16, 27362, 13127, 0, 0, 40505, 1.36533e+07
n1000x8192-coef-inner, 2048, 16, 27434, 13161, 0, 0, 40611, 1.36533e+07
n1000x8192-coef-inner, 2048, 16, 27552, 13065, 0, 0, 40633, 1.36533e+07
n1000x8192-coef-inner, 2048, 21, 27662, 13162, 0, 0, 40845, 1.36533e+07
n1000x8192-coef-inner, 2048, 16, 27595, 13191, 0, 0, 40802, 1.36533e+07
n1000x8192-coef-inner, 2048, 16, 27518, 13134, 0, 0, 40668, 1.36533e+07
n1000x8192-coef-inner, 2048, 16, 27411, 13144, 0, 0, 40571, 1.36533e+07
n1000x8192-coef-inner, 2048, 16, 27590, 13624, 0, 0, 41230, 1.36533e+07
n1000x8192-coef-inner, 2048, 16, 27604, 13146, 0, 0, 40766, 1.36533e+07
n1000x8192-coef-inner, 2048, 16, 27525, 13266, 0, 0, 40807, 1.36533e+07
n1000x8192-coef-inner, 2048, 19, 27607, 13139, 0, 0, 40765, 1.36533e+07
n1000x8192-coef-inner, 2048, 16, 27461, 13570, 0, 0, 41047, 1.36533e+07
n1000x8192-coef-inner, 2048, 17, 27767, 13202, 0, 0, 40986, 1.36533e+07
n1000x8192-coef-inner, 2048, 16, 27463, 13660, 0, 0, 41139, 1.36533e+07
n1000x8192-coef-inner, 2048, 16, 27577, 13198, 0, 0, 40791, 1.36533e+07
n1000x8192-coef-inner, 2048, 16, 27450, 13202, 0, 0, 40668, 1.36533e+07
n1000x8192-coef-inner, 2048, 17, 27530, 13238, 0, 0, 40785, 1.36533e+07
n1000x8192-coef-inner, 2048, 16, 27494, 13089, 0, 0, 40599, 1.36533e+07
n1000x8192-coef-inner, 2048, 16, 27498, 13177, 0, 0, 40691, 1.36533e+07
n1000x8192-coef-inner, 2048, 16, 27415, 13108, 0, 0, 40539, 1.36533e+07
n1000x8192-coef-inner, 2048, 16, 27511, 13320, 0, 0, 40847, 1.36533e+07
n1000x8192-coef-inner, 2048, 16, 27505, 13092, 0, 0, 40613, 1.36533e+07
n1000x8192-coef-inner, 2048, 16, 27411, 13059, 0, 0, 40486, 1.36533e+07
n1000x8192-coef-inner, 2048, 16, 27375, 13568, 0, 0, 40959, 1.36533e+07
n1000x8192-coef-inner, 2048, 16, 27426, 13159, 0, 0, 40601, 1.36533e+07
n1000x8192-coef-inner, 2048, 16, 27451, 13062, 0, 0, 40529, 1.36533e+07
n1000x8192-coef-inner, 2048, 16, 27440, 13551, 0, 0, 41007, 1.36533e+07
n1000x8192-coef-inner, 2048, 16, 27470, 13088, 0, 0, 40574, 1.36533e+07
n1000x8192-coef-inner, 2048, 16, 27404, 13343, 0, 0, 40763, 1.36533e+07
n1000x8192-coef-inner, 2048, 17, 27539, 13193, 0, 0, 40749, 1.36533e+07
n1000x8192-coef-inner, 2048, 16, 27470, 13142, 0, 0, 40628, 1.36533e+07
n1000x8192-coef-inner, 2048, 16, 27542, 13122, 0, 0, 40680, 1.36533e+07
n1000x8192-coef-inner, 2048, 16, 27627, 13111, 0, 0, 40754, 1.36533e+07
n1000x8192-coef-inner, 2048, 16, 27503, 13102, 0, 0, 40621, 1.36533e+07
n1000x8192-coef-inner, 2048, 16, 27608, 13471, 0, 0, 41095, 1.36533e+07
n1000x8192-coef-inner, 2048, 18, 27523, 13089, 0, 0, 40630, 1.36533e+07
n1000x8192-coef-inner, 2048, 16, 27519, 13670, 0, 0, 41205, 1.36533e+07
n1000x8192-coef-inner, 2048, 16, 27486, 13056, 0, 0, 40558, 1.36533e+07
n1000x8192-coef-inner, 2048, 16, 27438, 13158, 0, 0, 40612, 1.36533e+07
n1000x8192-coef-inner, 2048, 16, 27494, 13315, 0, 0, 40825, 1.36533e+07
n1000x8192-coef-inner, 2048, 16, 27549, 13168, 0, 0, 40733, 1.36533e+07
n1000x8192-coef-inner, 2048, 19, 27452, 13244, 0, 0, 40715, 1.36533e+07
n1000x8192-coef-inner, 2048, 19, 27631, 13303, 0, 0, 40953, 1.36533e+07
n1000x8192-coef-inner, 2048, 17, 27570, 13115, 0, 0, 40702, 1.36533e+07
n1000x8192-coef-inner, 2048, 16, 27487, 13151, 0, 0, 40654, 1.36533e+07
n1000x8192-coef-inner, 2048, 16, 27594, 13236, 0, 0, 40846, 1.36533e+07
n1000x8192-coef-inner, 2048, 16, 27602, 13291, 0, 0, 40909, 1.36533e+07
n1000x8192-coef-inner, 2048, 16, 27575, 13258, 0, 0, 40849, 1.36533e+07
n1000x8192-coef-inner, 2048, 16, 27475, 13138, 0, 0, 40629, 1.36533e+07
n1000x8192-coef-inner, 2048, 16, 27483, 13155, 0, 0, 40654, 1.36533e+07
n1000x8192-coef-inner, 2048, 16, 27840, 13324, 0, 0, 41180, 1.36533e+07
n1000x8192-coef-inner, 1024, 12, 28607, 13674, 0, 0, 42293, 1.36533e+07
n1000x8192-coef-inner, 1024, 12, 28691, 13591, 0, 0, 42294, 1.36533e+07
n1000x8192-coef-inner, 1024, 12, 28591, 13536, 0, 0, 42139, 1.36533e+07
n1000x8192-coef-inner, 1024, 13, 28628, 13695, 0, 0, 42336, 1.36533e+07
n1000x8192-coef-inner, 1024, 12, 28409, 13493, 0, 0, 41914, 1.36533e+07
n1000x8192-coef-inner, 1024, 12, 28559, 13783, 0, 0, 42354, 1.36533e+07
n1000x8192-coef-inner, 1024, 13, 28491, 13522, 0, 0, 42026, 1.36533e+07
n1000x8192-coef-inner, 1024, 12, 28715, 13790, 0, 0, 42517, 1.36533e+07
n1000x8192-coef-inner, 1024, 11, 28597, 13580, 0, 0, 42188, 1.36533e+07
n1000x8192-coef-inner, 1024, 12, 28551, 13622, 0, 0, 42185, 1.36533e+07
n1000x8192-coef-inner, 1024, 12, 28537, 13695, 0, 0, 42244, 1.36533e+07
n1000x8192-coef-inner, 1024, 12, 28478, 14040, 0, 0, 42530, 1.36533e+07
n1000x8192-coef-inner, 1024, 12, 28604, 14023, 0, 0, 42639, 1.36533e+07
n1000x8192-coef-inner, 1024, 12, 28597, 13952, 0, 0, 42561, 1.36533e+07
n1000x8192-coef-inner, 1024, 11, 28620, 13645, 0, 0, 42276, 1.36533e+07
n1000x8192-coef-inner, 1024, 12, 28353, 13599, 0, 0, 41964, 1.36533e+07
n1000x8192-coef-inner, 1024, 12, 28549, 13653, 0, 0, 42214, 1.36533e+07
n1000x8192-coef-inner, 1024, 12, 28410, 13647, 0, 0, 42069, 1.36533e+07
n1000x8192-coef-inner, 1024, 12, 28626, 13689, 0, 0, 42327, 1.36533e+07
n1000x8192-coef-inner, 1024, 12, 28525, 13792, 0, 0, 42329, 1.36533e+07
n1000x8192-coef-inner, 1024, 12, 28861, 13627, 0, 0, 42500, 1.36533e+07
n1000x8192-coef-inner, 1024, 12, 28866, 13900, 0, 0, 42778, 1.36533e+07
n1000x8192-coef-inner, 1024, 12, 28758, 13737, 0, 0, 42507, 1.36533e+07
n1000x8192-coef-inner, 1024, 12, 28573, 13742, 0, 0, 42327, 1.36533e+07
n1000x8192-coef-inner, 1024, 11, 28497, 13925, 0, 0, 42433, 1.36533e+07
n1000x8192-coef-inner, 1024, 13, 28717, 13757, 0, 0, 42487, 1.36533e+07
n1000x8192-coef-inner, 1024, 12, 28640, 14038, 0, 0, 42690, 1.36533e+07
n1000x8192-coef-inner, 1024, 12, 28646, 14031, 0, 0, 42689, 1.36533e+07
n1000x8192-coef-inner, 1024, 12, 28503, 14053, 0, 0, 42568, 1.36533e+07
n1000x8192-coef-inner, 1024, 12, 28463, 13968, 0, 0, 42443, 1.36533e+07
n1000x8192-coef-inner, 1024, 11, 28526, 14029, 0, 0, 42566, 1.36533e+07
n1000x8192-coef-inner, 1024, 12, 28471, 13950, 0, 0, 42433, 1.36533e+07
n1000x8192-coef-inner, 1024, 11, 28470, 13501, 0, 0, 41982, 1.36533e+07
n1000x8192-coef-inner, 1024, 12, 28568, 13473, 0, 0, 42053, 1.36533e+07
n1000x8192-coef-inner, 1024, 12, 28538, 13951, 0, 0, 42501, 1.36533e+07
n1000x8192-coef-inner, 1024, 12, 28413, 13577, 0, 0, 42002, 1.36533e+07
n1000x8192-coef-inner, 1024, 12, 28598, 13523, 0, 0, 42133, 1.36533e+07
n1000x8192-coef-inner, 1024, 13, 28464, 13484, 0, 0, 41961, 1.36533e+07
n1000x8192-coef-inner, 1024, 12, 28425, 13475, 0, 0, 41912, 1.36533e+07
n1000x8192-coef-inner, 1024, 12, 28347, 13595, 0, 0, 41954, 1.36533e+07
n1000x8192-coef-inner, 1024, 12, 28589, 13989, 0, 0, 42590, 1.36533e+07
n1000x8192-coef-inner, 1024, 12, 28755, 13560, 0, 0, 42327, 1.36533e+07
n1000x8192-coef-inner, 1024, 12, 28443, 13659, 0, 0, 42114, 1.36533e+07
n1000x8192-coef-inner, 1024, 12, 28640, 13568, 0, 0, 42220, 1.36533e+07
n1000x8192-coef-inner, 1024, 12, 28785, 13694, 0, 0, 42491, 1.36533e+07
n1000x8192-coef-inner, 1024, 13, 28571, 13730, 0, 0, 42314, 1.36533e+07
n1000x8192-coef-inner, 1024, 12, 28635, 13865, 0, 0, 42512, 1.36533e+07
n1000x8192-coef-inner, 1024, 13, 28725, 13888, 0, 0, 42626, 1.36533e+07
n1000x8192-coef-inner, 1024, 12, 28659, 14147, 0, 0, 42818, 1.36533e+07
n1000x8192-coef-inner, 1024, 12, 28471, 13541, 0, 0, 42024, 1.36533e+07
n1000x8192-coef-inner, 1024, 12, 28516, 13543, 0, 0, 42071, 1.36533e+07
n1000x8192-coef-inner, 1024, 12, 28426, 13627, 2, 0, 42067, 1.36533e+07
n1000x8192-coef-inner, 1024, 13, 28600, 13559, 0, 0, 42172, 1.36533e+07
n1000x8192-coef-inner, 1024, 12, 28946, 14180, 6, 0, 43144, 1.36533e+07
n1000x8192-coef-inner, 1024, 12, 29205, 13839, 0, 0, 43056, 1.36533e+07
n1000x8192-coef-inner, 1024, 12, 28686, 14029, 0, 0, 42727, 1.36533e+07
n1000x8192-coef-inner, 1024, 12, 28541, 13586, 0, 0, 42139, 1.36533e+07
n1000x8192-coef-inner, 1024, 12, 28499, 14092, 0, 0, 42603, 1.36533e+07
n1000x8192-coef-inner, 1024, 12, 28644, 14007, 0, 0, 42663, 1.36533e+07
n1000x8192-coef-inner, 1024, 12, 28494, 13699, 0, 0, 42205, 1.36533e+07
n1000x8192-coef-inner, 1024, 12, 28713, 13905, 0, 0, 42630, 1.36533e+07
n1000x8192-coef-inner, 1024, 13, 28840, 13868, 0, 0, 42721, 1.36533e+07
n1000x8192-coef-inner, 1024, 12, 29103, 13806, 0, 0, 42921, 1.36533e+07
n1000x8192-coef-inner, 1024, 12, 28896, 13874, 0, 0, 42782, 1.36533e+07
n1000x8192-coef-inner, 1024, 11, 28669, 13834, 0, 0, 42514, 1.36533e+07
n1000x8192-coef-inner, 1024, 12, 28539, 14161, 0, 0, 42712, 1.36533e+07
n1000x8192-coef-inner, 1024, 12, 28881, 13862, 0, 0, 42755, 1.36533e+07
n1000x8192-coef-inner, 1024, 12, 28753, 14060, 0, 0, 42825, 1.36533e+07
n1000x8192-coef-inner, 1024, 13, 28740, 13940, 0, 0, 42693, 1.36533e+07
n1000x8192-coef-inner, 1024, 12, 28917, 14065, 0, 0, 42994, 1.36533e+07
n1000x8192-coef-inner, 1024, 13, 28576, 13999, 0, 0, 42588, 1.36533e+07
n1000x8192-coef-inner, 1024, 12, 28906, 14020, 0, 0, 42938, 1.36533e+07
n1000x8192-coef-inner, 1024, 12, 28626, 13647, 0, 0, 42285, 1.36533e+07
n1000x8192-coef-inner, 1024, 12, 28636, 13601, 0, 0, 42249, 1.36533e+07
n1000x8192-coef-inner, 1024, 12, 28636, 13840, 0, 0, 42488, 1.36533e+07
n1000x8192-coef-inner, 1024, 12, 28642, 14297, 0, 0, 42951, 1.36533e+07
n1000x8192-coef-inner, 1024, 13, 28750, 13778, 0, 0, 42541, 1.36533e+07
n1000x8192-coef-inner, 1024, 12, 28562, 13725, 0, 0, 42299, 1.36533e+07
n1000x8192-coef-inner, 1024, 12, 28498, 13664, 0, 0, 42174, 1.36533e+07
n1000x8192-coef-inner, 1024, 12, 28514, 13642, 0, 0, 42168, 1.36533e+07
n1000x8192-coef-inner, 1024, 12, 28578, 13605, 0, 0, 42195, 1.36533e+07
n1000x8192-coef-inner, 1024, 11, 28502, 13670, 0, 0, 42183, 1.36533e+07
n1000x8192-coef-inner, 1024, 13, 28701, 13776, 0, 0, 42490, 1.36533e+07
n1000x8192-coef-inner, 1024, 13, 28986, 13587, 0, 0, 42586, 1.36533e+07
n1000x8192-coef-inner, 1024, 12, 28527, 13854, 0, 0, 42393, 1.36533e+07
n1000x8192-coef-inner, 1024, 12, 28512, 13643, 0, 0, 42167, 1.36533e+07
n1000x8192-coef-inner, 1024, 12, 28518, 13607, 0, 0, 42137, 1.36533e+07
n1000x8192-coef-inner, 1024, 13, 28600, 13752, 0, 0, 42365, 1.36533e+07
n1000x8192-coef-inner, 1024, 12, 28485, 13684, 0, 0, 42181, 1.36533e+07
n1000x8192-coef-inner, 1024, 12, 28592, 13808, 0, 0, 42412, 1.36533e+07
n1000x8192-coef-inner, 1024, 12, 28698, 13654, 0, 0, 42364, 1.36533e+07
n1000x8192-coef-inner, 1024, 12, 28567, 13588, 0, 0, 42167, 1.36533e+07
n1000x8192-coef-inner, 1024, 12, 28599, 13680, 0, 0, 42291, 1.36533e+07
n1000x8192-coef-inner, 1024, 12, 28354, 13588, 0, 0, 41954, 1.36533e+07
n1000x8192-coef-inner, 1024, 12, 28497, 14027, 0, 0, 42536, 1.36533e+07
n1000x8192-coef-inner, 1024, 12, 28498, 13622, 0, 0, 42132, 1.36533e+07
n1000x8192-coef-inner, 1024, 13, 28566, 13776, 0, 0, 42355, 1.36533e+07
n1000x8192-coef-inner, 1024, 12, 28722, 13853, 0, 0, 42587, 1.36533e+07
n1000x8192-coef-inner, 1024, 12, 28563, 13688, 0, 0, 42263, 1.36533e+07
n1000x8192-coef-inner, 1024, 12, 28716, 13708, 0, 0, 42436, 1.36533e+07
