n8192-slot-sum-2048, 59, 8, 0, 13, 80, 8193
n8192-slot-sum-2048, 60, 9, 0, 13, 82, 8193
n8192-slot-sum-2048, 59, 8, 0, 13, 80, 8193
n8192-slot-sum-2048, 59, 8, 0, 13, 80, 8193
n8192-slot-sum-2048, 59, 9, 0, 13, 81, 8193
n8192-slot-sum-2048, 61, 8, 0, 13, 82, 8193
n8192-slot-sum-2048, 67, 8, 0, 13, 88, 8193
n8192-slot-sum-2048, 63, 8, 0, 13, 84, 8193
n8192-slot-sum-2048, 59, 8, 0, 13, 80, 8193
n8192-slot-sum-2048, 59, 8, 0, 13, 80, 8193
n8192-slot-sum-2048, 59, 8, 0, 13, 80, 8193
n8192-slot-sum-2048, 59, 8, 0, 13, 80, 8193
n8192-slot-sum-2048, 61, 8, 0, 13, 82, 8193
n8192-slot-sum-2048, 63, 9, 0, 13, 85, 8193
n8192-slot-sum-2048, 60, 9, 0, 13, 82, 8193
n8192-slot-sum-2048, 60, 8, 0, 13, 81, 8193
n8192-slot-sum-2048, 63, 8, 0, 13, 84, 8193
n8192-slot-sum-2048, 59, 8, 0, 13, 80, 8193
n8192-slot-sum-2048, 63, 9, 0, 16, 88, 8193
n8192-slot-sum-2048, 59, 8, 0, 13, 80, 8193
n8192-slot-sum-2048, 59, 8, 0, 13, 80, 8193
n8192-slot-sum-2048, 60, 8, 0, 13, 81, 8193
n8192-slot-sum-2048, 59, 8, 0, 13, 80, 8193
n8192-slot-sum-2048, 67, 8, 0, 13, 88, 8193
n8192-slot-sum-2048, 59, 8, 0, 13, 80, 8193
n8192-slot-sum-2048, 61, 8, 0, 13, 82, 8193
n8192-slot-sum-2048, 60, 9, 0, 13, 82, 8193
n8192-slot-sum-2048, 59, 8, 0, 13, 80, 8193
n8192-slot-sum-2048, 60, 8, 0, 13, 81, 8193
n8192-slot-sum-2048, 59, 8, 0, 13, 80, 8193
n8192-slot-sum-2048, 60, 8, 0, 13, 81, 8193
n8192-slot-sum-2048, 58, 8, 0, 13, 79, 8193
n8192-slot-sum-2048, 61, 8, 0, 13, 82, 8193
n8192-slot-sum-2048, 59, 9, 0, 13, 81, 8193
n8192-slot-sum-2048, 60, 8, 0, 13, 81, 8193
n8192-slot-sum-2048, 59, 9, 0, 13, 81, 8193
n8192-slot-sum-2048, 59, 9, 0, 13, 81, 8193
n8192-slot-sum-2048, 59, 8, 0, 13, 80, 8193
n8192-slot-sum-2048, 59, 8, 0, 13, 80, 8193
n8192-slot-sum-2048, 59, 8, 0, 13, 80, 8193
n8192-slot-sum-2048, 59, 8, 0, 13, 80, 8193
n8192-slot-sum-2048, 60, 9, 0, 14, 83, 8193
n8192-slot-sum-2048, 67, 8, 0, 13, 88, 8193
n8192-slot-sum-2048, 59, 8, 0, 13, 80, 8193
n8192-slot-sum-2048, 59, 8, 0, 13, 80, 8193
n8192-slot-sum-2048, 59, 8, 2, 13, 82, 8193
n8192-slot-sum-2048, 60, 8, 0, 13, 81, 8193
n8192-slot-sum-2048, 59, 8, 0, 13, 80, 8193
n8192-slot-sum-2048, 59, 8, 0, 13, 80, 8193
n8192-slot-sum-2048, 60, 9, 0, 13, 82, 8193
n8192-slot-sum-2048, 63, 8, 0, 13, 84, 8193
n8192-slot-sum-2048, 59, 8, 0, 13, 80, 8193
n8192-slot-sum-2048, 67, 8, 0, 13, 88, 8193
n8192-slot-sum-2048, 59, 8, 0, 13, 80, 8193
n8192-slot-sum-2048, 60, 9, 0, 13, 82, 8193
n8192-slot-sum-2048, 59, 8, 0, 13, 80, 8193
n8192-slot-sum-2048, 59, 8, 0, 13, 80, 8193
n8192-slot-sum-2048, 59, 8, 0, 13, 80, 8193
n8192-slot-sum-2048, 59, 8, 0, 13, 80, 8193
n8192-slot-sum-2048, 61, 8, 0, 13, 82, 8193
n8192-slot-sum-2048, 63, 8, 0, 13, 84, 8193
n8192-slot-sum-2048, 59, 8, 0, 13, 80, 8193
n8192-slot-sum-2048, 59, 8, 0, 13, 80, 8193
n8192-slot-sum-2048, 63, 8, 0, 14, 85, 8193
n8192-slot-sum-2048, 73, 9, 0, 13, 95, 8193
n8192-slot-sum-2048, 62, 8, 0, 13, 83, 8193
n8192-slot-sum-2048, 59, 8, 0, 13, 80, 8193
n8192-slot-sum-2048, 62, 8, 0, 13, 83, 8193
n8192-slot-sum-2048, 59, 8, 0, 13, 80, 8193
n8192-slot-sum-2048, 59, 8, 0, 13, 80, 8193
n8192-slot-sum-2048, 60, 8, 0, 13, 81, 8193
n8192-slot-sum-2048, 61, 8, 0, 13, 82, 8193
n8192-slot-sum-2048, 62, 8, 0, 13, 83, 8193
n8192-slot-sum-2048, 63, 8, 0, 13, 84, 8193
n8192-slot-sum-2048, 59, 8, 0, 13, 80, 8193
n8192-slot-sum-2048, 59, 8, 0, 14, 81, 8193
n8192-slot-sum-2048, 59, 9, 0, 13, 81, 8193
n8192-slot-sum-2048, 59, 8, 0, 13, 80, 8193
n8192-slot-sum-2048, 60, 8, 0, 13, 81, 8193
n8192-slot-sum-2048, 59, 8, 0, 13, 80, 8193
n8192-slot-sum-2048, 60, 8, 0, 13, 81, 8193
n8192-slot-sum-2048, 69, 9, 0, 13, 91, 8193
n8192-slot-sum-2048, 60, 9, 0, 13, 82, 8193
n8192-slot-sum-2048, 61, 8, 0, 13, 82, 8193
n8192-slot-sum-2048, 59, 8, 0, 13, 80, 8193
n8192-slot-sum-2048, 59, 9, 0, 13, 81, 8193
n8192-slot-sum-2048, 60, 9, 0, 14, 83, 8193
n8192-slot-sum-2048, 60, 8, 0, 13, 81, 8193
n8192-slot-sum-2048, 61, 8, 0, 13, 82, 8193
n8192-slot-sum-2048, 59, 8, 0, 13, 80, 8193
n8192-slot-sum-2048, 61, 9, 0, 14, 84, 8193
n8192-slot-sum-2048, 61, 8, 0, 13, 82, 8193
n8192-slot-sum-2048, 62, 8, 0, 13, 83, 8193
n8192-slot-sum-2048, 59, 9, 0, 13, 81, 8193
n8192-slot-sum-2048, 66, 9, 0, 13, 88, 8193
n8192-slot-sum-2048, 60, 8, 0, 13, 81, 8193
n8192-slot-sum-2048, 59, 8, 0, 13, 80, 8193
n8192-slot-sum-2048, 59, 8, 0, 13, 80, 8193
n8192-slot-sum-2048, 59, 8, 0, 13, 80, 8193
n8192-slot-sum-2048, 59, 8, 0, 13, 80, 8193
n10x8192-slot-sum-2048, 59, 75, 3, 9, 146, 81921
n10x8192-slot-sum-2048, 59, 76, 3, 8, 146, 81921
n10x8192-slot-sum-2048, 59, 76, 3, 9, 147, 81921
n10x8192-slot-sum-2048, 59, 75, 3, 8, 145, 81921
n10x8192-slot-sum-2048, 59, 77, 3, 8, 147, 81921
n10x8192-slot-sum-2048, 60, 76, 3, 8, 147, 81921
n10x8192-slot-sum-2048, 60, 75, 3, 8, 146, 81921
n10x8192-slot-sum-2048, 59, 76, 3, 9, 147, 81921
n10x8192-slot-sum-2048, 59, 77, 3, 8, 147, 81921
n10x8192-slot-sum-2048, 59, 76, 3, 9, 147, 81921
n10x8192-slot-sum-2048, 59, 75, 3, 9, 146, 81921
n10x8192-slot-sum-2048, 60, 76, 3, 8, 147, 81921
n10x8192-slot-sum-2048, 65, 75, 3, 9, 152, 81921
n10x8192-slot-sum-2048, 60, 75, 3, 8, 146, 81921
n10x8192-slot-sum-2048, 60, 75, 3, 9, 147, 81921
n10x8192-slot-sum-2048, 59, 75, 3, 11, 148, 81921
n10x8192-slot-sum-2048, 63, 75, 3, 8, 149, 81921
n10x8192-slot-sum-2048, 59, 75, 3, 8, 145, 81921
n10x8192-slot-sum-2048, 59, 75, 3, 8, 145, 81921
n10x8192-slot-sum-2048, 59, 78, 3, 8, 148, 81921
n10x8192-slot-sum-2048, 67, 76, 3, 8, 154, 81921
n10x8192-slot-sum-2048, 60, 75, 3, 9, 147, 81921
n10x8192-slot-sum-2048, 62, 75, 3, 8, 148, 81921
n10x8192-slot-sum-2048, 60, 76, 3, 9, 148, 81921
n10x8192-slot-sum-2048, 60, 75, 3, 8, 146, 81921
n10x8192-slot-sum-2048, 59, 75, 3, 8, 145, 81921
n10x8192-slot-sum-2048, 60, 76, 3, 9, 148, 81921
n10x8192-slot-sum-2048, 59, 75, 3, 9, 146, 81921
n10x8192-slot-sum-2048, 59, 76, 3, 9, 147, 81921
n10x8192-slot-sum-2048, 62, 75, 3, 8, 148, 81921
n10x8192-slot-sum-2048, 62, 76, 3, 9, 150, 81921
n10x8192-slot-sum-2048, 59, 75, 3, 9, 146, 81921
n10x8192-slot-sum-2048, 59, 76, 3, 9, 147, 81921
n10x8192-slot-sum-2048, 59, 76, 3, 9, 147, 81921
n10x8192-slot-sum-2048, 59, 75, 3, 9, 146, 81921
n10x8192-slot-sum-2048, 59, 75, 3, 8, 145, 81921
n10x8192-slot-sum-2048, 59, 75, 3, 8, 145, 81921
n10x8192-slot-sum-2048, 62, 75, 3, 8, 148, 81921
n10x8192-slot-sum-2048, 60, 76, 3, 9, 148, 81921
n10x8192-slot-sum-2048, 59, 75, 3, 9, 146, 81921
n10x8192-slot-sum-2048, 59, 75, 4, 9, 147, 81921
n10x8192-slot-sum-2048, 61, 76, 3, 9, 149, 81921
n10x8192-slot-sum-2048, 64, 77, 3, 8, 152, 81921
n10x8192-slot-sum-2048, 60, 76, 3, 9, 148, 81921
n10x8192-slot-sum-2048, 59, 75, 3, 8, 145, 81921
n10x8192-slot-sum-2048, 59, 75, 3, 9, 146, 81921
n10x8192-slot-sum-2048, 60, 75, 3, 8, 146, 81921
n10x8192-slot-sum-2048, 59, 75, 3, 8, 145, 81921
n10x8192-slot-sum-2048, 61, 75, 3, 8, 147, 81921
n10x8192-slot-sum-2048, 59, 75, 3, 8, 145, 81921
n10x8192-slot-sum-2048, 59, 75, 3, 8, 145, 81921
n10x8192-slot-sum-2048, 59, 76, 3, 9, 147, 81921
n10x8192-slot-sum-2048, 60, 75, 3, 8, 146, 81921
n10x8192-slot-sum-2048, 59, 76, 3, 9, 147, 81921
n10x8192-slot-sum-2048, 60, 75, 3, 8, 146, 81921
n10x8192-slot-sum-2048, 59, 75, 3, 8, 145, 81921
n10x8192-slot-sum-2048, 70, 75, 3, 9, 157, 81921
n10x8192-slot-sum-2048, 60, 76, 3, 9, 148, 81921
n10x8192-slot-sum-2048, 66, 78, 3, 9, 156, 81921
n10x8192-slot-sum-2048, 59, 76, 3, 9, 147, 81921
n10x8192-slot-sum-2048, 59, 77, 3, 9, 148, 81921
n10x8192-slot-sum-2048, 59, 75, 3, 8, 145, 81921
n10x8192-slot-sum-2048, 59, 75, 3, 8, 145, 81921
n10x8192-slot-sum-2048, 60, 75, 3, 8, 146, 81921
n10x8192-slot-sum-2048, 60, 75, 3, 9, 147, 81921
n10x8192-slot-sum-2048, 59, 75, 3, 8, 145, 81921
n10x8192-slot-sum-2048, 59, 75, 3, 8, 145, 81921
n10x8192-slot-sum-2048, 59, 75, 3, 8, 145, 81921
n10x8192-slot-sum-2048, 59, 75, 3, 8, 145, 81921
n10x8192-slot-sum-2048, 59, 75, 3, 9, 146, 81921
n10x8192-slot-sum-2048, 59, 76, 3, 9, 147, 81921
n10x8192-slot-sum-2048, 59, 75, 3, 8, 145, 81921
n10x8192-slot-sum-2048, 58, 75, 3, 8, 144, 81921
n10x8192-slot-sum-2048, 60, 75, 3, 8, 146, 81921
n10x8192-slot-sum-2048, 60, 75, 3, 8, 146, 81921
n10x8192-slot-sum-2048, 67, 75, 3, 8, 153, 81921
n10x8192-slot-sum-2048, 59, 76, 3, 8, 146, 81921
n10x8192-slot-sum-2048, 59, 75, 3, 8, 145, 81921
n10x8192-slot-sum-2048, 59, 75, 3, 8, 145, 81921
n10x8192-slot-sum-2048, 60, 76, 3, 8, 147, 81921
n10x8192-slot-sum-2048, 59, 75, 3, 8, 145, 81921
n10x8192-slot-sum-2048, 59, 76, 3, 8, 146, 81921
n10x8192-slot-sum-2048, 59, 78, 3, 9, 149, 81921
n10x8192-slot-sum-2048, 59, 76, 3, 8, 146, 81921
n10x8192-slot-sum-2048, 59, 75, 3, 8, 145, 81921
n10x8192-slot-sum-2048, 64, 76, 3, 9, 152, 81921
n10x8192-slot-sum-2048, 59, 76, 3, 8, 146, 81921
n10x8192-slot-sum-2048, 59, 75, 3, 9, 146, 81921
n10x8192-slot-sum-2048, 59, 75, 3, 8, 145, 81921
n10x8192-slot-sum-2048, 59, 76, 3, 9, 147, 81921
n10x8192-slot-sum-2048, 59, 76, 3, 9, 147, 81921
n10x8192-slot-sum-2048, 59, 77, 3, 8, 147, 81921
n10x8192-slot-sum-2048, 59, 76, 3, 8, 146, 81921
n10x8192-slot-sum-2048, 59, 75, 3, 8, 145, 81921
n10x8192-slot-sum-2048, 59, 76, 3, 9, 147, 81921
n10x8192-slot-sum-2048, 62, 76, 3, 8, 149, 81921
n10x8192-slot-sum-2048, 59, 75, 3, 8, 145, 81921
n10x8192-slot-sum-2048, 60, 75, 3, 8, 146, 81921
n10x8192-slot-sum-2048, 60, 75, 3, 8, 146, 81921
n10x8192-slot-sum-2048, 59, 76, 3, 8, 146, 81921
n25x8192-slot-sum-2048, 59, 190, 10, 9, 268, 204801
n25x8192-slot-sum-2048, 60, 186, 9, 8, 263, 204801
n25x8192-slot-sum-2048, 59, 189, 9, 9, 266, 204801
n25x8192-slot-sum-2048, 64, 189, 9, 9, 271, 204801
n25x8192-slot-sum-2048, 59, 186, 9, 11, 265, 204801
n25x8192-slot-sum-2048, 62, 186, 9, 8, 265, 204801
n25x8192-slot-sum-2048, 61, 191, 9, 9, 270, 204801
n25x8192-slot-sum-2048, 65, 187, 9, 8, 269, 204801
n25x8192-slot-sum-2048, 62, 187, 9, 9, 267, 204801
n25x8192-slot-sum-2048, 63, 189, 9, 9, 270, 204801
n25x8192-slot-sum-2048, 59, 186, 9, 8, 262, 204801
n25x8192-slot-sum-2048, 61, 188, 9, 9, 267, 204801
n25x8192-slot-sum-2048, 63, 188, 9, 9, 269, 204801
n25x8192-slot-sum-2048, 60, 190, 9, 9, 268, 204801
n25x8192-slot-sum-2048, 59, 188, 9, 9, 265, 204801
n25x8192-slot-sum-2048, 59, 189, 9, 8, 265, 204801
n25x8192-slot-sum-2048, 60, 189, 9, 9, 267, 204801
n25x8192-slot-sum-2048, 61, 189, 9, 9, 268, 204801
n25x8192-slot-sum-2048, 64, 188, 9, 9, 270, 204801
n25x8192-slot-sum-2048, 60, 191, 9, 8, 268, 204801
n25x8192-slot-sum-2048, 61, 187, 9, 9, 266, 204801
n25x8192-slot-sum-2048, 59, 190, 9, 9, 267, 204801
n25x8192-slot-sum-2048, 59, 189, 9, 9, 266, 204801
n25x8192-slot-sum-2048, 59, 191, 9, 9, 268, 204801
n25x8192-slot-sum-2048, 61, 190, 10, 9, 270, 204801
n25x8192-slot-sum-2048, 60, 190, 9, 9, 268, 204801
n25x8192-slot-sum-2048, 59, 187, 9, 9, 264, 204801
n25x8192-slot-sum-2048, 65, 193, 9, 9, 276, 204801
n25x8192-slot-sum-2048, 60, 188, 9, 9, 266, 204801
n25x8192-slot-sum-2048, 59, 189, 9, 9, 266, 204801
n25x8192-slot-sum-2048, 59, 189, 9, 8, 265, 204801
n25x8192-slot-sum-2048, 59, 187, 9, 11, 266, 204801
n25x8192-slot-sum-2048, 59, 192, 10, 9, 270, 204801
n25x8192-slot-sum-2048, 59, 187, 9, 9, 264, 204801
n25x8192-slot-sum-2048, 60, 187, 9, 9, 265, 204801
n25x8192-slot-sum-2048, 60, 187, 9, 8, 264, 204801
n25x8192-slot-sum-2048, 61, 187, 9, 9, 266, 204801
n25x8192-slot-sum-2048, 60, 190, 9, 9, 268, 204801
n25x8192-slot-sum-2048, 65, 189, 9, 9, 272, 204801
n25x8192-slot-sum-2048, 59, 191, 9, 9, 268, 204801
n25x8192-slot-sum-2048, 63, 192, 9, 9, 273, 204801
n25x8192-slot-sum-2048, 59, 188, 9, 8, 264, 204801
n25x8192-slot-sum-2048, 59, 186, 9, 9, 263, 204801
n25x8192-slot-sum-2048, 59, 189, 9, 8, 265, 204801
n25x8192-slot-sum-2048, 59, 189, 9, 8, 265, 204801
n25x8192-slot-sum-2048, 65, 188, 9, 9, 271, 204801
n25x8192-slot-sum-2048, 59, 188, 9, 9, 265, 204801
n25x8192-slot-sum-2048, 60, 189, 9, 9, 267, 204801
n25x8192-slot-sum-2048, 59, 187, 9, 8, 263, 204801
n25x8192-slot-sum-2048, 59, 188, 9, 8, 264, 204801
n25x8192-slot-sum-2048, 60, 188, 9, 9, 266, 204801
n25x8192-slot-sum-2048, 59, 187, 9, 9, 264, 204801
n25x8192-slot-sum-2048, 60, 189, 10, 9, 268, 204801
n25x8192-slot-sum-2048, 59, 187, 9, 9, 264, 204801
n25x8192-slot-sum-2048, 59, 189, 9, 9, 266, 204801
n25x8192-slot-sum-2048, 59, 190, 10, 9, 268, 204801
n25x8192-slot-sum-2048, 60, 188, 9, 9, 266, 204801
n25x8192-slot-sum-2048, 59, 187, 9, 9, 264, 204801
n25x8192-slot-sum-2048, 63, 191, 9, 9, 272, 204801
n25x8192-slot-sum-2048, 60, 187, 9, 9, 265, 204801
n25x8192-slot-sum-2048, 63, 187, 9, 9, 268, 204801
n25x8192-slot-sum-2048, 61, 190, 9, 8, 268, 204801
n25x8192-slot-sum-2048, 60, 187, 9, 9, 265, 204801
n25x8192-slot-sum-2048, 59, 187, 9, 8, 263, 204801
n25x8192-slot-sum-2048, 59, 187, 9, 8, 263, 204801
n25x8192-slot-sum-2048, 59, 188, 9, 9, 265, 204801
n25x8192-slot-sum-2048, 62, 187, 9, 9, 267, 204801
n25x8192-slot-sum-2048, 59, 186, 9, 9, 263, 204801
n25x8192-slot-sum-2048, 59, 188, 9, 8, 264, 204801
n25x8192-slot-sum-2048, 59, 188, 9, 9, 265, 204801
n25x8192-slot-sum-2048, 58, 187, 9, 8, 262, 204801
n25x8192-slot-sum-2048, 59, 187, 9, 9, 264, 204801
n25x8192-slot-sum-2048, 59, 188, 9, 9, 265, 204801
n25x8192-slot-sum-2048, 61, 187, 9, 9, 266, 204801
n25x8192-slot-sum-2048, 59, 189, 9, 9, 266, 204801
n25x8192-slot-sum-2048, 59, 187, 9, 8, 263, 204801
n25x8192-slot-sum-2048, 65, 188, 9, 9, 271, 204801
n25x8192-slot-sum-2048, 69, 187, 9, 8, 273, 204801
n25x8192-slot-sum-2048, 59, 188, 9, 9, 265, 204801
n25x8192-slot-sum-2048, 60, 188, 9, 9, 266, 204801
n25x8192-slot-sum-2048, 59, 187, 9, 9, 264, 204801
n25x8192-slot-sum-2048, 59, 187, 9, 9, 264, 204801
n25x8192-slot-sum-2048, 59, 188, 11, 8, 266, 204801
n25x8192-slot-sum-2048, 62, 187, 9, 9, 267, 204801
n25x8192-slot-sum-2048, 59, 187, 9, 9, 264, 204801
n25x8192-slot-sum-2048, 60, 188, 9, 9, 266, 204801
n25x8192-slot-sum-2048, 63, 188, 9, 9, 269, 204801
n25x8192-slot-sum-2048, 60, 188, 10, 9, 267, 204801
n25x8192-slot-sum-2048, 67, 186, 9, 9, 271, 204801
n25x8192-slot-sum-2048, 59, 188, 9, 9, 265, 204801
n25x8192-slot-sum-2048, 60, 187, 9, 9, 265, 204801
n25x8192-slot-sum-2048, 59, 188, 9, 9, 265, 204801
n25x8192-slot-sum-2048, 60, 187, 9, 9, 265, 204801
n25x8192-slot-sum-2048, 59, 191, 9, 8, 267, 204801
n25x8192-slot-sum-2048, 60, 188, 9, 9, 266, 204801
n25x8192-slot-sum-2048, 67, 191, 9, 9, 276, 204801
n25x8192-slot-sum-2048, 59, 192, 9, 9, 269, 204801
n25x8192-slot-sum-2048, 59, 188, 10, 9, 266, 204801
n25x8192-slot-sum-2048, 60, 189, 9, 9, 267, 204801
n25x8192-slot-sum-2048, 59, 188, 9, 9, 265, 204801
n50x8192-slot-sum-2048, 59, 377, 19, 9, 464, 409600
n50x8192-slot-sum-2048, 60, 376, 19, 9, 464, 409600
n50x8192-slot-sum-2048, 59, 376, 19, 9, 463, 409600
n50x8192-slot-sum-2048, 60, 377, 19, 9, 465, 409600
n50x8192-slot-sum-2048, 59, 375, 19, 9, 462, 409600
n50x8192-slot-sum-2048, 63, 375, 19, 9, 466, 409600
n50x8192-slot-sum-2048, 62, 374, 19, 9, 464, 409600
n50x8192-slot-sum-2048, 60, 376, 19, 9, 464, 409600
n50x8192-slot-sum-2048, 62, 372, 18, 9, 461, 409600
n50x8192-slot-sum-2048, 59, 375, 19, 8, 461, 409600
n50x8192-slot-sum-2048, 60, 376, 19, 9, 464, 409600
n50x8192-slot-sum-2048, 60, 374, 18, 9, 461, 409600
n50x8192-slot-sum-2048, 59, 371, 18, 9, 457, 409600
n50x8192-slot-sum-2048, 60, 373, 18, 9, 460, 409600
n50x8192-slot-sum-2048, 60, 372, 18, 9, 459, 409600
n50x8192-slot-sum-2048, 63, 373, 18, 9, 463, 409600
n50x8192-slot-sum-2048, 59, 372, 18, 9, 458, 409600
n50x8192-slot-sum-2048, 58, 373, 18, 9, 458, 409600
n50x8192-slot-sum-2048, 59, 374, 18, 9, 460, 409600
n50x8192-slot-sum-2048, 59, 374, 19, 9, 461, 409600
n50x8192-slot-sum-2048, 59, 377, 20, 9, 465, 409600
n50x8192-slot-sum-2048, 61, 378, 20, 9, 468, 409600
n50x8192-slot-sum-2048, 59, 372, 18, 9, 458, 409600
n50x8192-slot-sum-2048, 59, 374, 18, 9, 460, 409600
n50x8192-slot-sum-2048, 60, 375, 20, 9, 464, 409600
n50x8192-slot-sum-2048, 59, 376, 19, 9, 463, 409600
n50x8192-slot-sum-2048, 59, 374, 19, 9, 461, 409600
n50x8192-slot-sum-2048, 59, 374, 19, 9, 461, 409600
n50x8192-slot-sum-2048, 66, 376, 19, 9, 470, 409600
n50x8192-slot-sum-2048, 59, 374, 18, 9, 460, 409600
n50x8192-slot-sum-2048, 59, 377, 21, 9, 466, 409600
n50x8192-slot-sum-2048, 60, 372, 18, 9, 459, 409600
n50x8192-slot-sum-2048, 59, 374, 18, 9, 460, 409600
n50x8192-slot-sum-2048, 60, 375, 18, 9, 462, 409600
n50x8192-slot-sum-2048, 59, 379, 19, 9, 466, 409600
n50x8192-slot-sum-2048, 64, 375, 18, 9, 466, 409600
n50x8192-slot-sum-2048, 59, 376, 19, 9, 463, 409600
n50x8192-slot-sum-2048, 59, 374, 18, 9, 460, 409600
n50x8192-slot-sum-2048, 60, 375, 19, 9, 463, 409600
n50x8192-slot-sum-2048, 61, 378, 18, 9, 466, 409600
n50x8192-slot-sum-2048, 60, 373, 19, 9, 461, 409600
n50x8192-slot-sum-2048, 59, 375, 18, 9, 461, 409600
n50x8192-slot-sum-2048, 64, 389, 19, 9, 481, 409600
n50x8192-slot-sum-2048, 60, 374, 18, 9, 461, 409600
n50x8192-slot-sum-2048, 60, 374, 18, 9, 461, 409600
n50x8192-slot-sum-2048, 59, 374, 18, 9, 460, 409600
n50x8192-slot-sum-2048, 65, 374, 19, 9, 467, 409600
n50x8192-slot-sum-2048, 59, 374, 18, 9, 460, 409600
n50x8192-slot-sum-2048, 62, 376, 18, 9, 465, 409600
n50x8192-slot-sum-2048, 60, 378, 19, 9, 466, 409600
n50x8192-slot-sum-2048, 67, 373, 18, 9, 467, 409600
n50x8192-slot-sum-2048, 58, 373, 18, 8, 457, 409600
n50x8192-slot-sum-2048, 59, 373, 18, 9, 459, 409600
n50x8192-slot-sum-2048, 63, 374, 19, 9, 465, 409600
n50x8192-slot-sum-2048, 62, 376, 19, 9, 466, 409600
n50x8192-slot-sum-2048, 59, 376, 19, 9, 463, 409600
n50x8192-slot-sum-2048, 61, 373, 18, 9, 461, 409600
n50x8192-slot-sum-2048, 59, 375, 19, 9, 462, 409600
n50x8192-slot-sum-2048, 59, 382, 18, 9, 468, 409600
n50x8192-slot-sum-2048, 61, 378, 19, 9, 467, 409600
n50x8192-slot-sum-2048, 64, 377, 19, 9, 469, 409600
n50x8192-slot-sum-2048, 62, 376, 18, 9, 465, 409600
n50x8192-slot-sum-2048, 58, 372, 19, 10, 459, 409600
n50x8192-slot-sum-2048, 60, 375, 18, 9, 462, 409600
n50x8192-slot-sum-2048, 59, 379, 19, 9, 466, 409600
n50x8192-slot-sum-2048, 59, 375, 18, 9, 461, 409600
n50x8192-slot-sum-2048, 59, 375, 18, 9, 461, 409600
n50x8192-slot-sum-2048, 59, 374, 19, 9, 461, 409600
n50x8192-slot-sum-2048, 59, 374, 19, 9, 461, 409600
n50x8192-slot-sum-2048, 60, 376, 18, 9, 463, 409600
n50x8192-slot-sum-2048, 60, 372, 19, 9, 460, 409600
n50x8192-slot-sum-2048, 59, 373, 18, 9, 459, 409600
n50x8192-slot-sum-2048, 58, 371, 18, 9, 456, 409600
n50x8192-slot-sum-2048, 60, 374, 18, 9, 461, 409600
n50x8192-slot-sum-2048, 58, 371, 19, 9, 457, 409600
n50x8192-slot-sum-2048, 59, 376, 18, 9, 462, 409600
n50x8192-slot-sum-2048, 59, 372, 18, 9, 458, 409600
n50x8192-slot-sum-2048, 64, 376, 19, 9, 468, 409600
n50x8192-slot-sum-2048, 60, 373, 18, 9, 460, 409600
n50x8192-slot-sum-2048, 65, 374, 18, 9, 466, 409600
n50x8192-slot-sum-2048, 59, 374, 19, 9, 461, 409600
n50x8192-slot-sum-2048, 59, 374, 19, 9, 461, 409600
n50x8192-slot-sum-2048, 60, 373, 18, 9, 460, 409600
n50x8192-slot-sum-2048, 59, 373, 18, 9, 459, 409600
n50x8192-slot-sum-2048, 59, 373, 18, 9, 459, 409600
n50x8192-slot-sum-2048, 59, 375, 18, 9, 461, 409600
n50x8192-slot-sum-2048, 59, 373, 18, 9, 459, 409600
n50x8192-slot-sum-2048, 60, 376, 18, 9, 463, 409600
n50x8192-slot-sum-2048, 59, 374, 18, 9, 460, 409600
n50x8192-slot-sum-2048, 59, 374, 18, 9, 460, 409600
n50x8192-slot-sum-2048, 59, 372, 19, 9, 459, 409600
n50x8192-slot-sum-2048, 59, 374, 18, 9, 460, 409600
n50x8192-slot-sum-2048, 65, 376, 18, 9, 468, 409600
n50x8192-slot-sum-2048, 60, 375, 18, 9, 462, 409600
n50x8192-slot-sum-2048, 59, 377, 20, 9, 465, 409600
n50x8192-slot-sum-2048, 59, 373, 18, 9, 459, 409600
n50x8192-slot-sum-2048, 59, 375, 18, 9, 461, 409600
n50x8192-slot-sum-2048, 66, 377, 19, 9, 471, 409600
n50x8192-slot-sum-2048, 59, 372, 18, 9, 458, 409600
n50x8192-slot-sum-2048, 66, 375, 19, 9, 469, 409600
n100x8192-slot-sum-2048, 59, 749, 38, 9, 855, 819201
n100x8192-slot-sum-2048, 59, 752, 39, 9, 859, 819201
n100x8192-slot-sum-2048, 59, 748, 38, 9, 854, 819201
n100x8192-slot-sum-2048, 61, 750, 37, 9, 857, 819201
n100x8192-slot-sum-2048, 59, 755, 38, 9, 861, 819201
n100x8192-slot-sum-2048, 60, 745, 38, 9, 852, 819201
n100x8192-slot-sum-2048, 60, 752, 38, 9, 859, 819201
n100x8192-slot-sum-2048, 62, 752, 38, 9, 861, 819201
n100x8192-slot-sum-2048, 60, 746, 37, 9, 852, 819201
n100x8192-slot-sum-2048, 65, 752, 38, 9, 864, 819201
n100x8192-slot-sum-2048, 59, 755, 38, 9, 861, 819201
n100x8192-slot-sum-2048, 60, 750, 38, 9, 857, 819201
n100x8192-slot-sum-2048, 60, 754, 41, 9, 864, 819201
n100x8192-slot-sum-2048, 67, 756, 39, 10, 872, 819201
n100x8192-slot-sum-2048, 62, 748, 37, 9, 856, 819201
n100x8192-slot-sum-2048, 75, 748, 38, 9, 870, 819201
n100x8192-slot-sum-2048, 60, 752, 38, 9, 859, 819201
n100x8192-slot-sum-2048, 60, 753, 37, 9, 859, 819201
n100x8192-slot-sum-2048, 59, 746, 38, 9, 852, 819201
n100x8192-slot-sum-2048, 59, 746, 38, 9, 852, 819201
n100x8192-slot-sum-2048, 62, 746, 37, 9, 854, 819201
n100x8192-slot-sum-2048, 60, 747, 39, 9, 855, 819201
n100x8192-slot-sum-2048, 60, 747, 37, 9, 853, 819201
n100x8192-slot-sum-2048, 59, 748, 38, 9, 854, 819201
n100x8192-slot-sum-2048, 60, 750, 38, 9, 857, 819201
n100x8192-slot-sum-2048, 59, 746, 37, 9, 851, 819201
n100x8192-slot-sum-2048, 59, 750, 38, 9, 856, 819201
n100x8192-slot-sum-2048, 59, 750, 38, 9, 856, 819201
n100x8192-slot-sum-2048, 62, 749, 40, 9, 860, 819201
n100x8192-slot-sum-2048, 60, 751, 37, 9, 857, 819201
n100x8192-slot-sum-2048, 59, 745, 39, 9, 852, 819201
n100x8192-slot-sum-2048, 59, 749, 38, 9, 855, 819201
n100x8192-slot-sum-2048, 59, 748, 38, 9, 854, 819201
n100x8192-slot-sum-2048, 62, 753, 38, 9, 862, 819201
n100x8192-slot-sum-2048, 60, 747, 37, 9, 853, 819201
n100x8192-slot-sum-2048, 61, 751, 39, 9, 860, 819201
n100x8192-slot-sum-2048, 60, 747, 38, 9, 854, 819201
n100x8192-slot-sum-2048, 59, 751, 38, 9, 857, 819201
n100x8192-slot-sum-2048, 60, 753, 38, 9, 860, 819201
n100x8192-slot-sum-2048, 59, 748, 38, 9, 854, 819201
n100x8192-slot-sum-2048, 59, 747, 38, 9, 853, 819201
n100x8192-slot-sum-2048, 64, 766, 38, 9, 877, 819201
n100x8192-slot-sum-2048, 60, 749, 38, 9, 856, 819201
n100x8192-slot-sum-2048, 62, 755, 38, 9, 864, 819201
n100x8192-slot-sum-2048, 61, 758, 45, 9, 873, 819201
n100x8192-slot-sum-2048, 60, 750, 41, 9, 860, 819201
n100x8192-slot-sum-2048, 59, 756, 37, 9, 861, 819201
n100x8192-slot-sum-2048, 59, 754, 38, 9, 860, 819201
n100x8192-slot-sum-2048, 59, 754, 38, 9, 860, 819201
n100x8192-slot-sum-2048, 60, 758, 38, 9, 865, 819201
n100x8192-slot-sum-2048, 59, 769, 38, 9, 875, 819201
n100x8192-slot-sum-2048, 59, 751, 37, 9, 856, 819201
n100x8192-slot-sum-2048, 59, 748, 38, 9, 854, 819201
n100x8192-slot-sum-2048, 60, 755, 38, 9, 862, 819201
n100x8192-slot-sum-2048, 59, 755, 39, 9, 862, 819201
n100x8192-slot-sum-2048, 60, 753, 38, 9, 860, 819201
n100x8192-slot-sum-2048, 59, 751, 38, 9, 857, 819201
n100x8192-slot-sum-2048, 59, 747, 38, 9, 853, 819201
n100x8192-slot-sum-2048, 59, 752, 38, 9, 858, 819201
n100x8192-slot-sum-2048, 60, 753, 38, 9, 860, 819201
n100x8192-slot-sum-2048, 64, 750, 38, 9, 861, 819201
n100x8192-slot-sum-2048, 72, 747, 38, 9, 866, 819201
n100x8192-slot-sum-2048, 64, 754, 38, 9, 865, 819201
n100x8192-slot-sum-2048, 59, 750, 38, 9, 856, 819201
n100x8192-slot-sum-2048, 59, 754, 38, 9, 860, 819201
n100x8192-slot-sum-2048, 59, 754, 38, 9, 860, 819201
n100x8192-slot-sum-2048, 59, 752, 38, 9, 858, 819201
n100x8192-slot-sum-2048, 59, 745, 38, 9, 851, 819201
n100x8192-slot-sum-2048, 59, 749, 38, 9, 855, 819201
n100x8192-slot-sum-2048, 59, 748, 41, 9, 857, 819201
n100x8192-slot-sum-2048, 59, 755, 38, 9, 861, 819201
n100x8192-slot-sum-2048, 62, 751, 39, 9, 861, 819201
n100x8192-slot-sum-2048, 60, 749, 38, 9, 856, 819201
n100x8192-slot-sum-2048, 59, 750, 38, 9, 856, 819201
n100x8192-slot-sum-2048, 59, 748, 39, 9, 855, 819201
n100x8192-slot-sum-2048, 59, 746, 37, 9, 851, 819201
n100x8192-slot-sum-2048, 69, 750, 38, 9, 866, 819201
n100x8192-slot-sum-2048, 60, 755, 38, 9, 862, 819201
n100x8192-slot-sum-2048, 59, 747, 38, 9, 853, 819201
n100x8192-slot-sum-2048, 60, 749, 37, 9, 855, 819201
n100x8192-slot-sum-2048, 59, 747, 38, 9, 853, 819201
n100x8192-slot-sum-2048, 59, 746, 39, 9, 853, 819201
n100x8192-slot-sum-2048, 59, 751, 37, 9, 856, 819201
n100x8192-slot-sum-2048, 60, 748, 38, 9, 855, 819201
n100x8192-slot-sum-2048, 60, 747, 38, 9, 854, 819201
n100x8192-slot-sum-2048, 59, 751, 38, 9, 857, 819201
n100x8192-slot-sum-2048, 60, 754, 38, 9, 861, 819201
n100x8192-slot-sum-2048, 59, 752, 38, 9, 858, 819201
n100x8192-slot-sum-2048, 59, 751, 38, 9, 857, 819201
n100x8192-slot-sum-2048, 60, 749, 38, 9, 856, 819201
n100x8192-slot-sum-2048, 59, 749, 38, 9, 855, 819201
n100x8192-slot-sum-2048, 59, 749, 40, 9, 857, 819201
n100x8192-slot-sum-2048, 65, 758, 38, 9, 870, 819201
n100x8192-slot-sum-2048, 59, 749, 37, 9, 854, 819201
n100x8192-slot-sum-2048, 60, 752, 38, 9, 859, 819201
n100x8192-slot-sum-2048, 60, 758, 40, 9, 867, 819201
n100x8192-slot-sum-2048, 60, 753, 41, 9, 863, 819201
n100x8192-slot-sum-2048, 59, 747, 39, 9, 854, 819201
n100x8192-slot-sum-2048, 60, 754, 38, 9, 861, 819201
n100x8192-slot-sum-2048, 59, 751, 38, 9, 857, 819201
n250x8192-slot-sum-2048, 59, 191, 9, 9, 268, 204801
n250x8192-slot-sum-2048, 59, 190, 9, 9, 267, 204801
n250x8192-slot-sum-2048, 60, 188, 9, 9, 266, 204801
n250x8192-slot-sum-2048, 60, 187, 9, 11, 267, 204801
n250x8192-slot-sum-2048, 59, 188, 9, 9, 265, 204801
n250x8192-slot-sum-2048, 68, 188, 9, 8, 273, 204801
n250x8192-slot-sum-2048, 67, 188, 9, 9, 273, 204801
n250x8192-slot-sum-2048, 60, 190, 9, 9, 268, 204801
n250x8192-slot-sum-2048, 71, 190, 9, 9, 279, 204801
n250x8192-slot-sum-2048, 59, 188, 9, 9, 265, 204801
n250x8192-slot-sum-2048, 64, 188, 9, 9, 270, 204801
n250x8192-slot-sum-2048, 62, 188, 9, 8, 267, 204801
n250x8192-slot-sum-2048, 61, 187, 9, 9, 266, 204801
n250x8192-slot-sum-2048, 61, 193, 9, 9, 272, 204801
n250x8192-slot-sum-2048, 62, 188, 9, 9, 268, 204801
n250x8192-slot-sum-2048, 63, 188, 9, 9, 269, 204801
n250x8192-slot-sum-2048, 60, 190, 9, 9, 268, 204801
n250x8192-slot-sum-2048, 60, 191, 9, 8, 268, 204801
n250x8192-slot-sum-2048, 59, 189, 9, 9, 266, 204801
n250x8192-slot-sum-2048, 59, 188, 9, 9, 265, 204801
n250x8192-slot-sum-2048, 60, 190, 9, 9, 268, 204801
n250x8192-slot-sum-2048, 60, 188, 9, 8, 265, 204801
n250x8192-slot-sum-2048, 59, 189, 9, 9, 266, 204801
n250x8192-slot-sum-2048, 59, 189, 9, 8, 265, 204801
n250x8192-slot-sum-2048, 59, 188, 9, 9, 265, 204801
n250x8192-slot-sum-2048, 59, 187, 9, 9, 264, 204801
n250x8192-slot-sum-2048, 59, 192, 9, 9, 269, 204801
n250x8192-slot-sum-2048, 71, 187, 10, 9, 277, 204801
n250x8192-slot-sum-2048, 59, 190, 9, 9, 267, 204801
n250x8192-slot-sum-2048, 64, 189, 9, 9, 271, 204801
n250x8192-slot-sum-2048, 59, 189, 9, 9, 266, 204801
n250x8192-slot-sum-2048, 58, 186, 9, 9, 262, 204801
n250x8192-slot-sum-2048, 63, 189, 9, 11, 272, 204801
n250x8192-slot-sum-2048, 59, 187, 9, 9, 264, 204801
n250x8192-slot-sum-2048, 59, 188, 9, 9, 265, 204801
n250x8192-slot-sum-2048, 60, 189, 9, 8, 266, 204801
n250x8192-slot-sum-2048, 60, 188, 10, 9, 267, 204801
n250x8192-slot-sum-2048, 69, 190, 9, 9, 277, 204801
n250x8192-slot-sum-2048, 59, 189, 10, 9, 267, 204801
n250x8192-slot-sum-2048, 61, 186, 9, 9, 265, 204801
n250x8192-slot-sum-2048, 59, 189, 9, 9, 266, 204801
n250x8192-slot-sum-2048, 59, 190, 10, 9, 268, 204801
n250x8192-slot-sum-2048, 59, 189, 9, 8, 265, 204801
n250x8192-slot-sum-2048, 59, 187, 9, 9, 264, 204801
n250x8192-slot-sum-2048, 60, 190, 9, 9, 268, 204801
n250x8192-slot-sum-2048, 60, 188, 9, 9, 266, 204801
n250x8192-slot-sum-2048, 63, 190, 9, 9, 271, 204801
n250x8192-slot-sum-2048, 66, 189, 9, 9, 273, 204801
n250x8192-slot-sum-2048, 59, 190, 10, 9, 268, 204801
n250x8192-slot-sum-2048, 60, 188, 9, 9, 266, 204801
n250x8192-slot-sum-2048, 59, 188, 9, 9, 265, 204801
n250x8192-slot-sum-2048, 60, 188, 9, 9, 266, 204801
n250x8192-slot-sum-2048, 61, 189, 9, 9, 268, 204801
n250x8192-slot-sum-2048, 59, 187, 9, 9, 264, 204801
n250x8192-slot-sum-2048, 61, 190, 10, 9, 270, 204801
n250x8192-slot-sum-2048, 59, 189, 9, 9, 266, 204801
n250x8192-slot-sum-2048, 59, 188, 9, 9, 265, 204801
n250x8192-slot-sum-2048, 59, 188, 9, 9, 265, 204801
n250x8192-slot-sum-2048, 60, 187, 9, 9, 265, 204801
n250x8192-slot-sum-2048, 59, 187, 9, 9, 264, 204801
n250x8192-slot-sum-2048, 59, 189, 9, 9, 266, 204801
n250x8192-slot-sum-2048, 63, 187, 9, 9, 268, 204801
n250x8192-slot-sum-2048, 59, 189, 9, 9, 266, 204801
n250x8192-slot-sum-2048, 59, 189, 9, 9, 266, 204801
n250x8192-slot-sum-2048, 60, 188, 9, 9, 266, 204801
n250x8192-slot-sum-2048, 60, 187, 9, 8, 264, 204801
n250x8192-slot-sum-2048, 59, 188, 9, 9, 265, 204801
n250x8192-slot-sum-2048, 59, 187, 9, 8, 263, 204801
n250x8192-slot-sum-2048, 69, 188, 9, 9, 275, 204801
n250x8192-slot-sum-2048, 60, 189, 9, 9, 267, 204801
n250x8192-slot-sum-2048, 59, 188, 9, 9, 265, 204801
n250x8192-slot-sum-2048, 59, 187, 9, 9, 264, 204801
n250x8192-slot-sum-2048, 62, 188, 9, 9, 268, 204801
n250x8192-slot-sum-2048, 61, 188, 9, 8, 266, 204801
n250x8192-slot-sum-2048, 60, 188, 9, 9, 266, 204801
n250x8192-slot-sum-2048, 60, 187, 9, 9, 265, 204801
n250x8192-slot-sum-2048, 60, 187, 9, 9, 265, 204801
n250x8192-slot-sum-2048, 60, 188, 9, 9, 266, 204801
n250x8192-slot-sum-2048, 60, 188, 9, 9, 266, 204801
n250x8192-slot-sum-2048, 60, 188, 9, 9, 266, 204801
n250x8192-slot-sum-2048, 59, 187, 9, 9, 264, 204801
n250x8192-slot-sum-2048, 63, 187, 9, 9, 268, 204801
n250x8192-slot-sum-2048, 61, 192, 9, 9, 271, 204801
n250x8192-slot-sum-2048, 60, 189, 9, 9, 267, 204801
n250x8192-slot-sum-2048, 59, 190, 9, 9, 267, 204801
n250x8192-slot-sum-2048, 59, 192, 9, 9, 269, 204801
n250x8192-slot-sum-2048, 58, 189, 9, 9, 265, 204801
n250x8192-slot-sum-2048, 59, 188, 9, 8, 264, 204801
n250x8192-slot-sum-2048, 59, 188, 9, 8, 264, 204801
n250x8192-slot-sum-2048, 59, 187, 9, 9, 264, 204801
n250x8192-slot-sum-2048, 60, 188, 10, 9, 267, 204801
n250x8192-slot-sum-2048, 60, 188, 10, 9, 267, 204801
n250x8192-slot-sum-2048, 59, 189, 9, 9, 266, 204801
n250x8192-slot-sum-2048, 59, 187, 9, 9, 264, 204801
n250x8192-slot-sum-2048, 59, 188, 9, 8, 264, 204801
n250x8192-slot-sum-2048, 63, 187, 9, 8, 267, 204801
n250x8192-slot-sum-2048, 66, 186, 9, 9, 270, 204801
n250x8192-slot-sum-2048, 63, 188, 9, 9, 269, 204801
n250x8192-slot-sum-2048, 59, 188, 9, 9, 265, 204801
n250x8192-slot-sum-2048, 59, 197, 9, 9, 274, 204801
n500x8192-slot-sum-2048, 59, 10354, 198, 9, 10620, 4.096e+06
n500x8192-slot-sum-2048, 63, 3752, 195, 9, 4019, 4.096e+06
n500x8192-slot-sum-2048, 60, 3735, 196, 9, 4000, 4.096e+06
n500x8192-slot-sum-2048, 59, 3732, 198, 9, 3998, 4.096e+06
n500x8192-slot-sum-2048, 60, 3744, 197, 9, 4010, 4.096e+06
n500x8192-slot-sum-2048, 59, 3736, 198, 9, 4002, 4.096e+06
n500x8192-slot-sum-2048, 60, 3762, 204, 9, 4035, 4.096e+06
n500x8192-slot-sum-2048, 61, 3752, 195, 12, 4020, 4.096e+06
n500x8192-slot-sum-2048, 59, 3744, 203, 9, 4015, 4.096e+06
n500x8192-slot-sum-2048, 60, 3730, 201, 9, 4000, 4.096e+06
n500x8192-slot-sum-2048, 59, 3730, 196, 9, 3994, 4.096e+06
n500x8192-slot-sum-2048, 60, 3745, 197, 9, 4011, 4.096e+06
n500x8192-slot-sum-2048, 59, 3732, 203, 9, 4003, 4.096e+06
n500x8192-slot-sum-2048, 60, 3719, 201, 9, 3989, 4.096e+06
n500x8192-slot-sum-2048, 61, 3744, 198, 9, 4012, 4.096e+06
n500x8192-slot-sum-2048, 59, 3741, 195, 9, 4004, 4.096e+06
n500x8192-slot-sum-2048, 60, 3733, 197, 9, 3999, 4.096e+06
n500x8192-slot-sum-2048, 60, 3738, 196, 9, 4003, 4.096e+06
n500x8192-slot-sum-2048, 63, 4022, 195, 12, 4292, 4.096e+06
n500x8192-slot-sum-2048, 59, 3734, 204, 9, 4006, 4.096e+06
n500x8192-slot-sum-2048, 59, 3746, 211, 9, 4025, 4.096e+06
n500x8192-slot-sum-2048, 61, 3751, 199, 9, 4020, 4.096e+06
n500x8192-slot-sum-2048, 61, 3749, 201, 9, 4020, 4.096e+06
n500x8192-slot-sum-2048, 61, 3736, 196, 9, 4002, 4.096e+06
n500x8192-slot-sum-2048, 67, 3735, 199, 9, 4010, 4.096e+06
n500x8192-slot-sum-2048, 61, 3760, 203, 9, 4033, 4.096e+06
n500x8192-slot-sum-2048, 59, 3722, 198, 9, 3988, 4.096e+06
n500x8192-slot-sum-2048, 59, 3729, 200, 9, 3997, 4.096e+06
n500x8192-slot-sum-2048, 59, 3725, 197, 9, 3990, 4.096e+06
n500x8192-slot-sum-2048, 60, 3748, 199, 9, 4016, 4.096e+06
n500x8192-slot-sum-2048, 59, 3736, 198, 9, 4002, 4.096e+06
n500x8192-slot-sum-2048, 72, 3751, 197, 9, 4029, 4.096e+06
n500x8192-slot-sum-2048, 60, 3734, 197, 9, 4000, 4.096e+06
n500x8192-slot-sum-2048, 59, 3855, 237, 14, 4165, 4.096e+06
n500x8192-slot-sum-2048, 63, 7269, 300, 9, 7641, 4.096e+06
n500x8192-slot-sum-2048, 61, 4040, 206, 9, 4316, 4.096e+06
n500x8192-slot-sum-2048, 61, 3763, 197, 9, 4030, 4.096e+06
n500x8192-slot-sum-2048, 63, 3756, 197, 9, 4025, 4.096e+06
n500x8192-slot-sum-2048, 60, 3736, 197, 9, 4002, 4.096e+06
n500x8192-slot-sum-2048, 59, 3734, 207, 9, 4009, 4.096e+06
n500x8192-slot-sum-2048, 66, 3729, 197, 9, 4001, 4.096e+06
n500x8192-slot-sum-2048, 61, 3755, 197, 9, 4022, 4.096e+06
n500x8192-slot-sum-2048, 60, 3771, 200, 9, 4040, 4.096e+06
n500x8192-slot-sum-2048, 65, 3750, 200, 9, 4024, 4.096e+06
n500x8192-slot-sum-2048, 60, 3732, 196, 9, 3997, 4.096e+06
n500x8192-slot-sum-2048, 59, 3725, 196, 9, 3989, 4.096e+06
n500x8192-slot-sum-2048, 60, 3751, 196, 9, 4016, 4.096e+06
n500x8192-slot-sum-2048, 61, 3752, 207, 9, 4029, 4.096e+06
n500x8192-slot-sum-2048, 59, 3728, 197, 9, 3993, 4.096e+06
n500x8192-slot-sum-2048, 59, 3729, 201, 9, 3998, 4.096e+06
n500x8192-slot-sum-2048, 59, 3735, 196, 9, 3999, 4.096e+06
n500x8192-slot-sum-2048, 59, 3731, 213, 9, 4012, 4.096e+06
n500x8192-slot-sum-2048, 61, 3756, 200, 9, 4026, 4.096e+06
n500x8192-slot-sum-2048, 60, 3733, 193, 12, 3998, 4.096e+06
n500x8192-slot-sum-2048, 59, 3738, 204, 9, 4010, 4.096e+06
n500x8192-slot-sum-2048, 59, 3739, 195, 9, 4002, 4.096e+06
n500x8192-slot-sum-2048, 59, 3731, 200, 9, 3999, 4.096e+06
n500x8192-slot-sum-2048, 61, 3750, 200, 9, 4020, 4.096e+06
n500x8192-slot-sum-2048, 59, 3762, 195, 9, 4025, 4.096e+06
n500x8192-slot-sum-2048, 62, 3740, 196, 9, 4007, 4.096e+06
n500x8192-slot-sum-2048, 59, 3728, 198, 9, 3994, 4.096e+06
n500x8192-slot-sum-2048, 59, 3731, 198, 9, 3997, 4.096e+06
n500x8192-slot-sum-2048, 62, 3743, 195, 9, 4009, 4.096e+06
n500x8192-slot-sum-2048, 59, 3728, 198, 9, 3994, 4.096e+06
n500x8192-slot-sum-2048, 59, 3736, 200, 9, 4004, 4.096e+06
n500x8192-slot-sum-2048, 59, 3747, 199, 9, 4014, 4.096e+06
n500x8192-slot-sum-2048, 64, 3753, 204, 9, 4030, 4.096e+06
n500x8192-slot-sum-2048, 61, 3735, 195, 9, 4000, 4.096e+06
n500x8192-slot-sum-2048, 60, 3749, 199, 9, 4017, 4.096e+06
n500x8192-slot-sum-2048, 60, 3739, 198, 9, 4006, 4.096e+06
n500x8192-slot-sum-2048, 60, 3742, 199, 9, 4010, 4.096e+06
n500x8192-slot-sum-2048, 59, 3737, 199, 13, 4008, 4.096e+06
n500x8192-slot-sum-2048, 60, 3732, 196, 9, 3997, 4.096e+06
n500x8192-slot-sum-2048, 61, 3755, 195, 9, 4020, 4.096e+06
n500x8192-slot-sum-2048, 63, 3737, 197, 9, 4006, 4.096e+06
n500x8192-slot-sum-2048, 59, 3742, 208, 12, 4021, 4.096e+06
n500x8192-slot-sum-2048, 60, 3737, 197, 9, 4003, 4.096e+06
n500x8192-slot-sum-2048, 65, 3732, 196, 9, 4002, 4.096e+06
n500x8192-slot-sum-2048, 61, 3752, 197, 9, 4019, 4.096e+06
n500x8192-slot-sum-2048, 60, 3750, 200, 9, 4019, 4.096e+06
n500x8192-slot-sum-2048, 59, 3736, 195, 9, 3999, 4.096e+06
n500x8192-slot-sum-2048, 59, 3727, 195, 9, 3990, 4.096e+06
n500x8192-slot-sum-2048, 62, 3732, 195, 9, 3998, 4.096e+06
n500x8192-slot-sum-2048, 61, 3742, 199, 9, 4011, 4.096e+06
n500x8192-slot-sum-2048, 59, 3726, 194, 9, 3988, 4.096e+06
n500x8192-slot-sum-2048, 59, 3733, 198, 9, 3999, 4.096e+06
n500x8192-slot-sum-2048, 59, 3735, 196, 9, 3999, 4.096e+06
n500x8192-slot-sum-2048, 71, 3723, 198, 9, 4001, 4.096e+06
n500x8192-slot-sum-2048, 59, 3771, 198, 9, 4037, 4.096e+06
n500x8192-slot-sum-2048, 60, 3768, 197, 9, 4034, 4.096e+06
n500x8192-slot-sum-2048, 59, 3737, 198, 9, 4003, 4.096e+06
n500x8192-slot-sum-2048, 59, 3743, 197, 9, 4008, 4.096e+06
n500x8192-slot-sum-2048, 62, 3753, 196, 9, 4020, 4.096e+06
n500x8192-slot-sum-2048, 61, 3767, 199, 9, 4036, 4.096e+06
n500x8192-slot-sum-2048, 61, 3763, 197, 9, 4030, 4.096e+06
n500x8192-slot-sum-2048, 59, 3735, 197, 9, 4000, 4.096e+06
n500x8192-slot-sum-2048, 67, 3740, 199, 9, 4015, 4.096e+06
n500x8192-slot-sum-2048, 59, 3733, 197, 9, 3998, 4.096e+06
n500x8192-slot-sum-2048, 59, 3734, 201, 9, 4003, 4.096e+06
n500x8192-slot-sum-2048, 60, 3741, 199, 9, 4009, 4.096e+06
n1000x8192-slot-sum-2048, 59, 7469, 398, 9, 7935, 8.192e+06
n1000x8192-slot-sum-2048, 60, 7495, 395, 9, 7959, 8.192e+06
n1000x8192-slot-sum-2048, 60, 7478, 397, 9, 7944, 8.192e+06
n1000x8192-slot-sum-2048, 58, 7475, 393, 9, 7935, 8.192e+06
n1000x8192-slot-sum-2048, 61, 7513, 404, 9, 7987, 8.192e+06
n1000x8192-slot-sum-2048, 61, 7500, 402, 9, 7972, 8.192e+06
n1000x8192-slot-sum-2048, 59, 7475, 412, 9, 7955, 8.192e+06
n1000x8192-slot-sum-2048, 61, 7511, 396, 9, 7977, 8.192e+06
n1000x8192-slot-sum-2048, 61, 7467, 410, 9, 7947, 8.192e+06
n1000x8192-slot-sum-2048, 59, 7473, 395, 9, 7936, 8.192e+06
n1000x8192-slot-sum-2048, 62, 7503, 421, 9, 7995, 8.192e+06
n1000x8192-slot-sum-2048, 62, 7566, 402, 9, 8039, 8.192e+06
n1000x8192-slot-sum-2048, 60, 7482, 395, 9, 7946, 8.192e+06
n1000x8192-slot-sum-2048, 60, 7502, 396, 9, 7967, 8.192e+06
n1000x8192-slot-sum-2048, 59, 7513, 394, 9, 7975, 8.192e+06
n1000x8192-slot-sum-2048, 59, 7474, 401, 9, 7943, 8.192e+06
n1000x8192-slot-sum-2048, 61, 7497, 398, 9, 7965, 8.192e+06
n1000x8192-slot-sum-2048, 61, 7526, 393, 9, 7989, 8.192e+06
n1000x8192-slot-sum-2048, 59, 7485, 396, 9, 7949, 8.192e+06
n1000x8192-slot-sum-2048, 62, 7531, 397, 9, 7999, 8.192e+06
n1000x8192-slot-sum-2048, 60, 7473, 406, 9, 7948, 8.192e+06
n1000x8192-slot-sum-2048, 59, 7463, 406, 9, 7937, 8.192e+06
n1000x8192-slot-sum-2048, 61, 7505, 412, 9, 7987, 8.192e+06
n1000x8192-slot-sum-2048, 60, 7487, 397, 9, 7953, 8.192e+06
n1000x8192-slot-sum-2048, 59, 7482, 393, 9, 7943, 8.192e+06
n1000x8192-slot-sum-2048, 61, 7505, 400, 9, 7975, 8.192e+06
n1000x8192-slot-sum-2048, 61, 7493, 395, 9, 7958, 8.192e+06
n1000x8192-slot-sum-2048, 59, 7484, 397, 9, 7949, 8.192e+06
n1000x8192-slot-sum-2048, 60, 7498, 396, 9, 7963, 8.192e+06
n1000x8192-slot-sum-2048, 60, 7484, 400, 9, 7953, 8.192e+06
n1000x8192-slot-sum-2048, 59, 7457, 394, 9, 7919, 8.192e+06
n1000x8192-slot-sum-2048, 69, 7472, 392, 9, 7942, 8.192e+06
n1000x8192-slot-sum-2048, 60, 7495, 400, 9, 7964, 8.192e+06
n1000x8192-slot-sum-2048, 59, 7475, 395, 9, 7938, 8.192e+06
n1000x8192-slot-sum-2048, 60, 7471, 393, 9, 7933, 8.192e+06
n1000x8192-slot-sum-2048, 60, 7481, 402, 12, 7955, 8.192e+06
n1000x8192-slot-sum-2048, 59, 7466, 391, 9, 7925, 8.192e+06
n1000x8192-slot-sum-2048, 59, 7486, 398, 9, 7952, 8.192e+06
n1000x8192-slot-sum-2048, 61, 7469, 397, 9, 7936, 8.192e+06
n1000x8192-slot-sum-2048, 62, 7455, 395, 9, 7921, 8.192e+06
n1000x8192-slot-sum-2048, 59, 7479, 392, 9, 7939, 8.192e+06
n1000x8192-slot-sum-2048, 62, 7486, 397, 9, 7954, 8.192e+06
n1000x8192-slot-sum-2048, 61, 7505, 400, 9, 7975, 8.192e+06
n1000x8192-slot-sum-2048, 59, 7490, 393, 9, 7951, 8.192e+06
n1000x8192-slot-sum-2048, 62, 7491, 394, 9, 7956, 8.192e+06
n1000x8192-slot-sum-2048, 62, 7505, 397, 9, 7973, 8.192e+06
n1000x8192-slot-sum-2048, 63, 7479, 413, 9, 7964, 8.192e+06
n1000x8192-slot-sum-2048, 61, 7547, 400, 9, 8017, 8.192e+06
n1000x8192-slot-sum-2048, 60, 7491, 395, 9, 7955, 8.192e+06
n1000x8192-slot-sum-2048, 59, 7474, 393, 9, 7935, 8.192e+06
n1000x8192-slot-sum-2048, 61, 7501, 398, 9, 7969, 8.192e+06
n1000x8192-slot-sum-2048, 61, 7488, 394, 9, 7952, 8.192e+06
n1000x8192-slot-sum-2048, 59, 7465, 404, 9, 7937, 8.192e+06
n1000x8192-slot-sum-2048, 60, 7477, 397, 9, 7943, 8.192e+06
n1000x8192-slot-sum-2048, 60, 7486, 401, 9, 7956, 8.192e+06
n1000x8192-slot-sum-2048, 59, 7469, 414, 9, 7951, 8.192e+06
n1000x8192-slot-sum-2048, 61, 7486, 400, 9, 7956, 8.192e+06
n1000x8192-slot-sum-2048, 60, 7526, 400, 9, 7995, 8.192e+06
n1000x8192-slot-sum-2048, 59, 7462, 395, 9, 7925, 8.192e+06
n1000x8192-slot-sum-2048, 62, 7495, 397, 9, 7963, 8.192e+06
n1000x8192-slot-sum-2048, 60, 7469, 397, 9, 7935, 8.192e+06
n1000x8192-slot-sum-2048, 62, 7483, 412, 9, 7966, 8.192e+06
n1000x8192-slot-sum-2048, 59, 7481, 411, 9, 7960, 8.192e+06
n1000x8192-slot-sum-2048, 61, 7514, 423, 9, 8007, 8.192e+06
n1000x8192-slot-sum-2048, 59, 7488, 397, 9, 7953, 8.192e+06
n1000x8192-slot-sum-2048, 59, 7481, 394, 9, 7943, 8.192e+06
n1000x8192-slot-sum-2048, 63, 7496, 405, 9, 7973, 8.192e+06
n1000x8192-slot-sum-2048, 68, 7553, 418, 9, 8048, 8.192e+06
n1000x8192-slot-sum-2048, 61, 7482, 402, 9, 7954, 8.192e+06
n1000x8192-slot-sum-2048, 60, 7495, 397, 9, 7961, 8.192e+06
n1000x8192-slot-sum-2048, 59, 7498, 402, 9, 7968, 8.192e+06
n1000x8192-slot-sum-2048, 59, 7489, 401, 9, 7958, 8.192e+06
n1000x8192-slot-sum-2048, 61, 7477, 401, 9, 7948, 8.192e+06
n1000x8192-slot-sum-2048, 60, 7487, 395, 9, 7951, 8.192e+06
n1000x8192-slot-sum-2048, 59, 7479, 404, 9, 7951, 8.192e+06
n1000x8192-slot-sum-2048, 66, 7509, 396, 9, 7980, 8.192e+06
n1000x8192-slot-sum-2048, 61, 7478, 393, 9, 7941, 8.192e+06
n1000x8192-slot-sum-2048, 60, 7466, 394, 9, 7929, 8.192e+06
n1000x8192-slot-sum-2048, 61, 7493, 404, 9, 7967, 8.192e+06
n1000x8192-slot-sum-2048, 60, 7497, 397, 9, 7963, 8.192e+06
n1000x8192-slot-sum-2048, 59, 7487, 403, 9, 7958, 8.192e+06
n1000x8192-slot-sum-2048, 61, 7494, 395, 9, 7959, 8.192e+06
n1000x8192-slot-sum-2048, 60, 7493, 398, 9, 7960, 8.192e+06
n1000x8192-slot-sum-2048, 59, 7479, 397, 9, 7944, 8.192e+06
n1000x8192-slot-sum-2048, 59, 7483, 394, 9, 7945, 8.192e+06
n1000x8192-slot-sum-2048, 60, 7488, 399, 9, 7956, 8.192e+06
n1000x8192-slot-sum-2048, 59, 7482, 396, 9, 7946, 8.192e+06
n1000x8192-slot-sum-2048, 59, 7478, 395, 9, 7941, 8.192e+06
n1000x8192-slot-sum-2048, 60, 7504, 394, 9, 7967, 8.192e+06
n1000x8192-slot-sum-2048, 59, 7499, 394, 9, 7961, 8.192e+06
n1000x8192-slot-sum-2048, 59, 7531, 405, 9, 8004, 8.192e+06
n1000x8192-slot-sum-2048, 61, 7488, 395, 9, 7953, 8.192e+06
n1000x8192-slot-sum-2048, 60, 7495, 396, 9, 7960, 8.192e+06
n1000x8192-slot-sum-2048, 60, 7494, 404, 9, 7967, 8.192e+06
n1000x8192-slot-sum-2048, 60, 7488, 396, 9, 7953, 8.192e+06
n1000x8192-slot-sum-2048, 59, 7479, 427, 9, 7974, 8.192e+06
n1000x8192-slot-sum-2048, 60, 7493, 412, 9, 7974, 8.192e+06
n1000x8192-slot-sum-2048, 70, 7525, 398, 9, 8002, 8.192e+06
n1000x8192-slot-sum-2048, 59, 7481, 393, 9, 7942, 8.192e+06
n1000x8192-slot-sum-2048, 59, 7482, 397, 9, 7947, 8.192e+06
