type, setup, encryption, homomorphic, decryption, plaintext, total, value

sum-squares-slot, 321, 12, 164, 1, 0, 498, 0.666626
sum-squares-slot, 304, 12, 167, 1, 0, 484, 0.666626
sum-squares-slot, 299, 12, 163, 1, 0, 475, 0.666626
sum-squares-slot, 297, 14, 166, 1, 0, 478, 0.666626
sum-squares-slot, 299, 12, 169, 1, 0, 481, 0.666626
sum-squares-slot, 292, 12, 157, 1, 0, 462, 0.666626
sum-squares-slot, 301, 14, 161, 1, 0, 477, 0.666626
sum-squares-slot, 298, 12, 164, 1, 0, 475, 0.666626
sum-squares-slot, 299, 15, 162, 1, 0, 477, 0.666626
sum-squares-slot, 301, 12, 167, 1, 0, 481, 0.666626
sum-squares-slot, 300, 12, 162, 1, 0, 475, 0.666626
sum-squares-slot, 296, 12, 164, 1, 0, 473, 0.666626
sum-squares-slot, 301, 12, 166, 1, 0, 480, 0.666626
sum-squares-slot, 299, 12, 161, 1, 0, 473, 0.666626
sum-squares-slot, 309, 12, 170, 1, 0, 492, 0.666626
sum-squares-slot, 302, 12, 164, 1, 0, 479, 0.666626
sum-squares-slot, 309, 12, 162, 1, 0, 484, 0.666626
sum-squares-slot, 302, 12, 168, 1, 0, 483, 0.666626
sum-squares-slot, 302, 11, 161, 1, 0, 475, 0.666626
sum-squares-slot, 296, 12, 170, 1, 0, 479, 0.666626
sum-squares-slot, 303, 12, 172, 1, 0, 488, 0.666626
sum-squares-slot, 296, 12, 165, 1, 0, 474, 0.666626
sum-squares-slot, 311, 12, 162, 1, 0, 486, 0.666626
sum-squares-slot, 313, 12, 165, 1, 0, 491, 0.666626
sum-squares-slot, 318, 12, 163, 1, 0, 494, 0.666626
sum-squares-slot, 301, 12, 170, 1, 0, 484, 0.666626
sum-squares-slot, 296, 12, 165, 1, 0, 474, 0.666626
sum-squares-slot, 295, 12, 162, 1, 0, 470, 0.666626
sum-squares-slot, 317, 12, 165, 1, 0, 495, 0.666626
sum-squares-slot, 312, 14, 175, 1, 0, 502, 0.666626
sum-squares-slot, 309, 12, 182, 1, 0, 504, 0.666626
sum-squares-slot, 314, 12, 167, 1, 0, 494, 0.666626
sum-squares-slot, 296, 12, 164, 1, 0, 473, 0.666626
sum-squares-slot, 292, 12, 160, 1, 0, 465, 0.666626
sum-squares-slot, 304, 12, 163, 1, 0, 480, 0.666626
sum-squares-slot, 307, 12, 162, 1, 0, 482, 0.666626
sum-squares-slot, 296, 12, 173, 1, 0, 482, 0.666626
sum-squares-slot, 303, 12, 164, 1, 0, 480, 0.666626
sum-squares-slot, 303, 14, 158, 1, 0, 476, 0.666626
sum-squares-slot, 309, 13, 166, 1, 0, 489, 0.666626
sum-squares-slot, 309, 12, 160, 1, 0, 482, 0.666626
sum-squares-slot, 294, 12, 167, 1, 0, 474, 0.666626
sum-squares-slot, 294, 12, 170, 1, 0, 477, 0.666626
sum-squares-slot, 304, 12, 162, 1, 0, 479, 0.666626
sum-squares-slot, 307, 12, 165, 1, 0, 485, 0.666626
sum-squares-slot, 301, 12, 159, 1, 0, 473, 0.666626
sum-squares-slot, 313, 12, 164, 1, 0, 490, 0.666626
sum-squares-slot, 292, 12, 166, 1, 0, 471, 0.666626
sum-squares-slot, 299, 12, 166, 1, 0, 478, 0.666626
sum-squares-slot, 302, 12, 161, 1, 0, 476, 0.666626
sum-squares-slot, 298, 12, 161, 1, 0, 472, 0.666626
sum-squares-slot, 306, 12, 161, 1, 0, 480, 0.666626
sum-squares-slot, 303, 12, 167, 1, 0, 483, 0.666626
sum-squares-slot, 309, 12, 167, 1, 0, 489, 0.666626
sum-squares-slot, 306, 12, 165, 1, 0, 484, 0.666626
sum-squares-slot, 303, 12, 163, 1, 0, 479, 0.666626
sum-squares-slot, 306, 12, 163, 1, 0, 482, 0.666626
sum-squares-slot, 299, 14, 166, 1, 0, 480, 0.666626
sum-squares-slot, 303, 12, 170, 1, 0, 486, 0.666626
sum-squares-slot, 304, 15, 162, 1, 0, 482, 0.666626
sum-squares-slot, 311, 12, 162, 1, 0, 486, 0.666626
sum-squares-slot, 306, 12, 161, 1, 0, 480, 0.666626
sum-squares-slot, 306, 12, 163, 1, 0, 482, 0.666626
sum-squares-slot, 304, 12, 173, 1, 0, 490, 0.666626
sum-squares-slot, 300, 12, 163, 1, 0, 476, 0.666626
sum-squares-slot, 299, 15, 161, 1, 0, 476, 0.666626
sum-squares-slot, 304, 12, 161, 1, 0, 478, 0.666626
sum-squares-slot, 306, 12, 162, 1, 0, 481, 0.666626
sum-squares-slot, 297, 12, 167, 1, 0, 477, 0.666626
sum-squares-slot, 303, 12, 169, 1, 0, 485, 0.666626
sum-squares-slot, 304, 12, 165, 1, 0, 482, 0.666626
sum-squares-slot, 302, 12, 163, 1, 0, 478, 0.666626
sum-squares-slot, 298, 12, 168, 1, 0, 479, 0.666626
sum-squares-slot, 319, 12, 170, 1, 0, 502, 0.666626
sum-squares-slot, 308, 12, 171, 1, 0, 492, 0.666626
sum-squares-slot, 308, 13, 177, 2, 0, 500, 0.666626
sum-squares-slot, 296, 12, 162, 1, 0, 471, 0.666626
sum-squares-slot, 301, 12, 167, 1, 0, 481, 0.666626
sum-squares-slot, 302, 12, 159, 1, 0, 474, 0.666626
sum-squares-slot, 299, 12, 171, 1, 0, 483, 0.666626
sum-squares-slot, 309, 12, 170, 1, 0, 492, 0.666626
sum-squares-slot, 291, 12, 161, 1, 0, 465, 0.666626
sum-squares-slot, 300, 12, 168, 1, 0, 481, 0.666626
sum-squares-slot, 302, 13, 165, 1, 0, 481, 0.666626
sum-squares-slot, 306, 12, 164, 1, 0, 483, 0.666626
sum-squares-slot, 292, 12, 209, 1, 0, 514, 0.666626
sum-squares-slot, 321, 23, 183, 1, 0, 528, 0.666626
sum-squares-slot, 302, 12, 166, 1, 0, 481, 0.666626
sum-squares-slot, 313, 12, 165, 1, 0, 491, 0.666626
sum-squares-slot, 303, 12, 166, 1, 0, 482, 0.666626
sum-squares-slot, 301, 12, 163, 1, 0, 477, 0.666626
sum-squares-slot, 297, 12, 168, 1, 0, 478, 0.666626
sum-squares-slot, 295, 12, 161, 1, 0, 469, 0.666626
sum-squares-slot, 300, 12, 165, 1, 0, 478, 0.666626
sum-squares-slot, 307, 12, 165, 1, 0, 485, 0.666626
sum-squares-slot, 299, 13, 165, 1, 0, 478, 0.666626
sum-squares-slot, 299, 12, 176, 1, 0, 488, 0.666626
sum-squares-slot, 302, 12, 169, 1, 0, 484, 0.666626
sum-squares-slot, 297, 12, 161, 1, 0, 471, 0.666626
sum-squares-slot, 304, 12, 165, 1, 0, 482, 0.666626
sum-squares-slot, 303, 12, 163, 1, 0, 479, 0.666626
sum-squares-slot, 308, 12, 162, 1, 0, 483, 0.666626
sum-squares-slot, 292, 12, 196, 1, 0, 501, 0.666626
sum-squares-slot, 296, 12, 162, 1, 0, 471, 0.666626
sum-squares-slot, 310, 12, 165, 1, 0, 488, 0.666626
sum-squares-slot, 308, 12, 173, 1, 0, 494, 0.666626
sum-squares-slot, 308, 12, 177, 1, 0, 498, 0.666626
sum-squares-slot, 293, 12, 160, 1, 0, 466, 0.666626
sum-squares-slot, 304, 12, 165, 1, 0, 482, 0.666626
sum-squares-slot, 296, 12, 162, 1, 0, 471, 0.666626
sum-squares-slot, 308, 12, 163, 1, 0, 484, 0.666626
sum-squares-slot, 307, 12, 162, 1, 0, 482, 0.666626
sum-squares-slot, 307, 12, 161, 1, 0, 481, 0.666626
sum-squares-slot, 299, 12, 165, 1, 0, 477, 0.666626
sum-squares-slot, 302, 12, 163, 1, 0, 478, 0.666626
sum-squares-slot, 298, 12, 160, 1, 0, 471, 0.666626
sum-squares-slot, 302, 12, 162, 1, 0, 477, 0.666626
sum-squares-slot, 290, 12, 161, 1, 0, 464, 0.666626
sum-squares-slot, 300, 12, 165, 1, 0, 478, 0.666626
sum-squares-slot, 304, 12, 159, 1, 0, 476, 0.666626
sum-squares-slot, 292, 12, 159, 1, 0, 464, 0.666626
sum-squares-slot, 295, 12, 161, 1, 0, 469, 0.666626
sum-squares-slot, 309, 12, 162, 1, 0, 484, 0.666626
sum-squares-slot, 306, 12, 167, 1, 0, 486, 0.666626
sum-squares-slot, 320, 12, 166, 1, 0, 499, 0.666626
sum-squares-slot, 295, 12, 164, 1, 0, 472, 0.666626
sum-squares-slot, 302, 12, 164, 1, 0, 479, 0.666626
sum-squares-slot, 298, 12, 164, 1, 0, 475, 0.666626
sum-squares-slot, 293, 12, 164, 1, 0, 470, 0.666626
sum-squares-slot, 298, 12, 161, 1, 0, 472, 0.666626
sum-squares-slot, 296, 12, 169, 1, 0, 478, 0.666626
sum-squares-slot, 294, 12, 176, 1, 0, 483, 0.666626
sum-squares-slot, 298, 12, 163, 1, 0, 474, 0.666626
sum-squares-slot, 295, 12, 164, 1, 0, 472, 0.666626
sum-squares-slot, 311, 12, 169, 1, 0, 493, 0.666626
sum-squares-slot, 306, 12, 164, 1, 0, 483, 0.666626
sum-squares-slot, 304, 14, 169, 1, 0, 488, 0.666626
sum-squares-slot, 297, 12, 162, 1, 0, 472, 0.666626
sum-squares-slot, 306, 12, 161, 1, 0, 480, 0.666626
sum-squares-slot, 298, 11, 173, 1, 0, 483, 0.666626
sum-squares-slot, 303, 12, 162, 1, 0, 478, 0.666626
sum-squares-slot, 294, 12, 161, 1, 0, 468, 0.666626
sum-squares-slot, 296, 12, 164, 1, 0, 473, 0.666626
sum-squares-slot, 307, 12, 167, 1, 0, 487, 0.666626
sum-squares-slot, 298, 12, 165, 1, 0, 476, 0.666626
sum-squares-slot, 296, 12, 159, 1, 0, 468, 0.666626
sum-squares-slot, 305, 12, 161, 1, 0, 479, 0.666626
sum-squares-slot, 290, 11, 161, 1, 0, 463, 0.666626
sum-squares-slot, 316, 12, 163, 1, 0, 492, 0.666626
sum-squares-slot, 298, 12, 163, 1, 0, 474, 0.666626
sum-squares-slot, 297, 12, 164, 1, 0, 474, 0.666626
sum-squares-slot, 293, 12, 161, 1, 0, 467, 0.666626
sum-squares-slot, 298, 12, 161, 1, 0, 472, 0.666626
sum-squares-slot, 301, 12, 164, 1, 0, 478, 0.666626
sum-squares-slot, 297, 12, 162, 1, 0, 472, 0.666626
sum-squares-slot, 293, 12, 160, 1, 0, 466, 0.666626
sum-squares-slot, 316, 12, 168, 1, 0, 497, 0.666626
sum-squares-slot, 309, 12, 165, 1, 0, 487, 0.666626
sum-squares-slot, 303, 11, 159, 1, 0, 474, 0.666626
sum-squares-slot, 297, 12, 161, 1, 0, 471, 0.666626
sum-squares-slot, 294, 12, 169, 1, 0, 476, 0.666626
sum-squares-slot, 297, 12, 161, 1, 0, 471, 0.666626
sum-squares-slot, 295, 12, 158, 1, 0, 466, 0.666626
sum-squares-slot, 297, 12, 162, 1, 0, 472, 0.666626
sum-squares-slot, 308, 12, 170, 1, 0, 491, 0.666626
sum-squares-slot, 300, 12, 167, 1, 0, 480, 0.666626
sum-squares-slot, 304, 12, 162, 1, 0, 479, 0.666626
sum-squares-slot, 297, 12, 160, 1, 0, 470, 0.666626
sum-squares-slot, 307, 12, 169, 1, 0, 489, 0.666626
sum-squares-slot, 294, 11, 160, 1, 0, 466, 0.666626
sum-squares-slot, 297, 11, 161, 1, 0, 470, 0.666626
sum-squares-slot, 309, 12, 163, 1, 0, 485, 0.666626
sum-squares-slot, 295, 12, 159, 1, 0, 467, 0.666626
sum-squares-slot, 309, 12, 159, 1, 0, 481, 0.666626
sum-squares-slot, 295, 12, 161, 1, 0, 469, 0.666626
sum-squares-slot, 297, 12, 163, 1, 0, 473, 0.666626
sum-squares-slot, 296, 12, 161, 1, 0, 470, 0.666626
sum-squares-slot, 298, 11, 161, 1, 0, 471, 0.666626
sum-squares-slot, 297, 13, 165, 1, 0, 476, 0.666626
sum-squares-slot, 302, 12, 165, 1, 0, 480, 0.666626
sum-squares-slot, 294, 12, 161, 1, 0, 468, 0.666626
sum-squares-slot, 308, 12, 163, 1, 0, 484, 0.666626
sum-squares-slot, 297, 12, 163, 1, 0, 473, 0.666626
sum-squares-slot, 301, 12, 159, 1, 0, 473, 0.666626
sum-squares-slot, 294, 12, 159, 1, 0, 466, 0.666626
sum-squares-slot, 295, 12, 163, 1, 0, 471, 0.666626
sum-squares-slot, 300, 13, 167, 1, 0, 481, 0.666626
sum-squares-slot, 307, 12, 164, 1, 0, 484, 0.666626
sum-squares-slot, 299, 12, 160, 1, 0, 472, 0.666626
sum-squares-slot, 297, 12, 170, 1, 0, 480, 0.666626
sum-squares-slot, 306, 11, 162, 1, 0, 480, 0.666626
sum-squares-slot, 297, 12, 162, 1, 0, 472, 0.666626
sum-squares-slot, 301, 12, 159, 1, 0, 473, 0.666626
sum-squares-slot, 293, 12, 167, 1, 0, 473, 0.666626
sum-squares-slot, 295, 12, 160, 1, 0, 468, 0.666626
sum-squares-slot, 298, 12, 159, 1, 0, 470, 0.666626
sum-squares-slot, 295, 12, 166, 1, 0, 474, 0.666626
sum-squares-slot, 308, 12, 161, 1, 0, 482, 0.666626
sum-squares-slot, 304, 12, 166, 1, 0, 483, 0.666626
sum-squares-slot, 306, 12, 161, 1, 0, 480, 0.666626
sum-squares-slot, 294, 12, 160, 1, 0, 467, 0.666626
sum-squares-slot, 299, 12, 162, 1, 0, 474, 0.666626
sum-squares-slot, 300, 12, 157, 1, 0, 470, 0.666626
sum-squares-slot, 292, 12, 161, 1, 0, 466, 0.666626
sum-squares-slot, 294, 12, 168, 1, 0, 475, 0.666626
sum-squares-slot, 294, 12, 162, 1, 0, 469, 0.666626
sum-squares-slot, 310, 12, 162, 1, 0, 485, 0.666626
sum-squares-slot, 298, 12, 168, 1, 0, 479, 0.666626
sum-squares-slot, 309, 12, 160, 1, 0, 482, 0.666626
sum-squares-slot, 294, 12, 161, 1, 0, 468, 0.666626
sum-squares-slot, 298, 16, 165, 1, 0, 480, 0.666626
sum-squares-slot, 301, 12, 166, 1, 0, 480, 0.666626
sum-squares-slot, 303, 12, 162, 1, 0, 478, 0.666626
sum-squares-slot, 308, 12, 160, 1, 0, 481, 0.666626
sum-squares-slot, 304, 12, 167, 1, 0, 484, 0.666626
sum-squares-slot, 300, 12, 165, 1, 0, 478, 0.666626
sum-squares-slot, 294, 12, 160, 1, 0, 467, 0.666626
sum-squares-slot, 301, 12, 164, 1, 0, 478, 0.666626
sum-squares-slot, 301, 12, 167, 1, 0, 481, 0.666626
sum-squares-slot, 303, 12, 166, 1, 0, 482, 0.666626
sum-squares-slot, 291, 12, 162, 1, 0, 466, 0.666626
sum-squares-slot, 301, 12, 161, 1, 0, 475, 0.666626
sum-squares-slot, 299, 12, 160, 1, 0, 472, 0.666626
sum-squares-slot, 300, 12, 157, 1, 0, 470, 0.666626
sum-squares-slot, 294, 12, 164, 1, 0, 471, 0.666626
sum-squares-slot, 298, 12, 164, 1, 0, 475, 0.666626
sum-squares-slot, 307, 12, 169, 1, 0, 489, 0.666626
sum-squares-slot, 305, 12, 172, 1, 0, 490, 0.666626
sum-squares-slot, 300, 12, 164, 1, 0, 477, 0.666626
sum-squares-slot, 302, 12, 169, 1, 0, 484, 0.666626
sum-squares-slot, 298, 12, 162, 1, 0, 473, 0.666626
sum-squares-slot, 293, 12, 165, 1, 0, 471, 0.666626
sum-squares-slot, 294, 12, 162, 1, 0, 469, 0.666626
sum-squares-slot, 295, 12, 160, 1, 0, 468, 0.666626
sum-squares-slot, 292, 18, 161, 1, 0, 472, 0.666626
sum-squares-slot, 299, 12, 165, 1, 0, 477, 0.666626
sum-squares-slot, 296, 12, 164, 1, 0, 473, 0.666626
sum-squares-slot, 305, 12, 164, 1, 0, 482, 0.666626
sum-squares-slot, 306, 12, 169, 1, 0, 488, 0.666626
sum-squares-slot, 296, 12, 165, 1, 0, 474, 0.666626
sum-squares-slot, 301, 12, 166, 1, 0, 480, 0.666626
sum-squares-slot, 300, 12, 161, 1, 0, 474, 0.666626
sum-squares-slot, 301, 12, 171, 2, 0, 486, 0.666626
sum-squares-slot, 293, 12, 158, 1, 0, 464, 0.666626
sum-squares-slot, 299, 12, 162, 1, 0, 474, 0.666626
sum-squares-slot, 289, 12, 159, 1, 0, 461, 0.666626
sum-squares-slot, 302, 12, 165, 1, 0, 480, 0.666626
sum-squares-slot, 299, 12, 172, 1, 0, 484, 0.666626
sum-squares-slot, 293, 12, 161, 1, 0, 467, 0.666626
sum-squares-slot, 300, 12, 165, 1, 0, 478, 0.666626
sum-squares-slot, 300, 12, 164, 1, 0, 477, 0.666626
sum-squares-slot, 302, 12, 164, 1, 0, 479, 0.666626
sum-squares-slot, 296, 12, 161, 1, 0, 470, 0.666626
sum-squares-slot, 298, 12, 162, 1, 0, 473, 0.666626
sum-squares-slot, 297, 12, 159, 1, 0, 469, 0.666626
sum-squares-slot, 310, 12, 165, 1, 0, 488, 0.666626
sum-squares-slot, 297, 12, 164, 1, 0, 474, 0.666626
sum-squares-slot, 296, 12, 163, 1, 0, 472, 0.666626
sum-squares-slot, 303, 12, 165, 1, 0, 481, 0.666626
sum-squares-slot, 292, 16, 161, 1, 0, 470, 0.666626
sum-squares-slot, 299, 12, 166, 1, 0, 478, 0.666626
sum-squares-slot, 297, 12, 160, 1, 0, 470, 0.666626
sum-squares-slot, 295, 12, 165, 1, 0, 473, 0.666626
sum-squares-slot, 301, 12, 170, 1, 0, 484, 0.666626
sum-squares-slot, 307, 12, 163, 1, 0, 483, 0.666626
sum-squares-slot, 309, 12, 161, 1, 0, 483, 0.666626
sum-squares-slot, 292, 12, 161, 1, 0, 466, 0.666626
sum-squares-slot, 308, 12, 170, 1, 0, 491, 0.666626
sum-squares-slot, 311, 12, 162, 1, 0, 486, 0.666626
sum-squares-slot, 301, 12, 161, 1, 0, 475, 0.666626
sum-squares-slot, 301, 12, 162, 1, 0, 476, 0.666626
sum-squares-slot, 302, 12, 163, 1, 0, 478, 0.666626
sum-squares-slot, 293, 12, 160, 1, 0, 466, 0.666626
sum-squares-slot, 301, 12, 168, 1, 0, 482, 0.666626
sum-squares-slot, 298, 12, 166, 1, 0, 477, 0.666626
sum-squares-slot, 311, 12, 167, 1, 0, 491, 0.666626
sum-squares-slot, 305, 12, 160, 1, 0, 478, 0.666626
sum-squares-slot, 300, 12, 158, 1, 0, 471, 0.666626
sum-squares-slot, 308, 12, 165, 1, 0, 486, 0.666626
sum-squares-slot, 297, 12, 162, 1, 0, 472, 0.666626
sum-squares-slot, 306, 12, 163, 1, 0, 482, 0.666626
sum-squares-slot, 305, 12, 165, 1, 0, 483, 0.666626
sum-squares-slot, 303, 12, 162, 1, 0, 478, 0.666626
sum-squares-slot, 306, 13, 166, 1, 0, 486, 0.666626
sum-squares-slot, 324, 15, 164, 1, 0, 504, 0.666626
sum-squares-slot, 292, 12, 163, 1, 0, 468, 0.666626
sum-squares-slot, 304, 12, 169, 1, 0, 486, 0.666626
sum-squares-slot, 297, 11, 160, 1, 0, 469, 0.666626
sum-squares-slot, 295, 16, 165, 1, 0, 477, 0.666626
sum-squares-slot, 307, 12, 169, 1, 0, 489, 0.666626
sum-squares-slot, 310, 12, 170, 1, 0, 493, 0.666626
sum-squares-slot, 297, 12, 167, 1, 0, 477, 0.666626
sum-squares-slot, 310, 16, 168, 1, 0, 495, 0.666626
sum-squares-slot, 296, 12, 161, 1, 0, 470, 0.666626
sum-squares-slot, 291, 12, 164, 1, 0, 468, 0.666626
sum-squares-slot, 299, 12, 168, 1, 0, 480, 0.666626
sum-squares-slot, 294, 12, 176, 1, 0, 483, 0.666626
sum-squares-slot, 295, 12, 164, 1, 0, 472, 0.666626
sum-squares-slot, 310, 12, 165, 1, 0, 488, 0.666626
sum-squares-slot, 294, 12, 166, 1, 0, 473, 0.666626
sum-squares-slot, 302, 12, 165, 1, 0, 480, 0.666626
sum-squares-slot, 295, 12, 162, 1, 0, 470, 0.666626
sum-squares-slot, 296, 12, 162, 1, 0, 471, 0.666626
sum-squares-slot, 295, 12, 165, 1, 0, 473, 0.666626
sum-squares-slot, 302, 13, 166, 1, 0, 482, 0.666626
sum-squares-slot, 307, 12, 163, 1, 0, 483, 0.666626
sum-squares-slot, 297, 12, 165, 1, 0, 475, 0.666626
sum-squares-slot, 295, 12, 162, 1, 0, 470, 0.666626
sum-squares-slot, 297, 12, 163, 1, 0, 473, 0.666626
sum-squares-slot, 302, 12, 158, 1, 0, 473, 0.666626
sum-squares-slot, 307, 12, 163, 1, 0, 483, 0.666626
sum-squares-slot, 299, 12, 160, 1, 0, 472, 0.666626
sum-squares-slot, 293, 12, 160, 1, 0, 466, 0.666626
sum-squares-slot, 317, 12, 164, 1, 0, 494, 0.666626
sum-squares-slot, 295, 12, 161, 1, 0, 469, 0.666626
sum-squares-slot, 301, 12, 166, 1, 0, 480, 0.666626
sum-squares-slot, 299, 12, 158, 1, 0, 470, 0.666626
sum-squares-slot, 295, 12, 172, 1, 0, 480, 0.666626
sum-squares-slot, 300, 12, 161, 1, 0, 474, 0.666626
sum-squares-slot, 299, 12, 164, 1, 0, 476, 0.666626
sum-squares-slot, 303, 12, 159, 1, 0, 475, 0.666626
sum-squares-slot, 306, 12, 175, 1, 0, 494, 0.666626
sum-squares-slot, 306, 12, 167, 1, 0, 486, 0.666626
sum-squares-slot, 303, 12, 163, 1, 0, 479, 0.666626
sum-squares-slot, 297, 11, 160, 1, 0, 469, 0.666626
sum-squares-slot, 294, 12, 160, 1, 0, 467, 0.666626
sum-squares-slot, 299, 12, 161, 1, 0, 473, 0.666626
sum-squares-slot, 296, 12, 162, 1, 0, 471, 0.666626
sum-squares-slot, 299, 12, 161, 1, 0, 473, 0.666626
sum-squares-slot, 297, 12, 159, 1, 0, 469, 0.666626
sum-squares-slot, 300, 12, 161, 1, 0, 474, 0.666626
sum-squares-slot, 306, 12, 165, 1, 0, 484, 0.666626
sum-squares-slot, 305, 12, 165, 1, 0, 483, 0.666626
sum-squares-slot, 299, 12, 159, 1, 0, 471, 0.666626
sum-squares-slot, 307, 12, 162, 1, 0, 482, 0.666626
sum-squares-slot, 302, 12, 163, 1, 0, 478, 0.666626
sum-squares-slot, 293, 12, 158, 1, 0, 464, 0.666626
sum-squares-slot, 293, 12, 162, 1, 0, 468, 0.666626
sum-squares-slot, 304, 15, 161, 1, 0, 481, 0.666626
sum-squares-slot, 301, 11, 164, 1, 0, 477, 0.666626
sum-squares-slot, 296, 11, 165, 1, 0, 473, 0.666626
sum-squares-slot, 295, 12, 162, 1, 0, 470, 0.666626
sum-squares-slot, 299, 12, 171, 1, 0, 483, 0.666626
sum-squares-slot, 294, 12, 159, 1, 0, 466, 0.666626
sum-squares-slot, 306, 12, 161, 1, 0, 480, 0.666626
sum-squares-slot, 296, 12, 158, 1, 0, 467, 0.666626
sum-squares-slot, 299, 12, 176, 1, 0, 488, 0.666626
sum-squares-slot, 307, 12, 165, 1, 0, 485, 0.666626
sum-squares-slot, 304, 12, 164, 1, 0, 481, 0.666626
sum-squares-slot, 306, 12, 170, 1, 0, 489, 0.666626
sum-squares-slot, 299, 12, 164, 1, 0, 476, 0.666626
sum-squares-slot, 304, 11, 159, 1, 0, 475, 0.666626
sum-squares-slot, 307, 12, 170, 1, 0, 490, 0.666626
sum-squares-slot, 302, 12, 171, 1, 0, 486, 0.666626
sum-squares-slot, 298, 11, 161, 1, 0, 471, 0.666626
sum-squares-slot, 298, 12, 162, 1, 0, 473, 0.666626
sum-squares-slot, 311, 12, 162, 1, 0, 486, 0.666626
sum-squares-slot, 299, 12, 164, 1, 0, 476, 0.666626
sum-squares-slot, 296, 12, 160, 1, 0, 469, 0.666626
sum-squares-slot, 290, 12, 161, 1, 0, 464, 0.666626
sum-squares-slot, 301, 12, 161, 1, 0, 475, 0.666626
sum-squares-slot, 304, 12, 162, 1, 0, 479, 0.666626
sum-squares-slot, 306, 12, 159, 1, 0, 478, 0.666626
sum-squares-slot, 304, 14, 164, 1, 0, 483, 0.666626
sum-squares-slot, 296, 12, 161, 1, 0, 470, 0.666626
sum-squares-slot, 294, 12, 162, 1, 0, 469, 0.666626
sum-squares-slot, 306, 12, 161, 1, 0, 480, 0.666626
sum-squares-slot, 297, 12, 161, 1, 0, 471, 0.666626
sum-squares-slot, 298, 12, 163, 1, 0, 474, 0.666626
sum-squares-slot, 292, 11, 157, 1, 0, 461, 0.666626
sum-squares-slot, 298, 12, 167, 1, 0, 478, 0.666626
sum-squares-slot, 302, 12, 160, 1, 0, 475, 0.666626
sum-squares-slot, 293, 12, 164, 1, 0, 470, 0.666626
sum-squares-slot, 295, 12, 163, 1, 0, 471, 0.666626
sum-squares-slot, 294, 12, 168, 1, 0, 475, 0.666626
sum-squares-slot, 295, 12, 164, 1, 0, 472, 0.666626
sum-squares-slot, 297, 12, 164, 1, 0, 474, 0.666626
sum-squares-slot, 301, 12, 166, 1, 0, 480, 0.666626
sum-squares-slot, 312, 12, 172, 1, 0, 497, 0.666626
sum-squares-slot, 299, 12, 159, 1, 0, 471, 0.666626
sum-squares-slot, 302, 12, 160, 1, 0, 475, 0.666626
sum-squares-slot, 302, 12, 161, 1, 0, 476, 0.666626
sum-squares-slot, 296, 13, 164, 1, 0, 474, 0.666626
sum-squares-slot, 299, 12, 163, 1, 0, 475, 0.666626
sum-squares-slot, 302, 12, 163, 1, 0, 478, 0.666626
sum-squares-slot, 295, 12, 162, 1, 0, 470, 0.666626
sum-squares-slot, 301, 12, 158, 1, 0, 472, 0.666626
sum-squares-slot, 302, 12, 162, 1, 0, 477, 0.666626
sum-squares-slot, 297, 12, 166, 1, 0, 476, 0.666626
sum-squares-slot, 308, 12, 166, 1, 0, 487, 0.666626
sum-squares-slot, 297, 12, 162, 1, 0, 472, 0.666626
sum-squares-slot, 303, 12, 162, 1, 0, 478, 0.666626
sum-squares-slot, 294, 12, 162, 1, 0, 469, 0.666626
sum-squares-slot, 302, 12, 163, 1, 0, 478, 0.666626
sum-squares-slot, 305, 12, 161, 1, 0, 479, 0.666626
sum-squares-slot, 296, 11, 157, 1, 0, 465, 0.666626
sum-squares-slot, 296, 12, 164, 1, 0, 473, 0.666626
sum-squares-slot, 308, 12, 165, 1, 0, 486, 0.666626
sum-squares-slot, 296, 12, 161, 1, 0, 470, 0.666626
sum-squares-slot, 298, 12, 162, 1, 0, 473, 0.666626
sum-squares-slot, 294, 11, 160, 1, 0, 466, 0.666626
sum-squares-slot, 300, 12, 159, 1, 0, 472, 0.666626
sum-squares-slot, 298, 12, 161, 1, 0, 472, 0.666626
sum-squares-slot, 296, 12, 163, 1, 0, 472, 0.666626
sum-squares-slot, 304, 12, 162, 1, 0, 479, 0.666626
sum-squares-slot, 298, 12, 160, 1, 0, 471, 0.666626
sum-squares-slot, 306, 12, 165, 1, 0, 484, 0.666626
sum-squares-slot, 293, 12, 171, 1, 0, 477, 0.666626
sum-squares-slot, 301, 12, 158, 1, 0, 472, 0.666626
sum-squares-slot, 306, 12, 166, 1, 0, 485, 0.666626
sum-squares-slot, 300, 12, 167, 1, 0, 480, 0.666626
sum-squares-slot, 303, 12, 161, 1, 0, 477, 0.666626
sum-squares-slot, 305, 12, 165, 1, 0, 483, 0.666626
sum-squares-slot, 301, 12, 162, 1, 0, 476, 0.666626
sum-squares-slot, 302, 12, 168, 1, 0, 483, 0.666626
sum-squares-slot, 297, 12, 159, 1, 0, 469, 0.666626
sum-squares-slot, 299, 12, 161, 1, 0, 473, 0.666626
sum-squares-slot, 304, 12, 162, 1, 0, 479, 0.666626
sum-squares-slot, 296, 12, 162, 1, 0, 471, 0.666626
sum-squares-slot, 307, 12, 159, 1, 0, 479, 0.666626
sum-squares-slot, 299, 12, 159, 1, 0, 471, 0.666626
sum-squares-slot, 297, 12, 162, 1, 0, 472, 0.666626
sum-squares-slot, 297, 12, 161, 1, 0, 471, 0.666626
sum-squares-slot, 293, 12, 162, 1, 0, 468, 0.666626
sum-squares-slot, 302, 12, 163, 1, 0, 478, 0.666626
sum-squares-slot, 307, 12, 163, 1, 0, 483, 0.666626
sum-squares-slot, 293, 12, 157, 1, 0, 463, 0.666626
sum-squares-slot, 305, 12, 169, 1, 0, 487, 0.666626
sum-squares-slot, 298, 12, 179, 1, 0, 490, 0.666626
sum-squares-slot, 301, 11, 160, 1, 0, 473, 0.666626
sum-squares-slot, 298, 12, 162, 1, 0, 473, 0.666626
sum-squares-slot, 295, 12, 159, 1, 0, 467, 0.666626
sum-squares-slot, 298, 12, 163, 1, 0, 474, 0.666626
sum-squares-slot, 295, 12, 161, 1, 0, 469, 0.666626
sum-squares-slot, 317, 12, 165, 1, 0, 495, 0.666626
sum-squares-slot, 303, 12, 162, 1, 0, 478, 0.666626
sum-squares-slot, 301, 12, 159, 1, 0, 473, 0.666626
sum-squares-slot, 299, 11, 164, 1, 0, 475, 0.666626
sum-squares-slot, 294, 12, 159, 1, 0, 466, 0.666626
sum-squares-slot, 299, 11, 163, 1, 0, 474, 0.666626
sum-squares-slot, 295, 12, 168, 1, 0, 476, 0.666626
sum-squares-slot, 323, 12, 164, 1, 0, 500, 0.666626
sum-squares-slot, 298, 12, 158, 1, 0, 469, 0.666626
sum-squares-slot, 297, 12, 169, 1, 0, 479, 0.666626
sum-squares-slot, 300, 12, 162, 1, 0, 475, 0.666626
sum-squares-slot, 309, 12, 165, 1, 0, 487, 0.666626
sum-squares-slot, 302, 12, 162, 1, 0, 477, 0.666626
sum-squares-slot, 298, 12, 163, 1, 0, 474, 0.666626
sum-squares-slot, 296, 12, 161, 1, 0, 470, 0.666626
sum-squares-slot, 297, 12, 159, 1, 0, 469, 0.666626
sum-squares-slot, 301, 12, 163, 1, 0, 477, 0.666626
sum-squares-slot, 292, 11, 161, 1, 0, 465, 0.666626
sum-squares-slot, 297, 12, 162, 1, 0, 472, 0.666626
sum-squares-slot, 301, 16, 164, 1, 0, 482, 0.666626
sum-squares-slot, 299, 12, 165, 1, 0, 477, 0.666626
sum-squares-slot, 296, 12, 163, 1, 0, 472, 0.666626
sum-squares-slot, 291, 12, 161, 1, 0, 465, 0.666626
sum-squares-slot, 294, 12, 169, 1, 0, 476, 0.666626
sum-squares-slot, 293, 12, 160, 1, 0, 466, 0.666626
sum-squares-slot, 297, 12, 163, 1, 0, 473, 0.666626
sum-squares-slot, 302, 12, 158, 1, 0, 473, 0.666626
sum-squares-slot, 293, 12, 163, 1, 0, 469, 0.666626
sum-squares-slot, 305, 12, 164, 1, 0, 482, 0.666626
sum-squares-slot, 301, 12, 159, 1, 0, 473, 0.666626
sum-squares-slot, 297, 12, 157, 1, 0, 467, 0.666626
sum-squares-slot, 294, 12, 160, 1, 0, 467, 0.666626
sum-squares-slot, 298, 12, 167, 1, 0, 478, 0.666626
sum-squares-slot, 301, 12, 163, 1, 0, 477, 0.666626
sum-squares-slot, 292, 12, 160, 1, 0, 465, 0.666626
sum-squares-slot, 295, 12, 160, 1, 0, 468, 0.666626
sum-squares-slot, 317, 12, 162, 1, 0, 492, 0.666626
sum-squares-slot, 301, 12, 163, 1, 0, 477, 0.666626
sum-squares-slot, 296, 12, 164, 1, 0, 473, 0.666626
sum-squares-slot, 302, 12, 161, 1, 0, 476, 0.666626
sum-squares-slot, 294, 12, 163, 1, 0, 470, 0.666626
sum-squares-slot, 297, 12, 163, 1, 0, 473, 0.666626
sum-squares-slot, 302, 12, 169, 1, 0, 484, 0.666626
sum-squares-slot, 312, 12, 169, 1, 0, 494, 0.666626
sum-squares-slot, 307, 12, 165, 1, 0, 485, 0.666626
sum-squares-slot, 309, 12, 166, 1, 0, 488, 0.666626
sum-squares-slot, 292, 13, 162, 1, 0, 468, 0.666626
sum-squares-slot, 312, 12, 175, 1, 0, 500, 0.666626
sum-squares-slot, 290, 12, 159, 1, 0, 462, 0.666626
sum-squares-slot, 302, 12, 166, 1, 0, 481, 0.666626
sum-squares-slot, 305, 12, 166, 1, 0, 484, 0.666626
sum-squares-slot, 299, 12, 167, 1, 0, 479, 0.666626
sum-squares-slot, 299, 12, 161, 1, 0, 473, 0.666626
sum-squares-slot, 309, 12, 164, 1, 0, 486, 0.666626
sum-squares-slot, 297, 12, 162, 1, 0, 472, 0.666626
sum-squares-slot, 295, 12, 163, 1, 0, 471, 0.666626
sum-squares-slot, 316, 12, 157, 1, 0, 486, 0.666626
sum-squares-slot, 294, 12, 160, 1, 0, 467, 0.666626
sum-squares-slot, 295, 12, 165, 1, 0, 473, 0.666626
sum-squares-slot, 304, 12, 163, 1, 0, 480, 0.666626
sum-squares-slot, 299, 12, 162, 1, 0, 474, 0.666626
sum-squares-slot, 310, 12, 161, 1, 0, 484, 0.666626
sum-squares-slot, 294, 12, 161, 1, 0, 468, 0.666626
sum-squares-slot, 299, 12, 159, 1, 0, 471, 0.666626
sum-squares-slot, 301, 12, 161, 1, 0, 475, 0.666626
sum-squares-slot, 299, 12, 160, 1, 0, 472, 0.666626
sum-squares-slot, 306, 12, 165, 1, 0, 484, 0.666626
sum-squares-slot, 302, 13, 162, 1, 0, 478, 0.666626
sum-squares-slot, 309, 12, 164, 1, 0, 486, 0.666626
sum-squares-slot, 295, 12, 160, 1, 0, 468, 0.666626
sum-squares-slot, 294, 12, 161, 1, 0, 468, 0.666626
sum-squares-slot, 302, 12, 170, 1, 0, 485, 0.666626
sum-squares-slot, 301, 12, 166, 1, 0, 480, 0.666626
sum-squares-slot, 300, 12, 171, 1, 0, 484, 0.666626
sum-squares-slot, 294, 12, 163, 1, 0, 470, 0.666626
sum-squares-slot, 305, 12, 166, 1, 0, 484, 0.666626
sum-squares-slot, 301, 12, 172, 1, 0, 486, 0.666626
sum-squares-slot, 296, 12, 161, 1, 0, 470, 0.666626
sum-squares-slot, 296, 14, 165, 1, 0, 476, 0.666626
sum-squares-slot, 308, 12, 164, 1, 0, 485, 0.666626
sum-squares-slot, 303, 12, 177, 1, 0, 493, 0.666626
sum-squares-slot, 298, 12, 159, 1, 0, 470, 0.666626
sum-squares-slot, 308, 12, 165, 1, 0, 486, 0.666626
sum-squares-slot, 293, 12, 162, 1, 0, 468, 0.666626
sum-squares-slot, 296, 12, 162, 1, 0, 471, 0.666626
sum-squares-slot, 292, 12, 162, 1, 0, 467, 0.666626
sum-squares-slot, 296, 12, 165, 1, 0, 474, 0.666626
sum-squares-slot, 305, 12, 165, 1, 0, 483, 0.666626
sum-squares-slot, 300, 12, 162, 1, 0, 475, 0.666626
sum-squares-slot, 312, 12, 160, 1, 0, 485, 0.666626
sum-squares-slot, 303, 12, 160, 1, 0, 476, 0.666626
sum-squares-slot, 299, 12, 162, 1, 0, 474, 0.666626
sum-squares-slot, 304, 12, 163, 1, 0, 480, 0.666626
sum-squares-slot, 304, 12, 163, 1, 0, 480, 0.666626
sum-squares-slot, 295, 12, 160, 1, 0, 468, 0.666626
sum-squares-slot, 301, 12, 166, 1, 0, 480, 0.666626
sum-squares-slot, 304, 12, 163, 1, 0, 480, 0.666626
sum-squares-slot, 299, 12, 163, 1, 0, 475, 0.666626
sum-squares-slot, 301, 12, 163, 1, 0, 477, 0.666626
sum-squares-slot, 298, 12, 163, 1, 0, 474, 0.666626
sum-squares-slot, 310, 12, 165, 1, 0, 488, 0.666626
sum-squares-slot, 302, 12, 166, 1, 0, 481, 0.666626
sum-squares-slot, 301, 12, 165, 1, 0, 479, 0.666626
sum-squares-slot, 307, 12, 166, 1, 0, 486, 0.666626
sum-squares-slot, 308, 12, 166, 1, 0, 487, 0.666626
sum-squares-slot, 301, 12, 169, 1, 0, 483, 0.666626
sum-squares-slot, 297, 12, 160, 1, 0, 470, 0.666626
sum-squares-slot, 295, 12, 159, 1, 0, 467, 0.666626
sum-squares-slot, 309, 12, 164, 1, 0, 486, 0.666626
sum-squares-slot, 301, 12, 166, 1, 0, 480, 0.666626
sum-squares-slot, 292, 12, 163, 1, 0, 468, 0.666626
sum-squares-slot, 299, 12, 163, 1, 0, 475, 0.666626
sum-squares-slot, 298, 12, 165, 1, 0, 476, 0.666626
sum-squares-slot, 304, 12, 170, 1, 0, 487, 0.666626
sum-squares-slot, 298, 12, 161, 1, 0, 472, 0.666626
sum-squares-slot, 305, 12, 165, 1, 0, 483, 0.666626
sum-squares-slot, 297, 12, 167, 1, 0, 477, 0.666626
sum-squares-slot, 306, 12, 165, 1, 0, 484, 0.666626
sum-squares-slot, 309, 13, 164, 1, 0, 487, 0.666626
sum-squares-slot, 298, 12, 160, 1, 0, 471, 0.666626
sum-squares-slot, 296, 12, 165, 1, 0, 474, 0.666626
sum-squares-slot, 302, 12, 164, 1, 0, 479, 0.666626
sum-squares-slot, 309, 12, 166, 1, 0, 488, 0.666626
sum-squares-slot, 303, 12, 163, 1, 0, 479, 0.666626
sum-squares-slot, 297, 12, 167, 1, 0, 477, 0.666626
sum-squares-slot, 294, 12, 162, 1, 0, 469, 0.666626
sum-squares-slot, 292, 12, 162, 1, 0, 467, 0.666626
sum-squares-slot, 296, 12, 159, 1, 0, 468, 0.666626
sum-squares-slot, 299, 13, 167, 1, 0, 480, 0.666626
sum-squares-slot, 299, 12, 167, 1, 0, 479, 0.666626
sum-squares-slot, 300, 15, 163, 1, 0, 479, 0.666626
sum-squares-slot, 302, 12, 164, 1, 0, 479, 0.666626
sum-squares-slot, 297, 12, 161, 1, 0, 471, 0.666626
sum-squares-slot, 298, 12, 164, 1, 0, 475, 0.666626
sum-squares-slot, 295, 12, 172, 1, 0, 480, 0.666626
sum-squares-slot, 320, 12, 165, 1, 0, 498, 0.666626
sum-squares-slot, 295, 11, 163, 1, 0, 470, 0.666626
sum-squares-slot, 295, 12, 163, 1, 0, 471, 0.666626
sum-squares-slot, 301, 12, 181, 1, 0, 495, 0.666626
sum-squares-slot, 301, 12, 160, 1, 0, 474, 0.666626
sum-squares-slot, 293, 12, 161, 1, 0, 467, 0.666626
sum-squares-slot, 308, 12, 164, 1, 0, 485, 0.666626
sum-squares-slot, 301, 12, 165, 1, 0, 479, 0.666626
sum-squares-slot, 308, 12, 164, 1, 0, 485, 0.666626
sum-squares-slot, 300, 12, 163, 1, 0, 476, 0.666626
sum-squares-slot, 304, 12, 164, 1, 0, 481, 0.666626
sum-squares-slot, 304, 15, 165, 1, 0, 485, 0.666626
sum-squares-slot, 301, 12, 162, 1, 0, 476, 0.666626
sum-squares-slot, 299, 12, 166, 1, 0, 478, 0.666626
sum-squares-slot, 307, 12, 162, 1, 0, 482, 0.666626
sum-squares-slot, 306, 12, 163, 1, 0, 482, 0.666626
sum-squares-slot, 313, 12, 167, 1, 0, 493, 0.666626
sum-squares-slot, 295, 12, 159, 1, 0, 467, 0.666626
sum-squares-slot, 296, 12, 163, 1, 0, 472, 0.666626
sum-squares-slot, 329, 12, 175, 1, 0, 517, 0.666626
sum-squares-slot, 308, 11, 163, 1, 0, 483, 0.666626
sum-squares-slot, 297, 12, 167, 1, 0, 477, 0.666626
sum-squares-slot, 307, 12, 164, 1, 0, 484, 0.666626
sum-squares-slot, 302, 12, 176, 1, 0, 491, 0.666626
sum-squares-slot, 314, 12, 168, 1, 0, 495, 0.666626
sum-squares-slot, 298, 12, 163, 1, 0, 474, 0.666626
sum-squares-slot, 308, 12, 162, 1, 0, 483, 0.666626
sum-squares-slot, 313, 12, 164, 1, 0, 490, 0.666626
sum-squares-slot, 297, 12, 165, 1, 0, 475, 0.666626
sum-squares-slot, 299, 12, 166, 1, 0, 478, 0.666626
sum-squares-slot, 309, 12, 171, 1, 0, 493, 0.666626
sum-squares-slot, 302, 12, 166, 1, 0, 481, 0.666626
sum-squares-slot, 299, 12, 169, 1, 0, 481, 0.666626
sum-squares-slot, 299, 12, 162, 1, 0, 474, 0.666626
sum-squares-slot, 297, 12, 163, 1, 0, 473, 0.666626
sum-squares-slot, 302, 12, 169, 1, 0, 484, 0.666626
sum-squares-slot, 300, 12, 160, 1, 0, 473, 0.666626
sum-squares-slot, 298, 12, 165, 1, 0, 476, 0.666626
sum-squares-slot, 301, 12, 168, 1, 0, 482, 0.666626
sum-squares-slot, 304, 12, 172, 1, 0, 489, 0.666626
sum-squares-slot, 295, 12, 162, 1, 0, 470, 0.666626
sum-squares-slot, 308, 12, 166, 1, 0, 487, 0.666626
sum-squares-slot, 297, 12, 162, 1, 0, 472, 0.666626
sum-squares-slot, 298, 12, 162, 1, 0, 473, 0.666626
sum-squares-slot, 304, 12, 164, 1, 0, 481, 0.666626
sum-squares-slot, 292, 12, 162, 1, 0, 467, 0.666626
sum-squares-slot, 293, 12, 162, 1, 0, 468, 0.666626
sum-squares-slot, 308, 12, 160, 1, 0, 481, 0.666626
sum-squares-slot, 308, 12, 161, 1, 0, 482, 0.666626
sum-squares-slot, 304, 12, 163, 1, 0, 480, 0.666626
sum-squares-slot, 305, 12, 167, 1, 0, 485, 0.666626
sum-squares-slot, 304, 12, 161, 1, 0, 478, 0.666626
sum-squares-slot, 300, 12, 160, 1, 0, 473, 0.666626
sum-squares-slot, 300, 12, 162, 1, 0, 475, 0.666626
sum-squares-slot, 301, 12, 170, 1, 0, 484, 0.666626
sum-squares-slot, 304, 12, 160, 1, 0, 477, 0.666626
sum-squares-slot, 307, 12, 166, 1, 0, 486, 0.666626
sum-squares-slot, 294, 12, 176, 1, 0, 483, 0.666626
sum-squares-slot, 298, 12, 161, 1, 0, 472, 0.666626
sum-squares-slot, 300, 12, 169, 1, 0, 482, 0.666626
sum-squares-slot, 305, 12, 163, 1, 0, 481, 0.666626
sum-squares-slot, 307, 12, 168, 1, 0, 488, 0.666626
sum-squares-slot, 302, 12, 161, 1, 0, 476, 0.666626
sum-squares-slot, 304, 12, 162, 1, 0, 479, 0.666626
sum-squares-slot, 307, 12, 167, 1, 0, 487, 0.666626
sum-squares-slot, 301, 12, 169, 1, 0, 483, 0.666626
sum-squares-slot, 307, 12, 162, 1, 0, 482, 0.666626
sum-squares-slot, 296, 12, 164, 1, 0, 473, 0.666626
sum-squares-slot, 294, 12, 166, 1, 0, 473, 0.666626
sum-squares-slot, 304, 12, 164, 1, 0, 481, 0.666626
sum-squares-slot, 302, 12, 161, 1, 0, 476, 0.666626
sum-squares-slot, 307, 12, 166, 1, 0, 486, 0.666626
sum-squares-slot, 304, 12, 167, 1, 0, 484, 0.666626
sum-squares-slot, 303, 12, 164, 1, 0, 480, 0.666626
sum-squares-slot, 305, 12, 161, 1, 0, 479, 0.666626
sum-squares-slot, 299, 12, 166, 1, 0, 478, 0.666626
sum-squares-slot, 295, 12, 165, 1, 0, 473, 0.666626
sum-squares-slot, 312, 12, 168, 1, 0, 493, 0.666626
sum-squares-slot, 297, 12, 163, 1, 0, 473, 0.666626
sum-squares-slot, 295, 12, 167, 1, 0, 475, 0.666626
sum-squares-slot, 300, 12, 163, 1, 0, 476, 0.666626
sum-squares-slot, 307, 12, 164, 1, 0, 484, 0.666626
sum-squares-slot, 307, 12, 169, 1, 0, 489, 0.666626
sum-squares-slot, 298, 12, 166, 1, 0, 477, 0.666626
sum-squares-slot, 293, 12, 162, 1, 0, 468, 0.666626
sum-squares-slot, 303, 12, 165, 1, 0, 481, 0.666626
sum-squares-slot, 307, 12, 167, 1, 0, 487, 0.666626
sum-squares-slot, 295, 12, 162, 1, 0, 470, 0.666626
sum-squares-slot, 300, 12, 161, 1, 0, 474, 0.666626
sum-squares-slot, 302, 12, 166, 1, 0, 481, 0.666626
sum-squares-slot, 299, 12, 164, 1, 0, 476, 0.666626
sum-squares-slot, 302, 12, 166, 1, 0, 481, 0.666626
sum-squares-slot, 302, 14, 164, 1, 0, 481, 0.666626
sum-squares-slot, 291, 15, 163, 1, 0, 470, 0.666626
sum-squares-slot, 303, 12, 165, 1, 0, 481, 0.666626
sum-squares-slot, 300, 12, 162, 1, 0, 475, 0.666626
sum-squares-slot, 298, 12, 162, 1, 0, 473, 0.666626
sum-squares-slot, 294, 12, 164, 1, 0, 471, 0.666626
sum-squares-slot, 292, 12, 158, 1, 0, 463, 0.666626
sum-squares-slot, 300, 12, 162, 1, 0, 475, 0.666626
sum-squares-slot, 299, 12, 164, 1, 0, 476, 0.666626
sum-squares-slot, 298, 12, 166, 1, 0, 477, 0.666626
sum-squares-slot, 295, 14, 164, 1, 0, 474, 0.666626
sum-squares-slot, 297, 12, 162, 1, 0, 472, 0.666626
sum-squares-slot, 301, 12, 166, 1, 0, 480, 0.666626
sum-squares-slot, 301, 12, 165, 1, 0, 479, 0.666626
sum-squares-slot, 302, 12, 165, 1, 0, 480, 0.666626
sum-squares-slot, 294, 12, 160, 1, 0, 467, 0.666626
sum-squares-slot, 305, 12, 166, 1, 0, 484, 0.666626
sum-squares-slot, 300, 12, 162, 1, 0, 475, 0.666626
sum-squares-slot, 307, 12, 164, 1, 0, 484, 0.666626
sum-squares-slot, 302, 12, 162, 1, 0, 477, 0.666626
sum-squares-slot, 299, 12, 164, 1, 0, 476, 0.666626
sum-squares-slot, 296, 12, 165, 1, 0, 474, 0.666626
sum-squares-slot, 308, 12, 167, 1, 0, 488, 0.666626
sum-squares-slot, 298, 12, 162, 1, 0, 473, 0.666626
sum-squares-slot, 296, 12, 166, 1, 0, 475, 0.666626
sum-squares-slot, 299, 12, 164, 1, 0, 476, 0.666626
sum-squares-slot, 302, 12, 168, 1, 0, 483, 0.666626
sum-squares-slot, 298, 12, 161, 1, 0, 472, 0.666626
sum-squares-slot, 302, 12, 164, 1, 0, 479, 0.666626
sum-squares-slot, 299, 13, 165, 1, 0, 478, 0.666626
sum-squares-slot, 293, 12, 182, 1, 0, 488, 0.666626
sum-squares-slot, 304, 12, 168, 1, 0, 485, 0.666626
sum-squares-slot, 300, 12, 165, 1, 0, 478, 0.666626
sum-squares-slot, 305, 12, 167, 1, 0, 485, 0.666626
sum-squares-slot, 303, 16, 169, 1, 0, 489, 0.666626
sum-squares-slot, 302, 12, 163, 1, 0, 478, 0.666626
sum-squares-slot, 294, 12, 161, 1, 0, 468, 0.666626
sum-squares-slot, 301, 12, 166, 1, 0, 480, 0.666626
sum-squares-slot, 304, 12, 163, 1, 0, 480, 0.666626
sum-squares-slot, 317, 12, 166, 1, 0, 496, 0.666626
sum-squares-slot, 306, 12, 167, 1, 0, 486, 0.666626
sum-squares-slot, 306, 12, 165, 1, 0, 484, 0.666626
sum-squares-slot, 306, 12, 165, 1, 0, 484, 0.666626
sum-squares-slot, 307, 12, 169, 1, 0, 489, 0.666626
sum-squares-slot, 296, 12, 162, 1, 0, 471, 0.666626
sum-squares-slot, 308, 12, 169, 1, 0, 490, 0.666626
sum-squares-slot, 306, 12, 165, 1, 0, 484, 0.666626
sum-squares-slot, 302, 12, 166, 1, 0, 481, 0.666626
sum-squares-slot, 303, 12, 162, 1, 0, 478, 0.666626
sum-squares-slot, 299, 12, 161, 1, 0, 473, 0.666626
sum-squares-slot, 303, 12, 167, 1, 0, 483, 0.666626
sum-squares-slot, 332, 12, 164, 1, 0, 509, 0.666626
sum-squares-slot, 298, 12, 163, 1, 0, 474, 0.666626
sum-squares-slot, 300, 12, 166, 1, 0, 479, 0.666626
sum-squares-slot, 308, 13, 170, 1, 0, 492, 0.666626
sum-squares-slot, 302, 13, 168, 1, 0, 484, 0.666626
sum-squares-slot, 303, 12, 171, 1, 0, 487, 0.666626
sum-squares-slot, 308, 12, 171, 1, 0, 492, 0.666626
sum-squares-slot, 317, 12, 171, 1, 0, 501, 0.666626
sum-squares-slot, 299, 12, 170, 1, 0, 482, 0.666626
sum-squares-slot, 300, 12, 160, 1, 0, 473, 0.666626
sum-squares-slot, 316, 12, 172, 1, 0, 501, 0.666626
sum-squares-slot, 320, 12, 170, 1, 0, 503, 0.666626
sum-squares-slot, 302, 12, 171, 1, 0, 486, 0.666626
sum-squares-slot, 304, 13, 163, 1, 0, 481, 0.666626
sum-squares-slot, 299, 12, 164, 1, 0, 476, 0.666626
sum-squares-slot, 314, 12, 167, 1, 0, 494, 0.666626
sum-squares-slot, 302, 12, 166, 1, 0, 481, 0.666626
sum-squares-slot, 297, 12, 166, 1, 0, 476, 0.666626
sum-squares-slot, 311, 12, 173, 1, 0, 497, 0.666626
sum-squares-slot, 303, 12, 167, 1, 0, 483, 0.666626
sum-squares-slot, 295, 12, 170, 1, 0, 478, 0.666626
sum-squares-slot, 309, 12, 165, 1, 0, 487, 0.666626
sum-squares-slot, 305, 12, 166, 1, 0, 484, 0.666626
sum-squares-slot, 311, 12, 163, 1, 0, 487, 0.666626
sum-squares-slot, 301, 12, 165, 1, 0, 479, 0.666626
sum-squares-slot, 310, 12, 167, 1, 0, 490, 0.666626
sum-squares-slot, 299, 12, 165, 1, 0, 477, 0.666626
sum-squares-slot, 304, 12, 172, 1, 0, 489, 0.666626
sum-squares-slot, 313, 12, 165, 1, 0, 491, 0.666626
sum-squares-slot, 310, 12, 164, 1, 0, 487, 0.666626
sum-squares-slot, 300, 15, 167, 1, 0, 483, 0.666626
sum-squares-slot, 297, 12, 171, 1, 0, 481, 0.666626
sum-squares-slot, 297, 12, 164, 1, 0, 474, 0.666626
sum-squares-slot, 301, 12, 165, 1, 0, 479, 0.666626
sum-squares-slot, 304, 12, 166, 1, 0, 483, 0.666626
sum-squares-slot, 303, 12, 169, 1, 0, 485, 0.666626
sum-squares-slot, 308, 12, 161, 1, 0, 482, 0.666626
sum-squares-slot, 293, 12, 158, 1, 0, 464, 0.666626
sum-squares-slot, 304, 12, 163, 1, 0, 480, 0.666626
sum-squares-slot, 303, 12, 165, 1, 0, 481, 0.666626
sum-squares-slot, 300, 12, 175, 1, 0, 488, 0.666626
sum-squares-slot, 304, 13, 166, 1, 0, 484, 0.666626
sum-squares-slot, 292, 12, 162, 1, 0, 467, 0.666626
sum-squares-slot, 298, 12, 162, 1, 0, 473, 0.666626
sum-squares-slot, 298, 12, 163, 1, 0, 474, 0.666626
sum-squares-slot, 298, 11, 161, 1, 0, 471, 0.666626
sum-squares-slot, 298, 12, 162, 1, 0, 473, 0.666626
sum-squares-slot, 303, 12, 164, 1, 0, 480, 0.666626
sum-squares-slot, 305, 12, 163, 1, 0, 481, 0.666626
sum-squares-slot, 295, 12, 165, 1, 0, 473, 0.666626
sum-squares-slot, 299, 12, 164, 1, 0, 476, 0.666626
sum-squares-slot, 305, 12, 166, 1, 0, 484, 0.666626
sum-squares-slot, 305, 12, 163, 1, 0, 481, 0.666626
sum-squares-slot, 299, 12, 169, 1, 0, 481, 0.666626
sum-squares-slot, 309, 12, 167, 1, 0, 489, 0.666626
sum-squares-slot, 303, 12, 163, 1, 0, 479, 0.666626
sum-squares-slot, 302, 12, 162, 1, 0, 477, 0.666626
sum-squares-slot, 293, 11, 166, 1, 0, 471, 0.666626
sum-squares-slot, 301, 12, 162, 1, 0, 476, 0.666626
sum-squares-slot, 300, 12, 165, 1, 0, 478, 0.666626
sum-squares-slot, 309, 12, 166, 1, 0, 488, 0.666626
sum-squares-slot, 296, 12, 164, 1, 0, 473, 0.666626
sum-squares-slot, 304, 12, 162, 1, 0, 479, 0.666626
sum-squares-slot, 301, 12, 165, 1, 0, 479, 0.666626
sum-squares-slot, 301, 11, 168, 1, 0, 481, 0.666626
sum-squares-slot, 309, 12, 163, 1, 0, 485, 0.666626
sum-squares-slot, 303, 12, 168, 1, 0, 484, 0.666626
sum-squares-slot, 297, 12, 166, 1, 0, 476, 0.666626
sum-squares-slot, 298, 12, 168, 1, 0, 479, 0.666626
sum-squares-slot, 302, 12, 162, 1, 0, 477, 0.666626
sum-squares-slot, 300, 12, 164, 1, 0, 477, 0.666626
sum-squares-slot, 305, 12, 163, 1, 0, 481, 0.666626
sum-squares-slot, 306, 14, 163, 1, 0, 484, 0.666626
sum-squares-slot, 310, 12, 163, 1, 0, 486, 0.666626
sum-squares-slot, 300, 12, 163, 1, 0, 476, 0.666626
sum-squares-slot, 306, 12, 166, 1, 0, 485, 0.666626
sum-squares-slot, 296, 12, 160, 1, 0, 469, 0.666626
sum-squares-slot, 309, 12, 162, 1, 0, 484, 0.666626
sum-squares-slot, 298, 12, 162, 1, 0, 473, 0.666626
sum-squares-slot, 299, 12, 165, 1, 0, 477, 0.666626
sum-squares-slot, 305, 12, 164, 1, 0, 482, 0.666626
sum-squares-slot, 308, 12, 169, 1, 0, 490, 0.666626
sum-squares-slot, 297, 13, 165, 1, 0, 476, 0.666626
sum-squares-slot, 292, 12, 162, 1, 0, 467, 0.666626
sum-squares-slot, 308, 12, 174, 1, 0, 495, 0.666626
sum-squares-slot, 307, 12, 166, 1, 0, 486, 0.666626
sum-squares-slot, 294, 12, 165, 1, 0, 472, 0.666626
sum-squares-slot, 302, 12, 167, 1, 0, 482, 0.666626
sum-squares-slot, 298, 12, 164, 1, 0, 475, 0.666626
sum-squares-slot, 297, 12, 165, 1, 0, 475, 0.666626
sum-squares-slot, 293, 12, 164, 1, 0, 470, 0.666626
sum-squares-slot, 301, 12, 168, 1, 0, 482, 0.666626
sum-squares-slot, 299, 12, 163, 1, 0, 475, 0.666626
sum-squares-slot, 296, 12, 168, 1, 0, 477, 0.666626
sum-squares-slot, 301, 15, 168, 1, 0, 485, 0.666626
sum-squares-slot, 298, 15, 173, 1, 0, 487, 0.666626
sum-squares-slot, 305, 12, 166, 1, 0, 484, 0.666626
sum-squares-slot, 294, 12, 170, 1, 0, 477, 0.666626
sum-squares-slot, 310, 12, 167, 1, 0, 490, 0.666626
sum-squares-slot, 296, 12, 163, 1, 0, 472, 0.666626
sum-squares-slot, 300, 12, 168, 1, 0, 481, 0.666626
sum-squares-slot, 303, 12, 169, 1, 0, 485, 0.666626
sum-squares-slot, 308, 12, 168, 1, 0, 489, 0.666626
sum-squares-slot, 302, 12, 164, 1, 0, 479, 0.666626
sum-squares-slot, 292, 12, 162, 1, 0, 467, 0.666626
sum-squares-slot, 297, 12, 163, 1, 0, 473, 0.666626
sum-squares-slot, 308, 12, 164, 1, 0, 485, 0.666626
sum-squares-slot, 302, 12, 164, 1, 0, 479, 0.666626
sum-squares-slot, 307, 12, 167, 1, 0, 487, 0.666626
sum-squares-slot, 299, 12, 166, 1, 0, 478, 0.666626
sum-squares-slot, 309, 12, 166, 1, 0, 488, 0.666626
sum-squares-slot, 303, 12, 170, 1, 0, 486, 0.666626
sum-squares-slot, 297, 12, 166, 1, 0, 476, 0.666626
sum-squares-slot, 296, 12, 160, 1, 0, 469, 0.666626
sum-squares-slot, 314, 12, 164, 1, 0, 491, 0.666626
sum-squares-slot, 310, 12, 165, 1, 0, 488, 0.666626
sum-squares-slot, 304, 12, 165, 1, 0, 482, 0.666626
sum-squares-slot, 295, 12, 159, 1, 0, 467, 0.666626
sum-squares-slot, 300, 12, 168, 1, 0, 481, 0.666626
sum-squares-slot, 300, 12, 163, 1, 0, 476, 0.666626
sum-squares-slot, 295, 14, 161, 1, 0, 471, 0.666626
sum-squares-slot, 299, 12, 164, 1, 0, 476, 0.666626
sum-squares-slot, 307, 12, 166, 1, 0, 486, 0.666626
sum-squares-slot, 299, 12, 165, 1, 0, 477, 0.666626
sum-squares-slot, 300, 14, 162, 1, 0, 477, 0.666626
sum-squares-slot, 305, 12, 163, 1, 0, 481, 0.666626
sum-squares-slot, 294, 12, 162, 1, 0, 469, 0.666626
sum-squares-slot, 297, 12, 163, 1, 0, 473, 0.666626
sum-squares-slot, 297, 12, 162, 1, 0, 472, 0.666626
sum-squares-slot, 301, 12, 170, 1, 0, 484, 0.666626
sum-squares-slot, 300, 12, 165, 1, 0, 478, 0.666626
sum-squares-slot, 297, 12, 164, 1, 0, 474, 0.666626
sum-squares-slot, 309, 12, 198, 1, 0, 520, 0.666626
sum-squares-slot, 297, 12, 165, 1, 0, 475, 0.666626
sum-squares-slot, 301, 12, 162, 1, 0, 476, 0.666626
sum-squares-slot, 307, 12, 166, 1, 0, 486, 0.666626
sum-squares-slot, 306, 12, 164, 1, 0, 483, 0.666626
sum-squares-slot, 302, 12, 162, 1, 0, 477, 0.666626
sum-squares-slot, 306, 12, 161, 1, 0, 480, 0.666626
sum-squares-slot, 298, 12, 162, 1, 0, 473, 0.666626
sum-squares-slot, 298, 12, 162, 1, 0, 473, 0.666626
sum-squares-slot, 308, 12, 165, 1, 0, 486, 0.666626
sum-squares-slot, 300, 12, 165, 1, 0, 478, 0.666626
sum-squares-slot, 304, 12, 164, 1, 0, 481, 0.666626
sum-squares-slot, 302, 12, 162, 1, 0, 477, 0.666626
sum-squares-slot, 299, 12, 168, 1, 0, 480, 0.666626
sum-squares-slot, 307, 12, 166, 1, 0, 486, 0.666626
sum-squares-slot, 307, 12, 166, 1, 0, 486, 0.666626
sum-squares-slot, 310, 12, 165, 1, 0, 488, 0.666626
sum-squares-slot, 295, 12, 163, 1, 0, 471, 0.666626
sum-squares-slot, 303, 12, 163, 1, 0, 479, 0.666626
sum-squares-slot, 312, 12, 168, 1, 0, 493, 0.666626
sum-squares-slot, 300, 12, 165, 1, 0, 478, 0.666626
sum-squares-slot, 301, 12, 161, 1, 0, 475, 0.666626
sum-squares-slot, 309, 12, 161, 1, 0, 483, 0.666626
sum-squares-slot, 304, 12, 165, 1, 0, 482, 0.666626
sum-squares-slot, 305, 12, 168, 1, 0, 486, 0.666626
sum-squares-slot, 298, 12, 175, 1, 0, 486, 0.666626
sum-squares-slot, 299, 12, 172, 1, 0, 484, 0.666626
sum-squares-slot, 295, 12, 165, 1, 0, 473, 0.666626
sum-squares-slot, 310, 12, 164, 1, 0, 487, 0.666626
sum-squares-slot, 308, 12, 167, 1, 0, 488, 0.666626
sum-squares-slot, 293, 11, 163, 1, 0, 468, 0.666626
sum-squares-slot, 313, 12, 178, 1, 0, 504, 0.666626
sum-squares-slot, 313, 12, 161, 1, 0, 487, 0.666626
sum-squares-slot, 298, 12, 160, 1, 0, 471, 0.666626
sum-squares-slot, 297, 12, 170, 1, 0, 480, 0.666626
sum-squares-slot, 307, 12, 165, 1, 0, 485, 0.666626
sum-squares-slot, 303, 13, 166, 1, 0, 483, 0.666626
sum-squares-slot, 294, 12, 165, 1, 0, 472, 0.666626
sum-squares-slot, 294, 12, 169, 1, 0, 476, 0.666626
sum-squares-slot, 299, 12, 163, 1, 0, 475, 0.666626
sum-squares-slot, 306, 12, 164, 1, 0, 483, 0.666626
sum-squares-slot, 294, 12, 168, 1, 0, 475, 0.666626
sum-squares-slot, 294, 12, 165, 1, 0, 472, 0.666626
sum-squares-slot, 312, 12, 168, 1, 0, 493, 0.666626
sum-squares-slot, 297, 12, 162, 1, 0, 472, 0.666626
sum-squares-slot, 306, 12, 166, 1, 0, 485, 0.666626
sum-squares-slot, 302, 12, 163, 1, 0, 478, 0.666626
sum-squares-slot, 296, 12, 160, 1, 0, 469, 0.666626
sum-squares-slot, 295, 12, 165, 1, 0, 473, 0.666626
sum-squares-slot, 309, 12, 163, 1, 0, 485, 0.666626
sum-squares-slot, 295, 12, 162, 1, 0, 470, 0.666626
sum-squares-slot, 298, 14, 160, 1, 0, 473, 0.666626
sum-squares-slot, 298, 12, 164, 1, 0, 475, 0.666626
sum-squares-slot, 312, 12, 157, 1, 0, 482, 0.666626
sum-squares-slot, 297, 12, 165, 1, 0, 475, 0.666626
sum-squares-slot, 304, 12, 162, 1, 0, 479, 0.666626
sum-squares-slot, 293, 12, 158, 1, 0, 464, 0.666626
sum-squares-slot, 305, 12, 159, 1, 0, 477, 0.666626
sum-squares-slot, 293, 16, 166, 1, 0, 476, 0.666626
sum-squares-slot, 294, 12, 172, 1, 0, 479, 0.666626
sum-squares-slot, 294, 12, 172, 1, 0, 479, 0.666626
sum-squares-slot, 299, 12, 164, 1, 0, 476, 0.666626
sum-squares-slot, 316, 12, 164, 1, 0, 493, 0.666626
sum-squares-slot, 306, 12, 169, 1, 0, 488, 0.666626
sum-squares-slot, 302, 12, 163, 1, 0, 478, 0.666626
sum-squares-slot, 296, 12, 166, 1, 0, 475, 0.666626
sum-squares-slot, 296, 12, 165, 1, 0, 474, 0.666626
sum-squares-slot, 300, 12, 163, 1, 0, 476, 0.666626
sum-squares-slot, 302, 12, 156, 1, 0, 471, 0.666626
sum-squares-slot, 297, 12, 163, 1, 0, 473, 0.666626
sum-squares-slot, 306, 12, 165, 1, 0, 484, 0.666626
sum-squares-slot, 309, 12, 165, 1, 0, 487, 0.666626
sum-squares-slot, 303, 12, 163, 1, 0, 479, 0.666626
sum-squares-slot, 294, 12, 165, 1, 0, 472, 0.666626
sum-squares-slot, 300, 12, 169, 1, 0, 482, 0.666626
sum-squares-slot, 298, 12, 166, 1, 0, 477, 0.666626
sum-squares-slot, 317, 12, 163, 1, 0, 493, 0.666626
sum-squares-slot, 302, 12, 165, 1, 0, 480, 0.666626
sum-squares-slot, 297, 12, 165, 1, 0, 475, 0.666626
sum-squares-slot, 305, 14, 160, 1, 0, 480, 0.666626
sum-squares-slot, 307, 12, 163, 1, 0, 483, 0.666626
sum-squares-slot, 304, 12, 170, 1, 0, 487, 0.666626
sum-squares-slot, 297, 12, 172, 1, 0, 482, 0.666626
sum-squares-slot, 297, 12, 158, 1, 0, 468, 0.666626
sum-squares-slot, 306, 12, 164, 1, 0, 483, 0.666626
sum-squares-slot, 300, 12, 162, 1, 0, 475, 0.666626
sum-squares-slot, 302, 12, 165, 1, 0, 480, 0.666626
sum-squares-slot, 293, 12, 161, 1, 0, 467, 0.666626
sum-squares-slot, 305, 16, 163, 1, 0, 485, 0.666626
sum-squares-slot, 302, 12, 162, 1, 0, 477, 0.666626
sum-squares-slot, 296, 12, 160, 1, 0, 469, 0.666626
sum-squares-slot, 305, 12, 166, 1, 0, 484, 0.666626
sum-squares-slot, 300, 12, 174, 1, 0, 487, 0.666626
sum-squares-slot, 303, 12, 166, 1, 0, 482, 0.666626
sum-squares-slot, 296, 12, 162, 1, 0, 471, 0.666626
sum-squares-slot, 296, 12, 159, 1, 0, 468, 0.666626
sum-squares-slot, 296, 12, 168, 1, 0, 477, 0.666626
sum-squares-slot, 302, 13, 163, 1, 0, 479, 0.666626
sum-squares-slot, 297, 12, 161, 1, 0, 471, 0.666626
sum-squares-slot, 295, 12, 161, 1, 0, 469, 0.666626
sum-squares-slot, 307, 12, 165, 1, 0, 485, 0.666626
sum-squares-slot, 318, 12, 165, 1, 0, 496, 0.666626
sum-squares-slot, 300, 12, 169, 1, 0, 482, 0.666626
sum-squares-slot, 301, 12, 160, 1, 0, 474, 0.666626
sum-squares-slot, 295, 12, 160, 1, 0, 468, 0.666626
sum-squares-slot, 297, 12, 165, 1, 0, 475, 0.666626
sum-squares-slot, 302, 12, 166, 1, 0, 481, 0.666626
sum-squares-slot, 299, 12, 161, 1, 0, 473, 0.666626
sum-squares-slot, 298, 12, 162, 1, 0, 473, 0.666626
sum-squares-slot, 305, 12, 163, 1, 0, 481, 0.666626
sum-squares-slot, 299, 12, 160, 1, 0, 472, 0.666626
sum-squares-slot, 297, 12, 160, 1, 0, 470, 0.666626
sum-squares-slot, 303, 12, 159, 1, 0, 475, 0.666626
sum-squares-slot, 300, 12, 168, 1, 0, 481, 0.666626
sum-squares-slot, 309, 12, 167, 1, 0, 489, 0.666626
sum-squares-slot, 298, 12, 162, 1, 0, 473, 0.666626
sum-squares-slot, 296, 12, 165, 1, 0, 474, 0.666626
sum-squares-slot, 299, 12, 172, 1, 0, 484, 0.666626
sum-squares-slot, 295, 12, 169, 1, 0, 477, 0.666626
sum-squares-slot, 302, 12, 161, 1, 0, 476, 0.666626
sum-squares-slot, 296, 12, 169, 1, 0, 478, 0.666626
sum-squares-slot, 297, 12, 161, 1, 0, 471, 0.666626
sum-squares-slot, 300, 12, 159, 1, 0, 472, 0.666626
sum-squares-slot, 306, 12, 176, 1, 0, 495, 0.666626
sum-squares-slot, 300, 12, 172, 1, 0, 485, 0.666626
sum-squares-slot, 294, 12, 163, 1, 0, 470, 0.666626
sum-squares-slot, 306, 12, 164, 1, 0, 483, 0.666626
sum-squares-slot, 301, 13, 160, 1, 0, 475, 0.666626
sum-squares-slot, 295, 12, 160, 1, 0, 468, 0.666626
sum-squares-slot, 296, 12, 157, 1, 0, 466, 0.666626
sum-squares-slot, 298, 12, 163, 1, 0, 474, 0.666626
sum-squares-slot, 296, 12, 166, 1, 0, 475, 0.666626
sum-squares-slot, 310, 12, 165, 1, 0, 488, 0.666626
sum-squares-slot, 311, 12, 165, 1, 0, 489, 0.666626
sum-squares-slot, 302, 12, 163, 1, 0, 478, 0.666626
sum-squares-slot, 293, 12, 161, 1, 0, 467, 0.666626
sum-squares-slot, 296, 14, 168, 1, 0, 479, 0.666626
sum-squares-slot, 301, 12, 164, 1, 0, 478, 0.666626
sum-squares-slot, 302, 12, 160, 1, 0, 475, 0.666626
sum-squares-slot, 300, 12, 158, 1, 0, 471, 0.666626
sum-squares-slot, 292, 12, 163, 1, 0, 468, 0.666626
sum-squares-slot, 301, 13, 162, 1, 0, 477, 0.666626
sum-squares-slot, 312, 12, 161, 1, 0, 486, 0.666626
sum-squares-slot, 295, 12, 162, 1, 0, 470, 0.666626
sum-squares-slot, 300, 12, 167, 1, 0, 480, 0.666626
sum-squares-slot, 301, 12, 166, 1, 0, 480, 0.666626
sum-squares-slot, 294, 12, 160, 1, 0, 467, 0.666626
sum-squares-slot, 295, 12, 160, 1, 0, 468, 0.666626
sum-squares-slot, 298, 12, 164, 1, 0, 475, 0.666626
sum-squares-slot, 291, 12, 161, 1, 0, 465, 0.666626
sum-squares-slot, 298, 12, 164, 1, 0, 475, 0.666626
sum-squares-slot, 307, 12, 163, 1, 0, 483, 0.666626
sum-squares-slot, 310, 12, 165, 1, 0, 488, 0.666626
sum-squares-slot, 294, 12, 159, 1, 0, 466, 0.666626
sum-squares-slot, 300, 12, 170, 1, 0, 483, 0.666626
sum-squares-slot, 304, 12, 167, 1, 0, 484, 0.666626
inner-product-slot, 299, 12, 179, 1, 0, 491, 0.666626
inner-product-slot, 299, 12, 181, 1, 0, 493, 0.666626
inner-product-slot, 301, 12, 178, 1, 0, 492, 0.666626
inner-product-slot, 296, 12, 178, 1, 0, 487, 0.666626
inner-product-slot, 298, 12, 182, 1, 0, 493, 0.666626
inner-product-slot, 299, 12, 182, 1, 0, 494, 0.666626
inner-product-slot, 318, 11, 182, 1, 0, 512, 0.666626
inner-product-slot, 316, 12, 184, 1, 0, 513, 0.666626
inner-product-slot, 302, 12, 183, 1, 0, 498, 0.666626
inner-product-slot, 301, 12, 179, 1, 0, 493, 0.666626
inner-product-slot, 303, 12, 184, 1, 0, 500, 0.666626
inner-product-slot, 301, 12, 180, 1, 0, 494, 0.666626
inner-product-slot, 312, 12, 190, 1, 0, 515, 0.666626
inner-product-slot, 304, 12, 187, 1, 0, 504, 0.666626
inner-product-slot, 358, 16, 208, 1, 0, 583, 0.666626
inner-product-slot, 328, 11, 211, 1, 0, 551, 0.666626
inner-product-slot, 341, 16, 205, 1, 0, 563, 0.666626
inner-product-slot, 299, 12, 179, 1, 0, 491, 0.666626
inner-product-slot, 300, 12, 184, 1, 0, 497, 0.666626
inner-product-slot, 302, 12, 180, 1, 0, 495, 0.666626
inner-product-slot, 304, 12, 188, 1, 0, 505, 0.666626
inner-product-slot, 328, 12, 202, 1, 0, 543, 0.666626
inner-product-slot, 328, 12, 206, 1, 0, 547, 0.666626
inner-product-slot, 312, 12, 180, 1, 0, 505, 0.666626
inner-product-slot, 292, 12, 179, 1, 0, 484, 0.666626
inner-product-slot, 302, 12, 182, 1, 0, 497, 0.666626
inner-product-slot, 309, 12, 188, 1, 0, 510, 0.666626
inner-product-slot, 302, 12, 191, 1, 0, 506, 0.666626
inner-product-slot, 305, 12, 179, 1, 0, 497, 0.666626
inner-product-slot, 295, 12, 181, 1, 0, 489, 0.666626
inner-product-slot, 300, 12, 190, 1, 0, 503, 0.666626
inner-product-slot, 305, 12, 183, 1, 0, 501, 0.666626
inner-product-slot, 298, 12, 183, 1, 0, 494, 0.666626
inner-product-slot, 304, 13, 183, 1, 0, 501, 0.666626
inner-product-slot, 298, 12, 190, 1, 0, 501, 0.666626
inner-product-slot, 306, 12, 184, 1, 0, 503, 0.666626
inner-product-slot, 295, 12, 179, 1, 0, 487, 0.666626
inner-product-slot, 304, 12, 185, 1, 0, 502, 0.666626
inner-product-slot, 310, 12, 176, 1, 0, 499, 0.666626
inner-product-slot, 302, 12, 184, 1, 0, 499, 0.666626
inner-product-slot, 314, 12, 190, 1, 0, 517, 0.666626
inner-product-slot, 310, 12, 183, 1, 0, 506, 0.666626
inner-product-slot, 293, 12, 184, 1, 0, 490, 0.666626
inner-product-slot, 296, 12, 181, 1, 0, 490, 0.666626
inner-product-slot, 295, 12, 181, 1, 0, 489, 0.666626
inner-product-slot, 304, 12, 180, 1, 0, 497, 0.666626
inner-product-slot, 302, 12, 184, 1, 0, 499, 0.666626
inner-product-slot, 302, 12, 186, 1, 0, 501, 0.666626
inner-product-slot, 295, 12, 178, 1, 0, 486, 0.666626
inner-product-slot, 303, 12, 183, 1, 0, 499, 0.666626
inner-product-slot, 307, 12, 182, 1, 0, 502, 0.666626
inner-product-slot, 300, 12, 182, 1, 0, 495, 0.666626
inner-product-slot, 293, 12, 183, 1, 0, 489, 0.666626
inner-product-slot, 301, 12, 185, 1, 0, 499, 0.666626
inner-product-slot, 295, 12, 177, 1, 0, 485, 0.666626
inner-product-slot, 296, 12, 189, 1, 0, 498, 0.666626
inner-product-slot, 306, 12, 186, 1, 0, 505, 0.666626
inner-product-slot, 301, 12, 183, 1, 0, 497, 0.666626
inner-product-slot, 305, 12, 182, 1, 0, 500, 0.666626
inner-product-slot, 304, 12, 185, 1, 0, 502, 0.666626
inner-product-slot, 300, 12, 182, 1, 0, 495, 0.666626
inner-product-slot, 293, 12, 183, 1, 0, 489, 0.666626
inner-product-slot, 293, 12, 181, 1, 0, 487, 0.666626
inner-product-slot, 303, 12, 179, 1, 0, 495, 0.666626
inner-product-slot, 302, 12, 187, 1, 0, 502, 0.666626
inner-product-slot, 295, 12, 198, 1, 0, 506, 0.666626
inner-product-slot, 309, 12, 189, 1, 0, 511, 0.666626
inner-product-slot, 303, 14, 180, 1, 0, 498, 0.666626
inner-product-slot, 295, 12, 182, 1, 0, 490, 0.666626
inner-product-slot, 302, 12, 184, 1, 0, 499, 0.666626
inner-product-slot, 303, 12, 184, 1, 0, 500, 0.666626
inner-product-slot, 307, 12, 185, 1, 0, 505, 0.666626
inner-product-slot, 294, 12, 186, 1, 0, 493, 0.666626
inner-product-slot, 301, 12, 184, 1, 0, 498, 0.666626
inner-product-slot, 293, 11, 178, 1, 0, 483, 0.666626
inner-product-slot, 308, 12, 183, 1, 0, 504, 0.666626
inner-product-slot, 294, 12, 183, 1, 0, 490, 0.666626
inner-product-slot, 300, 12, 183, 1, 0, 496, 0.666626
inner-product-slot, 295, 12, 177, 1, 0, 485, 0.666626
inner-product-slot, 304, 12, 181, 1, 0, 498, 0.666626
inner-product-slot, 301, 12, 182, 1, 0, 496, 0.666626
inner-product-slot, 302, 12, 181, 1, 0, 496, 0.666626
inner-product-slot, 299, 12, 181, 1, 0, 493, 0.666626
inner-product-slot, 302, 12, 180, 1, 0, 495, 0.666626
inner-product-slot, 308, 12, 182, 1, 0, 503, 0.666626
inner-product-slot, 301, 12, 184, 1, 0, 498, 0.666626
inner-product-slot, 297, 13, 189, 1, 0, 500, 0.666626
inner-product-slot, 307, 12, 191, 1, 0, 511, 0.666626
inner-product-slot, 302, 12, 185, 1, 0, 500, 0.666626
inner-product-slot, 300, 12, 181, 1, 0, 494, 0.666626
inner-product-slot, 292, 12, 177, 1, 0, 482, 0.666626
inner-product-slot, 302, 12, 183, 1, 0, 498, 0.666626
inner-product-slot, 293, 12, 182, 1, 0, 488, 0.666626
inner-product-slot, 294, 12, 176, 1, 0, 483, 0.666626
inner-product-slot, 302, 12, 182, 1, 0, 497, 0.666626
inner-product-slot, 299, 12, 182, 1, 0, 494, 0.666626
inner-product-slot, 303, 12, 185, 1, 0, 501, 0.666626
inner-product-slot, 305, 12, 183, 1, 0, 501, 0.666626
inner-product-slot, 294, 12, 184, 1, 0, 491, 0.666626
inner-product-slot, 295, 12, 177, 1, 0, 485, 0.666626
inner-product-slot, 328, 12, 212, 1, 0, 553, 0.666626
inner-product-slot, 355, 15, 183, 1, 0, 554, 0.666626
inner-product-slot, 310, 12, 181, 1, 0, 504, 0.666626
inner-product-slot, 297, 12, 182, 1, 0, 492, 0.666626
inner-product-slot, 306, 12, 201, 1, 0, 520, 0.666626
inner-product-slot, 314, 12, 211, 1, 0, 538, 0.666626
inner-product-slot, 362, 13, 213, 1, 0, 589, 0.666626
inner-product-slot, 312, 17, 207, 1, 0, 537, 0.666626
inner-product-slot, 298, 12, 177, 1, 0, 488, 0.666626
inner-product-slot, 296, 12, 181, 1, 0, 490, 0.666626
inner-product-slot, 292, 12, 186, 1, 0, 491, 0.666626
inner-product-slot, 295, 12, 179, 1, 0, 487, 0.666626
inner-product-slot, 320, 12, 207, 1, 0, 540, 0.666626
inner-product-slot, 319, 12, 179, 1, 0, 511, 0.666626
inner-product-slot, 305, 12, 187, 1, 0, 505, 0.666626
inner-product-slot, 297, 12, 183, 1, 0, 493, 0.666626
inner-product-slot, 301, 12, 182, 1, 0, 496, 0.666626
inner-product-slot, 314, 12, 181, 1, 0, 508, 0.666626
inner-product-slot, 296, 12, 194, 1, 0, 503, 0.666626
inner-product-slot, 300, 12, 182, 1, 0, 495, 0.666626
inner-product-slot, 295, 12, 183, 1, 0, 491, 0.666626
inner-product-slot, 307, 12, 181, 1, 0, 501, 0.666626
inner-product-slot, 299, 12, 184, 1, 0, 496, 0.666626
inner-product-slot, 303, 12, 183, 1, 0, 499, 0.666626
inner-product-slot, 297, 12, 184, 1, 0, 494, 0.666626
inner-product-slot, 307, 12, 185, 1, 0, 505, 0.666626
inner-product-slot, 296, 12, 180, 1, 0, 489, 0.666626
inner-product-slot, 299, 12, 186, 1, 0, 498, 0.666626
inner-product-slot, 300, 12, 184, 1, 0, 497, 0.666626
inner-product-slot, 300, 12, 189, 1, 0, 502, 0.666626
inner-product-slot, 294, 12, 183, 1, 0, 490, 0.666626
inner-product-slot, 299, 12, 182, 1, 0, 494, 0.666626
inner-product-slot, 295, 12, 179, 1, 0, 487, 0.666626
inner-product-slot, 300, 12, 182, 1, 0, 495, 0.666626
inner-product-slot, 321, 12, 188, 1, 0, 522, 0.666626
inner-product-slot, 304, 12, 181, 1, 0, 498, 0.666626
inner-product-slot, 293, 12, 180, 1, 0, 486, 0.666626
inner-product-slot, 310, 12, 180, 1, 0, 503, 0.666626
inner-product-slot, 300, 12, 185, 1, 0, 498, 0.666626
inner-product-slot, 306, 12, 182, 1, 0, 501, 0.666626
inner-product-slot, 295, 12, 179, 1, 0, 487, 0.666626
inner-product-slot, 306, 12, 183, 1, 0, 502, 0.666626
inner-product-slot, 301, 12, 185, 1, 0, 499, 0.666626
inner-product-slot, 300, 12, 183, 1, 0, 496, 0.666626
inner-product-slot, 312, 12, 182, 1, 0, 507, 0.666626
inner-product-slot, 326, 17, 192, 1, 0, 536, 0.666626
inner-product-slot, 298, 12, 179, 1, 0, 490, 0.666626
inner-product-slot, 294, 12, 182, 1, 0, 489, 0.666626
inner-product-slot, 303, 12, 180, 1, 0, 496, 0.666626
inner-product-slot, 300, 12, 203, 1, 0, 516, 0.666626
inner-product-slot, 317, 13, 200, 1, 0, 531, 0.666626
inner-product-slot, 333, 12, 177, 1, 0, 523, 0.666626
inner-product-slot, 302, 12, 182, 1, 0, 497, 0.666626
inner-product-slot, 319, 12, 181, 1, 0, 513, 0.666626
inner-product-slot, 296, 12, 186, 1, 0, 495, 0.666626
inner-product-slot, 304, 12, 179, 1, 0, 496, 0.666626
inner-product-slot, 299, 12, 184, 1, 0, 496, 0.666626
inner-product-slot, 312, 12, 185, 1, 0, 510, 0.666626
inner-product-slot, 305, 12, 184, 1, 0, 502, 0.666626
inner-product-slot, 302, 12, 181, 1, 0, 496, 0.666626
inner-product-slot, 302, 12, 180, 1, 0, 495, 0.666626
inner-product-slot, 308, 12, 181, 1, 0, 502, 0.666626
inner-product-slot, 299, 12, 184, 1, 0, 496, 0.666626
inner-product-slot, 295, 12, 179, 1, 0, 487, 0.666626
inner-product-slot, 307, 12, 181, 1, 0, 501, 0.666626
inner-product-slot, 298, 12, 183, 1, 0, 494, 0.666626
inner-product-slot, 302, 12, 185, 1, 0, 500, 0.666626
inner-product-slot, 306, 12, 183, 1, 0, 502, 0.666626
inner-product-slot, 293, 12, 179, 1, 0, 485, 0.666626
inner-product-slot, 302, 12, 181, 1, 0, 496, 0.666626
inner-product-slot, 299, 12, 182, 1, 0, 494, 0.666626
inner-product-slot, 302, 12, 178, 1, 0, 493, 0.666626
inner-product-slot, 298, 12, 178, 1, 0, 489, 0.666626
inner-product-slot, 298, 12, 189, 1, 0, 500, 0.666626
inner-product-slot, 293, 12, 179, 1, 0, 485, 0.666626
inner-product-slot, 310, 12, 180, 1, 0, 503, 0.666626
inner-product-slot, 296, 12, 181, 1, 0, 490, 0.666626
inner-product-slot, 303, 12, 183, 1, 0, 499, 0.666626
inner-product-slot, 304, 12, 183, 1, 0, 500, 0.666626
inner-product-slot, 310, 12, 182, 1, 0, 505, 0.666626
inner-product-slot, 297, 12, 179, 1, 0, 489, 0.666626
inner-product-slot, 299, 12, 185, 1, 0, 497, 0.666626
inner-product-slot, 296, 12, 180, 1, 0, 489, 0.666626
inner-product-slot, 295, 12, 183, 1, 0, 491, 0.666626
inner-product-slot, 303, 12, 180, 1, 0, 496, 0.666626
inner-product-slot, 299, 12, 184, 1, 0, 496, 0.666626
inner-product-slot, 299, 12, 180, 1, 0, 492, 0.666626
inner-product-slot, 307, 12, 180, 1, 0, 500, 0.666626
inner-product-slot, 298, 12, 183, 1, 0, 494, 0.666626
inner-product-slot, 294, 12, 175, 1, 0, 482, 0.666626
inner-product-slot, 304, 12, 180, 1, 0, 497, 0.666626
inner-product-slot, 316, 12, 184, 1, 0, 513, 0.666626
inner-product-slot, 294, 12, 179, 1, 0, 486, 0.666626
inner-product-slot, 304, 12, 182, 1, 0, 499, 0.666626
inner-product-slot, 308, 12, 184, 1, 0, 505, 0.666626
inner-product-slot, 317, 12, 178, 1, 0, 508, 0.666626
inner-product-slot, 295, 12, 179, 1, 0, 487, 0.666626
inner-product-slot, 301, 14, 175, 1, 0, 491, 0.666626
inner-product-slot, 298, 12, 179, 1, 0, 490, 0.666626
inner-product-slot, 311, 12, 182, 1, 0, 506, 0.666626
inner-product-slot, 303, 12, 178, 1, 0, 494, 0.666626
inner-product-slot, 300, 12, 186, 1, 0, 499, 0.666626
inner-product-slot, 293, 12, 176, 1, 0, 482, 0.666626
inner-product-slot, 305, 12, 184, 1, 0, 502, 0.666626
inner-product-slot, 310, 13, 192, 1, 0, 516, 0.666626
inner-product-slot, 306, 13, 191, 1, 0, 511, 0.666626
inner-product-slot, 302, 12, 184, 1, 0, 499, 0.666626
inner-product-slot, 295, 12, 180, 1, 0, 488, 0.666626
inner-product-slot, 300, 12, 184, 1, 0, 497, 0.666626
inner-product-slot, 312, 12, 187, 1, 0, 512, 0.666626
inner-product-slot, 295, 12, 180, 1, 0, 488, 0.666626
inner-product-slot, 298, 12, 181, 1, 0, 492, 0.666626
inner-product-slot, 304, 12, 189, 1, 0, 506, 0.666626
inner-product-slot, 306, 12, 192, 1, 0, 511, 0.666626
inner-product-slot, 293, 12, 181, 1, 0, 487, 0.666626
inner-product-slot, 296, 12, 181, 1, 0, 490, 0.666626
inner-product-slot, 299, 12, 187, 1, 0, 499, 0.666626
inner-product-slot, 307, 12, 185, 1, 0, 505, 0.666626
inner-product-slot, 298, 12, 177, 1, 0, 488, 0.666626
inner-product-slot, 301, 12, 179, 1, 0, 493, 0.666626
inner-product-slot, 301, 12, 181, 1, 0, 495, 0.666626
inner-product-slot, 296, 12, 185, 1, 0, 494, 0.666626
inner-product-slot, 307, 12, 181, 1, 0, 501, 0.666626
inner-product-slot, 301, 12, 181, 1, 0, 495, 0.666626
inner-product-slot, 297, 12, 187, 1, 0, 497, 0.666626
inner-product-slot, 303, 12, 187, 1, 0, 503, 0.666626
inner-product-slot, 295, 12, 178, 1, 0, 486, 0.666626
inner-product-slot, 295, 12, 180, 1, 0, 488, 0.666626
inner-product-slot, 303, 12, 183, 1, 0, 499, 0.666626
inner-product-slot, 295, 12, 186, 1, 0, 494, 0.666626
inner-product-slot, 298, 12, 177, 1, 0, 488, 0.666626
inner-product-slot, 299, 12, 180, 1, 0, 492, 0.666626
inner-product-slot, 299, 12, 186, 1, 0, 498, 0.666626
inner-product-slot, 300, 12, 180, 1, 0, 493, 0.666626
inner-product-slot, 302, 12, 190, 1, 0, 505, 0.666626
inner-product-slot, 300, 12, 177, 1, 0, 490, 0.666626
inner-product-slot, 306, 12, 185, 1, 0, 504, 0.666626
inner-product-slot, 296, 12, 181, 1, 0, 490, 0.666626
inner-product-slot, 299, 12, 180, 1, 0, 492, 0.666626
inner-product-slot, 298, 12, 176, 1, 0, 487, 0.666626
inner-product-slot, 295, 12, 179, 1, 0, 487, 0.666626
inner-product-slot, 295, 12, 184, 1, 0, 492, 0.666626
inner-product-slot, 292, 12, 181, 1, 0, 486, 0.666626
inner-product-slot, 298, 12, 182, 1, 0, 493, 0.666626
inner-product-slot, 298, 12, 178, 1, 0, 489, 0.666626
inner-product-slot, 298, 12, 192, 1, 0, 503, 0.666626
inner-product-slot, 291, 19, 178, 1, 0, 489, 0.666626
inner-product-slot, 295, 12, 181, 1, 0, 489, 0.666626
inner-product-slot, 297, 12, 180, 1, 0, 490, 0.666626
inner-product-slot, 306, 12, 189, 1, 0, 508, 0.666626
inner-product-slot, 300, 12, 180, 1, 0, 493, 0.666626
inner-product-slot, 299, 11, 174, 1, 0, 485, 0.666626
inner-product-slot, 299, 12, 180, 1, 0, 492, 0.666626
inner-product-slot, 296, 12, 179, 1, 0, 488, 0.666626
inner-product-slot, 298, 12, 184, 1, 0, 495, 0.666626
inner-product-slot, 304, 12, 180, 1, 0, 497, 0.666626
inner-product-slot, 293, 12, 182, 1, 0, 488, 0.666626
inner-product-slot, 291, 12, 186, 1, 0, 490, 0.666626
inner-product-slot, 296, 12, 183, 1, 0, 492, 0.666626
inner-product-slot, 302, 12, 179, 1, 0, 494, 0.666626
inner-product-slot, 295, 12, 180, 1, 0, 488, 0.666626
inner-product-slot, 293, 12, 183, 1, 0, 489, 0.666626
inner-product-slot, 293, 12, 189, 1, 0, 495, 0.666626
inner-product-slot, 307, 12, 177, 1, 0, 497, 0.666626
inner-product-slot, 298, 12, 180, 1, 0, 491, 0.666626
inner-product-slot, 298, 12, 182, 1, 0, 493, 0.666626
inner-product-slot, 298, 12, 180, 1, 0, 491, 0.666626
inner-product-slot, 304, 12, 180, 1, 0, 497, 0.666626
inner-product-slot, 302, 12, 176, 1, 0, 491, 0.666626
inner-product-slot, 293, 12, 177, 1, 0, 483, 0.666626
inner-product-slot, 305, 12, 179, 1, 0, 497, 0.666626
inner-product-slot, 300, 12, 181, 1, 0, 494, 0.666626
inner-product-slot, 300, 12, 179, 1, 0, 492, 0.666626
inner-product-slot, 300, 12, 178, 1, 0, 491, 0.666626
inner-product-slot, 306, 12, 182, 1, 0, 501, 0.666626
inner-product-slot, 303, 13, 181, 1, 0, 498, 0.666626
inner-product-slot, 293, 12, 185, 1, 0, 491, 0.666626
inner-product-slot, 297, 12, 180, 1, 0, 490, 0.666626
inner-product-slot, 300, 12, 183, 1, 0, 496, 0.666626
inner-product-slot, 298, 12, 190, 1, 0, 501, 0.666626
inner-product-slot, 303, 12, 181, 1, 0, 497, 0.666626
inner-product-slot, 296, 11, 175, 1, 0, 483, 0.666626
inner-product-slot, 300, 12, 180, 1, 0, 493, 0.666626
inner-product-slot, 293, 12, 180, 1, 0, 486, 0.666626
inner-product-slot, 300, 12, 179, 1, 0, 492, 0.666626
inner-product-slot, 297, 12, 181, 1, 0, 491, 0.666626
inner-product-slot, 305, 12, 184, 1, 0, 502, 0.666626
inner-product-slot, 304, 12, 186, 1, 0, 503, 0.666626
inner-product-slot, 299, 12, 177, 1, 0, 489, 0.666626
inner-product-slot, 297, 12, 184, 1, 0, 494, 0.666626
inner-product-slot, 319, 12, 181, 1, 0, 513, 0.666626
inner-product-slot, 296, 12, 178, 1, 0, 487, 0.666626
inner-product-slot, 299, 12, 185, 1, 0, 497, 0.666626
inner-product-slot, 295, 12, 176, 1, 0, 484, 0.666626
inner-product-slot, 305, 12, 182, 1, 0, 500, 0.666626
inner-product-slot, 302, 12, 183, 1, 0, 498, 0.666626
inner-product-slot, 305, 12, 180, 1, 0, 498, 0.666626
inner-product-slot, 300, 12, 179, 1, 0, 492, 0.666626
inner-product-slot, 304, 12, 181, 1, 0, 498, 0.666626
inner-product-slot, 298, 12, 179, 1, 0, 490, 0.666626
inner-product-slot, 297, 12, 178, 1, 0, 488, 0.666626
inner-product-slot, 305, 16, 180, 1, 0, 502, 0.666626
inner-product-slot, 304, 12, 180, 1, 0, 497, 0.666626
inner-product-slot, 295, 12, 181, 1, 0, 489, 0.666626
inner-product-slot, 305, 12, 188, 1, 0, 506, 0.666626
inner-product-slot, 298, 12, 184, 1, 0, 495, 0.666626
inner-product-slot, 307, 12, 184, 1, 0, 504, 0.666626
inner-product-slot, 298, 12, 181, 1, 0, 492, 0.666626
inner-product-slot, 306, 14, 182, 1, 0, 503, 0.666626
inner-product-slot, 301, 12, 182, 1, 0, 496, 0.666626
inner-product-slot, 304, 12, 180, 1, 0, 497, 0.666626
inner-product-slot, 296, 12, 180, 1, 0, 489, 0.666626
inner-product-slot, 303, 12, 185, 1, 0, 501, 0.666626
inner-product-slot, 293, 12, 183, 1, 0, 489, 0.666626
inner-product-slot, 307, 12, 181, 1, 0, 501, 0.666626
inner-product-slot, 298, 12, 186, 1, 0, 497, 0.666626
inner-product-slot, 300, 12, 176, 1, 0, 489, 0.666626
inner-product-slot, 310, 12, 178, 1, 0, 501, 0.666626
inner-product-slot, 304, 12, 185, 1, 0, 502, 0.666626
inner-product-slot, 316, 12, 180, 1, 0, 509, 0.666626
inner-product-slot, 303, 12, 188, 1, 0, 504, 0.666626
inner-product-slot, 295, 12, 178, 1, 0, 486, 0.666626
inner-product-slot, 309, 12, 183, 1, 0, 505, 0.666626
inner-product-slot, 297, 12, 189, 1, 0, 499, 0.666626
inner-product-slot, 301, 12, 194, 1, 0, 508, 0.666626
inner-product-slot, 302, 12, 182, 1, 0, 497, 0.666626
inner-product-slot, 303, 12, 180, 1, 0, 496, 0.666626
inner-product-slot, 300, 12, 181, 1, 0, 494, 0.666626
inner-product-slot, 302, 12, 185, 1, 0, 500, 0.666626
inner-product-slot, 294, 12, 178, 1, 0, 485, 0.666626
inner-product-slot, 297, 12, 182, 1, 0, 492, 0.666626
inner-product-slot, 305, 12, 184, 1, 0, 502, 0.666626
inner-product-slot, 303, 12, 199, 1, 0, 515, 0.666626
inner-product-slot, 311, 12, 180, 1, 0, 504, 0.666626
inner-product-slot, 298, 12, 177, 1, 0, 488, 0.666626
inner-product-slot, 303, 12, 183, 1, 0, 499, 0.666626
inner-product-slot, 304, 12, 182, 1, 0, 499, 0.666626
inner-product-slot, 320, 16, 200, 1, 0, 537, 0.666626
inner-product-slot, 326, 12, 203, 1, 0, 542, 0.666626
inner-product-slot, 342, 12, 188, 1, 0, 543, 0.666626
inner-product-slot, 298, 12, 182, 1, 0, 493, 0.666626
inner-product-slot, 310, 12, 183, 1, 0, 506, 0.666626
inner-product-slot, 295, 12, 178, 1, 0, 486, 0.666626
inner-product-slot, 294, 12, 203, 1, 0, 510, 0.666626
inner-product-slot, 330, 12, 206, 1, 0, 549, 0.666626
inner-product-slot, 316, 12, 176, 1, 0, 505, 0.666626
inner-product-slot, 294, 12, 177, 1, 0, 484, 0.666626
inner-product-slot, 295, 12, 192, 1, 0, 500, 0.666626
inner-product-slot, 312, 12, 179, 1, 0, 504, 0.666626
inner-product-slot, 302, 11, 178, 1, 0, 492, 0.666626
inner-product-slot, 296, 12, 186, 1, 0, 495, 0.666626
inner-product-slot, 304, 12, 182, 1, 0, 499, 0.666626
inner-product-slot, 301, 12, 182, 1, 0, 496, 0.666626
inner-product-slot, 307, 12, 183, 1, 0, 503, 0.666626
inner-product-slot, 298, 12, 182, 1, 0, 493, 0.666626
inner-product-slot, 299, 12, 182, 1, 0, 494, 0.666626
inner-product-slot, 303, 12, 181, 1, 0, 497, 0.666626
inner-product-slot, 301, 12, 185, 1, 0, 499, 0.666626
inner-product-slot, 293, 12, 183, 1, 0, 489, 0.666626
inner-product-slot, 302, 12, 178, 1, 0, 493, 0.666626
inner-product-slot, 306, 12, 182, 1, 0, 501, 0.666626
inner-product-slot, 318, 12, 181, 1, 0, 512, 0.666626
inner-product-slot, 302, 12, 180, 1, 0, 495, 0.666626
inner-product-slot, 295, 12, 176, 1, 0, 484, 0.666626
inner-product-slot, 293, 12, 175, 1, 0, 481, 0.666626
inner-product-slot, 306, 12, 181, 1, 0, 500, 0.666626
inner-product-slot, 311, 12, 184, 1, 0, 508, 0.666626
inner-product-slot, 297, 12, 180, 1, 0, 490, 0.666626
inner-product-slot, 300, 12, 183, 1, 0, 496, 0.666626
inner-product-slot, 303, 12, 180, 1, 0, 496, 0.666626
inner-product-slot, 297, 12, 178, 1, 0, 488, 0.666626
inner-product-slot, 305, 12, 180, 1, 0, 498, 0.666626
inner-product-slot, 302, 12, 184, 1, 0, 499, 0.666626
inner-product-slot, 304, 12, 183, 1, 0, 500, 0.666626
inner-product-slot, 293, 12, 184, 1, 0, 490, 0.666626
inner-product-slot, 304, 12, 181, 1, 0, 498, 0.666626
inner-product-slot, 290, 12, 177, 1, 0, 480, 0.666626
inner-product-slot, 302, 12, 180, 1, 0, 495, 0.666626
inner-product-slot, 290, 12, 179, 1, 0, 482, 0.666626
inner-product-slot, 311, 12, 176, 1, 0, 500, 0.666626
inner-product-slot, 299, 12, 179, 1, 0, 491, 0.666626
inner-product-slot, 308, 12, 181, 1, 0, 502, 0.666626
inner-product-slot, 292, 12, 190, 1, 0, 495, 0.666626
inner-product-slot, 298, 12, 176, 1, 0, 487, 0.666626
inner-product-slot, 288, 11, 176, 1, 0, 476, 0.666626
inner-product-slot, 304, 12, 181, 1, 0, 498, 0.666626
inner-product-slot, 312, 12, 184, 1, 0, 509, 0.666626
inner-product-slot, 304, 12, 182, 1, 0, 499, 0.666626
inner-product-slot, 297, 12, 189, 1, 0, 499, 0.666626
inner-product-slot, 304, 12, 193, 1, 0, 510, 0.666626
inner-product-slot, 294, 12, 185, 1, 0, 492, 0.666626
inner-product-slot, 302, 12, 180, 1, 0, 495, 0.666626
inner-product-slot, 297, 12, 181, 1, 0, 491, 0.666626
inner-product-slot, 299, 12, 182, 1, 0, 494, 0.666626
inner-product-slot, 308, 12, 187, 1, 0, 508, 0.666626
inner-product-slot, 303, 12, 185, 1, 0, 501, 0.666626
inner-product-slot, 300, 12, 183, 1, 0, 496, 0.666626
inner-product-slot, 301, 12, 182, 1, 0, 496, 0.666626
inner-product-slot, 293, 12, 182, 1, 0, 488, 0.666626
inner-product-slot, 312, 12, 181, 1, 0, 506, 0.666626
inner-product-slot, 299, 12, 187, 1, 0, 499, 0.666626
inner-product-slot, 296, 12, 176, 1, 0, 485, 0.666626
inner-product-slot, 298, 12, 181, 1, 0, 492, 0.666626
inner-product-slot, 295, 12, 176, 1, 0, 484, 0.666626
inner-product-slot, 300, 12, 180, 1, 0, 493, 0.666626
inner-product-slot, 307, 12, 182, 1, 0, 502, 0.666626
inner-product-slot, 302, 12, 186, 1, 0, 501, 0.666626
inner-product-slot, 295, 12, 183, 1, 0, 491, 0.666626
inner-product-slot, 307, 12, 185, 1, 0, 505, 0.666626
inner-product-slot, 303, 16, 181, 1, 0, 501, 0.666626
inner-product-slot, 298, 12, 180, 1, 0, 491, 0.666626
inner-product-slot, 300, 12, 180, 1, 0, 493, 0.666626
inner-product-slot, 304, 12, 185, 1, 0, 502, 0.666626
inner-product-slot, 306, 12, 184, 1, 0, 503, 0.666626
inner-product-slot, 296, 12, 184, 1, 0, 493, 0.666626
inner-product-slot, 308, 12, 181, 1, 0, 502, 0.666626
inner-product-slot, 295, 12, 183, 1, 0, 491, 0.666626
inner-product-slot, 310, 12, 183, 1, 0, 506, 0.666626
inner-product-slot, 302, 12, 180, 1, 0, 495, 0.666626
inner-product-slot, 304, 12, 185, 1, 0, 502, 0.666626
inner-product-slot, 302, 12, 181, 1, 0, 496, 0.666626
inner-product-slot, 321, 12, 184, 1, 0, 518, 0.666626
inner-product-slot, 300, 12, 177, 1, 0, 490, 0.666626
inner-product-slot, 296, 12, 181, 1, 0, 490, 0.666626
inner-product-slot, 296, 12, 182, 1, 0, 491, 0.666626
inner-product-slot, 303, 12, 182, 1, 0, 498, 0.666626
inner-product-slot, 309, 12, 179, 1, 0, 501, 0.666626
inner-product-slot, 298, 12, 184, 1, 0, 495, 0.666626
inner-product-slot, 301, 12, 182, 1, 0, 496, 0.666626
inner-product-slot, 296, 12, 181, 1, 0, 490, 0.666626
inner-product-slot, 299, 12, 186, 1, 0, 498, 0.666626
inner-product-slot, 295, 12, 182, 1, 0, 490, 0.666626
inner-product-slot, 301, 12, 179, 1, 0, 493, 0.666626
inner-product-slot, 300, 12, 180, 1, 0, 493, 0.666626
inner-product-slot, 295, 12, 177, 1, 0, 485, 0.666626
inner-product-slot, 294, 12, 176, 1, 0, 483, 0.666626
inner-product-slot, 305, 12, 180, 1, 0, 498, 0.666626
inner-product-slot, 301, 12, 182, 1, 0, 496, 0.666626
inner-product-slot, 294, 12, 176, 1, 0, 483, 0.666626
inner-product-slot, 306, 12, 182, 1, 0, 501, 0.666626
inner-product-slot, 302, 12, 191, 1, 0, 506, 0.666626
inner-product-slot, 292, 12, 180, 1, 0, 485, 0.666626
inner-product-slot, 307, 12, 186, 1, 0, 506, 0.666626
inner-product-slot, 307, 12, 178, 1, 0, 498, 0.666626
inner-product-slot, 295, 20, 183, 1, 0, 499, 0.666626
inner-product-slot, 298, 12, 182, 1, 0, 493, 0.666626
inner-product-slot, 301, 12, 181, 1, 0, 495, 0.666626
inner-product-slot, 293, 12, 177, 1, 0, 483, 0.666626
inner-product-slot, 295, 12, 177, 1, 0, 485, 0.666626
inner-product-slot, 297, 12, 179, 1, 0, 489, 0.666626
inner-product-slot, 303, 12, 183, 1, 0, 499, 0.666626
inner-product-slot, 299, 13, 179, 1, 0, 492, 0.666626
inner-product-slot, 304, 12, 179, 1, 0, 496, 0.666626
inner-product-slot, 298, 12, 178, 1, 0, 489, 0.666626
inner-product-slot, 306, 12, 182, 1, 0, 501, 0.666626
inner-product-slot, 309, 12, 177, 1, 0, 499, 0.666626
inner-product-slot, 299, 14, 180, 1, 0, 494, 0.666626
inner-product-slot, 289, 12, 178, 1, 0, 480, 0.666626
inner-product-slot, 298, 12, 177, 1, 0, 488, 0.666626
inner-product-slot, 297, 12, 177, 1, 0, 487, 0.666626
inner-product-slot, 311, 12, 181, 1, 0, 505, 0.666626
inner-product-slot, 297, 12, 180, 1, 0, 490, 0.666626
inner-product-slot, 293, 12, 178, 1, 0, 484, 0.666626
inner-product-slot, 300, 11, 180, 1, 0, 492, 0.666626
inner-product-slot, 301, 12, 176, 1, 0, 490, 0.666626
inner-product-slot, 299, 12, 184, 1, 0, 496, 0.666626
inner-product-slot, 301, 12, 181, 1, 0, 495, 0.666626
inner-product-slot, 298, 12, 183, 1, 0, 494, 0.666626
inner-product-slot, 303, 12, 182, 1, 0, 498, 0.666626
inner-product-slot, 301, 12, 177, 1, 0, 491, 0.666626
inner-product-slot, 297, 12, 182, 1, 0, 492, 0.666626
inner-product-slot, 298, 12, 179, 1, 0, 490, 0.666626
inner-product-slot, 307, 12, 186, 1, 0, 506, 0.666626
inner-product-slot, 312, 12, 184, 1, 0, 509, 0.666626
inner-product-slot, 297, 12, 182, 1, 0, 492, 0.666626
inner-product-slot, 301, 12, 179, 1, 0, 493, 0.666626
inner-product-slot, 301, 12, 185, 1, 0, 499, 0.666626
inner-product-slot, 302, 12, 181, 1, 0, 496, 0.666626
inner-product-slot, 299, 12, 181, 1, 0, 493, 0.666626
inner-product-slot, 312, 12, 177, 1, 0, 502, 0.666626
inner-product-slot, 298, 12, 183, 1, 0, 494, 0.666626
inner-product-slot, 295, 12, 180, 1, 0, 488, 0.666626
inner-product-slot, 295, 12, 181, 1, 0, 489, 0.666626
inner-product-slot, 310, 12, 181, 1, 0, 504, 0.666626
inner-product-slot, 300, 12, 182, 1, 0, 495, 0.666626
inner-product-slot, 300, 12, 181, 1, 0, 494, 0.666626
inner-product-slot, 307, 12, 180, 1, 0, 500, 0.666626
inner-product-slot, 309, 12, 182, 1, 0, 504, 0.666626
inner-product-slot, 306, 13, 179, 1, 0, 499, 0.666626
inner-product-slot, 302, 12, 181, 1, 0, 496, 0.666626
inner-product-slot, 298, 12, 185, 1, 0, 496, 0.666626
inner-product-slot, 307, 12, 179, 1, 0, 499, 0.666626
inner-product-slot, 298, 12, 182, 1, 0, 493, 0.666626
inner-product-slot, 292, 12, 182, 1, 0, 487, 0.666626
inner-product-slot, 297, 12, 181, 1, 0, 491, 0.666626
inner-product-slot, 301, 12, 177, 1, 0, 491, 0.666626
inner-product-slot, 298, 12, 180, 1, 0, 491, 0.666626
inner-product-slot, 296, 12, 180, 1, 0, 489, 0.666626
inner-product-slot, 307, 12, 183, 1, 0, 503, 0.666626
inner-product-slot, 293, 11, 179, 1, 0, 484, 0.666626
inner-product-slot, 298, 12, 178, 1, 0, 489, 0.666626
inner-product-slot, 301, 12, 191, 1, 0, 505, 0.666626
inner-product-slot, 303, 12, 175, 1, 0, 491, 0.666626
inner-product-slot, 298, 12, 177, 1, 0, 488, 0.666626
inner-product-slot, 299, 12, 183, 1, 0, 495, 0.666626
inner-product-slot, 296, 12, 181, 1, 0, 490, 0.666626
inner-product-slot, 298, 12, 180, 1, 0, 491, 0.666626
inner-product-slot, 304, 16, 185, 1, 0, 506, 0.666626
inner-product-slot, 294, 12, 180, 1, 0, 487, 0.666626
inner-product-slot, 299, 12, 183, 1, 0, 495, 0.666626
inner-product-slot, 306, 12, 182, 1, 0, 501, 0.666626
inner-product-slot, 304, 12, 182, 1, 0, 499, 0.666626
inner-product-slot, 314, 12, 187, 1, 0, 514, 0.666626
inner-product-slot, 290, 12, 185, 1, 0, 488, 0.666626
inner-product-slot, 298, 12, 185, 1, 0, 496, 0.666626
inner-product-slot, 307, 12, 183, 1, 0, 503, 0.666626
inner-product-slot, 297, 12, 181, 1, 0, 491, 0.666626
inner-product-slot, 297, 12, 182, 1, 0, 492, 0.666626
inner-product-slot, 298, 12, 177, 1, 0, 488, 0.666626
inner-product-slot, 302, 12, 176, 1, 0, 491, 0.666626
inner-product-slot, 296, 12, 178, 1, 0, 487, 0.666626
inner-product-slot, 292, 11, 178, 1, 0, 482, 0.666626
inner-product-slot, 301, 12, 181, 1, 0, 495, 0.666626
inner-product-slot, 314, 11, 180, 1, 0, 506, 0.666626
inner-product-slot, 297, 12, 178, 1, 0, 488, 0.666626
inner-product-slot, 294, 12, 183, 1, 0, 490, 0.666626
inner-product-slot, 303, 12, 180, 1, 0, 496, 0.666626
inner-product-slot, 309, 12, 184, 1, 0, 506, 0.666626
inner-product-slot, 301, 12, 178, 1, 0, 492, 0.666626
inner-product-slot, 295, 12, 182, 1, 0, 490, 0.666626
inner-product-slot, 302, 12, 180, 1, 0, 495, 0.666626
inner-product-slot, 309, 12, 192, 1, 0, 514, 0.666626
inner-product-slot, 303, 12, 182, 1, 0, 498, 0.666626
inner-product-slot, 297, 12, 176, 1, 0, 486, 0.666626
inner-product-slot, 298, 12, 178, 1, 0, 489, 0.666626
inner-product-slot, 298, 12, 178, 1, 0, 489, 0.666626
inner-product-slot, 291, 12, 180, 1, 0, 484, 0.666626
inner-product-slot, 309, 12, 177, 1, 0, 499, 0.666626
inner-product-slot, 304, 12, 181, 1, 0, 498, 0.666626
inner-product-slot, 300, 12, 179, 1, 0, 492, 0.666626
inner-product-slot, 295, 12, 178, 1, 0, 486, 0.666626
inner-product-slot, 308, 12, 185, 1, 0, 506, 0.666626
inner-product-slot, 308, 12, 176, 1, 0, 497, 0.666626
inner-product-slot, 300, 12, 179, 1, 0, 492, 0.666626
inner-product-slot, 295, 12, 181, 1, 0, 489, 0.666626
inner-product-slot, 302, 12, 181, 1, 0, 496, 0.666626
inner-product-slot, 293, 12, 184, 1, 0, 490, 0.666626
inner-product-slot, 309, 12, 179, 1, 0, 501, 0.666626
inner-product-slot, 294, 12, 178, 1, 0, 485, 0.666626
inner-product-slot, 306, 12, 181, 1, 0, 500, 0.666626
inner-product-slot, 294, 12, 178, 1, 0, 485, 0.666626
inner-product-slot, 303, 12, 184, 1, 0, 500, 0.666626
inner-product-slot, 302, 12, 178, 1, 0, 493, 0.666626
inner-product-slot, 299, 12, 181, 1, 0, 493, 0.666626
inner-product-slot, 293, 12, 181, 1, 0, 487, 0.666626
inner-product-slot, 312, 12, 180, 1, 0, 505, 0.666626
inner-product-slot, 296, 12, 181, 1, 0, 490, 0.666626
inner-product-slot, 298, 12, 180, 1, 0, 491, 0.666626
inner-product-slot, 329, 12, 183, 1, 0, 525, 0.666626
inner-product-slot, 297, 12, 184, 1, 0, 494, 0.666626
inner-product-slot, 295, 12, 182, 1, 0, 490, 0.666626
inner-product-slot, 320, 12, 181, 1, 0, 514, 0.666626
inner-product-slot, 312, 12, 183, 1, 0, 508, 0.666626
inner-product-slot, 304, 12, 180, 1, 0, 497, 0.666626
inner-product-slot, 297, 12, 182, 1, 0, 492, 0.666626
inner-product-slot, 305, 12, 184, 1, 0, 502, 0.666626
inner-product-slot, 309, 12, 178, 1, 0, 500, 0.666626
inner-product-slot, 304, 13, 180, 1, 0, 498, 0.666626
inner-product-slot, 297, 12, 183, 1, 0, 493, 0.666626
inner-product-slot, 304, 12, 188, 1, 0, 505, 0.666626
inner-product-slot, 304, 12, 179, 1, 0, 496, 0.666626
inner-product-slot, 309, 12, 184, 1, 0, 506, 0.666626
inner-product-slot, 291, 12, 182, 1, 0, 486, 0.666626
inner-product-slot, 301, 12, 183, 1, 0, 497, 0.666626
inner-product-slot, 307, 12, 183, 1, 0, 503, 0.666626
inner-product-slot, 300, 12, 182, 1, 0, 495, 0.666626
inner-product-slot, 292, 12, 178, 1, 0, 483, 0.666626
inner-product-slot, 297, 12, 181, 1, 0, 491, 0.666626
inner-product-slot, 314, 12, 182, 1, 0, 509, 0.666626
inner-product-slot, 311, 12, 178, 1, 0, 502, 0.666626
inner-product-slot, 299, 12, 182, 1, 0, 494, 0.666626
inner-product-slot, 295, 12, 181, 1, 0, 489, 0.666626
inner-product-slot, 300, 12, 182, 1, 0, 495, 0.666626
inner-product-slot, 298, 12, 182, 1, 0, 493, 0.666626
inner-product-slot, 308, 12, 182, 1, 0, 503, 0.666626
inner-product-slot, 294, 12, 179, 1, 0, 486, 0.666626
inner-product-slot, 312, 12, 179, 1, 0, 504, 0.666626
inner-product-slot, 294, 12, 181, 1, 0, 488, 0.666626
inner-product-slot, 292, 12, 184, 1, 0, 489, 0.666626
inner-product-slot, 297, 12, 186, 1, 0, 496, 0.666626
inner-product-slot, 303, 11, 180, 1, 0, 495, 0.666626
inner-product-slot, 299, 12, 184, 1, 0, 496, 0.666626
inner-product-slot, 292, 12, 179, 1, 0, 484, 0.666626
inner-product-slot, 304, 12, 180, 1, 0, 497, 0.666626
inner-product-slot, 300, 12, 178, 1, 0, 491, 0.666626
inner-product-slot, 299, 12, 182, 1, 0, 494, 0.666626
inner-product-slot, 301, 12, 181, 1, 0, 495, 0.666626
inner-product-slot, 292, 12, 180, 1, 0, 485, 0.666626
inner-product-slot, 307, 12, 181, 1, 0, 501, 0.666626
inner-product-slot, 300, 16, 186, 1, 0, 503, 0.666626
inner-product-slot, 296, 12, 181, 1, 0, 490, 0.666626
inner-product-slot, 301, 12, 179, 1, 0, 493, 0.666626
inner-product-slot, 300, 12, 183, 1, 0, 496, 0.666626
inner-product-slot, 296, 12, 180, 1, 0, 489, 0.666626
inner-product-slot, 292, 12, 181, 1, 0, 486, 0.666626
inner-product-slot, 302, 12, 179, 1, 0, 494, 0.666626
inner-product-slot, 309, 12, 181, 1, 0, 503, 0.666626
inner-product-slot, 301, 12, 177, 1, 0, 491, 0.666626
inner-product-slot, 294, 11, 177, 1, 0, 483, 0.666626
inner-product-slot, 299, 12, 178, 1, 0, 490, 0.666626
inner-product-slot, 323, 12, 184, 1, 0, 520, 0.666626
inner-product-slot, 295, 12, 178, 1, 0, 486, 0.666626
inner-product-slot, 306, 13, 179, 1, 0, 499, 0.666626
inner-product-slot, 308, 12, 187, 1, 0, 508, 0.666626
inner-product-slot, 300, 12, 182, 1, 0, 495, 0.666626
inner-product-slot, 295, 12, 182, 1, 0, 490, 0.666626
inner-product-slot, 293, 12, 179, 1, 0, 485, 0.666626
inner-product-slot, 298, 12, 178, 1, 0, 489, 0.666626
inner-product-slot, 306, 12, 182, 1, 0, 501, 0.666626
inner-product-slot, 307, 12, 179, 1, 0, 499, 0.666626
inner-product-slot, 293, 12, 185, 1, 0, 491, 0.666626
inner-product-slot, 293, 12, 182, 1, 0, 488, 0.666626
inner-product-slot, 299, 12, 176, 1, 0, 488, 0.666626
inner-product-slot, 307, 12, 182, 1, 0, 502, 0.666626
inner-product-slot, 297, 12, 181, 1, 0, 491, 0.666626
inner-product-slot, 299, 12, 182, 1, 0, 494, 0.666626
inner-product-slot, 311, 12, 182, 1, 0, 506, 0.666626
inner-product-slot, 293, 12, 181, 1, 0, 487, 0.666626
inner-product-slot, 297, 12, 179, 1, 0, 489, 0.666626
inner-product-slot, 303, 12, 181, 1, 0, 497, 0.666626
inner-product-slot, 300, 11, 180, 1, 0, 492, 0.666626
inner-product-slot, 298, 12, 179, 1, 0, 490, 0.666626
inner-product-slot, 296, 12, 182, 1, 0, 491, 0.666626
inner-product-slot, 305, 15, 185, 1, 0, 506, 0.666626
inner-product-slot, 298, 12, 180, 1, 0, 491, 0.666626
inner-product-slot, 295, 12, 176, 1, 0, 484, 0.666626
inner-product-slot, 301, 12, 179, 1, 0, 493, 0.666626
inner-product-slot, 296, 12, 182, 1, 0, 491, 0.666626
inner-product-slot, 309, 12, 182, 1, 0, 504, 0.666626
inner-product-slot, 296, 12, 181, 1, 0, 490, 0.666626
inner-product-slot, 293, 12, 179, 1, 0, 485, 0.666626
inner-product-slot, 305, 12, 181, 1, 0, 499, 0.666626
inner-product-slot, 302, 12, 182, 1, 0, 497, 0.666626
inner-product-slot, 295, 12, 177, 1, 0, 485, 0.666626
inner-product-slot, 297, 12, 183, 1, 0, 493, 0.666626
inner-product-slot, 298, 12, 181, 1, 0, 492, 0.666626
inner-product-slot, 305, 12, 182, 1, 0, 500, 0.666626
inner-product-slot, 295, 12, 178, 1, 0, 486, 0.666626
inner-product-slot, 292, 12, 177, 1, 0, 482, 0.666626
inner-product-slot, 307, 12, 183, 1, 0, 503, 0.666626
inner-product-slot, 305, 12, 193, 1, 0, 511, 0.666626
inner-product-slot, 310, 12, 179, 1, 0, 502, 0.666626
inner-product-slot, 295, 12, 181, 1, 0, 489, 0.666626
inner-product-slot, 304, 12, 183, 1, 0, 500, 0.666626
inner-product-slot, 317, 12, 207, 1, 0, 537, 0.666626
inner-product-slot, 316, 12, 177, 1, 0, 506, 0.666626
inner-product-slot, 302, 12, 181, 1, 0, 496, 0.666626
inner-product-slot, 303, 12, 182, 1, 0, 498, 0.666626
inner-product-slot, 300, 12, 179, 1, 0, 492, 0.666626
inner-product-slot, 314, 12, 182, 1, 0, 509, 0.666626
inner-product-slot, 300, 12, 182, 1, 0, 495, 0.666626
inner-product-slot, 313, 12, 182, 1, 0, 508, 0.666626
inner-product-slot, 301, 12, 182, 1, 0, 496, 0.666626
inner-product-slot, 302, 12, 177, 1, 0, 492, 0.666626
inner-product-slot, 300, 12, 178, 1, 0, 491, 0.666626
inner-product-slot, 305, 12, 177, 1, 0, 495, 0.666626
inner-product-slot, 300, 12, 184, 1, 0, 497, 0.666626
inner-product-slot, 317, 12, 174, 1, 0, 504, 0.666626
inner-product-slot, 310, 12, 181, 1, 0, 504, 0.666626
inner-product-slot, 295, 12, 180, 1, 0, 488, 0.666626
inner-product-slot, 311, 13, 185, 1, 0, 510, 0.666626
inner-product-slot, 299, 12, 180, 1, 0, 492, 0.666626
inner-product-slot, 295, 12, 182, 1, 0, 490, 0.666626
inner-product-slot, 296, 11, 179, 1, 0, 487, 0.666626
inner-product-slot, 312, 12, 183, 1, 0, 508, 0.666626
inner-product-slot, 303, 12, 181, 1, 0, 497, 0.666626
inner-product-slot, 298, 12, 182, 1, 0, 493, 0.666626
inner-product-slot, 311, 12, 186, 1, 0, 510, 0.666626
inner-product-slot, 300, 12, 185, 1, 0, 498, 0.666626
inner-product-slot, 307, 12, 183, 1, 0, 503, 0.666626
inner-product-slot, 307, 13, 183, 1, 0, 504, 0.666626
inner-product-slot, 310, 12, 181, 1, 0, 504, 0.666626
inner-product-slot, 304, 12, 185, 1, 0, 502, 0.666626
inner-product-slot, 300, 12, 181, 1, 0, 494, 0.666626
inner-product-slot, 304, 12, 181, 1, 0, 498, 0.666626
inner-product-slot, 302, 12, 180, 1, 0, 495, 0.666626
inner-product-slot, 296, 12, 185, 1, 0, 494, 0.666626
inner-product-slot, 297, 12, 183, 1, 0, 493, 0.666626
inner-product-slot, 305, 12, 184, 1, 0, 502, 0.666626
inner-product-slot, 295, 12, 177, 1, 0, 485, 0.666626
inner-product-slot, 299, 12, 185, 1, 0, 497, 0.666626
inner-product-slot, 289, 12, 181, 1, 0, 483, 0.666626
inner-product-slot, 310, 12, 183, 1, 0, 506, 0.666626
inner-product-slot, 299, 12, 176, 1, 0, 488, 0.666626
inner-product-slot, 302, 12, 183, 1, 0, 498, 0.666626
inner-product-slot, 300, 12, 184, 1, 0, 497, 0.666626
inner-product-slot, 297, 12, 179, 1, 0, 489, 0.666626
inner-product-slot, 304, 11, 182, 1, 0, 498, 0.666626
inner-product-slot, 311, 12, 182, 1, 0, 506, 0.666626
inner-product-slot, 295, 12, 178, 1, 0, 486, 0.666626
inner-product-slot, 301, 12, 180, 1, 0, 494, 0.666626
inner-product-slot, 301, 12, 176, 1, 0, 490, 0.666626
inner-product-slot, 300, 12, 184, 1, 0, 497, 0.666626
inner-product-slot, 299, 12, 180, 1, 0, 492, 0.666626
inner-product-slot, 301, 12, 179, 1, 0, 493, 0.666626
inner-product-slot, 298, 12, 175, 1, 0, 486, 0.666626
inner-product-slot, 304, 12, 181, 1, 0, 498, 0.666626
inner-product-slot, 293, 12, 181, 1, 0, 487, 0.666626
inner-product-slot, 306, 12, 178, 1, 0, 497, 0.666626
inner-product-slot, 306, 12, 184, 1, 0, 503, 0.666626
inner-product-slot, 301, 12, 184, 1, 0, 498, 0.666626
inner-product-slot, 298, 12, 178, 1, 0, 489, 0.666626
inner-product-slot, 300, 12, 183, 1, 0, 496, 0.666626
inner-product-slot, 301, 12, 177, 1, 0, 491, 0.666626
inner-product-slot, 296, 12, 178, 1, 0, 487, 0.666626
inner-product-slot, 298, 12, 182, 1, 0, 493, 0.666626
inner-product-slot, 299, 12, 184, 1, 0, 496, 0.666626
inner-product-slot, 306, 12, 185, 1, 0, 504, 0.666626
inner-product-slot, 299, 12, 182, 1, 0, 494, 0.666626
inner-product-slot, 298, 12, 178, 1, 0, 489, 0.666626
inner-product-slot, 300, 12, 183, 1, 0, 496, 0.666626
inner-product-slot, 311, 12, 182, 1, 0, 506, 0.666626
inner-product-slot, 300, 12, 183, 1, 0, 496, 0.666626
inner-product-slot, 297, 12, 184, 1, 0, 494, 0.666626
inner-product-slot, 316, 12, 182, 1, 0, 511, 0.666626
inner-product-slot, 307, 12, 188, 1, 0, 508, 0.666626
inner-product-slot, 301, 12, 184, 1, 0, 498, 0.666626
inner-product-slot, 296, 12, 184, 1, 0, 493, 0.666626
inner-product-slot, 295, 12, 180, 1, 0, 488, 0.666626
inner-product-slot, 298, 11, 180, 1, 0, 490, 0.666626
inner-product-slot, 294, 12, 181, 1, 0, 488, 0.666626
inner-product-slot, 304, 12, 181, 1, 0, 498, 0.666626
inner-product-slot, 294, 11, 176, 1, 0, 482, 0.666626
inner-product-slot, 306, 12, 180, 1, 0, 499, 0.666626
inner-product-slot, 293, 11, 180, 1, 0, 485, 0.666626
inner-product-slot, 292, 12, 179, 1, 0, 484, 0.666626
inner-product-slot, 296, 12, 180, 1, 0, 489, 0.666626
inner-product-slot, 300, 12, 183, 1, 0, 496, 0.666626
inner-product-slot, 299, 12, 178, 1, 0, 490, 0.666626
inner-product-slot, 295, 12, 193, 1, 0, 501, 0.666626
inner-product-slot, 300, 12, 184, 1, 0, 497, 0.666626
inner-product-slot, 302, 12, 178, 1, 0, 493, 0.666626
inner-product-slot, 302, 12, 186, 1, 0, 501, 0.666626
inner-product-slot, 298, 12, 184, 1, 0, 495, 0.666626
inner-product-slot, 294, 12, 174, 1, 0, 481, 0.666626
inner-product-slot, 301, 11, 180, 1, 0, 493, 0.666626
inner-product-slot, 298, 12, 182, 1, 0, 493, 0.666626
inner-product-slot, 298, 12, 185, 1, 0, 496, 0.666626
inner-product-slot, 297, 12, 182, 1, 0, 492, 0.666626
inner-product-slot, 302, 12, 179, 1, 0, 494, 0.666626
inner-product-slot, 298, 12, 182, 1, 0, 493, 0.666626
inner-product-slot, 302, 12, 185, 1, 0, 500, 0.666626
inner-product-slot, 301, 12, 185, 1, 0, 499, 0.666626
inner-product-slot, 310, 12, 182, 1, 0, 505, 0.666626
inner-product-slot, 294, 12, 178, 1, 0, 485, 0.666626
inner-product-slot, 295, 14, 180, 1, 0, 490, 0.666626
inner-product-slot, 308, 12, 180, 1, 0, 501, 0.666626
inner-product-slot, 301, 12, 184, 1, 0, 498, 0.666626
inner-product-slot, 296, 12, 179, 1, 0, 488, 0.666626
inner-product-slot, 295, 12, 179, 1, 0, 487, 0.666626
inner-product-slot, 298, 11, 178, 1, 0, 488, 0.666626
inner-product-slot, 302, 12, 180, 1, 0, 495, 0.666626
inner-product-slot, 295, 12, 176, 1, 0, 484, 0.666626
inner-product-slot, 295, 12, 178, 1, 0, 486, 0.666626
inner-product-slot, 305, 13, 181, 1, 0, 500, 0.666626
inner-product-slot, 297, 12, 184, 1, 0, 494, 0.666626
inner-product-slot, 301, 12, 178, 1, 0, 492, 0.666626
inner-product-slot, 311, 12, 181, 1, 0, 505, 0.666626
inner-product-slot, 304, 12, 182, 1, 0, 499, 0.666626
inner-product-slot, 298, 12, 188, 1, 0, 499, 0.666626
inner-product-slot, 303, 12, 180, 1, 0, 496, 0.666626
inner-product-slot, 314, 15, 180, 1, 0, 510, 0.666626
inner-product-slot, 299, 12, 180, 1, 0, 492, 0.666626
inner-product-slot, 318, 12, 183, 1, 0, 514, 0.666626
inner-product-slot, 298, 12, 183, 1, 0, 494, 0.666626
inner-product-slot, 296, 12, 178, 1, 0, 487, 0.666626
inner-product-slot, 298, 12, 178, 1, 0, 489, 0.666626
inner-product-slot, 302, 12, 180, 1, 0, 495, 0.666626
inner-product-slot, 305, 12, 181, 1, 0, 499, 0.666626
inner-product-slot, 293, 12, 177, 1, 0, 483, 0.666626
inner-product-slot, 292, 12, 179, 1, 0, 484, 0.666626
inner-product-slot, 299, 12, 182, 1, 0, 494, 0.666626
inner-product-slot, 311, 12, 184, 1, 0, 508, 0.666626
inner-product-slot, 310, 11, 179, 1, 0, 501, 0.666626
inner-product-slot, 294, 12, 175, 1, 0, 482, 0.666626
inner-product-slot, 295, 12, 177, 1, 0, 485, 0.666626
inner-product-slot, 299, 12, 182, 1, 0, 494, 0.666626
inner-product-slot, 293, 12, 180, 1, 0, 486, 0.666626
inner-product-slot, 296, 12, 180, 1, 0, 489, 0.666626
inner-product-slot, 306, 12, 178, 1, 0, 497, 0.666626
inner-product-slot, 296, 12, 180, 1, 0, 489, 0.666626
inner-product-slot, 291, 12, 176, 1, 0, 480, 0.666626
inner-product-slot, 294, 12, 179, 1, 0, 486, 0.666626
inner-product-slot, 307, 12, 180, 1, 0, 500, 0.666626
inner-product-slot, 296, 12, 181, 1, 0, 490, 0.666626
inner-product-slot, 303, 12, 178, 1, 0, 494, 0.666626
inner-product-slot, 297, 12, 182, 1, 0, 492, 0.666626
inner-product-slot, 307, 12, 186, 1, 0, 506, 0.666626
inner-product-slot, 298, 12, 179, 1, 0, 490, 0.666626
inner-product-slot, 301, 12, 183, 1, 0, 497, 0.666626
inner-product-slot, 303, 12, 186, 1, 0, 502, 0.666626
inner-product-slot, 300, 12, 181, 1, 0, 494, 0.666626
inner-product-slot, 306, 12, 178, 1, 0, 497, 0.666626
inner-product-slot, 296, 13, 184, 1, 0, 494, 0.666626
inner-product-slot, 302, 12, 180, 1, 0, 495, 0.666626
inner-product-slot, 298, 12, 181, 1, 0, 492, 0.666626
inner-product-slot, 296, 12, 181, 1, 0, 490, 0.666626
inner-product-slot, 301, 12, 183, 1, 0, 497, 0.666626
inner-product-slot, 301, 12, 184, 1, 0, 498, 0.666626
inner-product-slot, 300, 12, 178, 1, 0, 491, 0.666626
inner-product-slot, 302, 12, 179, 1, 0, 494, 0.666626
inner-product-slot, 289, 12, 179, 1, 0, 481, 0.666626
inner-product-slot, 291, 18, 182, 1, 0, 492, 0.666626
inner-product-slot, 302, 12, 178, 1, 0, 493, 0.666626
inner-product-slot, 304, 11, 174, 1, 0, 490, 0.666626
inner-product-slot, 291, 12, 178, 1, 0, 482, 0.666626
inner-product-slot, 296, 16, 181, 1, 0, 494, 0.666626
inner-product-slot, 305, 12, 178, 1, 0, 496, 0.666626
inner-product-slot, 304, 12, 181, 1, 0, 498, 0.666626
inner-product-slot, 296, 12, 176, 1, 0, 485, 0.666626
inner-product-slot, 305, 12, 188, 1, 0, 506, 0.666626
inner-product-slot, 295, 12, 183, 1, 0, 491, 0.666626
inner-product-slot, 292, 12, 178, 1, 0, 483, 0.666626
inner-product-slot, 296, 12, 179, 1, 0, 488, 0.666626
inner-product-slot, 304, 12, 190, 1, 0, 507, 0.666626
inner-product-slot, 298, 12, 178, 1, 0, 489, 0.666626
inner-product-slot, 298, 12, 175, 1, 0, 486, 0.666626
inner-product-slot, 300, 12, 185, 1, 0, 498, 0.666626
inner-product-slot, 295, 12, 182, 1, 0, 490, 0.666626
inner-product-slot, 303, 12, 186, 1, 0, 502, 0.666626
inner-product-slot, 296, 12, 178, 1, 0, 487, 0.666626
inner-product-slot, 293, 12, 178, 1, 0, 484, 0.666626
inner-product-slot, 301, 12, 180, 1, 0, 494, 0.666626
inner-product-slot, 295, 14, 177, 1, 0, 487, 0.666626
inner-product-slot, 304, 12, 181, 1, 0, 498, 0.666626
inner-product-slot, 302, 12, 185, 1, 0, 500, 0.666626
inner-product-slot, 297, 12, 189, 1, 0, 499, 0.666626
inner-product-slot, 302, 12, 183, 1, 0, 498, 0.666626
inner-product-slot, 306, 12, 183, 1, 0, 502, 0.666626
inner-product-slot, 300, 12, 178, 1, 0, 491, 0.666626
inner-product-slot, 300, 15, 176, 1, 0, 492, 0.666626
inner-product-slot, 303, 12, 180, 1, 0, 496, 0.666626
inner-product-slot, 308, 12, 181, 1, 0, 502, 0.666626
inner-product-slot, 292, 12, 178, 1, 0, 483, 0.666626
inner-product-slot, 298, 12, 186, 1, 0, 497, 0.666626
inner-product-slot, 302, 15, 179, 1, 0, 497, 0.666626
inner-product-slot, 295, 12, 178, 1, 0, 486, 0.666626
inner-product-slot, 300, 12, 182, 1, 0, 495, 0.666626
inner-product-slot, 292, 12, 183, 1, 0, 488, 0.666626
inner-product-slot, 294, 12, 180, 1, 0, 487, 0.666626
inner-product-slot, 298, 12, 176, 1, 0, 487, 0.666626
inner-product-slot, 295, 12, 182, 1, 0, 490, 0.666626
inner-product-slot, 302, 12, 191, 1, 0, 506, 0.666626
inner-product-slot, 297, 12, 181, 1, 0, 491, 0.666626
inner-product-slot, 306, 12, 182, 1, 0, 501, 0.666626
inner-product-slot, 302, 12, 184, 1, 0, 499, 0.666626
inner-product-slot, 294, 12, 190, 1, 0, 497, 0.666626
inner-product-slot, 298, 12, 188, 1, 0, 499, 0.666626
inner-product-slot, 300, 12, 187, 1, 0, 500, 0.666626
inner-product-slot, 302, 12, 186, 1, 0, 501, 0.666626
inner-product-slot, 309, 14, 179, 1, 0, 503, 0.666626
inner-product-slot, 301, 12, 182, 1, 0, 496, 0.666626
inner-product-slot, 298, 12, 179, 1, 0, 490, 0.666626
inner-product-slot, 305, 12, 185, 1, 0, 503, 0.666626
inner-product-slot, 303, 13, 178, 1, 0, 495, 0.666626
inner-product-slot, 300, 12, 183, 1, 0, 496, 0.666626
inner-product-slot, 299, 12, 181, 1, 0, 493, 0.666626
inner-product-slot, 295, 12, 182, 1, 0, 490, 0.666626
inner-product-slot, 292, 12, 185, 1, 0, 490, 0.666626
inner-product-slot, 300, 12, 180, 1, 0, 493, 0.666626
inner-product-slot, 303, 12, 179, 1, 0, 495, 0.666626
inner-product-slot, 300, 12, 185, 1, 0, 498, 0.666626
inner-product-slot, 301, 21, 212, 1, 0, 535, 0.666626
inner-product-slot, 324, 12, 207, 1, 0, 544, 0.666626
inner-product-slot, 330, 11, 207, 1, 0, 549, 0.666626
inner-product-slot, 315, 12, 209, 1, 0, 537, 0.666626
inner-product-slot, 334, 12, 206, 1, 0, 553, 0.666626
inner-product-slot, 341, 12, 206, 1, 0, 560, 0.666626
inner-product-slot, 319, 12, 207, 1, 0, 539, 0.666626
inner-product-slot, 298, 12, 180, 1, 0, 491, 0.666626
inner-product-slot, 294, 12, 179, 1, 0, 486, 0.666626
inner-product-slot, 301, 12, 187, 1, 0, 501, 0.666626
inner-product-slot, 306, 12, 185, 1, 0, 504, 0.666626
inner-product-slot, 296, 12, 181, 1, 0, 490, 0.666626
inner-product-slot, 312, 12, 181, 1, 0, 506, 0.666626
inner-product-slot, 294, 12, 175, 1, 0, 482, 0.666626
inner-product-slot, 317, 12, 194, 1, 0, 524, 0.666626
inner-product-slot, 294, 12, 184, 1, 0, 491, 0.666626
inner-product-slot, 304, 12, 182, 1, 0, 499, 0.666626
inner-product-slot, 295, 12, 175, 1, 0, 483, 0.666626
inner-product-slot, 308, 12, 188, 1, 0, 509, 0.666626
inner-product-slot, 291, 12, 176, 1, 0, 480, 0.666626
inner-product-slot, 307, 13, 179, 1, 0, 500, 0.666626
inner-product-slot, 292, 12, 176, 1, 0, 481, 0.666626
inner-product-slot, 303, 12, 186, 1, 0, 502, 0.666626
inner-product-slot, 302, 12, 179, 1, 0, 494, 0.666626
inner-product-slot, 308, 12, 181, 1, 0, 502, 0.666626
inner-product-slot, 300, 12, 185, 1, 0, 498, 0.666626
inner-product-slot, 291, 11, 183, 1, 0, 486, 0.666626
inner-product-slot, 303, 12, 181, 1, 0, 497, 0.666626
inner-product-slot, 294, 12, 179, 1, 0, 486, 0.666626
inner-product-slot, 301, 12, 180, 1, 0, 494, 0.666626
inner-product-slot, 296, 12, 185, 1, 0, 494, 0.666626
inner-product-slot, 302, 12, 182, 1, 0, 497, 0.666626
inner-product-slot, 302, 15, 181, 1, 0, 499, 0.666626
inner-product-slot, 290, 12, 178, 1, 0, 481, 0.666626
inner-product-slot, 299, 12, 187, 1, 0, 499, 0.666626
inner-product-slot, 299, 12, 181, 1, 0, 493, 0.666626
inner-product-slot, 295, 12, 178, 1, 0, 486, 0.666626
inner-product-slot, 295, 11, 176, 1, 0, 483, 0.666626
inner-product-slot, 302, 12, 186, 1, 0, 501, 0.666626
inner-product-slot, 294, 11, 176, 1, 0, 482, 0.666626
inner-product-slot, 297, 12, 178, 1, 0, 488, 0.666626
inner-product-slot, 302, 12, 180, 1, 0, 495, 0.666626
inner-product-slot, 300, 12, 177, 1, 0, 490, 0.666626
inner-product-slot, 305, 12, 179, 1, 0, 497, 0.666626
inner-product-slot, 301, 12, 180, 1, 0, 494, 0.666626
inner-product-slot, 302, 12, 197, 1, 0, 512, 0.666626
inner-product-slot, 300, 12, 184, 1, 0, 497, 0.666626
inner-product-slot, 302, 12, 183, 1, 0, 498, 0.666626
inner-product-slot, 299, 12, 180, 1, 0, 492, 0.666626
inner-product-slot, 298, 12, 181, 1, 0, 492, 0.666626
inner-product-slot, 300, 12, 185, 1, 0, 498, 0.666626
inner-product-slot, 304, 12, 178, 1, 0, 495, 0.666626
inner-product-slot, 296, 12, 180, 1, 0, 489, 0.666626
inner-product-slot, 304, 12, 184, 1, 0, 501, 0.666626
inner-product-slot, 308, 12, 189, 1, 0, 510, 0.666626
inner-product-slot, 297, 12, 181, 1, 0, 491, 0.666626
inner-product-slot, 295, 12, 177, 1, 0, 485, 0.666626
inner-product-slot, 292, 12, 181, 1, 0, 486, 0.666626
inner-product-slot, 300, 12, 185, 1, 0, 498, 0.666626
inner-product-slot, 295, 12, 176, 1, 0, 484, 0.666626
inner-product-slot, 302, 11, 181, 1, 0, 495, 0.666626
inner-product-slot, 297, 11, 180, 1, 0, 489, 0.666626
inner-product-slot, 294, 11, 178, 1, 0, 484, 0.666626
inner-product-slot, 301, 12, 192, 1, 0, 506, 0.666626
inner-product-slot, 298, 12, 181, 1, 0, 492, 0.666626
inner-product-slot, 303, 12, 181, 1, 0, 497, 0.666626
inner-product-slot, 303, 12, 179, 1, 0, 495, 0.666626
inner-product-slot, 298, 12, 177, 1, 0, 488, 0.666626
inner-product-slot, 302, 12, 177, 1, 0, 492, 0.666626
inner-product-slot, 293, 12, 183, 1, 0, 489, 0.666626
inner-product-slot, 300, 12, 182, 1, 0, 495, 0.666626
inner-product-slot, 308, 12, 177, 1, 0, 498, 0.666626
inner-product-slot, 301, 12, 181, 1, 0, 495, 0.666626
inner-product-slot, 304, 12, 183, 1, 0, 500, 0.666626
inner-product-slot, 296, 12, 180, 1, 0, 489, 0.666626
inner-product-slot, 305, 12, 188, 1, 0, 506, 0.666626
inner-product-slot, 298, 12, 180, 1, 0, 491, 0.666626
inner-product-slot, 304, 12, 179, 1, 0, 496, 0.666626
inner-product-slot, 299, 12, 185, 1, 0, 497, 0.666626
inner-product-slot, 294, 12, 181, 1, 0, 488, 0.666626
inner-product-slot, 299, 12, 179, 1, 0, 491, 0.666626
inner-product-slot, 291, 12, 180, 1, 0, 484, 0.666626
inner-product-slot, 298, 12, 184, 1, 0, 495, 0.666626
inner-product-slot, 297, 11, 180, 1, 0, 489, 0.666626
inner-product-slot, 309, 12, 182, 1, 0, 504, 0.666626
inner-product-slot, 292, 11, 179, 1, 0, 483, 0.666626
inner-product-slot, 298, 12, 182, 1, 0, 493, 0.666626
inner-product-slot, 296, 12, 178, 1, 0, 487, 0.666626
inner-product-slot, 301, 12, 182, 1, 0, 496, 0.666626
inner-product-slot, 296, 14, 184, 1, 0, 495, 0.666626
inner-product-slot, 292, 12, 180, 1, 0, 485, 0.666626
inner-product-slot, 304, 12, 181, 1, 0, 498, 0.666626
inner-product-slot, 303, 12, 181, 1, 0, 497, 0.666626
inner-product-slot, 311, 12, 184, 1, 0, 508, 0.666626
inner-product-slot, 302, 12, 185, 1, 0, 500, 0.666626
inner-product-slot, 305, 12, 183, 1, 0, 501, 0.666626
inner-product-slot, 303, 15, 184, 1, 0, 503, 0.666626
inner-product-slot, 301, 12, 180, 1, 0, 494, 0.666626
inner-product-slot, 302, 12, 180, 1, 0, 495, 0.666626
inner-product-slot, 300, 12, 182, 1, 0, 495, 0.666626
inner-product-slot, 297, 12, 183, 1, 0, 493, 0.666626
inner-product-slot, 306, 12, 184, 1, 0, 503, 0.666626
inner-product-slot, 291, 12, 178, 1, 0, 482, 0.666626
inner-product-slot, 300, 12, 182, 1, 0, 495, 0.666626
inner-product-slot, 297, 12, 181, 1, 0, 491, 0.666626
inner-product-slot, 307, 12, 181, 1, 0, 501, 0.666626
inner-product-slot, 296, 12, 177, 1, 0, 486, 0.666626
inner-product-slot, 301, 12, 177, 1, 0, 491, 0.666626
inner-product-slot, 306, 12, 182, 1, 0, 501, 0.666626
inner-product-slot, 291, 12, 178, 1, 0, 482, 0.666626
inner-product-slot, 293, 12, 179, 1, 0, 485, 0.666626
inner-product-slot, 304, 12, 178, 1, 0, 495, 0.666626
inner-product-slot, 298, 12, 179, 1, 0, 490, 0.666626
inner-product-slot, 296, 12, 181, 1, 0, 490, 0.666626
inner-product-slot, 304, 14, 186, 1, 0, 505, 0.666626
inner-product-slot, 309, 12, 179, 1, 0, 501, 0.666626
inner-product-slot, 304, 12, 181, 1, 0, 498, 0.666626
inner-product-slot, 299, 12, 181, 1, 0, 493, 0.666626
inner-product-slot, 304, 13, 180, 1, 0, 498, 0.666626
inner-product-slot, 306, 12, 180, 1, 0, 499, 0.666626
inner-product-slot, 305, 12, 182, 1, 0, 500, 0.666626
inner-product-slot, 295, 14, 180, 1, 0, 490, 0.666626
inner-product-slot, 299, 12, 181, 1, 0, 493, 0.666626
inner-product-slot, 313, 12, 184, 1, 0, 510, 0.666626
inner-product-slot, 298, 12, 181, 1, 0, 492, 0.666626
inner-product-slot, 305, 12, 181, 1, 0, 499, 0.666626
inner-product-slot, 291, 12, 177, 1, 0, 481, 0.666626
inner-product-slot, 298, 12, 178, 1, 0, 489, 0.666626
half-size-inner-coef, 139, 64, 97, 1, 0, 301, 0.666626
half-size-inner-coef, 139, 61, 99, 1, 0, 300, 0.666626
half-size-inner-coef, 138, 62, 99, 1, 0, 300, 0.666626
half-size-inner-coef, 135, 61, 97, 1, 0, 294, 0.666626
half-size-inner-coef, 138, 61, 98, 1, 0, 298, 0.666626
half-size-inner-coef, 143, 61, 97, 1, 0, 302, 0.666626
half-size-inner-coef, 141, 62, 97, 1, 0, 301, 0.666626
half-size-inner-coef, 143, 60, 99, 1, 0, 303, 0.666626
half-size-inner-coef, 140, 61, 98, 1, 0, 300, 0.666626
half-size-inner-coef, 133, 61, 98, 1, 0, 293, 0.666626
half-size-inner-coef, 139, 61, 97, 1, 0, 298, 0.666626
half-size-inner-coef, 139, 67, 101, 1, 0, 308, 0.666626
half-size-inner-coef, 138, 61, 99, 1, 0, 299, 0.666626
half-size-inner-coef, 136, 60, 95, 1, 0, 292, 0.666626
half-size-inner-coef, 136, 60, 99, 1, 0, 296, 0.666626
half-size-inner-coef, 135, 62, 98, 1, 0, 296, 0.666626
half-size-inner-coef, 138, 62, 99, 1, 0, 300, 0.666626
half-size-inner-coef, 141, 62, 97, 1, 0, 301, 0.666626
half-size-inner-coef, 135, 60, 97, 1, 0, 293, 0.666626
half-size-inner-coef, 139, 60, 97, 1, 0, 297, 0.666626
half-size-inner-coef, 136, 62, 97, 1, 0, 296, 0.666626
half-size-inner-coef, 142, 61, 101, 1, 0, 305, 0.666626
half-size-inner-coef, 135, 61, 98, 1, 0, 295, 0.666626
half-size-inner-coef, 152, 61, 98, 1, 0, 312, 0.666626
half-size-inner-coef, 138, 63, 101, 1, 0, 303, 0.666626
half-size-inner-coef, 141, 60, 98, 1, 0, 300, 0.666626
half-size-inner-coef, 133, 60, 99, 1, 0, 293, 0.666626
half-size-inner-coef, 135, 61, 99, 1, 0, 296, 0.666626
half-size-inner-coef, 137, 60, 96, 1, 0, 294, 0.666626
half-size-inner-coef, 134, 60, 97, 1, 0, 292, 0.666626
half-size-inner-coef, 147, 62, 96, 1, 0, 306, 0.666626
half-size-inner-coef, 135, 62, 97, 1, 0, 295, 0.666626
half-size-inner-coef, 142, 62, 98, 1, 0, 303, 0.666626
half-size-inner-coef, 136, 61, 98, 1, 0, 296, 0.666626
half-size-inner-coef, 136, 61, 100, 1, 0, 298, 0.666626
half-size-inner-coef, 137, 61, 97, 1, 0, 296, 0.666626
half-size-inner-coef, 136, 61, 98, 1, 0, 296, 0.666626
half-size-inner-coef, 136, 66, 96, 1, 0, 299, 0.666626
half-size-inner-coef, 138, 61, 100, 1, 0, 300, 0.666626
half-size-inner-coef, 136, 61, 97, 1, 0, 295, 0.666626
half-size-inner-coef, 140, 61, 99, 1, 0, 301, 0.666626
half-size-inner-coef, 136, 62, 97, 1, 0, 296, 0.666626
half-size-inner-coef, 137, 60, 97, 1, 0, 295, 0.666626
half-size-inner-coef, 138, 63, 98, 1, 0, 300, 0.666626
half-size-inner-coef, 137, 60, 100, 1, 0, 298, 0.666626
half-size-inner-coef, 138, 60, 98, 1, 0, 297, 0.666626
half-size-inner-coef, 135, 61, 95, 1, 0, 292, 0.666626
half-size-inner-coef, 142, 61, 99, 1, 0, 303, 0.666626
half-size-inner-coef, 137, 60, 95, 1, 0, 293, 0.666626
half-size-inner-coef, 139, 61, 97, 1, 0, 298, 0.666626
half-size-inner-coef, 138, 65, 95, 1, 0, 299, 0.666626
half-size-inner-coef, 135, 61, 96, 1, 0, 293, 0.666626
half-size-inner-coef, 140, 62, 99, 1, 0, 302, 0.666626
half-size-inner-coef, 136, 60, 98, 1, 0, 295, 0.666626
half-size-inner-coef, 138, 61, 97, 1, 0, 297, 0.666626
half-size-inner-coef, 141, 62, 97, 1, 0, 301, 0.666626
half-size-inner-coef, 139, 61, 96, 1, 0, 297, 0.666626
half-size-inner-coef, 136, 62, 102, 1, 0, 301, 0.666626
half-size-inner-coef, 135, 61, 100, 1, 0, 297, 0.666626
half-size-inner-coef, 137, 61, 102, 1, 0, 301, 0.666626
half-size-inner-coef, 157, 62, 101, 1, 0, 321, 0.666626
half-size-inner-coef, 140, 61, 107, 1, 0, 309, 0.666626
half-size-inner-coef, 140, 62, 100, 1, 0, 303, 0.666626
half-size-inner-coef, 138, 61, 99, 1, 0, 299, 0.666626
half-size-inner-coef, 138, 62, 98, 1, 0, 299, 0.666626
half-size-inner-coef, 142, 60, 101, 1, 0, 304, 0.666626
half-size-inner-coef, 136, 61, 99, 1, 0, 297, 0.666626
half-size-inner-coef, 137, 61, 97, 1, 0, 296, 0.666626
half-size-inner-coef, 137, 64, 96, 1, 0, 298, 0.666626
half-size-inner-coef, 141, 61, 99, 1, 0, 302, 0.666626
half-size-inner-coef, 138, 62, 98, 1, 0, 299, 0.666626
half-size-inner-coef, 136, 62, 99, 1, 0, 298, 0.666626
half-size-inner-coef, 136, 61, 100, 1, 0, 298, 0.666626
half-size-inner-coef, 138, 61, 99, 1, 0, 299, 0.666626
half-size-inner-coef, 134, 64, 96, 1, 0, 295, 0.666626
half-size-inner-coef, 136, 61, 96, 1, 0, 294, 0.666626
half-size-inner-coef, 137, 61, 98, 1, 0, 297, 0.666626
half-size-inner-coef, 137, 63, 97, 1, 0, 298, 0.666626
half-size-inner-coef, 135, 61, 100, 1, 0, 297, 0.666626
half-size-inner-coef, 138, 61, 98, 1, 0, 298, 0.666626
half-size-inner-coef, 141, 61, 98, 1, 0, 301, 0.666626
half-size-inner-coef, 141, 63, 99, 1, 0, 304, 0.666626
half-size-inner-coef, 137, 61, 97, 1, 0, 296, 0.666626
half-size-inner-coef, 143, 62, 101, 1, 0, 307, 0.666626
half-size-inner-coef, 137, 62, 98, 1, 0, 298, 0.666626
half-size-inner-coef, 137, 64, 100, 1, 0, 302, 0.666626
half-size-inner-coef, 136, 61, 98, 1, 0, 296, 0.666626
half-size-inner-coef, 138, 62, 97, 1, 0, 298, 0.666626
half-size-inner-coef, 136, 61, 109, 1, 0, 307, 0.666626
half-size-inner-coef, 135, 60, 96, 1, 0, 292, 0.666626
half-size-inner-coef, 139, 61, 99, 1, 0, 300, 0.666626
half-size-inner-coef, 139, 62, 98, 1, 0, 300, 0.666626
half-size-inner-coef, 135, 61, 97, 1, 0, 294, 0.666626
half-size-inner-coef, 140, 61, 97, 1, 0, 299, 0.666626
half-size-inner-coef, 137, 61, 102, 1, 0, 301, 0.666626
half-size-inner-coef, 139, 62, 97, 1, 0, 299, 0.666626
half-size-inner-coef, 135, 61, 97, 1, 0, 294, 0.666626
half-size-inner-coef, 139, 64, 100, 1, 0, 304, 0.666626
half-size-inner-coef, 139, 63, 103, 1, 0, 306, 0.666626
half-size-inner-coef, 139, 59, 102, 1, 0, 301, 0.666626
half-size-inner-coef, 140, 61, 102, 1, 0, 304, 0.666626
half-size-inner-coef, 137, 62, 98, 1, 0, 298, 0.666626
half-size-inner-coef, 136, 61, 97, 1, 0, 295, 0.666626
half-size-inner-coef, 133, 59, 96, 1, 0, 289, 0.666626
half-size-inner-coef, 138, 61, 96, 1, 0, 296, 0.666626
half-size-inner-coef, 138, 62, 100, 1, 0, 301, 0.666626
half-size-inner-coef, 134, 61, 101, 1, 0, 297, 0.666626
half-size-inner-coef, 138, 61, 101, 1, 0, 301, 0.666626
half-size-inner-coef, 135, 62, 97, 1, 0, 295, 0.666626
half-size-inner-coef, 136, 61, 103, 1, 0, 301, 0.666626
half-size-inner-coef, 138, 61, 97, 1, 0, 297, 0.666626
half-size-inner-coef, 138, 62, 97, 1, 0, 298, 0.666626
half-size-inner-coef, 139, 63, 99, 1, 0, 302, 0.666626
half-size-inner-coef, 150, 62, 101, 1, 0, 314, 0.666626
half-size-inner-coef, 136, 62, 98, 1, 0, 297, 0.666626
half-size-inner-coef, 139, 62, 97, 1, 0, 299, 0.666626
half-size-inner-coef, 137, 64, 98, 1, 0, 300, 0.666626
half-size-inner-coef, 137, 60, 96, 1, 0, 294, 0.666626
half-size-inner-coef, 137, 63, 97, 1, 0, 298, 0.666626
half-size-inner-coef, 135, 61, 102, 1, 0, 299, 0.666626
half-size-inner-coef, 138, 60, 99, 1, 0, 298, 0.666626
half-size-inner-coef, 133, 61, 98, 1, 0, 293, 0.666626
half-size-inner-coef, 138, 60, 97, 1, 0, 296, 0.666626
half-size-inner-coef, 138, 61, 99, 1, 0, 299, 0.666626
half-size-inner-coef, 145, 63, 98, 1, 0, 307, 0.666626
half-size-inner-coef, 137, 62, 97, 1, 0, 297, 0.666626
half-size-inner-coef, 144, 62, 98, 1, 0, 305, 0.666626
half-size-inner-coef, 135, 60, 96, 1, 0, 292, 0.666626
half-size-inner-coef, 135, 60, 97, 1, 0, 293, 0.666626
half-size-inner-coef, 137, 61, 98, 1, 0, 297, 0.666626
half-size-inner-coef, 141, 60, 100, 1, 0, 302, 0.666626
half-size-inner-coef, 137, 60, 97, 1, 0, 295, 0.666626
half-size-inner-coef, 137, 60, 103, 1, 0, 301, 0.666626
half-size-inner-coef, 134, 63, 98, 1, 0, 296, 0.666626
half-size-inner-coef, 135, 60, 97, 1, 0, 293, 0.666626
half-size-inner-coef, 136, 61, 100, 1, 0, 298, 0.666626
half-size-inner-coef, 141, 61, 97, 1, 0, 300, 0.666626
half-size-inner-coef, 141, 61, 100, 1, 0, 303, 0.666626
half-size-inner-coef, 142, 63, 99, 1, 0, 305, 0.666626
half-size-inner-coef, 146, 60, 100, 1, 0, 307, 0.666626
half-size-inner-coef, 139, 61, 98, 1, 0, 299, 0.666626
half-size-inner-coef, 140, 61, 96, 1, 0, 298, 0.666626
half-size-inner-coef, 141, 62, 98, 1, 0, 302, 0.666626
half-size-inner-coef, 144, 61, 98, 1, 0, 304, 0.666626
half-size-inner-coef, 136, 61, 98, 1, 0, 296, 0.666626
half-size-inner-coef, 139, 64, 103, 1, 0, 307, 0.666626
half-size-inner-coef, 139, 62, 100, 1, 0, 302, 0.666626
half-size-inner-coef, 137, 60, 100, 1, 0, 298, 0.666626
half-size-inner-coef, 140, 61, 97, 1, 0, 299, 0.666626
half-size-inner-coef, 137, 61, 96, 1, 0, 295, 0.666626
half-size-inner-coef, 134, 64, 97, 1, 0, 296, 0.666626
half-size-inner-coef, 139, 61, 97, 1, 0, 298, 0.666626
half-size-inner-coef, 145, 61, 97, 1, 0, 304, 0.666626
half-size-inner-coef, 136, 61, 100, 1, 0, 298, 0.666626
half-size-inner-coef, 137, 60, 100, 1, 0, 298, 0.666626
half-size-inner-coef, 135, 61, 100, 1, 0, 297, 0.666626
half-size-inner-coef, 140, 61, 99, 1, 0, 301, 0.666626
half-size-inner-coef, 135, 61, 96, 1, 0, 293, 0.666626
half-size-inner-coef, 137, 66, 97, 1, 0, 301, 0.666626
half-size-inner-coef, 135, 60, 95, 1, 0, 291, 0.666626
half-size-inner-coef, 136, 62, 100, 1, 0, 299, 0.666626
half-size-inner-coef, 137, 61, 99, 1, 0, 298, 0.666626
half-size-inner-coef, 140, 61, 98, 1, 0, 300, 0.666626
half-size-inner-coef, 142, 61, 95, 1, 0, 299, 0.666626
half-size-inner-coef, 138, 62, 97, 1, 0, 298, 0.666626
half-size-inner-coef, 144, 60, 97, 1, 0, 302, 0.666626
half-size-inner-coef, 137, 60, 98, 1, 0, 296, 0.666626
half-size-inner-coef, 142, 62, 98, 1, 0, 303, 0.666626
half-size-inner-coef, 134, 61, 98, 1, 0, 294, 0.666626
half-size-inner-coef, 135, 61, 97, 1, 0, 294, 0.666626
half-size-inner-coef, 140, 62, 101, 1, 0, 304, 0.666626
half-size-inner-coef, 140, 64, 97, 1, 0, 302, 0.666626
half-size-inner-coef, 135, 61, 97, 1, 0, 294, 0.666626
half-size-inner-coef, 141, 61, 98, 1, 0, 301, 0.666626
half-size-inner-coef, 138, 60, 99, 1, 0, 298, 0.666626
half-size-inner-coef, 139, 62, 98, 1, 0, 300, 0.666626
half-size-inner-coef, 140, 62, 96, 1, 0, 299, 0.666626
half-size-inner-coef, 137, 62, 102, 1, 0, 302, 0.666626
half-size-inner-coef, 140, 61, 97, 1, 0, 299, 0.666626
half-size-inner-coef, 140, 61, 97, 1, 0, 299, 0.666626
half-size-inner-coef, 141, 60, 97, 1, 0, 299, 0.666626
half-size-inner-coef, 141, 60, 99, 1, 0, 301, 0.666626
half-size-inner-coef, 148, 64, 98, 1, 0, 311, 0.666626
half-size-inner-coef, 140, 60, 96, 1, 0, 297, 0.666626
half-size-inner-coef, 137, 60, 100, 1, 0, 298, 0.666626
half-size-inner-coef, 138, 60, 96, 1, 0, 295, 0.666626
half-size-inner-coef, 139, 60, 97, 1, 0, 297, 0.666626
half-size-inner-coef, 136, 61, 98, 1, 0, 296, 0.666626
half-size-inner-coef, 138, 60, 98, 1, 0, 297, 0.666626
half-size-inner-coef, 144, 62, 100, 1, 0, 307, 0.666626
half-size-inner-coef, 138, 61, 102, 1, 0, 302, 0.666626
half-size-inner-coef, 139, 61, 97, 1, 0, 298, 0.666626
half-size-inner-coef, 136, 61, 97, 1, 0, 295, 0.666626
half-size-inner-coef, 135, 64, 98, 1, 0, 298, 0.666626
half-size-inner-coef, 136, 61, 98, 1, 0, 296, 0.666626
half-size-inner-coef, 138, 61, 101, 1, 0, 301, 0.666626
half-size-inner-coef, 139, 61, 97, 1, 0, 298, 0.666626
half-size-inner-coef, 142, 60, 98, 1, 0, 301, 0.666626
half-size-inner-coef, 135, 61, 99, 1, 0, 296, 0.666626
half-size-inner-coef, 144, 63, 98, 1, 0, 306, 0.666626
half-size-inner-coef, 135, 60, 94, 1, 0, 290, 0.666626
half-size-inner-coef, 138, 62, 101, 1, 0, 302, 0.666626
half-size-inner-coef, 144, 61, 101, 1, 0, 307, 0.666626
half-size-inner-coef, 136, 61, 102, 1, 0, 300, 0.666626
half-size-inner-coef, 142, 63, 100, 1, 0, 306, 0.666626
half-size-inner-coef, 139, 61, 100, 1, 0, 301, 0.666626
half-size-inner-coef, 137, 60, 99, 1, 0, 297, 0.666626
half-size-inner-coef, 137, 60, 99, 1, 0, 297, 0.666626
half-size-inner-coef, 135, 61, 97, 1, 0, 294, 0.666626
half-size-inner-coef, 136, 60, 99, 1, 0, 296, 0.666626
half-size-inner-coef, 142, 61, 96, 1, 0, 300, 0.666626
half-size-inner-coef, 137, 60, 98, 1, 0, 296, 0.666626
half-size-inner-coef, 133, 60, 96, 1, 0, 290, 0.666626
half-size-inner-coef, 143, 60, 103, 1, 0, 307, 0.666626
half-size-inner-coef, 142, 61, 97, 1, 0, 301, 0.666626
half-size-inner-coef, 144, 60, 98, 1, 0, 303, 0.666626
half-size-inner-coef, 137, 61, 100, 1, 0, 299, 0.666626
half-size-inner-coef, 141, 61, 97, 1, 0, 300, 0.666626
half-size-inner-coef, 139, 61, 97, 1, 0, 298, 0.666626
half-size-inner-coef, 136, 64, 96, 1, 0, 297, 0.666626
half-size-inner-coef, 138, 60, 100, 1, 0, 299, 0.666626
half-size-inner-coef, 139, 62, 98, 1, 0, 300, 0.666626
half-size-inner-coef, 136, 60, 96, 1, 0, 293, 0.666626
half-size-inner-coef, 141, 62, 97, 1, 0, 301, 0.666626
half-size-inner-coef, 140, 61, 97, 1, 0, 299, 0.666626
half-size-inner-coef, 156, 63, 99, 1, 0, 319, 0.666626
half-size-inner-coef, 136, 61, 98, 1, 0, 296, 0.666626
half-size-inner-coef, 146, 61, 102, 1, 0, 310, 0.666626
half-size-inner-coef, 143, 63, 97, 1, 0, 304, 0.666626
half-size-inner-coef, 139, 70, 101, 1, 0, 311, 0.666626
half-size-inner-coef, 140, 62, 98, 1, 0, 301, 0.666626
half-size-inner-coef, 136, 61, 96, 1, 0, 294, 0.666626
half-size-inner-coef, 142, 62, 98, 1, 0, 303, 0.666626
half-size-inner-coef, 136, 62, 98, 1, 0, 297, 0.666626
half-size-inner-coef, 136, 62, 99, 1, 0, 298, 0.666626
half-size-inner-coef, 144, 60, 98, 1, 0, 303, 0.666626
half-size-inner-coef, 140, 60, 101, 1, 0, 302, 0.666626
half-size-inner-coef, 138, 61, 101, 1, 0, 301, 0.666626
half-size-inner-coef, 136, 61, 97, 1, 0, 295, 0.666626
half-size-inner-coef, 138, 61, 97, 1, 0, 297, 0.666626
half-size-inner-coef, 139, 61, 97, 1, 0, 298, 0.666626
half-size-inner-coef, 135, 61, 98, 1, 0, 295, 0.666626
half-size-inner-coef, 135, 65, 96, 1, 0, 297, 0.666626
half-size-inner-coef, 139, 61, 97, 1, 0, 298, 0.666626
half-size-inner-coef, 135, 60, 96, 1, 0, 292, 0.666626
half-size-inner-coef, 135, 60, 99, 1, 0, 295, 0.666626
half-size-inner-coef, 140, 61, 96, 1, 0, 298, 0.666626
half-size-inner-coef, 143, 72, 99, 1, 0, 315, 0.666626
half-size-inner-coef, 136, 61, 97, 1, 0, 295, 0.666626
half-size-inner-coef, 138, 61, 101, 1, 0, 301, 0.666626
half-size-inner-coef, 139, 61, 99, 1, 0, 300, 0.666626
half-size-inner-coef, 139, 62, 101, 1, 0, 303, 0.666626
half-size-inner-coef, 139, 61, 100, 1, 0, 301, 0.666626
half-size-inner-coef, 134, 61, 98, 1, 0, 294, 0.666626
half-size-inner-coef, 137, 61, 101, 1, 0, 300, 0.666626
half-size-inner-coef, 139, 61, 98, 1, 0, 299, 0.666626
half-size-inner-coef, 136, 60, 96, 1, 0, 293, 0.666626
half-size-inner-coef, 139, 61, 98, 1, 0, 299, 0.666626
half-size-inner-coef, 138, 61, 101, 1, 0, 301, 0.666626
half-size-inner-coef, 137, 60, 98, 1, 0, 296, 0.666626
half-size-inner-coef, 138, 68, 97, 1, 0, 304, 0.666626
half-size-inner-coef, 139, 61, 98, 1, 0, 299, 0.666626
half-size-inner-coef, 138, 61, 97, 1, 0, 297, 0.666626
half-size-inner-coef, 134, 60, 97, 1, 0, 292, 0.666626
half-size-inner-coef, 141, 62, 96, 1, 0, 300, 0.666626
half-size-inner-coef, 136, 64, 98, 1, 0, 299, 0.666626
half-size-inner-coef, 138, 61, 103, 1, 0, 303, 0.666626
half-size-inner-coef, 132, 61, 96, 1, 0, 290, 0.666626
half-size-inner-coef, 135, 60, 96, 1, 0, 292, 0.666626
half-size-inner-coef, 139, 61, 98, 1, 0, 299, 0.666626
half-size-inner-coef, 141, 61, 101, 1, 0, 304, 0.666626
half-size-inner-coef, 134, 61, 99, 1, 0, 295, 0.666626
half-size-inner-coef, 136, 61, 99, 1, 0, 297, 0.666626
half-size-inner-coef, 146, 61, 101, 1, 0, 309, 0.666626
half-size-inner-coef, 136, 62, 98, 1, 0, 297, 0.666626
half-size-inner-coef, 134, 60, 99, 1, 0, 294, 0.666626
half-size-inner-coef, 138, 61, 97, 1, 0, 297, 0.666626
half-size-inner-coef, 136, 60, 97, 1, 0, 294, 0.666626
half-size-inner-coef, 144, 62, 97, 1, 0, 304, 0.666626
half-size-inner-coef, 146, 62, 109, 1, 0, 318, 0.666626
half-size-inner-coef, 135, 64, 99, 1, 0, 299, 0.666626
half-size-inner-coef, 156, 61, 98, 1, 0, 316, 0.666626
half-size-inner-coef, 135, 61, 98, 1, 0, 295, 0.666626
half-size-inner-coef, 146, 61, 99, 1, 0, 307, 0.666626
half-size-inner-coef, 138, 61, 98, 1, 0, 298, 0.666626
half-size-inner-coef, 139, 61, 96, 1, 0, 297, 0.666626
half-size-inner-coef, 149, 69, 111, 1, 0, 330, 0.666626
half-size-inner-coef, 146, 63, 108, 1, 0, 318, 0.666626
half-size-inner-coef, 156, 71, 111, 1, 0, 339, 0.666626
half-size-inner-coef, 152, 81, 111, 1, 0, 345, 0.666626
half-size-inner-coef, 144, 68, 115, 1, 0, 328, 0.666626
half-size-inner-coef, 142, 69, 114, 1, 0, 326, 0.666626
half-size-inner-coef, 147, 69, 110, 1, 0, 327, 0.666626
half-size-inner-coef, 145, 72, 113, 1, 0, 331, 0.666626
half-size-inner-coef, 147, 64, 107, 1, 0, 319, 0.666626
half-size-inner-coef, 153, 73, 114, 1, 0, 341, 0.666626
half-size-inner-coef, 148, 73, 115, 6, 0, 342, 0.666626
half-size-inner-coef, 147, 60, 96, 1, 0, 304, 0.666626
half-size-inner-coef, 134, 60, 98, 1, 0, 293, 0.666626
half-size-inner-coef, 140, 63, 100, 1, 0, 304, 0.666626
half-size-inner-coef, 135, 62, 98, 1, 0, 296, 0.666626
half-size-inner-coef, 134, 61, 95, 1, 0, 291, 0.666626
half-size-inner-coef, 136, 61, 97, 1, 0, 295, 0.666626
half-size-inner-coef, 145, 60, 102, 1, 0, 308, 0.666626
half-size-inner-coef, 145, 63, 103, 1, 0, 312, 0.666626
half-size-inner-coef, 136, 61, 96, 1, 0, 294, 0.666626
half-size-inner-coef, 134, 61, 98, 1, 0, 294, 0.666626
half-size-inner-coef, 138, 60, 97, 1, 0, 296, 0.666626
half-size-inner-coef, 135, 61, 98, 1, 0, 295, 0.666626
half-size-inner-coef, 137, 61, 98, 1, 0, 297, 0.666626
half-size-inner-coef, 140, 63, 100, 1, 0, 304, 0.666626
half-size-inner-coef, 135, 61, 99, 1, 0, 296, 0.666626
half-size-inner-coef, 134, 60, 100, 1, 0, 295, 0.666626
half-size-inner-coef, 137, 60, 96, 1, 0, 294, 0.666626
half-size-inner-coef, 135, 61, 97, 1, 0, 294, 0.666626
half-size-inner-coef, 140, 63, 97, 1, 0, 301, 0.666626
half-size-inner-coef, 139, 61, 107, 1, 0, 308, 0.666626
half-size-inner-coef, 136, 62, 96, 1, 0, 295, 0.666626
half-size-inner-coef, 136, 61, 98, 1, 0, 296, 0.666626
half-size-inner-coef, 136, 61, 100, 1, 0, 298, 0.666626
half-size-inner-coef, 137, 61, 98, 1, 0, 297, 0.666626
half-size-inner-coef, 140, 65, 100, 1, 0, 306, 0.666626
half-size-inner-coef, 136, 61, 98, 1, 0, 296, 0.666626
half-size-inner-coef, 154, 61, 98, 1, 0, 314, 0.666626
half-size-inner-coef, 141, 60, 102, 1, 0, 304, 0.666626
half-size-inner-coef, 139, 62, 98, 1, 0, 300, 0.666626
half-size-inner-coef, 140, 64, 100, 1, 0, 305, 0.666626
half-size-inner-coef, 134, 60, 96, 1, 0, 291, 0.666626
half-size-inner-coef, 140, 61, 98, 1, 0, 300, 0.666626
half-size-inner-coef, 136, 65, 96, 1, 0, 298, 0.666626
half-size-inner-coef, 143, 61, 99, 1, 0, 304, 0.666626
half-size-inner-coef, 140, 61, 98, 1, 0, 300, 0.666626
half-size-inner-coef, 135, 61, 97, 1, 0, 294, 0.666626
half-size-inner-coef, 140, 61, 100, 1, 0, 302, 0.666626
half-size-inner-coef, 143, 64, 101, 1, 0, 309, 0.666626
half-size-inner-coef, 139, 62, 108, 1, 0, 310, 0.666626
half-size-inner-coef, 134, 66, 100, 1, 0, 301, 0.666626
half-size-inner-coef, 133, 61, 97, 1, 0, 292, 0.666626
half-size-inner-coef, 135, 60, 97, 1, 0, 293, 0.666626
half-size-inner-coef, 139, 61, 98, 1, 0, 299, 0.666626
half-size-inner-coef, 139, 62, 98, 1, 0, 300, 0.666626
half-size-inner-coef, 147, 60, 99, 1, 0, 307, 0.666626
half-size-inner-coef, 140, 61, 99, 1, 0, 301, 0.666626
half-size-inner-coef, 142, 61, 98, 1, 0, 302, 0.666626
half-size-inner-coef, 139, 61, 101, 1, 0, 302, 0.666626
half-size-inner-coef, 137, 64, 99, 1, 0, 301, 0.666626
half-size-inner-coef, 137, 60, 98, 1, 0, 296, 0.666626
half-size-inner-coef, 144, 61, 100, 1, 0, 306, 0.666626
half-size-inner-coef, 137, 61, 107, 1, 0, 306, 0.666626
half-size-inner-coef, 140, 62, 97, 1, 0, 300, 0.666626
half-size-inner-coef, 140, 62, 99, 1, 0, 302, 0.666626
half-size-inner-coef, 143, 62, 98, 1, 0, 304, 0.666626
half-size-inner-coef, 137, 60, 98, 1, 0, 296, 0.666626
half-size-inner-coef, 140, 62, 100, 1, 0, 303, 0.666626
half-size-inner-coef, 133, 60, 100, 1, 0, 294, 0.666626
half-size-inner-coef, 137, 65, 98, 1, 0, 301, 0.666626
half-size-inner-coef, 135, 61, 99, 1, 0, 296, 0.666626
half-size-inner-coef, 137, 61, 99, 1, 0, 298, 0.666626
half-size-inner-coef, 140, 62, 97, 1, 0, 300, 0.666626
half-size-inner-coef, 140, 59, 96, 1, 0, 296, 0.666626
half-size-inner-coef, 135, 60, 96, 1, 0, 292, 0.666626
half-size-inner-coef, 135, 63, 98, 1, 0, 297, 0.666626
half-size-inner-coef, 135, 62, 97, 1, 0, 295, 0.666626
half-size-inner-coef, 142, 62, 97, 1, 0, 302, 0.666626
half-size-inner-coef, 137, 61, 98, 1, 0, 297, 0.666626
half-size-inner-coef, 137, 61, 95, 1, 0, 294, 0.666626
half-size-inner-coef, 138, 61, 97, 1, 0, 297, 0.666626
half-size-inner-coef, 148, 62, 97, 1, 0, 308, 0.666626
half-size-inner-coef, 138, 60, 95, 1, 0, 294, 0.666626
half-size-inner-coef, 143, 61, 101, 1, 0, 306, 0.666626
half-size-inner-coef, 136, 60, 96, 1, 0, 293, 0.666626
half-size-inner-coef, 139, 61, 98, 1, 0, 299, 0.666626
half-size-inner-coef, 138, 60, 99, 1, 0, 298, 0.666626
half-size-inner-coef, 140, 61, 98, 1, 0, 300, 0.666626
half-size-inner-coef, 137, 72, 99, 1, 0, 309, 0.666626
half-size-inner-coef, 139, 60, 97, 1, 0, 297, 0.666626
half-size-inner-coef, 139, 62, 101, 1, 0, 303, 0.666626
half-size-inner-coef, 138, 61, 100, 1, 0, 300, 0.666626
half-size-inner-coef, 138, 61, 97, 1, 0, 297, 0.666626
half-size-inner-coef, 138, 60, 98, 1, 0, 297, 0.666626
half-size-inner-coef, 135, 60, 98, 1, 0, 294, 0.666626
half-size-inner-coef, 137, 61, 101, 1, 0, 300, 0.666626
half-size-inner-coef, 140, 60, 101, 1, 0, 302, 0.666626
half-size-inner-coef, 138, 61, 97, 1, 0, 297, 0.666626
half-size-inner-coef, 139, 61, 99, 1, 0, 300, 0.666626
half-size-inner-coef, 139, 62, 97, 1, 0, 299, 0.666626
half-size-inner-coef, 136, 61, 96, 1, 0, 294, 0.666626
half-size-inner-coef, 136, 73, 99, 1, 0, 309, 0.666626
half-size-inner-coef, 147, 60, 100, 1, 0, 308, 0.666626
half-size-inner-coef, 135, 61, 96, 1, 0, 293, 0.666626
half-size-inner-coef, 139, 62, 99, 1, 0, 301, 0.666626
half-size-inner-coef, 142, 60, 101, 1, 0, 304, 0.666626
half-size-inner-coef, 141, 64, 101, 1, 0, 307, 0.666626
half-size-inner-coef, 144, 61, 105, 1, 0, 311, 0.666626
half-size-inner-coef, 135, 61, 99, 1, 0, 296, 0.666626
half-size-inner-coef, 148, 63, 96, 1, 0, 308, 0.666626
half-size-inner-coef, 137, 64, 97, 1, 0, 299, 0.666626
half-size-inner-coef, 136, 65, 96, 1, 0, 298, 0.666626
half-size-inner-coef, 137, 61, 97, 1, 0, 296, 0.666626
half-size-inner-coef, 138, 61, 102, 1, 0, 302, 0.666626
half-size-inner-coef, 137, 60, 97, 1, 0, 295, 0.666626
half-size-inner-coef, 142, 66, 102, 1, 0, 311, 0.666626
half-size-inner-coef, 138, 60, 96, 1, 0, 295, 0.666626
half-size-inner-coef, 135, 60, 98, 1, 0, 294, 0.666626
half-size-inner-coef, 143, 64, 100, 1, 0, 308, 0.666626
half-size-inner-coef, 141, 61, 96, 1, 0, 299, 0.666626
half-size-inner-coef, 137, 61, 102, 1, 0, 301, 0.666626
half-size-inner-coef, 134, 61, 97, 1, 0, 293, 0.666626
half-size-inner-coef, 136, 61, 98, 1, 0, 296, 0.666626
half-size-inner-coef, 137, 61, 99, 1, 0, 298, 0.666626
half-size-inner-coef, 138, 64, 100, 1, 0, 303, 0.666626
half-size-inner-coef, 137, 61, 96, 1, 0, 295, 0.666626
half-size-inner-coef, 142, 61, 97, 1, 0, 301, 0.666626
half-size-inner-coef, 140, 62, 96, 1, 0, 299, 0.666626
half-size-inner-coef, 141, 61, 98, 1, 0, 301, 0.666626
half-size-inner-coef, 139, 60, 97, 1, 0, 297, 0.666626
half-size-inner-coef, 146, 62, 101, 1, 0, 310, 0.666626
half-size-inner-coef, 135, 61, 97, 1, 0, 294, 0.666626
half-size-inner-coef, 137, 61, 97, 1, 0, 296, 0.666626
half-size-inner-coef, 136, 63, 95, 1, 0, 295, 0.666626
half-size-inner-coef, 137, 61, 96, 1, 0, 295, 0.666626
half-size-inner-coef, 135, 61, 97, 1, 0, 294, 0.666626
half-size-inner-coef, 144, 61, 96, 1, 0, 302, 0.666626
half-size-inner-coef, 142, 60, 97, 1, 0, 300, 0.666626
half-size-inner-coef, 136, 60, 100, 1, 0, 297, 0.666626
half-size-inner-coef, 136, 61, 101, 1, 0, 299, 0.666626
half-size-inner-coef, 140, 60, 99, 1, 0, 300, 0.666626
half-size-inner-coef, 142, 62, 103, 1, 0, 308, 0.666626
half-size-inner-coef, 137, 61, 99, 1, 0, 298, 0.666626
half-size-inner-coef, 140, 60, 96, 1, 0, 297, 0.666626
half-size-inner-coef, 137, 61, 99, 1, 0, 298, 0.666626
half-size-inner-coef, 141, 63, 97, 1, 0, 302, 0.666626
half-size-inner-coef, 138, 64, 99, 1, 0, 302, 0.666626
half-size-inner-coef, 138, 61, 98, 1, 0, 298, 0.666626
half-size-inner-coef, 140, 63, 98, 1, 0, 302, 0.666626
half-size-inner-coef, 141, 61, 97, 1, 0, 300, 0.666626
half-size-inner-coef, 138, 62, 97, 1, 0, 298, 0.666626
half-size-inner-coef, 143, 62, 97, 1, 0, 303, 0.666626
half-size-inner-coef, 142, 64, 101, 1, 0, 308, 0.666626
half-size-inner-coef, 140, 60, 98, 1, 0, 299, 0.666626
half-size-inner-coef, 144, 61, 101, 1, 0, 307, 0.666626
half-size-inner-coef, 141, 61, 98, 1, 0, 301, 0.666626
half-size-inner-coef, 139, 61, 102, 1, 0, 303, 0.666626
half-size-inner-coef, 140, 61, 102, 1, 0, 304, 0.666626
half-size-inner-coef, 138, 61, 125, 1, 0, 325, 0.666626
half-size-inner-coef, 135, 62, 99, 1, 0, 297, 0.666626
half-size-inner-coef, 136, 62, 101, 1, 0, 300, 0.666626
half-size-inner-coef, 134, 61, 98, 1, 0, 294, 0.666626
half-size-inner-coef, 137, 61, 98, 1, 0, 297, 0.666626
half-size-inner-coef, 137, 60, 102, 1, 0, 300, 0.666626
half-size-inner-coef, 134, 61, 97, 1, 0, 293, 0.666626
half-size-inner-coef, 140, 62, 101, 1, 0, 304, 0.666626
half-size-inner-coef, 140, 61, 99, 1, 0, 301, 0.666626
half-size-inner-coef, 138, 61, 98, 1, 0, 298, 0.666626
half-size-inner-coef, 135, 61, 98, 1, 0, 295, 0.666626
half-size-inner-coef, 138, 61, 99, 1, 0, 299, 0.666626
half-size-inner-coef, 136, 62, 98, 1, 0, 297, 0.666626
half-size-inner-coef, 140, 67, 99, 1, 0, 307, 0.666626
half-size-inner-coef, 135, 60, 96, 1, 0, 292, 0.666626
half-size-inner-coef, 149, 63, 96, 1, 0, 309, 0.666626
half-size-inner-coef, 136, 61, 96, 1, 0, 294, 0.666626
half-size-inner-coef, 136, 62, 98, 1, 0, 297, 0.666626
half-size-inner-coef, 141, 62, 100, 1, 0, 304, 0.666626
half-size-inner-coef, 138, 60, 98, 1, 0, 297, 0.666626
half-size-inner-coef, 137, 62, 102, 1, 0, 302, 0.666626
half-size-inner-coef, 133, 60, 96, 1, 0, 290, 0.666626
half-size-inner-coef, 139, 60, 100, 1, 0, 300, 0.666626
half-size-inner-coef, 137, 61, 97, 1, 0, 296, 0.666626
half-size-inner-coef, 135, 61, 96, 1, 0, 293, 0.666626
half-size-inner-coef, 138, 62, 98, 1, 0, 299, 0.666626
half-size-inner-coef, 136, 62, 101, 1, 0, 300, 0.666626
half-size-inner-coef, 135, 60, 111, 1, 0, 307, 0.666626
half-size-inner-coef, 135, 61, 97, 1, 0, 294, 0.666626
half-size-inner-coef, 148, 61, 101, 1, 0, 311, 0.666626
half-size-inner-coef, 145, 62, 100, 1, 0, 308, 0.666626
half-size-inner-coef, 140, 61, 101, 1, 0, 303, 0.666626
half-size-inner-coef, 135, 60, 102, 1, 0, 298, 0.666626
half-size-inner-coef, 136, 61, 97, 1, 0, 295, 0.666626
half-size-inner-coef, 136, 61, 97, 1, 0, 295, 0.666626
half-size-inner-coef, 135, 61, 96, 1, 0, 293, 0.666626
half-size-inner-coef, 138, 61, 100, 1, 0, 300, 0.666626
half-size-inner-coef, 138, 61, 96, 1, 0, 296, 0.666626
half-size-inner-coef, 138, 61, 102, 1, 0, 302, 0.666626
half-size-inner-coef, 151, 61, 100, 1, 0, 313, 0.666626
half-size-inner-coef, 136, 61, 101, 1, 0, 299, 0.666626
half-size-inner-coef, 146, 66, 103, 1, 0, 316, 0.666626
half-size-inner-coef, 137, 60, 97, 1, 0, 295, 0.666626
half-size-inner-coef, 139, 60, 96, 1, 0, 296, 0.666626
half-size-inner-coef, 138, 62, 98, 1, 0, 299, 0.666626
half-size-inner-coef, 137, 61, 102, 1, 0, 301, 0.666626
half-size-inner-coef, 140, 61, 101, 1, 0, 303, 0.666626
half-size-inner-coef, 143, 63, 99, 1, 0, 306, 0.666626
half-size-inner-coef, 138, 63, 100, 1, 0, 302, 0.666626
half-size-inner-coef, 143, 61, 98, 1, 0, 303, 0.666626
half-size-inner-coef, 139, 62, 98, 1, 0, 300, 0.666626
half-size-inner-coef, 138, 61, 99, 1, 0, 299, 0.666626
half-size-inner-coef, 143, 61, 97, 1, 0, 302, 0.666626
half-size-inner-coef, 139, 61, 97, 1, 0, 298, 0.666626
half-size-inner-coef, 138, 60, 97, 1, 0, 296, 0.666626
half-size-inner-coef, 138, 61, 101, 1, 0, 301, 0.666626
half-size-inner-coef, 140, 62, 100, 1, 0, 303, 0.666626
half-size-inner-coef, 138, 60, 96, 1, 0, 295, 0.666626
half-size-inner-coef, 136, 66, 101, 1, 0, 304, 0.666626
half-size-inner-coef, 138, 60, 97, 1, 0, 296, 0.666626
half-size-inner-coef, 147, 63, 101, 1, 0, 312, 0.666626
half-size-inner-coef, 141, 62, 99, 1, 0, 303, 0.666626
half-size-inner-coef, 140, 62, 100, 1, 0, 303, 0.666626
half-size-inner-coef, 148, 67, 100, 1, 0, 316, 0.666626
half-size-inner-coef, 140, 64, 97, 1, 0, 302, 0.666626
half-size-inner-coef, 137, 60, 97, 1, 0, 295, 0.666626
half-size-inner-coef, 136, 61, 100, 1, 0, 298, 0.666626
half-size-inner-coef, 140, 63, 98, 1, 0, 302, 0.666626
half-size-inner-coef, 134, 61, 97, 1, 0, 293, 0.666626
half-size-inner-coef, 137, 60, 100, 1, 0, 298, 0.666626
half-size-inner-coef, 137, 61, 97, 1, 0, 296, 0.666626
half-size-inner-coef, 136, 65, 99, 1, 0, 301, 0.666626
half-size-inner-coef, 136, 60, 98, 1, 0, 295, 0.666626
half-size-inner-coef, 140, 62, 99, 1, 0, 302, 0.666626
half-size-inner-coef, 137, 61, 103, 1, 0, 302, 0.666626
half-size-inner-coef, 136, 62, 97, 1, 0, 296, 0.666626
half-size-inner-coef, 134, 61, 97, 1, 0, 293, 0.666626
half-size-inner-coef, 143, 62, 101, 1, 0, 307, 0.666626
half-size-inner-coef, 135, 60, 96, 1, 0, 292, 0.666626
half-size-inner-coef, 138, 62, 97, 1, 0, 298, 0.666626
half-size-inner-coef, 136, 62, 100, 1, 0, 299, 0.666626
half-size-inner-coef, 136, 61, 98, 1, 0, 296, 0.666626
half-size-inner-coef, 140, 61, 98, 1, 0, 300, 0.666626
half-size-inner-coef, 141, 61, 97, 1, 0, 300, 0.666626
half-size-inner-coef, 149, 62, 101, 1, 0, 313, 0.666626
half-size-inner-coef, 140, 62, 99, 1, 0, 302, 0.666626
half-size-inner-coef, 138, 62, 100, 1, 0, 301, 0.666626
half-size-inner-coef, 142, 61, 100, 1, 0, 304, 0.666626
half-size-inner-coef, 140, 61, 98, 1, 0, 300, 0.666626
half-size-inner-coef, 134, 61, 97, 1, 0, 293, 0.666626
half-size-inner-coef, 141, 62, 103, 1, 0, 307, 0.666626
half-size-inner-coef, 136, 60, 97, 1, 0, 294, 0.666626
half-size-inner-coef, 135, 62, 100, 1, 0, 298, 0.666626
half-size-inner-coef, 135, 60, 99, 1, 0, 295, 0.666626
half-size-inner-coef, 139, 63, 103, 1, 0, 306, 0.666626
half-size-inner-coef, 148, 61, 102, 1, 0, 312, 0.666626
half-size-inner-coef, 144, 60, 97, 1, 0, 302, 0.666626
half-size-inner-coef, 141, 62, 101, 1, 0, 305, 0.666626
half-size-inner-coef, 137, 62, 101, 1, 0, 301, 0.666626
half-size-inner-coef, 139, 62, 99, 1, 0, 301, 0.666626
half-size-inner-coef, 140, 61, 99, 1, 0, 301, 0.666626
half-size-inner-coef, 134, 61, 97, 1, 0, 293, 0.666626
half-size-inner-coef, 138, 60, 96, 1, 0, 295, 0.666626
half-size-inner-coef, 134, 60, 101, 1, 0, 296, 0.666626
half-size-inner-coef, 136, 64, 97, 1, 0, 298, 0.666626
half-size-inner-coef, 139, 61, 99, 1, 0, 300, 0.666626
half-size-inner-coef, 138, 61, 102, 1, 0, 302, 0.666626
half-size-inner-coef, 135, 61, 98, 1, 0, 295, 0.666626
half-size-inner-coef, 136, 61, 102, 1, 0, 300, 0.666626
half-size-inner-coef, 134, 61, 97, 1, 0, 293, 0.666626
half-size-inner-coef, 138, 60, 97, 1, 0, 296, 0.666626
half-size-inner-coef, 137, 61, 97, 1, 0, 296, 0.666626
half-size-inner-coef, 147, 63, 101, 1, 0, 312, 0.666626
half-size-inner-coef, 136, 65, 99, 1, 0, 301, 0.666626
half-size-inner-coef, 137, 61, 97, 1, 0, 296, 0.666626
half-size-inner-coef, 140, 60, 100, 1, 0, 301, 0.666626
half-size-inner-coef, 138, 61, 104, 1, 0, 304, 0.666626
half-size-inner-coef, 140, 61, 97, 1, 0, 299, 0.666626
half-size-inner-coef, 139, 60, 96, 1, 0, 296, 0.666626
half-size-inner-coef, 137, 61, 99, 1, 0, 298, 0.666626
half-size-inner-coef, 135, 60, 99, 1, 0, 295, 0.666626
half-size-inner-coef, 134, 61, 97, 1, 0, 293, 0.666626
half-size-inner-coef, 142, 65, 99, 1, 0, 307, 0.666626
half-size-inner-coef, 137, 60, 97, 1, 0, 295, 0.666626
half-size-inner-coef, 138, 61, 97, 1, 0, 297, 0.666626
half-size-inner-coef, 144, 61, 99, 1, 0, 305, 0.666626
half-size-inner-coef, 142, 62, 103, 1, 0, 308, 0.666626
half-size-inner-coef, 138, 61, 96, 1, 0, 296, 0.666626
half-size-inner-coef, 142, 62, 99, 1, 0, 304, 0.666626
half-size-inner-coef, 134, 60, 105, 1, 0, 300, 0.666626
half-size-inner-coef, 142, 62, 96, 1, 0, 301, 0.666626
half-size-inner-coef, 139, 62, 98, 1, 0, 300, 0.666626
half-size-inner-coef, 135, 62, 98, 1, 0, 296, 0.666626
half-size-inner-coef, 143, 62, 97, 1, 0, 303, 0.666626
half-size-inner-coef, 144, 61, 97, 1, 0, 303, 0.666626
half-size-inner-coef, 140, 62, 97, 1, 0, 300, 0.666626
half-size-inner-coef, 136, 60, 96, 1, 0, 293, 0.666626
half-size-inner-coef, 136, 60, 96, 1, 0, 293, 0.666626
half-size-inner-coef, 136, 60, 97, 1, 0, 294, 0.666626
half-size-inner-coef, 137, 61, 98, 1, 0, 297, 0.666626
half-size-inner-coef, 137, 63, 99, 1, 0, 300, 0.666626
half-size-inner-coef, 135, 61, 96, 1, 0, 293, 0.666626
half-size-inner-coef, 135, 63, 99, 1, 0, 298, 0.666626
half-size-inner-coef, 146, 61, 96, 1, 0, 304, 0.666626
half-size-inner-coef, 140, 61, 97, 1, 0, 299, 0.666626
half-size-inner-coef, 138, 62, 101, 1, 0, 302, 0.666626
half-size-inner-coef, 137, 62, 97, 1, 0, 297, 0.666626
half-size-inner-coef, 137, 63, 98, 1, 0, 299, 0.666626
half-size-inner-coef, 143, 60, 100, 1, 0, 304, 0.666626
half-size-inner-coef, 141, 62, 100, 1, 0, 304, 0.666626
half-size-inner-coef, 139, 61, 97, 1, 0, 298, 0.666626
half-size-inner-coef, 137, 60, 102, 1, 0, 300, 0.666626
half-size-inner-coef, 139, 60, 98, 1, 0, 298, 0.666626
half-size-inner-coef, 140, 60, 100, 1, 0, 301, 0.666626
half-size-inner-coef, 139, 61, 99, 1, 0, 300, 0.666626
half-size-inner-coef, 146, 70, 99, 1, 0, 316, 0.666626
half-size-inner-coef, 139, 61, 97, 1, 0, 298, 0.666626
half-size-inner-coef, 136, 64, 99, 1, 0, 300, 0.666626
half-size-inner-coef, 145, 61, 99, 1, 0, 306, 0.666626
half-size-inner-coef, 140, 63, 98, 1, 0, 302, 0.666626
half-size-inner-coef, 141, 60, 100, 1, 0, 302, 0.666626
half-size-inner-coef, 136, 61, 102, 1, 0, 300, 0.666626
half-size-inner-coef, 134, 60, 96, 1, 0, 291, 0.666626
half-size-inner-coef, 134, 61, 95, 1, 0, 291, 0.666626
half-size-inner-coef, 143, 63, 99, 1, 0, 306, 0.666626
half-size-inner-coef, 139, 62, 96, 1, 0, 298, 0.666626
half-size-inner-coef, 137, 61, 98, 1, 0, 297, 0.666626
half-size-inner-coef, 140, 61, 96, 1, 0, 298, 0.666626
half-size-inner-coef, 141, 62, 98, 1, 0, 302, 0.666626
half-size-inner-coef, 134, 61, 96, 1, 0, 292, 0.666626
half-size-inner-coef, 134, 60, 99, 1, 0, 294, 0.666626
half-size-inner-coef, 138, 62, 100, 1, 0, 301, 0.666626
half-size-inner-coef, 139, 61, 96, 1, 0, 297, 0.666626
half-size-inner-coef, 138, 60, 100, 1, 0, 299, 0.666626
half-size-inner-coef, 134, 60, 115, 1, 0, 310, 0.666626
half-size-inner-coef, 136, 62, 97, 1, 0, 296, 0.666626
half-size-inner-coef, 140, 60, 95, 1, 0, 296, 0.666626
half-size-inner-coef, 137, 61, 97, 1, 0, 296, 0.666626
half-size-inner-coef, 144, 62, 99, 1, 0, 306, 0.666626
half-size-inner-coef, 135, 61, 97, 1, 0, 294, 0.666626
half-size-inner-coef, 136, 60, 96, 1, 0, 293, 0.666626
half-size-inner-coef, 146, 62, 98, 1, 0, 307, 0.666626
half-size-inner-coef, 136, 61, 102, 1, 0, 300, 0.666626
half-size-inner-coef, 136, 61, 96, 1, 0, 294, 0.666626
half-size-inner-coef, 134, 61, 97, 1, 0, 293, 0.666626
half-size-inner-coef, 142, 65, 98, 1, 0, 306, 0.666626
half-size-inner-coef, 136, 61, 98, 1, 0, 296, 0.666626
half-size-inner-coef, 135, 61, 96, 1, 0, 293, 0.666626
half-size-inner-coef, 139, 63, 100, 1, 0, 303, 0.666626
half-size-inner-coef, 141, 61, 102, 1, 0, 305, 0.666626
half-size-inner-coef, 139, 63, 105, 1, 0, 308, 0.666626
half-size-inner-coef, 141, 61, 100, 1, 0, 303, 0.666626
half-size-inner-coef, 148, 61, 99, 1, 0, 309, 0.666626
half-size-inner-coef, 137, 62, 99, 1, 0, 299, 0.666626
half-size-inner-coef, 141, 62, 97, 1, 0, 301, 0.666626
half-size-inner-coef, 139, 63, 101, 1, 0, 304, 0.666626
half-size-inner-coef, 137, 60, 100, 1, 0, 298, 0.666626
half-size-inner-coef, 135, 61, 101, 1, 0, 298, 0.666626
half-size-inner-coef, 138, 60, 105, 1, 0, 304, 0.666626
half-size-inner-coef, 135, 60, 97, 1, 0, 293, 0.666626
half-size-inner-coef, 145, 64, 100, 1, 0, 310, 0.666626
half-size-inner-coef, 143, 61, 100, 1, 0, 305, 0.666626
half-size-inner-coef, 145, 60, 100, 1, 0, 306, 0.666626
half-size-inner-coef, 136, 64, 100, 1, 0, 301, 0.666626
half-size-inner-coef, 136, 61, 99, 1, 0, 297, 0.666626
half-size-inner-coef, 148, 61, 101, 1, 0, 311, 0.666626
half-size-inner-coef, 141, 61, 96, 1, 0, 299, 0.666626
half-size-inner-coef, 134, 61, 97, 1, 0, 293, 0.666626
half-size-inner-coef, 142, 60, 96, 1, 0, 299, 0.666626
half-size-inner-coef, 134, 60, 98, 1, 0, 293, 0.666626
half-size-inner-coef, 136, 60, 98, 1, 0, 295, 0.666626
half-size-inner-coef, 140, 61, 104, 1, 0, 306, 0.666626
half-size-inner-coef, 138, 61, 96, 1, 0, 296, 0.666626
half-size-inner-coef, 139, 62, 97, 1, 0, 299, 0.666626
half-size-inner-coef, 139, 61, 99, 1, 0, 300, 0.666626
half-size-inner-coef, 141, 60, 101, 1, 0, 303, 0.666626
half-size-inner-coef, 137, 60, 97, 1, 0, 295, 0.666626
half-size-inner-coef, 136, 61, 98, 1, 0, 296, 0.666626
half-size-inner-coef, 142, 63, 99, 1, 0, 305, 0.666626
half-size-inner-coef, 142, 66, 97, 1, 0, 306, 0.666626
half-size-inner-coef, 136, 61, 97, 1, 0, 295, 0.666626
half-size-inner-coef, 141, 62, 101, 1, 0, 305, 0.666626
half-size-inner-coef, 135, 61, 100, 1, 0, 297, 0.666626
half-size-inner-coef, 135, 60, 96, 1, 0, 292, 0.666626
half-size-inner-coef, 135, 71, 95, 1, 0, 302, 0.666626
half-size-inner-coef, 138, 62, 97, 1, 0, 298, 0.666626
half-size-inner-coef, 146, 63, 99, 1, 0, 309, 0.666626
half-size-inner-coef, 144, 61, 99, 1, 0, 305, 0.666626
half-size-inner-coef, 138, 63, 98, 1, 0, 300, 0.666626
half-size-inner-coef, 142, 61, 101, 1, 0, 305, 0.666626
half-size-inner-coef, 143, 62, 99, 1, 0, 305, 0.666626
half-size-inner-coef, 136, 60, 99, 1, 0, 296, 0.666626
half-size-inner-coef, 141, 60, 97, 1, 0, 299, 0.666626
half-size-inner-coef, 135, 61, 97, 1, 0, 294, 0.666626
half-size-inner-coef, 134, 61, 97, 1, 0, 293, 0.666626
half-size-inner-coef, 136, 61, 98, 1, 0, 296, 0.666626
half-size-inner-coef, 142, 61, 98, 1, 0, 302, 0.666626
half-size-inner-coef, 138, 63, 97, 1, 0, 299, 0.666626
half-size-inner-coef, 142, 61, 99, 1, 0, 303, 0.666626
half-size-inner-coef, 141, 61, 97, 1, 0, 300, 0.666626
half-size-inner-coef, 144, 61, 97, 1, 0, 303, 0.666626
half-size-inner-coef, 137, 62, 100, 1, 0, 300, 0.666626
half-size-inner-coef, 141, 62, 99, 1, 0, 303, 0.666626
half-size-inner-coef, 135, 61, 100, 1, 0, 297, 0.666626
half-size-inner-coef, 142, 61, 100, 1, 0, 304, 0.666626
half-size-inner-coef, 137, 62, 97, 1, 0, 297, 0.666626
half-size-inner-coef, 145, 62, 99, 1, 0, 307, 0.666626
half-size-inner-coef, 140, 61, 98, 1, 0, 300, 0.666626
half-size-inner-coef, 137, 61, 100, 1, 0, 299, 0.666626
half-size-inner-coef, 140, 61, 97, 1, 0, 299, 0.666626
half-size-inner-coef, 138, 61, 100, 1, 0, 300, 0.666626
half-size-inner-coef, 136, 62, 98, 1, 0, 297, 0.666626
half-size-inner-coef, 140, 62, 99, 1, 0, 302, 0.666626
half-size-inner-coef, 137, 61, 98, 1, 0, 297, 0.666626
half-size-inner-coef, 139, 61, 98, 1, 0, 299, 0.666626
half-size-inner-coef, 136, 60, 97, 1, 0, 294, 0.666626
half-size-inner-coef, 135, 61, 102, 1, 0, 299, 0.666626
half-size-inner-coef, 138, 61, 97, 1, 0, 297, 0.666626
half-size-inner-coef, 140, 61, 105, 1, 0, 307, 0.666626
half-size-inner-coef, 142, 61, 97, 1, 0, 301, 0.666626
half-size-inner-coef, 137, 63, 97, 1, 0, 298, 0.666626
half-size-inner-coef, 136, 60, 96, 1, 0, 293, 0.666626
half-size-inner-coef, 142, 61, 97, 1, 0, 301, 0.666626
half-size-inner-coef, 151, 62, 98, 1, 0, 312, 0.666626
half-size-inner-coef, 139, 61, 99, 1, 0, 300, 0.666626
half-size-inner-coef, 136, 61, 96, 1, 0, 294, 0.666626
half-size-inner-coef, 141, 60, 98, 1, 0, 300, 0.666626
half-size-inner-coef, 136, 61, 98, 1, 0, 296, 0.666626
half-size-inner-coef, 135, 60, 96, 1, 0, 292, 0.666626
half-size-inner-coef, 133, 60, 102, 1, 0, 296, 0.666626
half-size-inner-coef, 140, 61, 101, 1, 0, 303, 0.666626
half-size-inner-coef, 139, 61, 98, 1, 0, 299, 0.666626
half-size-inner-coef, 138, 60, 97, 1, 0, 296, 0.666626
half-size-inner-coef, 136, 60, 97, 1, 0, 294, 0.666626
half-size-inner-coef, 142, 64, 97, 1, 0, 304, 0.666626
half-size-inner-coef, 141, 60, 99, 1, 0, 301, 0.666626
half-size-inner-coef, 146, 63, 96, 1, 0, 306, 0.666626
half-size-inner-coef, 143, 63, 100, 1, 0, 307, 0.666626
half-size-inner-coef, 139, 61, 100, 1, 0, 301, 0.666626
half-size-inner-coef, 135, 61, 98, 1, 0, 295, 0.666626
half-size-inner-coef, 139, 65, 98, 1, 0, 303, 0.666626
half-size-inner-coef, 133, 60, 98, 1, 0, 292, 0.666626
half-size-inner-coef, 134, 60, 101, 1, 0, 296, 0.666626
half-size-inner-coef, 144, 61, 98, 1, 0, 304, 0.666626
half-size-inner-coef, 139, 62, 100, 1, 0, 302, 0.666626
half-size-inner-coef, 137, 62, 96, 1, 0, 296, 0.666626
half-size-inner-coef, 137, 64, 101, 1, 0, 303, 0.666626
half-size-inner-coef, 137, 61, 98, 1, 0, 297, 0.666626
half-size-inner-coef, 138, 61, 96, 1, 0, 296, 0.666626
half-size-inner-coef, 136, 60, 96, 1, 0, 293, 0.666626
half-size-inner-coef, 139, 62, 101, 1, 0, 303, 0.666626
half-size-inner-coef, 143, 61, 97, 1, 0, 302, 0.666626
half-size-inner-coef, 133, 60, 96, 1, 0, 290, 0.666626
half-size-inner-coef, 137, 60, 100, 1, 0, 298, 0.666626
half-size-inner-coef, 147, 61, 103, 1, 0, 312, 0.666626
half-size-inner-coef, 141, 60, 97, 1, 0, 299, 0.666626
half-size-inner-coef, 139, 62, 99, 1, 0, 301, 0.666626
half-size-inner-coef, 146, 61, 99, 1, 0, 307, 0.666626
half-size-inner-coef, 135, 60, 98, 1, 0, 294, 0.666626
half-size-inner-coef, 141, 61, 101, 1, 0, 304, 0.666626
half-size-inner-coef, 135, 61, 99, 1, 0, 296, 0.666626
half-size-inner-coef, 137, 61, 104, 1, 0, 303, 0.666626
half-size-inner-coef, 136, 60, 96, 1, 0, 293, 0.666626
half-size-inner-coef, 139, 63, 100, 1, 0, 303, 0.666626
half-size-inner-coef, 138, 61, 97, 1, 0, 297, 0.666626
half-size-inner-coef, 137, 61, 100, 1, 0, 299, 0.666626
half-size-inner-coef, 145, 62, 100, 1, 0, 308, 0.666626
half-size-inner-coef, 135, 68, 99, 1, 0, 303, 0.666626
half-size-inner-coef, 140, 62, 97, 1, 0, 300, 0.666626
half-size-inner-coef, 137, 61, 97, 1, 0, 296, 0.666626
half-size-inner-coef, 140, 60, 99, 1, 0, 300, 0.666626
half-size-inner-coef, 145, 61, 101, 1, 0, 308, 0.666626
half-size-inner-coef, 141, 62, 98, 1, 0, 302, 0.666626
half-size-inner-coef, 138, 61, 98, 1, 0, 298, 0.666626
half-size-inner-coef, 135, 61, 99, 1, 0, 296, 0.666626
half-size-inner-coef, 139, 63, 99, 1, 0, 302, 0.666626
half-size-inner-coef, 134, 61, 97, 1, 0, 293, 0.666626
half-size-inner-coef, 141, 63, 99, 1, 0, 304, 0.666626
half-size-inner-coef, 141, 62, 97, 1, 0, 301, 0.666626
half-size-inner-coef, 141, 61, 96, 1, 0, 299, 0.666626
half-size-inner-coef, 136, 64, 97, 1, 0, 298, 0.666626
half-size-inner-coef, 138, 61, 98, 1, 0, 298, 0.666626
half-size-inner-coef, 137, 60, 101, 1, 0, 299, 0.666626
half-size-inner-coef, 136, 61, 97, 1, 0, 295, 0.666626
half-size-inner-coef, 138, 62, 98, 1, 0, 299, 0.666626
half-size-inner-coef, 134, 63, 96, 1, 0, 294, 0.666626
half-size-inner-coef, 138, 61, 98, 1, 0, 298, 0.666626
half-size-inner-coef, 137, 63, 96, 1, 0, 297, 0.666626
half-size-inner-coef, 137, 62, 98, 1, 0, 298, 0.666626
half-size-inner-coef, 142, 63, 98, 1, 0, 304, 0.666626
half-size-inner-coef, 133, 60, 97, 1, 0, 291, 0.666626
half-size-inner-coef, 136, 61, 98, 1, 0, 296, 0.666626
half-size-inner-coef, 146, 63, 99, 1, 0, 309, 0.666626
half-size-inner-coef, 140, 59, 95, 1, 0, 295, 0.666626
half-size-inner-coef, 138, 63, 100, 1, 0, 302, 0.666626
half-size-inner-coef, 134, 60, 98, 1, 0, 293, 0.666626
half-size-inner-coef, 139, 63, 97, 1, 0, 300, 0.666626
half-size-inner-coef, 143, 61, 96, 1, 0, 301, 0.666626
half-size-inner-coef, 144, 61, 97, 1, 0, 303, 0.666626
half-size-inner-coef, 138, 60, 96, 1, 0, 295, 0.666626
half-size-inner-coef, 137, 60, 96, 1, 0, 294, 0.666626
half-size-inner-coef, 141, 61, 97, 1, 0, 300, 0.666626
half-size-inner-coef, 145, 60, 98, 1, 0, 304, 0.666626
half-size-inner-coef, 139, 62, 97, 1, 0, 299, 0.666626
half-size-inner-coef, 144, 61, 97, 1, 0, 303, 0.666626
half-size-inner-coef, 141, 62, 97, 1, 0, 301, 0.666626
half-size-inner-coef, 139, 61, 101, 1, 0, 302, 0.666626
half-size-inner-coef, 143, 61, 97, 1, 0, 302, 0.666626
half-size-inner-coef, 143, 63, 100, 1, 0, 307, 0.666626
half-size-inner-coef, 137, 61, 97, 1, 0, 296, 0.666626
half-size-inner-coef, 136, 61, 98, 1, 0, 296, 0.666626
half-size-inner-coef, 140, 63, 97, 1, 0, 301, 0.666626
half-size-inner-coef, 162, 62, 98, 1, 0, 323, 0.666626
half-size-inner-coef, 142, 61, 97, 1, 0, 301, 0.666626
half-size-inner-coef, 142, 61, 101, 1, 0, 305, 0.666626
half-size-inner-coef, 135, 60, 99, 1, 0, 295, 0.666626
half-size-inner-coef, 140, 62, 101, 1, 0, 304, 0.666626
half-size-inner-coef, 139, 61, 97, 1, 0, 298, 0.666626
half-size-inner-coef, 148, 69, 100, 1, 0, 318, 0.666626
half-size-inner-coef, 137, 61, 102, 1, 0, 301, 0.666626
half-size-inner-coef, 148, 61, 99, 1, 0, 309, 0.666626
half-size-inner-coef, 141, 61, 97, 1, 0, 300, 0.666626
half-size-inner-coef, 140, 60, 95, 1, 0, 296, 0.666626
half-size-inner-coef, 139, 61, 102, 1, 0, 303, 0.666626
half-size-inner-coef, 137, 60, 100, 1, 0, 298, 0.666626
half-size-inner-coef, 146, 62, 101, 1, 0, 310, 0.666626
half-size-inner-coef, 143, 61, 99, 1, 0, 304, 0.666626
half-size-inner-coef, 136, 61, 102, 1, 0, 300, 0.666626
half-size-inner-coef, 136, 61, 97, 1, 0, 295, 0.666626
half-size-inner-coef, 138, 61, 96, 1, 0, 296, 0.666626
half-size-inner-coef, 142, 61, 101, 1, 0, 305, 0.666626
half-size-inner-coef, 141, 60, 101, 1, 0, 303, 0.666626
half-size-inner-coef, 143, 65, 101, 1, 0, 310, 0.666626
half-size-inner-coef, 134, 62, 100, 1, 0, 297, 0.666626
half-size-inner-coef, 138, 62, 99, 1, 0, 300, 0.666626
half-size-inner-coef, 143, 60, 100, 1, 0, 304, 0.666626
half-size-inner-coef, 139, 61, 97, 1, 0, 298, 0.666626
half-size-inner-coef, 140, 62, 102, 1, 0, 305, 0.666626
half-size-inner-coef, 137, 60, 96, 1, 0, 294, 0.666626
half-size-inner-coef, 138, 60, 97, 1, 0, 296, 0.666626
half-size-inner-coef, 140, 61, 98, 1, 0, 300, 0.666626
half-size-inner-coef, 146, 64, 102, 1, 0, 313, 0.666626
half-size-inner-coef, 139, 63, 101, 1, 0, 304, 0.666626
half-size-inner-coef, 147, 62, 101, 1, 0, 311, 0.666626
half-size-inner-coef, 138, 60, 96, 1, 0, 295, 0.666626
half-size-inner-coef, 135, 62, 97, 1, 0, 295, 0.666626
half-size-inner-coef, 136, 63, 99, 1, 0, 299, 0.666626
half-size-inner-coef, 143, 62, 104, 1, 0, 310, 0.666626
half-size-inner-coef, 138, 61, 100, 1, 0, 300, 0.666626
half-size-inner-coef, 141, 62, 100, 1, 0, 304, 0.666626
half-size-inner-coef, 140, 70, 102, 1, 0, 313, 0.666626
half-size-inner-coef, 139, 61, 101, 1, 0, 302, 0.666626
half-size-inner-coef, 135, 61, 96, 1, 0, 293, 0.666626
half-size-inner-coef, 139, 61, 100, 1, 0, 301, 0.666626
half-size-inner-coef, 139, 62, 100, 1, 0, 302, 0.666626
half-size-inner-coef, 139, 61, 97, 1, 0, 298, 0.666626
half-size-inner-coef, 136, 60, 103, 1, 0, 300, 0.666626
half-size-inner-coef, 137, 62, 97, 1, 0, 297, 0.666626
half-size-inner-coef, 142, 61, 108, 1, 0, 312, 0.666626
half-size-inner-coef, 139, 60, 103, 1, 0, 303, 0.666626
half-size-inner-coef, 138, 61, 100, 1, 0, 300, 0.666626
half-size-inner-coef, 136, 63, 99, 1, 0, 299, 0.666626
half-size-inner-coef, 152, 62, 103, 1, 0, 318, 0.666626
half-size-inner-coef, 139, 62, 98, 1, 0, 300, 0.666626
half-size-inner-coef, 137, 61, 96, 1, 0, 295, 0.666626
half-size-inner-coef, 134, 61, 97, 1, 0, 293, 0.666626
half-size-inner-coef, 136, 61, 98, 1, 0, 296, 0.666626
half-size-inner-coef, 139, 60, 99, 1, 0, 299, 0.666626
half-size-inner-coef, 141, 64, 98, 1, 0, 304, 0.666626
half-size-inner-coef, 136, 60, 101, 1, 0, 298, 0.666626
half-size-inner-coef, 136, 61, 98, 1, 0, 296, 0.666626
half-size-inner-coef, 148, 60, 96, 1, 0, 305, 0.666626
half-size-inner-coef, 140, 61, 98, 1, 0, 300, 0.666626
half-size-inner-coef, 137, 61, 97, 1, 0, 296, 0.666626
half-size-inner-coef, 139, 61, 101, 1, 0, 302, 0.666626
half-size-inner-coef, 140, 61, 100, 1, 0, 302, 0.666626
half-size-inner-coef, 142, 64, 101, 1, 0, 308, 0.666626
half-size-inner-coef, 137, 60, 96, 1, 0, 294, 0.666626
half-size-inner-coef, 137, 60, 97, 1, 0, 295, 0.666626
half-size-inner-coef, 138, 60, 102, 1, 0, 301, 0.666626
half-size-inner-coef, 137, 61, 97, 1, 0, 296, 0.666626
half-size-inner-coef, 144, 60, 96, 1, 0, 301, 0.666626
half-size-inner-coef, 137, 61, 107, 1, 0, 306, 0.666626
half-size-inner-coef, 137, 61, 97, 1, 0, 296, 0.666626
half-size-inner-coef, 136, 61, 97, 1, 0, 295, 0.666626
half-size-inner-coef, 139, 61, 98, 1, 0, 299, 0.666626
half-size-inner-coef, 136, 61, 98, 1, 0, 296, 0.666626
half-size-inner-coef, 139, 61, 101, 1, 0, 302, 0.666626
half-size-inner-coef, 140, 61, 97, 1, 0, 299, 0.666626
half-size-inner-coef, 146, 60, 97, 1, 0, 304, 0.666626
half-size-inner-coef, 137, 61, 101, 1, 0, 300, 0.666626
half-size-inner-coef, 136, 61, 101, 1, 0, 299, 0.666626
half-size-inner-coef, 138, 64, 100, 1, 0, 303, 0.666626
half-size-inner-coef, 139, 60, 98, 1, 0, 298, 0.666626
half-size-inner-coef, 135, 60, 97, 1, 0, 293, 0.666626
half-size-inner-coef, 135, 66, 97, 1, 0, 299, 0.666626
half-size-inner-coef, 141, 61, 98, 1, 0, 301, 0.666626
half-size-inner-coef, 135, 63, 99, 1, 0, 298, 0.666626
half-size-inner-coef, 143, 62, 100, 1, 0, 306, 0.666626
half-size-inner-coef, 136, 62, 98, 1, 0, 297, 0.666626
half-size-inner-coef, 141, 62, 99, 1, 0, 303, 0.666626
half-size-inner-coef, 140, 62, 100, 1, 0, 303, 0.666626
half-size-inner-coef, 136, 61, 98, 1, 0, 296, 0.666626
half-size-inner-coef, 139, 62, 98, 1, 0, 300, 0.666626
half-size-inner-coef, 138, 64, 99, 1, 0, 302, 0.666626
half-size-inner-coef, 143, 62, 97, 1, 0, 303, 0.666626
half-size-inner-coef, 134, 60, 96, 1, 0, 291, 0.666626
half-size-inner-coef, 138, 61, 98, 1, 0, 298, 0.666626
half-size-inner-coef, 142, 64, 98, 1, 0, 305, 0.666626
half-size-inner-coef, 138, 60, 100, 1, 0, 299, 0.666626
half-size-inner-coef, 136, 62, 96, 1, 0, 295, 0.666626
half-size-inner-coef, 134, 61, 99, 1, 0, 295, 0.666626
half-size-inner-coef, 140, 61, 100, 1, 0, 302, 0.666626
half-size-inner-coef, 136, 61, 97, 1, 0, 295, 0.666626
half-size-inner-coef, 138, 61, 102, 1, 0, 302, 0.666626
half-size-inner-coef, 135, 61, 98, 1, 0, 295, 0.666626
half-size-inner-coef, 142, 60, 96, 1, 0, 299, 0.666626
half-size-inner-coef, 138, 61, 98, 1, 0, 298, 0.666626
half-size-inner-coef, 138, 61, 97, 1, 0, 297, 0.666626
half-size-inner-coef, 136, 66, 98, 1, 0, 301, 0.666626
half-size-inner-coef, 136, 62, 99, 1, 0, 298, 0.666626
half-size-inner-coef, 141, 60, 97, 1, 0, 299, 0.666626
half-size-inner-coef, 147, 60, 99, 1, 0, 307, 0.666626
half-size-inner-coef, 137, 60, 98, 1, 0, 296, 0.666626
half-size-inner-coef, 137, 61, 98, 1, 0, 297, 0.666626
half-size-inner-coef, 146, 62, 103, 1, 0, 312, 0.666626
half-size-inner-coef, 141, 61, 99, 1, 0, 302, 0.666626
half-size-inner-coef, 139, 62, 106, 1, 0, 308, 0.666626
half-size-inner-coef, 138, 61, 94, 1, 0, 294, 0.666626
half-size-inner-coef, 137, 61, 96, 1, 0, 295, 0.666626
half-size-inner-coef, 137, 61, 101, 1, 0, 300, 0.666626
half-size-inner-coef, 137, 61, 100, 1, 0, 299, 0.666626
half-size-inner-coef, 137, 62, 97, 1, 0, 297, 0.666626
half-size-inner-coef, 138, 62, 98, 1, 0, 299, 0.666626
half-size-inner-coef, 146, 65, 104, 1, 0, 316, 0.666626
half-size-inner-coef, 136, 62, 103, 1, 0, 302, 0.666626
half-size-inner-coef, 144, 62, 101, 1, 0, 308, 0.666626
half-size-inner-coef, 136, 61, 100, 1, 0, 298, 0.666626
half-size-inner-coef, 142, 61, 97, 1, 0, 301, 0.666626
half-size-inner-coef, 139, 63, 99, 1, 0, 302, 0.666626
half-size-inner-coef, 135, 65, 103, 1, 0, 304, 0.666626
half-size-inner-coef, 147, 72, 109, 5, 0, 333, 0.666626
half-size-inner-coef, 154, 69, 110, 1, 0, 334, 0.666626
half-size-inner-coef, 153, 71, 112, 1, 0, 337, 0.666626
half-size-inner-coef, 154, 70, 111, 1, 0, 336, 0.666626
half-size-inner-coef, 159, 73, 111, 1, 0, 344, 0.666626
half-size-inner-coef, 153, 66, 146, 1, 0, 366, 0.666626
half-size-inner-coef, 170, 69, 115, 1, 0, 355, 0.666626
half-size-inner-coef, 151, 88, 110, 1, 0, 350, 0.666626
half-size-inner-coef, 145, 61, 103, 1, 0, 310, 0.666626
half-size-inner-coef, 136, 60, 98, 1, 0, 295, 0.666626
half-size-inner-coef, 142, 61, 99, 1, 0, 303, 0.666626
half-size-inner-coef, 138, 60, 98, 1, 0, 297, 0.666626
half-size-inner-coef, 137, 60, 101, 1, 0, 299, 0.666626
half-size-inner-coef, 138, 62, 99, 1, 0, 300, 0.666626
half-size-inner-coef, 140, 70, 112, 1, 0, 323, 0.666626
half-size-inner-coef, 148, 64, 107, 1, 0, 320, 0.666626
half-size-inner-coef, 136, 61, 97, 1, 0, 295, 0.666626
half-size-inner-coef, 137, 62, 97, 1, 0, 297, 0.666626
half-size-inner-coef, 136, 62, 98, 1, 0, 297, 0.666626
half-size-inner-coef, 142, 61, 98, 1, 0, 302, 0.666626
half-size-inner-coef, 138, 61, 98, 1, 0, 298, 0.666626
half-size-inner-coef, 135, 62, 100, 1, 0, 298, 0.666626
half-size-inner-coef, 144, 61, 98, 1, 0, 304, 0.666626
half-size-inner-coef, 143, 62, 101, 1, 0, 307, 0.666626
half-size-inner-coef, 144, 61, 100, 1, 0, 306, 0.666626
half-size-inner-coef, 136, 61, 103, 1, 0, 301, 0.666626
half-size-inner-coef, 135, 60, 99, 1, 0, 295, 0.666626
half-size-inner-coef, 134, 62, 99, 1, 0, 296, 0.666626
half-size-inner-coef, 138, 61, 103, 1, 0, 303, 0.666626
half-size-inner-coef, 139, 65, 98, 1, 0, 303, 0.666626
half-size-inner-coef, 138, 60, 100, 1, 0, 299, 0.666626
half-size-inner-coef, 139, 62, 100, 1, 0, 302, 0.666626
half-size-inner-coef, 140, 60, 97, 1, 0, 298, 0.666626
half-size-inner-coef, 138, 61, 98, 1, 0, 298, 0.666626
half-size-inner-coef, 144, 62, 102, 1, 0, 309, 0.666626
half-size-inner-coef, 153, 61, 101, 1, 0, 316, 0.666626
half-size-inner-coef, 144, 60, 99, 1, 0, 304, 0.666626
half-size-inner-coef, 137, 61, 97, 1, 0, 296, 0.666626
half-size-inner-coef, 140, 61, 97, 1, 0, 299, 0.666626
half-size-inner-coef, 141, 63, 101, 1, 0, 306, 0.666626
half-size-inner-coef, 134, 63, 99, 1, 0, 297, 0.666626
half-size-inner-coef, 141, 63, 97, 1, 0, 302, 0.666626
half-size-inner-coef, 137, 60, 95, 1, 0, 293, 0.666626
half-size-inner-coef, 146, 61, 103, 1, 0, 311, 0.666626
half-size-inner-coef, 140, 61, 96, 1, 0, 298, 0.666626
half-size-inner-coef, 138, 61, 97, 1, 0, 297, 0.666626
half-size-inner-coef, 152, 61, 102, 1, 0, 316, 0.666626
half-size-inner-coef, 138, 61, 106, 1, 0, 306, 0.666626
half-size-inner-coef, 135, 65, 99, 1, 0, 300, 0.666626
half-size-inner-coef, 143, 61, 98, 1, 0, 303, 0.666626
half-size-inner-coef, 140, 61, 100, 1, 0, 302, 0.666626
half-size-inner-coef, 135, 60, 97, 1, 0, 293, 0.666626
half-size-inner-coef, 141, 61, 103, 1, 0, 306, 0.666626
half-size-inner-coef, 146, 62, 99, 1, 0, 308, 0.666626
half-size-inner-coef, 145, 60, 100, 1, 0, 306, 0.666626
half-size-inner-coef, 143, 62, 98, 1, 0, 304, 0.666626
half-size-inner-coef, 137, 62, 98, 1, 0, 298, 0.666626
half-size-inner-coef, 138, 61, 101, 1, 0, 301, 0.666626
half-size-inner-coef, 141, 62, 101, 1, 0, 305, 0.666626
half-size-inner-coef, 138, 62, 98, 1, 0, 299, 0.666626
half-size-inner-coef, 137, 61, 105, 1, 0, 304, 0.666626
half-size-inner-coef, 136, 60, 98, 1, 0, 295, 0.666626
half-size-inner-coef, 135, 63, 99, 1, 0, 298, 0.666626
half-size-inner-coef, 141, 61, 97, 1, 0, 300, 0.666626
half-size-inner-coef, 137, 61, 97, 1, 0, 296, 0.666626
half-size-inner-coef, 138, 61, 97, 1, 0, 297, 0.666626
half-size-inner-coef, 145, 64, 97, 1, 0, 307, 0.666626
half-size-inner-coef, 145, 62, 101, 1, 0, 309, 0.666626
half-size-inner-coef, 137, 61, 98, 1, 0, 297, 0.666626
half-size-inner-coef, 138, 61, 98, 1, 0, 298, 0.666626
half-size-inner-coef, 140, 60, 98, 1, 0, 299, 0.666626
half-size-inner-coef, 140, 62, 98, 1, 0, 301, 0.666626
half-size-inner-coef, 140, 61, 98, 1, 0, 300, 0.666626
half-size-inner-coef, 138, 64, 98, 1, 0, 301, 0.666626
half-size-inner-coef, 136, 60, 96, 1, 0, 293, 0.666626
